ID,CNT_TBM,CNT_ATM,CNT_POS,CNT_CSC,CNT_TOT
41360,34,3,3,9,49
52094,44,17,5,18,84
57340,122,26,32,36,216
76885,42,3,6,1,52
89150,20,15,2,2,39
94512,83,20,49,3,155
96396,33,9,49,17,108
98062,22,5,9,1,37
122779,21,27,2,1,51
125838,127,3,2,3,135
137317,52,20,2,11,85
147896,101,40,8,1,150
150206,156,52,80,4,292
160501,31,32,42,12,117
176820,107,3,2,1,113
187784,54,14,7,24,99
189200,92,3,2,2,99
198327,44,27,17,3,91
200237,146,3,2,1,152
207980,39,5,2,4,50
227355,180,3,2,10,195
228317,46,14,2,1,63
228906,25,3,2,1,31
229984,15,3,2,1,21
241022,13,3,2,1,19
253260,65,3,2,1,71
257910,35,3,2,1,41
261717,11,5,2,1,19
266600,15,3,2,1,21
269176,107,78,22,7,214
273510,110,15,6,21,152
302929,13,3,2,1,19
311940,16,15,16,1,48
341023,55,21,2,1,79
347091,17,14,7,1,39
375426,32,3,2,3,40
388852,18,3,2,1,24
404194,73,11,37,6,127
414364,49,11,2,1,63
417191,122,25,19,7,173
417996,133,27,7,1,168
420459,25,3,2,1,31
427493,27,31,39,52,149
434975,19,3,2,1,25
441474,19,3,2,1,25
469447,11,9,2,1,23
484515,59,36,2,10,107
489111,118,3,2,2,125
494168,199,3,2,1,205
504965,38,12,2,1,53
529476,76,3,2,1,82
548357,15,8,3,1,27
559012,76,3,2,1,82
599726,51,10,50,9,120
600359,112,24,28,5,169
629637,11,4,2,1,18
638213,166,14,6,3,189
641370,49,3,2,5,59
667651,93,22,27,3,145
696561,42,3,2,1,48
716261,60,46,2,1,109
755205,33,29,4,1,67
765932,186,50,12,18,266
766047,96,8,10,5,119
767265,12,6,2,1,21
772700,23,4,2,1,30
776709,40,3,2,1,46
778879,16,37,9,1,63
780357,51,24,2,1,78
785401,20,11,2,2,35
794342,191,21,2,11,225
803963,27,7,2,1,37
816976,14,5,2,1,22
858113,10,4,2,1,17
872299,119,13,17,15,164
891864,117,12,2,1,132
893304,14,11,3,1,29
899736,38,25,14,2,79
904410,16,4,2,1,23
942859,14,5,2,1,22
948961,211,21,4,1,237
964154,94,17,56,12,179
987437,17,3,2,1,23
993476,11,6,2,1,20
995997,188,5,2,2,197
997417,97,17,8,24,146
999996,25,85,15,6,131
1042998,17,3,2,2,24
1064704,1024,3,2,33,1062
1064731,20,37,2,2,61
1067051,79,18,2,5,104
1079463,12,3,2,1,18
1081759,53,21,23,55,152
1085242,94,7,2,1,104
1090812,227,28,76,26,357
1104403,49,3,2,1,55
1110480,190,3,2,11,206
1121453,25,11,24,26,86
1126673,51,19,2,8,80
1147225,54,36,37,19,146
1149223,25,32,3,3,63
1149433,27,3,2,1,33
1151911,81,88,86,46,301
1189420,14,37,38,1,90
1191887,107,38,60,5,210
1198314,11,3,2,1,17
1202405,18,14,8,2,42
1217236,77,13,2,2,94
1250537,102,23,32,20,177
1254942,170,95,40,12,317
1258533,157,8,2,3,170
1276424,19,7,2,1,29
1280471,194,31,4,1,230
1284276,13,3,2,1,19
1290045,91,3,2,17,113
1296079,66,4,2,4,76
1305374,35,53,70,10,168
1306224,180,3,2,27,212
1310114,58,3,2,9,72
1334535,11,3,2,1,17
1352356,71,38,2,10,121
1367745,15,3,2,3,23
1374288,64,23,40,29,156
1374351,87,35,23,24,169
1387608,12,3,2,1,18
1395604,67,14,3,1,85
1412859,66,14,70,1,151
1413185,60,14,18,4,96
1421269,93,3,2,1,99
1428714,83,12,4,12,111
1434126,67,36,43,12,158
1439866,117,67,3,2,189
1443044,95,8,2,2,107
1454002,569,3,2,8,582
1471061,72,3,2,1,78
1471421,39,16,2,9,66
1479999,22,28,2,1,53
1499528,10,8,2,1,21
1515549,10,3,2,2,17
1518124,20,3,2,3,28
1522816,345,51,2,16,414
1530597,81,24,4,1,110
1532078,12,3,2,1,18
1541975,10,28,2,1,41
1558803,78,18,4,1,101
1566186,43,21,56,41,161
1569261,11,15,2,5,33
1572913,11,3,3,1,18
1578231,22,8,2,8,40
1581108,18,25,2,1,46
1581133,26,15,4,2,47
1583756,55,3,2,2,62
1592143,123,3,2,2,130
1603893,34,3,2,1,40
1617077,51,16,2,2,71
1620381,199,3,2,2,206
1621870,420,3,2,2,427
1636631,287,20,26,9,342
1654868,99,29,26,1,155
1662817,207,60,2,6,275
1665107,35,33,2,21,91
1666169,12,8,2,1,23
1676184,33,12,2,8,55
1696116,36,31,12,1,80
1707667,11,8,2,1,22
1707701,103,29,87,1,220
1712039,52,41,21,25,139
1720618,32,3,2,1,38
1721703,100,40,2,5,147
1727701,13,3,2,2,20
1727767,37,3,2,6,48
1731937,39,18,2,9,68
1745202,52,51,16,15,134
1747537,10,13,2,2,27
1762053,16,12,6,1,35
1777852,27,41,11,1,80
1780971,39,51,131,40,261
1806221,86,22,40,11,159
1807957,19,59,2,1,81
1809028,114,3,2,1,120
1820979,14,3,2,1,20
1828853,105,19,2,2,128
1829210,38,26,37,1,102
1858358,11,5,2,1,19
1860885,59,45,2,2,108
1861100,138,15,16,26,195
1878860,13,4,2,1,20
1888294,53,3,2,1,59
1940864,31,6,2,1,40
1945099,23,3,16,18,60
1951315,14,4,2,1,21
1955596,56,3,2,5,66
1963038,21,7,2,1,31
1964627,44,99,15,12,170
1993530,18,25,3,1,47
1994437,23,3,2,1,29
1994655,46,44,33,10,133
1999565,110,3,2,5,120
2009292,26,53,14,7,100
2010470,11,3,2,2,18
2011568,691,3,2,7,703
2012422,66,14,54,1,135
2016078,68,3,2,3,76
2022296,72,3,2,2,79
2039975,119,3,4,11,137
2042837,14,3,2,1,20
2043101,20,3,2,1,26
2044626,80,25,2,4,111
2049108,88,21,28,1,138
2049466,37,26,4,5,72
2051398,30,3,2,1,36
2053325,280,3,2,6,291
2058059,118,31,31,3,183
2076704,12,3,2,3,20
2078336,70,29,2,1,102
2079352,22,94,2,1,119
2086295,68,19,43,9,139
2100641,33,58,20,1,112
2119525,65,46,2,1,114
2123114,11,3,2,3,19
2128617,55,56,2,1,114
2141189,148,21,7,11,187
2142497,172,3,2,1,178
2142687,27,41,22,7,97
2159766,129,3,17,1,150
2166117,113,95,5,3,216
2171584,38,3,2,1,44
2172173,27,65,22,1,115
2174463,149,57,23,63,292
2174621,64,47,2,42,155
2184535,72,3,2,1,78
2193607,35,4,2,1,42
2203937,75,13,2,2,92
2214035,41,15,3,1,60
2239614,86,3,2,1,92
2251545,77,24,2,2,105
2255606,47,81,20,3,151
2296447,41,4,2,4,51
2301285,92,44,2,6,144
2336432,17,3,2,1,23
2381349,41,81,8,1,131
2381883,84,20,2,1,107
2397047,94,15,2,8,119
2418071,17,6,2,1,26
2419818,36,16,4,12,68
2463136,97,31,2,1,131
2469729,41,65,2,2,110
2472254,88,18,29,11,146
2494149,20,3,2,1,26
2498151,42,16,2,8,68
2511506,11,3,2,1,17
2516018,50,3,2,1,56
2516671,10,3,2,2,17
2517396,173,3,2,2,180
2519748,39,30,5,47,121
2528621,54,31,2,2,89
2529653,132,7,45,6,190
2530328,168,37,11,27,243
2536981,47,3,2,1,53
2543875,58,8,41,6,113
2550206,39,49,5,28,121
2552229,29,7,2,1,39
2574623,40,31,8,1,80
2586148,43,3,2,16,64
2591748,266,22,2,5,295
2604858,16,4,2,4,26
2622224,10,27,2,1,40
2648266,45,3,2,14,64
2672464,57,23,8,92,180
2700454,59,3,2,1,65
2704645,111,16,2,1,130
2708921,97,3,2,1,103
2709673,100,52,91,32,275
2714850,12,8,3,1,24
2715437,41,67,33,1,142
2734190,29,52,5,38,124
2744422,13,21,2,1,37
2747685,28,3,2,5,38
2756805,162,28,18,1,209
2761016,27,63,45,1,136
2771129,56,19,2,1,78
2772688,66,23,10,69,168
2789363,22,30,33,1,86
2804407,16,9,2,4,31
2813265,58,3,12,1,74
2815364,130,20,8,5,163
2826153,13,27,2,1,43
2837748,62,3,15,1,81
2838728,121,10,10,72,213
2863568,55,9,2,1,67
2864040,56,9,16,4,85
2869933,98,6,2,1,107
2873069,36,12,88,7,143
2875167,10,8,2,1,21
2898953,69,8,2,46,125
2909512,25,5,20,2,52
2927709,11,4,2,1,18
2933858,67,41,55,3,166
2934967,16,30,2,1,49
2940044,33,10,2,2,47
2940910,45,3,2,1,51
2949926,28,17,10,5,60
2956559,61,4,2,5,72
2969496,117,53,77,8,255
2979761,87,6,2,13,108
2983586,98,42,2,3,145
3006203,86,13,2,1,102
3007114,47,5,25,1,78
3018775,19,9,2,3,33
3034106,81,5,41,29,156
3048431,100,15,2,1,118
3068317,63,15,2,7,87
3078118,86,20,5,3,114
3083980,22,9,12,3,46
3085966,30,3,2,1,36
3091112,10,23,2,1,36
3092038,106,3,2,13,124
3100050,146,19,8,4,177
3107769,53,3,2,1,59
3110787,95,16,33,4,148
3114345,30,3,2,14,49
3119357,13,47,3,1,64
3158393,21,3,2,1,27
3163044,42,3,2,1,48
3172649,75,19,13,1,108
3184140,165,74,5,9,253
3197042,33,13,9,7,62
3204130,147,53,35,2,237
3204378,40,21,20,1,82
3219205,70,3,2,15,90
3219926,32,24,13,20,89
3230329,175,37,62,3,277
3230961,45,9,20,16,90
3231102,15,3,2,1,21
3236646,22,4,4,3,33
3237259,69,3,32,2,106
3248214,195,27,3,1,226
3254556,63,10,2,2,77
3255426,22,3,2,3,30
3280310,51,55,35,167,308
3282981,116,3,2,1,122
3293431,14,3,2,2,21
3296586,121,15,39,18,193
3300085,225,3,2,1,231
3321043,26,3,2,1,32
3325447,28,72,7,9,116
3332642,24,31,15,1,71
3332702,35,10,2,3,50
3339091,23,3,2,1,29
3365257,55,20,3,8,86
3366718,105,14,7,1,127
3372355,79,6,2,1,88
3376732,111,3,2,49,165
3386514,68,20,60,14,162
3403371,13,57,4,2,76
3419466,18,34,2,1,55
3435507,70,50,2,3,125
3443114,11,3,2,1,17
3444328,65,27,3,2,97
3445676,31,3,2,7,43
3454944,92,84,31,13,220
3490950,69,56,29,4,158
3493676,27,19,2,1,49
3497175,10,24,2,1,37
3503705,20,16,2,3,41
3509924,72,8,12,11,103
3511040,12,3,2,1,18
3520200,100,40,2,1,143
3524070,11,3,2,1,17
3529615,22,3,2,1,28
3548384,38,8,2,5,53
3549678,24,10,2,12,48
3558902,65,13,24,4,106
3562471,69,3,2,6,80
3610605,24,35,4,14,77
3614767,16,6,2,2,26
3636249,36,22,13,4,75
3637841,21,21,6,1,49
3647503,168,3,2,1,174
3652869,241,67,178,16,502
3652961,93,48,20,3,164
3673625,86,3,2,1,92
3676430,94,3,2,1,100
3681058,16,3,2,1,22
3681943,153,32,20,1,206
3686296,37,27,2,1,67
3697329,78,44,8,6,136
3698020,45,67,60,7,179
3703187,121,10,2,1,134
3704582,67,42,79,52,240
3706725,17,3,2,6,28
3713250,26,16,2,1,45
3715341,14,3,2,1,20
3723302,19,3,2,1,25
3730657,62,40,2,11,115
3733019,33,17,4,7,61
3733044,12,3,2,1,18
3736834,320,3,2,5,330
3739674,11,3,2,1,17
3746299,10,3,2,2,17
3760680,14,3,2,1,20
3761949,40,21,2,1,64
3764385,41,3,2,1,47
3769076,16,3,2,1,22
3770761,20,4,2,1,27
3775537,39,20,4,1,64
3791045,161,41,26,1,229
3805801,53,3,2,3,61
3814263,16,3,2,1,22
3823666,13,5,2,1,21
3826997,57,14,2,3,76
3845881,70,9,7,9,95
3860067,87,32,9,3,131
3877826,87,3,2,14,106
3901981,12,14,2,1,29
3904411,62,18,136,1,217
3918802,40,57,2,2,101
3923715,54,3,2,1,60
3938809,35,32,6,1,74
3940482,46,11,32,1,90
3944533,53,29,40,12,134
3944823,52,45,23,1,121
3961002,12,3,2,1,18
3962709,48,6,2,3,59
3981811,92,3,2,1,98
3988127,229,4,16,2,251
3990329,56,9,13,7,85
4006604,55,3,2,2,62
4008610,19,3,2,3,27
4037483,11,10,15,1,37
4039095,35,3,2,16,56
4050587,11,3,2,1,17
4055805,44,3,12,4,63
4067464,20,10,4,5,39
4085582,15,12,2,1,30
4099855,14,6,2,3,25
4116239,121,24,39,4,188
4124685,106,22,130,13,271
4137674,21,3,2,1,27
4140371,92,21,15,3,131
4141067,33,3,2,1,39
4143444,239,20,62,58,379
4145526,25,32,6,3,66
4160887,22,18,41,1,82
4161045,36,39,36,1,112
4161639,157,56,159,41,413
4163245,13,3,2,6,24
4164984,47,19,41,25,132
4170019,20,3,2,4,29
4170691,76,15,2,13,106
4174839,166,3,2,1,172
4210383,136,44,3,8,191
4212879,82,24,4,4,114
4212883,15,17,3,10,45
4216286,88,21,2,1,112
4217946,74,5,6,1,86
4220963,56,24,2,9,91
4221948,40,3,2,1,46
4247149,11,5,2,1,19
4252609,172,13,2,12,199
4262249,145,29,16,3,193
4263851,54,36,20,1,111
4274249,50,3,2,3,58
4279436,37,25,10,25,97
4297758,19,10,2,1,32
4315992,15,3,2,1,21
4316865,11,3,2,1,17
4324827,85,13,2,18,118
4332174,92,3,2,6,103
4335756,183,50,9,1,243
4354438,46,3,2,7,58
4358514,88,41,18,77,224
4362065,18,24,5,61,108
4363682,48,5,2,1,56
4370040,85,3,2,18,108
4371284,11,3,2,1,17
4372477,11,3,2,1,17
4379405,57,47,11,1,116
4380529,62,19,2,6,89
4385632,20,12,19,1,52
4385908,33,20,5,1,59
4405743,12,3,2,1,18
4408788,75,44,2,11,132
4411880,14,4,2,1,21
4424349,64,19,2,36,121
4447833,58,21,2,1,82
4450166,72,12,2,4,90
4454398,14,18,7,7,46
4469820,76,3,2,1,82
4470172,23,33,2,1,59
4473280,93,3,2,6,104
4479857,65,48,11,4,128
4480103,58,16,2,19,95
4515312,40,30,3,8,81
4523775,78,34,2,2,116
4527828,92,3,2,1,98
4547186,76,53,4,1,134
4548575,75,32,9,1,117
4560042,126,58,27,4,215
4574039,42,28,7,1,78
4582500,185,60,19,5,269
4582954,64,28,5,30,127
4590727,24,14,7,19,64
4593890,126,3,2,2,133
4612708,40,13,2,7,62
4613187,42,29,30,9,110
4618929,39,75,2,2,118
4631551,27,54,38,13,132
4647944,99,10,3,2,114
4650193,59,33,19,1,112
4655091,74,15,2,5,96
4686142,13,3,2,1,19
4691929,21,15,6,1,43
4699769,11,3,2,1,17
4700420,48,5,2,5,60
4709553,194,3,2,5,204
4714663,40,25,2,1,68
4724799,45,39,31,74,189
4750267,85,11,2,3,101
4754068,139,3,2,3,147
4770779,19,3,2,1,25
4776028,55,3,2,1,61
4780128,77,14,49,4,144
4790485,221,117,52,1,391
4813425,22,3,2,2,29
4816502,70,27,10,15,122
4823061,82,3,2,1,88
4824521,64,33,20,17,134
4825648,14,11,2,1,28
4834253,126,3,2,19,150
4843711,15,11,2,1,29
4845004,56,30,69,1,156
4850663,11,6,2,1,20
4854162,85,37,28,1,151
4859205,24,22,30,11,87
4859949,32,61,2,5,100
4862517,25,8,2,4,39
4870052,18,15,3,1,37
4874678,76,3,2,1,82
4900023,112,20,14,4,150
4906965,17,3,2,1,23
4927896,51,4,2,3,60
4943660,16,3,2,3,24
4945870,39,4,2,51,96
4946958,15,29,2,1,47
4950969,58,4,65,4,131
4954659,66,34,21,15,136
4957353,119,51,2,24,196
4976283,67,30,17,19,133
4999541,37,34,21,10,102
5004198,20,3,2,1,26
5020680,123,32,2,10,167
5021794,135,39,3,7,184
5024256,117,12,94,1,224
5026220,98,18,75,1,192
5030519,97,3,2,2,104
5032307,10,6,2,1,19
5034859,102,9,32,7,150
5055272,144,3,2,2,151
5065897,11,3,2,1,17
5068087,206,5,5,4,220
5070515,89,47,2,1,139
5074472,50,59,14,26,149
5080204,64,54,3,1,122
5091524,48,23,19,3,93
5093894,24,3,2,3,32
5124690,90,3,2,1,96
5129404,123,13,2,2,140
5152831,13,7,2,1,23
5158931,87,20,28,2,137
5169272,159,3,2,1,165
5170054,85,12,3,4,104
5175664,91,3,2,8,104
5182376,10,6,2,1,19
5185167,99,14,2,10,125
5186546,24,3,2,5,34
5216982,36,44,2,10,92
5226604,61,15,3,6,85
5228616,10,3,2,3,18
5230017,23,13,2,1,39
5231104,75,65,8,12,160
5235797,116,15,2,2,135
5240049,12,3,2,3,20
5246730,18,17,2,1,38
5248795,20,60,2,1,83
5276388,30,29,17,1,77
5288944,15,3,2,1,21
5301980,20,9,2,1,32
5311968,20,3,2,2,27
5316484,14,13,2,1,30
5327806,11,9,2,1,23
5342521,109,21,99,1,230
5350616,23,40,2,1,66
5352574,101,7,2,1,111
5353116,68,3,2,1,74
5356122,168,3,2,9,182
5361366,55,3,2,1,61
5364731,12,6,2,1,21
5367144,10,7,2,1,20
5383633,14,39,2,2,57
5401753,53,8,2,1,64
5403921,49,32,38,3,122
5407900,80,15,2,6,103
5408543,11,3,2,1,17
5420820,28,15,3,1,47
5429501,21,3,2,1,27
5431767,74,3,2,1,80
5434155,58,11,2,4,75
5449796,71,5,31,3,110
5463882,38,3,2,1,44
5468334,14,14,2,1,31
5471074,28,3,2,1,34
5512484,12,3,2,1,18
5538315,57,29,14,25,125
5545798,10,5,2,1,18
5574319,40,38,25,11,114
5587535,35,44,63,19,161
5589358,118,27,2,35,182
5595127,37,11,2,2,52
5596776,23,83,2,2,110
5614068,10,27,2,1,40
5636245,151,5,2,2,160
5645546,140,28,2,1,171
5655974,98,3,2,1,104
5667886,312,7,2,31,352
5674387,43,3,2,1,49
5694082,61,18,57,40,176
5715024,67,6,13,12,98
5715982,14,3,2,4,23
5719245,11,3,2,1,17
5722959,14,4,2,2,22
5733390,73,4,2,5,84
5743574,34,3,2,1,40
5743680,46,17,2,1,66
5768343,45,51,13,7,116
5781981,169,13,51,10,243
5787637,14,5,2,1,22
5797901,20,11,2,1,34
5821116,29,14,2,1,46
5838950,10,3,2,9,24
5879207,130,11,26,11,178
5891509,92,3,2,1,98
5891798,168,11,2,5,186
5897615,40,44,10,15,109
5898819,17,6,2,1,26
5904781,48,3,2,1,54
5921933,158,8,2,15,183
5929366,145,18,11,20,194
5936225,33,22,2,2,59
5938792,60,3,2,1,66
5947139,109,34,2,9,154
5959999,19,3,2,6,30
5960310,14,3,2,1,20
5962547,173,45,33,5,256
5963289,12,3,2,3,20
5988584,127,63,68,51,309
5996230,14,7,2,5,28
6005129,44,11,23,2,80
6027462,137,16,40,10,203
6028466,13,3,2,1,19
6053411,15,3,2,1,21
6066463,76,3,2,2,83
6088443,90,34,97,22,243
6095023,95,3,2,26,126
6100366,49,61,5,1,116
6101146,94,7,2,15,118
6106396,16,3,2,2,23
6123151,81,50,39,11,181
6126487,109,3,2,1,115
6134783,28,27,5,7,67
6134834,92,3,2,1,98
6147352,25,3,2,8,38
6148334,96,16,13,1,126
6173192,39,26,33,8,106
6173817,67,26,2,1,96
6183510,16,3,2,1,22
6190226,114,3,2,1,120
6199884,158,9,65,2,234
6218314,74,7,2,1,84
6221087,49,18,3,2,72
6221915,91,13,47,40,191
6228684,48,9,2,3,62
6229044,65,52,57,9,183
6232238,20,28,2,4,54
6246082,27,6,2,6,41
6259914,50,18,12,1,81
6265388,13,3,2,3,21
6269892,10,22,2,1,35
6275875,13,12,2,8,35
6281037,75,26,4,1,106
6305036,23,19,4,1,47
6321999,51,3,2,5,61
6337996,33,6,2,1,42
6340164,62,79,3,2,146
6344404,20,3,2,1,26
6346173,20,88,3,3,114
6352345,98,50,10,65,223
6354617,94,64,3,19,180
6364895,12,3,2,1,18
6373229,67,62,18,21,168
6374960,10,5,2,4,21
6383760,14,3,2,1,20
6383764,92,3,2,1,98
6390442,70,3,2,11,86
6398052,85,8,2,2,97
6403461,32,3,2,1,38
6410290,209,5,73,3,290
6431994,93,35,52,9,189
6438306,45,3,2,1,51
6438667,101,8,18,4,131
6459162,18,46,2,1,67
6460103,87,4,3,4,98
6463170,71,3,26,2,102
6475662,42,21,63,1,127
6478944,33,3,2,1,39
6493738,64,28,27,11,130
6502096,31,18,2,6,57
6503980,16,3,2,1,22
6512107,45,4,2,8,59
6518878,73,8,9,3,93
6534580,32,3,2,2,39
6545851,49,3,2,1,55
6556738,13,3,2,1,19
6570701,342,3,2,11,358
6590792,27,3,2,1,33
6617637,54,80,26,11,171
6618876,36,6,2,5,49
6621006,58,3,2,2,65
6631179,17,9,7,1,34
6634044,67,40,9,18,134
6649083,25,42,2,9,78
6651015,122,3,2,1,128
6663310,27,3,2,1,33
6664932,26,3,2,1,32
6670408,53,17,32,1,103
6684287,16,3,2,1,22
6696584,156,46,2,40,244
6699456,27,3,2,3,35
6706133,14,17,5,1,37
6719604,43,16,59,28,146
6721301,129,7,2,5,143
6730610,86,3,2,1,92
6766196,30,3,2,1,36
6771829,10,42,11,1,64
6772934,136,19,49,2,206
6782232,87,3,2,1,93
6794044,27,3,2,1,33
6813931,38,7,2,4,51
6818724,11,3,2,1,17
6820319,48,33,36,12,129
6827523,155,3,2,6,166
6829794,97,3,2,6,108
6847104,83,6,19,1,109
6851012,51,3,2,1,57
6856487,72,32,15,5,124
6877624,34,40,2,1,77
6881969,39,27,3,6,75
6882571,23,3,2,2,30
6885806,10,10,2,2,24
6891696,77,6,4,9,96
6892180,64,18,9,14,105
6933198,22,11,2,9,44
6969621,99,6,2,1,108
6978906,79,13,4,1,97
6986636,41,42,2,2,87
7004737,110,13,79,5,207
7005599,17,3,2,1,23
7030482,121,22,99,2,244
7034417,41,41,49,1,132
7034794,18,3,2,1,24
7048498,58,42,5,6,111
7058270,38,3,2,4,47
7065182,23,27,19,23,92
7065770,99,17,2,1,119
7069081,74,26,68,2,170
7070072,87,3,2,1,93
7080415,23,3,23,4,53
7087031,11,6,2,1,20
7093989,152,66,6,7,231
7103845,193,17,2,8,220
7104586,73,3,4,1,81
7115287,58,3,2,10,73
7115651,29,3,5,10,47
7119926,12,14,2,1,29
7123554,42,51,12,2,107
7144697,427,3,2,3,435
7154773,88,24,3,1,116
7155167,643,3,2,79,727
7172443,30,22,3,7,62
7182917,100,3,2,3,108
7186759,49,19,21,2,91
7187918,28,3,2,1,34
7188621,62,22,13,3,100
7195775,161,3,2,1,167
7210140,75,32,23,11,141
7221235,85,22,30,10,147
7224231,10,5,2,1,18
7231409,102,22,22,1,147
7235558,11,3,2,1,17
7239570,14,3,2,1,20
7242727,50,87,2,25,164
7242878,44,8,24,2,78
7264898,70,18,74,1,163
7266002,87,3,2,1,93
7273827,71,16,48,1,136
7279774,75,31,2,3,111
7280982,24,9,2,1,36
7290296,113,40,2,1,156
7304866,111,15,42,5,173
7307561,58,4,2,2,66
7308758,48,21,2,2,73
7324007,39,33,41,1,114
7330675,29,9,24,4,66
7346679,10,4,2,1,17
7379222,73,22,2,1,98
7388564,80,3,2,4,89
7395571,17,37,2,1,57
7399103,175,30,19,8,232
7402273,23,10,8,11,52
7416272,87,9,57,12,165
7416531,59,3,2,15,79
7424109,11,3,2,4,20
7428848,41,8,5,3,57
7438406,61,6,6,14,87
7452129,146,10,2,1,159
7452409,49,3,2,15,69
7457277,156,35,19,9,219
7465736,73,26,2,11,112
7476155,19,34,12,6,71
7477917,63,3,2,15,83
7479601,212,3,2,11,228
7480269,194,4,35,6,239
7483083,88,23,61,23,195
7491834,154,21,18,1,194
7498788,93,3,2,1,99
7509526,60,36,26,30,152
7541689,127,16,2,9,154
7550360,24,45,14,1,84
7556686,68,5,2,1,76
7560277,81,20,34,14,149
7575850,59,3,2,1,65
7580976,14,3,2,1,20
7586100,46,39,21,4,110
7611633,79,5,2,2,88
7634208,25,24,6,1,56
7635396,47,68,32,26,173
7638889,17,14,2,18,51
7657640,55,63,14,47,179
7663830,31,16,10,1,58
7681060,134,17,2,5,158
7689318,109,78,46,6,239
7690868,16,22,14,1,53
7694791,15,3,2,6,26
7695234,150,16,137,28,331
7708908,10,26,2,1,39
7724595,53,3,2,9,67
7729185,125,37,91,1,254
7756882,55,11,7,2,75
7757891,77,23,26,1,127
7759078,11,3,2,1,17
7759422,49,48,12,58,167
7759552,91,29,14,11,145
7760977,48,3,49,18,118
7761004,66,10,2,2,80
7794711,31,26,2,22,81
7807689,32,30,2,1,65
7811192,43,31,2,10,86
7816193,41,46,45,2,134
7820689,16,18,2,1,37
7826559,11,6,6,2,25
7835547,76,3,2,1,82
7844415,60,69,30,34,193
7857307,127,35,18,10,190
7862905,111,40,3,1,155
7890757,110,34,7,1,152
7897148,14,3,2,3,22
7907767,10,3,2,2,17
7908447,40,10,2,9,61
7910200,80,3,2,2,87
7918256,49,22,32,11,114
7919698,96,26,18,16,156
7944786,50,33,29,2,114
7953271,231,14,3,7,255
7963789,48,66,48,13,175
7994079,172,14,5,3,194
8008082,14,3,2,1,20
8026799,12,16,2,1,31
8039613,59,10,18,8,95
8043273,14,3,2,1,20
8050024,38,8,4,14,64
8064237,167,16,26,15,224
8073519,10,3,2,3,18
8118392,32,75,2,2,111
8137415,228,3,2,3,236
8141472,25,3,2,6,36
8153534,93,3,2,2,100
8164316,92,6,16,1,115
8167863,130,31,57,17,235
8173977,32,3,2,1,38
8183982,31,57,14,1,103
8192851,26,18,2,3,49
8198209,81,59,7,4,151
8209540,22,27,3,1,53
8215033,10,22,2,2,36
8227150,63,3,2,1,69
8245031,161,22,18,4,205
8246886,22,17,10,1,50
8253932,10,5,2,5,22
8254894,19,3,2,1,25
8257435,64,19,26,5,114
8272368,17,15,2,1,35
8282820,106,19,21,9,155
8289507,21,18,2,1,42
8295548,55,8,2,2,67
8303507,12,3,2,2,19
8305532,15,7,2,1,25
8306146,40,19,6,14,79
8310189,111,18,66,16,211
8312264,21,26,14,1,62
8322088,20,10,8,8,46
8348377,52,23,2,5,82
8364014,22,16,2,1,41
8367987,61,72,11,2,146
8370909,17,15,2,1,35
8385164,92,3,2,1,98
8401887,53,7,2,3,65
8405924,199,12,22,1,234
8410472,10,9,2,1,22
8420320,14,25,8,13,60
8424745,91,3,2,1,97
8425580,10,3,2,5,20
8438917,47,22,2,1,72
8441940,11,3,2,1,17
8449363,39,30,72,103,244
8453047,91,3,2,1,97
8454318,16,5,2,8,31
8455051,438,3,2,14,457
8458364,101,3,2,1,107
8463589,80,13,22,3,118
8472149,135,3,2,1,141
8482352,194,5,2,1,202
8492312,13,11,2,2,28
8496831,90,3,2,1,96
8504011,143,35,62,20,260
8536262,85,6,5,7,103
8538856,44,3,3,1,51
8539614,75,3,2,1,81
8550962,19,9,3,5,36
8555152,64,3,2,1,70
8558875,53,6,4,2,65
8559796,140,22,20,14,196
8575315,30,21,6,5,62
8578369,222,8,3,1,234
8600924,11,3,2,1,17
8604621,201,7,2,20,230
8608115,94,9,74,29,206
8617930,15,3,2,1,21
8631462,88,9,6,1,104
8639110,145,3,2,2,152
8639606,18,7,2,8,35
8645509,75,23,155,18,271
8657894,17,3,2,1,23
8664217,56,73,3,1,133
8689676,133,40,2,1,176
8704979,12,4,2,1,19
8728944,27,56,7,3,93
8742169,153,3,2,2,160
8748134,47,57,5,2,111
8758138,56,4,2,5,67
8770274,31,3,2,1,37
8772850,88,21,20,14,143
8778223,83,35,2,2,122
8783235,130,33,3,21,187
8791851,59,9,40,13,121
8800843,59,25,31,3,118
8803556,49,27,16,21,113
8806327,67,3,2,1,73
8814459,150,39,2,1,192
8818024,33,14,34,1,82
8821206,52,29,25,1,107
8822161,80,25,2,1,108
8839132,14,3,2,1,20
8840705,78,52,17,18,165
8847866,30,30,2,4,66
8853248,121,6,2,8,137
8895425,87,13,2,1,103
8901610,123,27,13,8,171
8902283,44,3,2,6,55
8910108,27,15,6,5,53
8915310,103,3,2,2,110
8921514,48,27,16,29,120
8934699,18,3,2,2,25
8940170,123,73,45,2,243
8968500,17,6,2,1,26
8992829,65,22,17,63,167
8996356,21,3,2,1,27
9008446,59,60,3,3,125
9024725,32,56,21,1,110
9025421,109,90,22,11,232
9041487,13,5,5,1,24
9047898,17,49,2,1,69
9070344,58,12,2,13,85
9071247,69,29,2,4,104
9076057,24,3,2,1,30
9081200,233,3,2,1,239
9092790,13,6,35,7,61
9100982,579,3,2,25,609
9117587,13,3,2,1,19
9121714,37,32,3,1,73
9124112,458,3,2,7,470
9126545,58,40,7,25,130
9142606,10,3,2,2,17
9155557,77,34,3,9,123
9155594,15,9,10,1,35
9169882,124,47,2,42,215
9174942,24,10,2,1,37
9183772,15,3,2,1,21
9187006,21,4,3,1,29
9187986,47,3,2,1,53
9193113,142,68,2,15,227
9204490,125,18,113,36,292
9214434,43,20,38,2,103
9231616,14,3,2,2,21
9235568,10,3,2,2,17
9251866,21,13,5,4,43
9264372,139,32,2,5,178
9267383,53,19,53,2,127
9268581,28,38,24,1,91
9275671,118,15,29,1,163
9291585,58,3,2,1,64
9311638,36,5,2,12,55
9335398,31,3,2,4,40
9337857,62,33,40,23,158
9345625,13,5,2,1,21
9348455,12,3,2,1,18
9354211,31,22,2,2,57
9363321,12,5,2,1,20
9389912,10,12,2,1,25
9391879,56,57,2,6,121
9409898,115,22,15,1,153
9413540,21,14,2,1,38
9425306,54,31,21,19,125
9440472,10,4,2,1,17
9450066,166,33,197,3,399
9467292,224,3,2,1,230
9472143,29,30,38,1,98
9497041,128,37,23,10,198
9503029,179,14,84,9,286
9505342,183,35,2,4,224
9506764,62,21,49,18,150
9512437,133,61,12,3,209
9527476,11,3,2,1,17
9529959,148,29,2,5,184
9545675,116,3,2,1,122
9547827,248,3,2,1,254
9562829,22,10,2,2,36
9564794,51,18,3,29,101
9570638,25,60,2,1,88
9576892,10,7,2,1,20
9579513,46,28,6,9,89
9592579,37,20,2,1,60
9603521,53,12,7,4,76
9625332,36,3,2,2,43
9629973,336,19,15,7,377
9634811,36,22,3,4,65
9650908,29,40,10,5,84
9656895,165,3,2,4,174
9661773,12,6,2,1,21
9667330,126,3,2,25,156
9667588,30,3,2,1,36
9669942,63,15,2,13,93
9687697,101,3,2,1,107
9704140,72,210,70,20,372
9723058,14,3,2,1,20
9724030,20,25,27,2,74
9737175,58,11,2,12,83
9739875,29,35,3,1,68
9740555,41,42,18,4,105
9753674,83,22,2,4,111
9758570,226,9,4,2,241
9763883,10,3,2,2,17
9765374,28,45,2,1,76
9777409,88,43,5,6,142
9785437,30,29,4,6,69
9785755,37,63,4,2,106
9806512,25,3,2,1,31
9834445,65,64,52,13,194
9836548,82,12,2,1,97
9845651,234,67,2,5,308
9852301,90,51,3,2,146
9853124,47,3,2,1,53
9866328,15,3,2,1,21
9868410,11,3,2,1,17
9883410,16,3,2,1,22
9886761,17,3,2,1,23
9902678,14,3,2,1,20
9908628,93,3,2,2,100
9930258,54,17,2,2,75
9930468,299,3,2,1,305
9936504,88,11,26,4,129
9961755,18,22,2,1,43
9963490,33,5,10,4,52
9965426,137,28,42,7,214
9977050,174,17,35,9,235
9977994,135,38,2,5,180
9989799,11,7,2,1,21
9997569,13,14,3,1,31
10000581,157,9,2,7,175
10002056,82,56,22,8,168
10014728,16,9,2,1,28
10015331,51,22,3,1,77
10034844,148,3,2,9,162
10036128,122,20,74,18,234
10043308,97,14,2,3,116
10057458,20,3,2,1,26
10060471,184,77,25,21,307
10083866,15,3,2,1,21
10087508,122,76,8,11,217
10090576,71,33,2,2,108
10095163,140,83,4,8,235
10102378,101,3,2,1,107
10108908,168,32,2,2,204
10126447,86,22,7,7,122
10127690,12,17,2,4,35
10128372,29,3,2,2,36
10138385,52,21,2,5,80
10138752,104,21,3,3,131
10143760,52,45,2,1,100
10149094,199,10,9,3,221
10155110,33,4,3,3,43
10158549,12,3,2,1,18
10167520,41,28,2,1,72
10183215,13,3,2,1,19
10189104,51,7,5,1,64
10193863,11,3,2,1,17
10205014,22,6,8,1,37
10212019,44,15,51,1,111
10212702,161,3,2,5,171
10218811,13,3,2,1,19
10231033,45,27,41,16,129
10241794,14,3,2,1,20
10243307,15,6,2,1,24
10245898,101,3,2,4,110
10261212,107,12,2,1,122
10264816,51,4,8,5,68
10269730,21,4,2,1,28
10278116,11,10,2,1,24
10281791,34,25,2,1,62
10297467,182,20,3,4,209
10320714,45,6,2,4,57
10332860,82,13,127,11,233
10335839,12,3,2,1,18
10339801,70,6,41,4,121
10344144,14,3,2,1,20
10358362,10,3,2,3,18
10368251,12,38,2,1,53
10376669,108,43,3,1,155
10377501,13,24,3,1,41
10426422,21,22,32,1,76
10428844,146,43,3,1,193
10431210,142,3,2,8,155
10441477,11,3,2,1,17
10451316,86,14,13,10,123
10459177,55,30,9,3,97
10472630,233,3,2,8,246
10473013,70,3,2,1,76
10493046,36,3,2,11,52
10495703,108,14,3,8,133
10507628,15,11,2,20,48
10510651,88,8,2,1,99
10523174,186,82,57,10,335
10523839,104,5,59,8,176
10534262,15,30,2,1,48
10540322,204,25,5,15,249
10548139,10,3,2,5,20
10557940,92,8,2,4,106
10561188,18,3,2,1,24
10569668,27,3,2,1,33
10592137,106,32,2,1,141
10600340,12,4,2,1,19
10605688,25,3,2,1,31
10615123,69,3,2,1,75
10617607,71,3,68,11,153
10627170,65,69,15,20,169
10642900,60,3,2,1,66
10645536,40,32,2,1,75
10649615,82,82,7,1,172
10662728,125,24,16,2,167
10668310,34,39,30,16,119
10675693,103,77,5,23,208
10682968,89,31,27,9,156
10691322,16,15,75,1,107
10697830,20,6,2,4,32
10709837,10,3,2,5,20
10713526,19,10,2,7,38
10716635,112,11,7,3,133
10722723,20,9,3,4,36
10731458,110,11,22,1,144
10741892,10,3,2,3,18
10747093,61,25,2,3,91
10750678,41,6,2,1,50
10754494,99,53,46,1,199
10755519,47,48,9,1,105
10775959,67,3,2,1,73
10794511,13,11,2,5,31
10836644,13,6,2,1,22
10848746,172,27,2,10,211
10851284,32,3,2,1,38
10859497,15,3,2,1,21
10861892,14,3,2,2,21
10865331,11,3,2,1,17
10866405,26,3,2,1,32
10871386,20,21,45,1,87
10893938,41,37,12,5,95
10894649,27,39,39,5,110
10902079,15,3,2,6,26
10916073,45,26,2,4,77
10933806,65,22,44,11,142
10940175,18,3,2,1,24
10978695,120,30,2,4,156
10979046,13,3,2,4,22
10979869,48,36,2,5,91
10980380,40,24,42,21,127
10994548,56,18,27,3,104
10998570,27,38,8,54,127
11000637,55,3,2,3,63
11011845,56,3,2,7,68
11030623,87,8,88,3,186
11043143,33,72,2,1,108
11049581,65,9,28,1,103
11051293,57,40,32,1,130
11055285,81,15,15,2,113
11083408,60,33,14,3,110
11089053,17,11,2,1,31
11091826,15,3,2,1,21
11094518,18,17,9,2,46
11119698,10,9,2,1,22
11124985,47,10,4,1,62
11140895,86,3,2,1,92
11173628,50,38,45,24,157
11177038,13,3,2,1,19
11178440,165,21,2,1,189
11203815,76,22,12,5,115
11220522,26,40,17,43,126
11236148,127,26,2,7,162
11241547,14,3,2,1,20
11244388,72,10,2,1,85
11256897,15,35,2,1,53
11257271,59,3,2,4,68
11257907,94,11,2,1,108
11259771,10,3,2,2,17
11272587,35,26,2,1,64
11273898,40,4,13,1,58
11275046,94,3,2,3,102
11291328,103,3,20,8,134
11295430,11,5,2,1,19
11299245,81,3,2,5,91
11301846,42,26,3,15,86
11303872,22,16,24,1,63
11321926,41,13,2,1,57
11324368,14,3,2,1,20
11326071,63,3,2,1,69
11351533,53,33,2,1,89
11352940,84,21,4,1,110
11358090,57,19,2,1,79
11360061,10,3,2,3,18
11360124,82,20,5,9,116
11365255,13,9,2,1,25
11369317,80,3,2,1,86
11385995,71,34,39,53,197
11391980,41,3,2,1,47
11392498,288,27,2,4,321
11404194,11,3,2,2,18
11422646,15,3,2,13,33
11433147,35,40,100,8,183
11433475,87,38,13,2,140
11448769,90,3,2,27,122
11453356,13,3,2,1,19
11460887,77,3,2,1,83
11482191,164,10,2,8,184
11490974,54,29,80,26,189
11504732,22,4,6,2,34
11510434,62,3,2,5,72
11525346,140,5,2,2,149
11528263,75,31,3,1,110
11534357,14,3,2,1,20
11535211,11,3,2,1,17
11545078,24,47,29,1,101
11548423,12,3,2,8,25
11555336,11,3,2,1,17
11564122,43,42,25,14,124
11580531,120,22,61,2,205
11580839,83,13,3,3,102
11611563,94,65,53,17,229
11615234,12,3,2,1,18
11633742,10,5,2,1,18
11638068,89,34,24,39,186
11646986,15,35,2,2,54
11654477,29,35,14,1,79
11656658,39,35,6,11,91
11656682,30,7,14,9,60
11657471,33,3,6,11,53
11659673,73,24,37,1,135
11660224,149,3,2,10,164
11670416,105,4,2,1,112
11676470,19,26,3,4,52
11685058,93,3,2,1,99
11703861,60,3,2,2,67
11705828,134,37,2,14,187
11707434,35,3,2,1,41
11709522,17,3,2,1,23
11710876,34,3,2,1,40
11714603,56,5,2,2,65
11726899,52,56,100,14,222
11737060,42,3,2,1,48
11738035,13,3,2,1,19
11765710,39,3,2,3,47
11766760,87,7,10,26,130
11795548,52,3,2,2,59
11802186,187,3,2,27,219
11802260,16,20,2,3,41
11808124,58,40,2,2,102
11817214,151,52,32,24,259
11822912,56,41,34,1,132
11838633,55,42,17,11,125
11852667,41,3,2,23,69
11865632,44,13,2,1,60
11866911,64,15,2,1,82
11893925,10,3,2,3,18
11897968,45,18,2,2,67
11910098,129,36,160,2,327
11912015,34,21,9,6,70
11926814,41,30,2,8,81
11934712,18,50,21,2,91
11947214,28,10,2,3,43
11950198,26,22,7,1,56
11955800,83,3,2,1,89
11976561,129,85,2,4,220
11985644,10,33,2,6,51
11993147,57,16,2,1,76
11995225,181,7,2,1,191
11997458,36,25,51,7,119
12004249,98,25,13,1,137
12009075,63,63,32,9,167
12009802,22,20,8,1,51
12017724,90,22,23,3,138
12019829,167,47,7,18,239
12024274,15,3,2,2,22
12033039,37,28,36,1,102
12034794,60,13,41,18,132
12061872,125,9,17,4,155
12103966,17,18,2,1,38
12124924,46,3,2,1,52
12127291,52,15,56,1,124
12136657,54,3,2,4,63
12159051,80,32,92,1,205
12190101,13,3,2,1,19
12190220,14,20,2,4,40
12199911,86,3,2,1,92
12201723,130,3,2,3,138
12204895,21,3,2,1,27
12228771,136,6,2,1,145
12247871,123,3,2,14,142
12259244,15,3,2,1,21
12262497,187,3,33,2,225
12275392,77,3,2,3,85
12288861,103,13,11,9,136
12293119,58,23,2,1,84
12302512,24,19,39,1,83
12323789,85,14,2,2,103
12338502,51,45,25,7,128
12342724,14,3,2,1,20
12354726,45,3,2,1,51
12355133,77,5,2,2,86
12363366,13,10,2,1,26
12367477,144,31,2,1,178
12371726,65,40,88,20,213
12381782,83,9,2,12,106
12391224,63,3,2,14,82
12391408,12,3,2,1,18
12392974,11,3,2,1,17
12402641,10,4,2,1,17
12405160,199,30,17,9,255
12416932,65,20,2,2,89
12417434,39,5,2,6,52
12419136,34,54,107,10,205
12429426,122,26,97,26,271
12432363,176,23,3,2,204
12465802,30,3,2,1,36
12477199,85,35,25,13,158
12485702,32,8,2,1,43
12497542,131,50,9,5,195
12503266,100,44,7,11,162
12519086,11,3,2,1,17
12519433,97,36,14,7,154
12529216,91,22,28,1,142
12540078,255,40,11,82,388
12545575,73,10,2,3,88
12553640,14,5,2,1,22
12571751,87,10,11,13,121
12575282,73,14,2,1,90
12589796,82,57,26,10,175
12590277,125,25,54,16,220
12599158,213,12,4,5,234
12601436,63,17,2,5,87
12617193,215,21,22,8,266
12628778,82,27,130,5,244
12630072,20,5,2,1,28
12644133,12,3,2,1,18
12646828,14,29,2,1,46
12647164,38,14,4,12,68
12648824,66,27,63,1,157
12656700,13,3,2,1,19
12675613,17,31,13,4,65
12712918,54,16,2,3,75
12715599,59,3,2,1,65
12737016,35,5,2,10,52
12737949,13,21,2,3,39
12741127,51,31,5,1,88
12742309,101,23,33,8,165
12760604,79,62,46,14,201
12785144,99,25,2,1,127
12787610,101,20,3,6,130
12830089,61,6,2,9,78
12831620,35,25,6,16,82
12842664,118,49,8,15,190
12851538,39,10,2,1,52
12859059,57,42,76,11,186
12865867,14,3,2,1,20
12890040,63,9,2,8,82
12906347,48,37,7,14,106
12909493,19,3,2,1,25
12913318,14,4,2,1,21
12915952,18,17,2,1,38
12944803,52,9,2,13,76
12945667,87,20,16,1,124
12953316,107,18,2,1,128
12971123,39,3,2,3,47
12982170,132,3,2,7,144
13007609,28,15,5,4,52
13011214,185,3,2,1,191
13018257,25,3,2,4,34
13024319,132,29,33,11,205
13053009,15,9,27,2,53
13075260,86,18,2,3,109
13079866,32,6,5,4,47
13086023,23,35,16,7,81
13087114,46,6,3,1,56
13088420,32,10,31,1,74
13101099,110,26,2,6,144
13101419,30,3,2,1,36
13106951,16,14,2,1,33
13109774,12,24,2,1,39
13113943,13,6,2,1,22
13119517,19,3,2,3,27
13128641,265,41,5,28,339
13158930,55,3,2,7,67
13167684,40,3,2,1,46
13189629,13,12,2,1,28
13197677,131,10,71,16,228
13213286,56,10,17,1,84
13217647,37,34,2,1,74
13223832,27,43,11,3,84
13249863,178,31,11,33,253
13266957,68,3,2,1,74
13272807,36,12,3,21,72
13273648,99,42,53,15,209
13290097,66,14,43,12,135
13294412,33,3,2,1,39
13294647,70,28,148,4,250
13313050,80,7,18,6,111
13337671,12,3,2,2,19
13338990,138,21,2,4,165
13348915,43,27,2,4,76
13357077,14,3,2,3,22
13401499,20,18,15,1,54
13408570,50,5,7,3,65
13418687,61,59,26,9,155
13422446,198,23,28,7,256
13465573,19,3,2,1,25
13475966,69,3,55,1,128
13488361,136,3,3,2,144
13498363,51,35,2,5,93
13500228,29,37,2,8,76
13507270,11,3,2,1,17
13510867,42,3,2,1,48
13512313,15,5,2,2,24
13518828,81,27,28,8,144
13521357,21,3,2,17,43
13532444,71,3,2,2,78
13532983,38,37,7,18,100
13533894,21,3,2,3,29
13536369,15,9,2,5,31
13537401,71,59,74,9,213
13549965,77,3,2,3,85
13557237,89,58,139,13,299
13569473,33,7,2,1,43
13573877,13,3,2,1,19
13577481,99,42,2,1,144
13581505,51,53,19,2,125
13582974,26,3,2,1,32
13594240,15,3,2,1,21
13594274,10,8,2,1,21
13599469,35,33,20,22,110
13602034,35,60,6,7,108
13629299,52,92,10,46,200
13641570,22,30,2,5,59
13677302,144,4,2,37,187
13701072,126,3,2,2,133
13702393,11,3,2,1,17
13706984,32,32,79,5,148
13710197,95,3,2,4,104
13710704,130,5,2,2,139
13717330,20,3,2,11,36
13723412,63,20,2,1,86
13731088,48,66,63,1,178
13766120,73,3,2,1,79
13767269,14,3,2,3,22
13783530,92,15,2,7,116
13787707,57,25,2,1,85
13805790,10,18,2,14,44
13816475,68,43,2,2,115
13820488,10,3,2,3,18
13830644,119,60,16,3,198
13831939,45,7,2,1,55
13850677,41,20,6,7,74
13852412,12,9,2,1,24
13864755,34,73,6,10,123
13870087,117,3,2,9,131
13873598,95,20,71,11,197
13885129,76,43,146,12,277
13890151,10,4,2,1,17
13894544,45,9,2,1,57
13923389,71,3,2,1,77
13943349,35,43,2,1,81
13951544,156,60,2,3,221
13952809,29,33,2,17,81
13979387,57,4,36,5,102
13990235,111,3,2,5,121
13995486,40,12,2,1,55
14002117,18,4,2,1,25
14002890,15,3,2,5,25
14005469,30,10,4,44,88
14011853,35,67,3,1,106
14024388,11,3,2,1,17
14055599,46,11,2,6,65
14060050,17,37,4,7,65
14068145,17,31,10,5,63
14069611,17,5,2,2,26
14076967,10,9,6,4,29
14080062,23,70,2,1,96
14083688,11,7,2,1,21
14100048,31,22,2,1,56
14102966,155,37,50,27,269
14121455,17,19,2,2,40
14121609,53,56,26,7,142
14122541,10,5,2,1,18
14130315,12,3,2,1,18
14137568,19,3,2,1,25
14165903,20,3,2,1,26
14169758,60,10,2,1,73
14170934,114,3,42,1,160
14182902,68,3,2,6,79
14190854,157,43,2,18,220
14199396,68,63,2,1,134
14199916,45,54,4,1,104
14219916,75,8,6,6,95
14230977,33,3,2,1,39
14250751,10,4,2,3,19
14252303,109,3,2,9,123
14255306,67,8,2,3,80
14255420,17,3,2,1,23
14261009,12,16,6,4,38
14263772,12,3,2,1,18
14303592,216,3,2,20,241
14320530,26,3,2,1,32
14321378,96,55,21,5,177
14338336,53,3,2,7,65
14343390,37,26,15,13,91
14348437,46,23,14,14,97
14358111,24,63,7,1,95
14358768,30,17,31,4,82
14365968,35,33,2,5,75
14368963,35,10,20,5,70
14372733,840,3,2,14,859
14380930,17,6,2,1,26
14381909,75,26,52,12,165
14426233,38,23,21,8,90
14431908,34,3,2,1,40
14435302,13,3,2,1,19
14439062,18,3,2,1,24
14453072,24,8,2,5,39
14455719,30,7,2,9,48
14475993,83,3,2,1,89
14477321,11,3,2,1,17
14479443,56,54,3,21,134
14483213,78,60,4,4,146
14485326,88,40,73,7,208
14489711,118,3,2,1,124
14492346,74,23,73,14,184
14514350,62,3,2,2,69
14516740,88,3,2,1,94
14534231,101,46,2,3,152
14552007,27,12,5,6,50
14557924,55,12,20,5,92
14560538,12,3,2,1,18
14562095,65,51,13,1,130
14569923,123,47,19,4,193
14601191,12,3,2,4,21
14634129,129,7,6,1,143
14655454,13,3,2,1,19
14659767,170,3,2,1,176
14683913,131,27,2,2,162
14684225,33,3,2,5,43
14706481,55,5,2,1,63
14712171,101,12,7,7,127
14718683,34,62,28,1,125
14724017,61,13,84,24,182
14731918,18,46,2,3,69
14732713,54,3,2,5,64
14736156,47,19,3,23,92
14738616,11,3,2,2,18
14743268,15,8,2,1,26
14770197,33,3,2,1,39
14772706,108,10,2,1,121
14772768,32,59,75,3,169
14773691,10,3,2,3,18
14781176,25,3,2,1,31
14811133,11,6,2,1,20
14815656,67,21,2,1,91
14825067,176,61,5,3,245
14828774,20,34,2,1,57
14831081,37,43,22,11,113
14855778,157,51,91,12,311
14857393,169,32,71,2,274
14858567,54,28,2,12,96
14860658,96,36,37,1,170
14861574,37,4,3,1,45
14891862,86,3,2,2,93
14894323,55,18,5,3,81
14898491,100,38,4,15,157
14908623,13,19,2,1,35
14914554,56,3,19,1,79
14916894,43,63,3,6,115
14919217,20,3,2,1,26
14923882,64,3,24,1,92
14964164,11,4,2,3,20
14966227,94,3,2,11,110
14978562,100,5,3,8,116
14990667,87,4,2,5,98
14992698,11,6,2,1,20
14995637,82,13,13,9,117
14997900,39,26,46,3,114
14998159,63,13,89,1,166
15019451,84,3,2,1,90
15024920,35,10,7,3,55
15033499,46,43,13,4,106
15040233,39,20,23,5,87
15045966,82,21,72,50,225
15057238,11,6,2,1,20
15063506,42,72,5,8,127
15064307,110,35,16,12,173
15067953,143,69,18,14,244
15080491,43,117,34,6,200
15080866,237,3,2,6,248
15084095,13,3,2,3,21
15087418,113,21,2,13,149
15097167,134,15,59,1,209
15104548,54,42,2,9,107
15113422,75,120,7,3,205
15114426,826,3,2,3,834
15115344,23,3,2,4,32
15119012,146,17,38,1,202
15140274,111,14,31,1,157
15161101,199,3,2,6,210
15163548,120,16,26,4,166
15167046,28,9,5,11,53
15182155,44,3,2,1,50
15197047,57,18,34,3,112
15199621,99,24,38,1,162
15200349,33,109,19,9,170
15201655,37,8,3,13,61
15211812,45,3,7,8,63
15213651,69,7,17,1,94
15220196,11,3,2,1,17
15227916,31,18,10,7,66
15243853,75,3,2,1,81
15244838,14,18,2,1,35
15255414,79,16,2,1,98
15261701,110,3,2,3,118
15284922,24,31,2,1,58
15296683,11,3,2,1,17
15314073,37,27,5,6,75
15350174,179,33,2,1,215
15360200,13,7,2,1,23
15360323,10,3,2,7,22
15363044,34,12,2,1,49
15367589,60,14,4,13,91
15377617,109,29,2,1,141
15386223,55,65,2,17,139
15401385,47,6,11,4,68
15414655,114,19,2,1,136
15419957,61,53,8,13,135
15424538,43,31,17,3,94
15425172,79,44,10,2,135
15425218,27,26,10,8,71
15439515,66,47,7,3,123
15445064,129,37,49,63,278
15486889,33,3,2,1,39
15488853,90,45,2,26,163
15490084,29,45,8,1,83
15493863,37,3,2,1,43
15506185,34,23,154,1,212
15510339,17,6,2,2,27
15517761,45,3,2,1,51
15535989,44,9,8,1,62
15555918,23,15,2,1,41
15566394,22,29,2,1,54
15574357,181,41,2,5,229
15591235,125,23,4,7,159
15595387,18,3,2,1,24
15598193,162,3,2,2,169
15600480,73,29,2,5,109
15603029,11,3,2,1,17
15606105,90,4,2,3,99
15650588,164,33,23,1,221
15653308,64,3,2,7,76
15694447,285,54,6,15,360
15699761,114,43,45,1,203
15702466,72,28,8,10,118
15702636,32,36,4,9,81
15703981,68,32,2,6,108
15725405,71,29,17,5,122
15730739,60,16,2,9,87
15732066,31,4,2,1,38
15735073,90,3,2,1,96
15753016,74,3,2,1,80
15763892,189,42,2,18,251
15783659,37,3,2,3,45
15794119,99,12,47,3,161
15796520,25,3,2,1,31
15799921,77,3,2,13,95
15799953,11,3,2,1,17
15802249,57,15,2,1,75
15814048,11,3,2,1,17
15814063,87,3,2,1,93
15846971,100,20,16,1,137
15862510,11,4,2,1,18
15862559,13,11,2,1,27
15862997,23,3,2,1,29
15867425,12,3,2,1,18
15881081,16,3,2,1,22
15889396,91,35,32,8,166
15895157,18,5,3,1,27
15898250,20,31,2,8,61
15899033,10,30,6,1,47
15899071,63,3,28,1,95
15913027,27,5,2,1,35
15914130,11,3,2,1,17
15920863,28,58,23,1,110
15953420,109,20,2,2,133
15966773,279,3,2,2,286
15982891,97,19,2,1,119
16015265,105,3,2,1,111
16053224,42,15,2,2,61
16057292,101,53,31,9,194
16068772,46,27,27,16,116
16088813,73,27,2,17,119
16123251,14,7,2,1,24
16134539,141,15,13,1,170
16145628,118,6,25,15,164
16153691,200,26,4,13,243
16177875,169,3,2,1,175
16179250,91,15,45,25,176
16190103,14,3,2,1,20
16190705,29,14,11,1,55
16194844,32,41,3,2,78
16197203,16,3,2,1,22
16202711,22,3,2,1,28
16212066,147,9,3,2,161
16213973,93,30,144,13,280
16215468,43,101,2,8,154
16216345,24,31,2,1,58
16223110,10,8,2,1,21
16226572,56,12,15,1,84
16237312,13,18,2,1,34
16240383,79,27,12,14,132
16246225,75,3,2,1,81
16247070,66,36,6,13,121
16249212,29,3,2,1,35
16270143,213,28,7,5,253
16283097,55,14,17,1,87
16293490,142,33,207,250,632
16338067,14,3,2,1,20
16351372,19,3,2,1,25
16360236,107,3,3,1,114
16366281,69,3,2,1,75
16367995,53,12,4,1,70
16374609,101,3,2,6,112
16394907,10,8,2,1,21
16396647,11,3,2,1,17
16399072,51,9,21,1,82
16399456,75,67,2,1,145
16408734,10,7,2,1,20
16410132,23,53,40,1,117
16415009,18,3,2,2,25
16422075,42,3,16,1,62
16425361,29,8,2,32,71
16429087,80,13,2,1,96
16432416,171,17,2,14,204
16434910,23,43,2,6,74
16440025,66,16,2,1,85
16446816,38,5,68,7,118
16451637,102,26,33,7,168
16451903,79,44,2,22,147
16454575,16,28,14,6,64
16469332,59,12,5,29,105
16481280,101,3,2,1,107
16483113,58,8,2,2,70
16494580,169,30,56,8,263
16495444,160,46,4,36,246
16496744,59,13,87,8,167
16498317,27,50,2,1,80
16501757,57,10,20,1,88
16516470,27,4,5,1,37
16520983,91,33,26,2,152
16523498,23,38,6,4,71
16532492,58,6,2,3,69
16538505,83,3,7,1,94
16543030,48,12,2,1,63
16554301,61,3,2,1,67
16557621,38,3,2,3,46
16567284,58,71,2,17,148
16567434,11,39,2,1,53
16579739,103,48,2,63,216
16579800,53,3,2,1,59
16589779,200,43,28,10,281
16593533,45,3,2,1,51
16596552,66,4,2,8,80
16600180,103,3,2,9,117
16603464,136,16,11,6,169
16604739,33,32,6,2,73
16607716,16,3,2,1,22
16620745,38,62,2,13,115
16626143,40,4,2,2,48
16645541,68,13,29,7,117
16650075,55,22,16,12,105
16658812,12,3,2,1,18
16660257,59,3,2,2,66
16669242,22,28,2,3,55
16670003,72,44,8,6,130
16671657,51,3,2,1,57
16675699,106,29,25,10,170
16685307,77,41,59,7,184
16690916,27,43,3,1,74
16693485,16,8,2,2,28
16706277,10,79,10,4,103
16706443,12,3,2,1,18
16709618,152,12,3,1,168
16710265,13,3,2,1,19
16715670,64,62,18,2,146
16730729,16,9,2,1,28
16743849,117,3,2,1,123
16747635,44,6,4,15,69
16752068,10,6,2,1,19
16755578,143,16,74,13,246
16758429,53,5,90,13,161
16765476,111,19,2,2,134
16769622,11,3,2,1,17
16774826,189,41,3,1,234
16775138,107,9,2,2,120
16780135,97,42,22,29,190
16786851,46,24,54,13,137
16794561,95,69,32,5,201
16796923,43,25,2,8,78
16798758,56,5,2,1,64
16803581,18,4,2,1,25
16820508,78,3,2,1,84
16826520,126,16,6,28,176
16828226,24,75,12,1,112
16829052,29,46,7,1,83
16829252,23,8,11,6,48
16834564,45,11,55,5,116
16836818,10,7,2,3,22
16843988,18,3,2,1,24
16845288,264,3,2,1,270
16859231,33,11,2,1,47
16883634,143,12,4,5,164
16893481,159,5,2,1,167
16895765,129,3,2,2,136
16906990,18,25,2,1,46
16907263,63,19,2,1,85
16918304,19,7,2,1,29
16926427,81,38,40,28,187
16928873,12,3,2,1,18
16932683,75,3,2,2,82
16937902,65,3,2,3,73
16945945,203,13,35,2,253
16950107,17,14,2,7,40
16950394,11,3,2,1,17
16979544,75,26,36,33,170
16986872,125,25,6,4,160
16991308,219,3,2,21,245
17003454,110,7,6,1,124
17004611,29,41,12,8,90
17009838,88,3,2,46,139
17011333,68,34,62,5,169
17015246,75,9,60,1,145
17038594,13,3,2,1,19
17047512,35,3,2,3,43
17047743,81,16,2,5,104
17048547,72,33,21,7,133
17056613,106,3,2,6,117
17058886,74,39,8,3,124
17059472,131,38,42,1,212
17066592,75,8,13,11,107
17067561,38,3,2,1,44
17083848,14,4,2,1,21
17096546,66,10,53,1,130
17102070,10,4,2,1,17
17102467,15,15,2,1,33
17103702,75,17,19,1,112
17106106,82,6,3,61,152
17112405,21,30,2,2,55
17121521,54,5,2,5,66
17154504,18,12,2,1,33
17164762,39,60,2,9,110
17165268,19,3,2,1,25
17190978,78,22,85,5,190
17192131,75,43,18,16,152
17195924,33,19,37,8,97
17204339,46,44,22,1,113
17213658,153,28,7,2,190
17218469,12,3,2,1,18
17232913,47,75,19,1,142
17245132,105,37,4,30,176
17249537,55,70,2,5,132
17251348,39,57,30,3,129
17253930,47,21,3,11,82
17258405,125,50,43,40,258
17260115,110,5,2,1,118
17278275,54,79,28,16,177
17290039,13,24,2,1,40
17290979,27,82,77,1,187
17296914,137,3,2,10,152
17297496,124,3,2,7,136
17304950,174,17,2,9,202
17305278,205,3,2,3,213
17314919,10,8,2,3,23
17325189,111,16,2,6,135
17338636,66,12,2,3,83
17339059,103,3,2,6,114
17340418,99,34,18,15,166
17346983,51,3,2,1,57
17364156,35,3,2,1,41
17368575,56,3,2,1,62
17382204,51,16,40,14,121
17384564,113,48,54,24,239
17388751,10,3,2,2,17
17396531,20,39,2,6,67
17417226,32,25,18,60,135
17419944,102,3,2,11,118
17430328,13,3,2,1,19
17432437,19,10,2,1,32
17454072,54,52,2,1,109
17469019,82,23,22,6,133
17472751,75,3,48,5,131
17480550,27,19,3,7,56
17481360,48,9,82,1,140
17488975,13,17,2,1,33
17495807,72,3,2,36,113
17499340,75,11,16,5,107
17517488,17,3,11,1,32
17540703,23,3,2,1,29
17571341,13,3,2,1,19
17584654,129,8,2,6,145
17593538,35,12,2,1,50
17601926,40,56,2,1,99
17606579,103,21,14,8,146
17613101,12,3,2,1,18
17619053,17,3,2,1,23
17621414,51,22,9,3,85
17623949,53,3,2,2,60
17632723,199,3,2,1,205
17634097,13,8,4,1,26
17651489,86,3,2,1,92
17695696,97,35,35,4,171
17695732,81,3,2,1,87
17696942,70,48,93,6,217
17710157,22,3,2,1,28
17716704,54,41,32,10,137
17730303,2741,3,2,1,2747
17735654,17,3,2,1,23
17735835,61,68,37,16,182
17739919,12,3,2,1,18
17746109,45,42,19,10,116
17750326,72,3,2,1,78
17757097,140,33,58,2,233
17776712,36,67,2,8,113
17785928,30,3,2,1,36
17790446,10,4,2,1,17
17801536,57,24,2,5,88
17809334,54,36,12,2,104
17811415,98,16,2,2,118
17818613,25,67,15,1,108
17822566,33,3,2,1,39
17823187,20,48,3,1,72
17832007,42,31,27,1,101
17871696,109,38,26,2,175
17873174,56,3,2,1,62
17874596,42,21,69,7,139
17877156,11,3,2,1,17
17883305,41,13,4,1,59
17892092,33,26,44,4,107
17897071,54,7,2,1,64
17914375,50,12,5,3,70
17918757,53,3,2,2,60
17930469,26,6,3,1,36
17933602,93,18,2,1,114
17946143,151,31,2,1,185
17952925,60,28,42,16,146
17973982,100,24,2,1,127
17978482,77,3,2,2,84
17987939,374,3,2,2,381
17989203,194,19,9,5,227
18015046,21,10,2,5,38
18032791,74,46,19,6,145
18035010,18,12,2,1,33
18048614,15,3,2,1,21
18062113,19,9,2,1,31
18078245,11,9,4,2,26
18085514,96,66,3,8,173
18088594,37,22,6,18,83
18106170,85,51,32,12,180
18114962,35,10,9,13,67
18123742,53,59,59,2,173
18140618,68,26,15,1,110
18143430,75,8,2,1,86
18152010,17,14,9,1,41
18175074,190,32,3,4,229
18195320,24,3,2,1,30
18205759,95,3,2,1,101
18211701,277,24,4,14,319
18242453,12,3,2,2,19
18243641,59,17,2,6,84
18259371,55,14,16,1,86
18265037,98,5,2,3,108
18266859,11,3,2,1,17
18268228,24,3,2,1,30
18281982,144,3,2,12,161
18297289,30,44,13,19,106
18300091,161,22,2,9,194
18308362,51,14,2,11,78
18312840,100,13,4,3,120
18313748,14,3,2,1,20
18318768,156,3,2,1,162
18318985,20,3,2,1,26
18332781,68,30,2,7,107
18341324,67,24,2,11,104
18344563,43,3,2,2,50
18347233,98,3,2,7,110
18348342,27,3,2,1,33
18348483,152,24,61,1,238
18351402,59,11,6,1,77
18354698,84,24,3,29,140
18356417,13,3,2,6,24
18363760,53,15,2,18,88
18364034,44,3,2,1,50
18386451,44,27,22,21,114
18389401,105,3,2,1,111
18396806,112,63,66,328,569
18399381,15,36,17,1,69
18400252,42,16,11,17,86
18403652,37,25,2,7,71
18423210,86,23,2,3,114
18436202,18,8,2,1,29
18441146,79,3,2,1,85
18460062,58,3,2,1,64
18472324,12,7,2,1,22
18473802,127,24,12,17,180
18485518,53,4,2,1,60
18487984,15,11,6,1,33
18491908,37,30,2,5,74
18498978,40,6,2,2,50
18501924,15,7,2,4,28
18517579,339,9,40,5,393
18529989,55,71,28,19,173
18536662,25,19,3,2,49
18554196,171,34,4,1,210
18555490,93,50,6,7,156
18562561,46,21,2,27,96
18568350,11,6,2,1,20
18573323,27,4,2,1,34
18577890,388,3,2,6,399
18578970,103,26,2,34,165
18582473,46,3,2,12,63
18586805,75,33,27,3,138
18589241,43,16,2,2,63
18591919,11,3,2,1,17
18596867,23,45,49,1,118
18605460,16,3,2,1,22
18616160,325,3,2,1,331
18633203,13,3,2,1,19
18670858,20,10,2,17,49
18674496,11,3,2,1,17
18675338,26,8,4,30,68
18678026,59,13,28,1,101
18687586,173,14,2,1,190
18689252,19,3,2,2,26
18702919,10,3,2,5,20
18734758,41,3,2,5,51
18735263,199,3,3,27,232
18743622,102,8,11,10,131
18744372,86,14,39,9,148
18750225,53,3,2,2,60
18768631,22,3,2,1,28
18799268,162,3,10,21,196
18808817,11,3,2,1,17
18812965,10,5,2,1,18
18818715,74,8,17,19,118
18841872,124,3,2,2,131
18853539,124,3,2,6,135
18853676,98,9,2,6,115
18865163,103,8,36,1,148
18879486,94,59,87,18,258
18881957,58,7,2,1,68
18923132,108,35,3,11,157
18954999,54,3,2,1,60
18960680,12,3,2,1,18
18966696,38,11,19,1,69
18977029,84,18,33,7,142
18994620,58,21,10,11,100
19002551,28,3,2,1,34
19006275,100,34,5,17,156
19047546,11,3,2,1,17
19050035,17,3,2,1,23
19056359,84,25,20,15,144
19057536,87,34,55,8,184
19068261,53,42,28,1,124
19090346,60,12,2,5,79
19105501,34,25,2,3,64
19116046,30,3,2,1,36
19117632,10,11,2,2,25
19130393,10,3,2,7,22
19149299,16,17,2,1,36
19190310,163,3,2,7,175
19215988,190,11,2,42,245
19221251,17,7,2,4,30
19229994,71,20,26,5,122
19274655,82,3,13,1,99
19283900,61,3,2,11,77
19312449,65,13,2,11,91
19318258,44,10,81,16,151
19328782,11,3,2,1,17
19332019,49,3,50,1,103
19350261,11,5,2,1,19
19354283,49,35,2,8,94
19360916,22,29,31,7,89
19363753,46,49,2,8,105
19372637,33,13,2,1,49
19378684,22,15,2,1,40
19380383,117,8,12,1,138
19385452,54,17,19,18,108
19385973,61,31,36,26,154
19392423,84,16,2,1,103
19400527,62,24,2,2,90
19404087,286,25,68,4,383
19404231,19,11,2,1,33
19424304,167,3,2,12,184
19427856,100,49,48,76,273
19433398,24,4,2,1,31
19447177,25,27,7,26,85
19472403,215,9,18,1,243
19486096,11,3,2,1,17
19494201,10,11,2,1,24
19501849,66,3,2,4,75
19505227,15,19,12,1,47
19517563,11,3,2,1,17
19539281,69,3,2,1,75
19552707,109,10,31,21,171
19556986,70,15,35,31,151
19560920,40,66,62,6,174
19569953,15,6,2,7,30
19592219,122,3,2,3,130
19597333,100,13,2,1,116
19601021,86,3,2,11,102
19603190,31,13,2,1,47
19612525,51,14,3,17,85
19613909,76,13,2,1,92
19635346,56,7,2,6,71
19637753,184,12,2,31,229
19640425,56,38,35,7,136
19648870,43,3,2,6,54
19648910,96,45,2,31,174
19652334,11,3,2,1,17
19655917,16,3,2,1,22
19666259,28,3,2,4,37
19667470,20,9,2,1,32
19689449,29,44,4,3,80
19701493,16,5,2,6,29
19702469,38,3,2,1,44
19708039,72,16,35,13,136
19728434,102,13,105,3,223
19745403,11,3,2,2,18
19756018,74,3,5,5,87
19760104,151,74,2,1,228
19769591,24,3,2,3,32
19774145,50,20,2,6,78
19786174,70,3,2,5,80
19799431,66,12,2,5,85
19805039,197,4,26,34,261
19809279,66,3,4,1,74
19817775,12,3,2,8,25
19837963,97,3,2,4,106
19845126,50,7,2,1,60
19884056,10,3,2,2,17
19887389,13,5,2,1,21
19891292,100,16,43,2,161
19901805,42,21,2,1,66
19904639,158,42,20,32,252
19911452,12,3,2,1,18
19915048,52,21,18,17,108
19927438,18,5,2,1,26
19935076,13,3,2,1,19
19936522,25,20,6,1,52
19943049,31,26,2,1,60
19948010,55,34,71,23,183
19954072,68,74,24,38,204
19963130,14,9,2,1,26
19966402,56,24,2,2,84
19969946,17,20,2,1,40
19976798,104,3,2,1,110
19993484,166,44,8,2,220
19997920,196,86,30,9,321
20003256,11,3,2,2,18
20005800,22,36,41,4,103
20010749,29,15,25,27,96
20013767,10,3,2,2,17
20032691,133,64,2,4,203
20035433,119,38,3,5,165
20035905,14,21,2,1,38
20042697,89,21,2,1,113
20050112,24,33,2,9,68
20055344,60,3,2,1,66
20055985,58,67,70,1,196
20087567,134,36,49,1,220
20091440,101,11,2,31,145
20108503,82,19,21,21,143
20110486,47,52,3,7,109
20114239,50,3,2,3,58
20129456,58,46,43,1,148
20140553,53,21,41,25,140
20141594,59,10,7,9,85
20155135,72,15,55,2,144
20157582,10,11,2,2,25
20177227,30,3,2,4,39
20177796,80,3,2,7,92
20195272,98,57,28,24,207
20208641,95,22,4,2,123
20221824,44,48,3,26,121
20231485,64,72,23,24,183
20235836,44,30,4,2,80
20256116,16,6,2,1,25
20256959,62,3,2,1,68
20260133,83,3,2,4,92
20263160,39,16,19,3,77
20266757,25,3,2,1,31
20275955,15,60,2,1,78
20295674,36,23,28,1,88
20309472,35,12,2,19,68
20311852,11,3,2,1,17
20312660,103,28,48,5,184
20317133,32,3,2,1,38
20317134,20,3,4,1,28
20332433,12,4,5,1,22
20339067,40,26,4,1,71
20366777,79,18,56,63,216
20395078,14,3,2,1,20
20400792,14,29,8,1,52
20411768,13,3,2,5,23
20415668,24,44,15,1,84
20422024,130,23,41,6,200
20424914,30,51,4,4,89
20438133,32,3,2,1,38
20458059,171,20,51,6,248
20458334,46,3,2,1,52
20475338,46,3,2,1,52
20479921,114,9,70,5,198
20485681,135,40,24,1,200
20488525,153,3,2,11,169
20490790,24,3,2,1,30
20492036,50,17,15,6,88
20501631,77,3,2,5,87
20503771,10,20,2,1,33
20505105,54,16,7,13,90
20511383,14,3,2,1,20
20513311,183,9,8,1,201
20528259,159,17,51,2,229
20541293,10,8,2,1,21
20548833,13,3,2,1,19
20573033,24,33,24,2,83
20582776,44,29,68,3,144
20584391,74,7,27,7,115
20594313,20,38,44,1,103
20595841,16,24,5,7,52
20609139,131,3,2,2,138
20613988,91,3,3,8,105
20624588,135,3,2,1,141
20644865,45,35,2,1,83
20647534,31,28,12,2,73
20660313,14,13,2,1,30
20684798,41,18,2,1,62
20706594,13,3,2,1,19
20725572,39,33,2,2,76
20729803,134,7,2,3,146
20730013,95,3,2,1,101
20735126,54,6,6,4,70
20740653,64,32,2,22,120
20742021,23,3,2,1,29
20752089,89,16,28,9,142
20756812,13,3,2,1,19
20762770,95,45,14,7,161
20811092,48,4,2,36,90
20811523,12,3,2,1,18
20821121,104,145,52,49,350
20832980,64,5,2,1,72
20835436,29,5,2,4,40
20837908,298,18,16,14,346
20841894,32,25,8,2,67
20849380,300,3,2,9,314
20853169,62,55,2,12,131
20870384,14,15,2,1,32
20877995,207,3,2,1,213
20894198,10,4,2,1,17
20905635,169,38,70,4,281
20920807,13,5,2,1,21
20921747,42,11,2,1,56
20927089,112,7,10,11,140
20931308,41,3,2,1,47
20938213,82,5,2,1,90
20959700,42,41,2,1,86
20967450,48,19,3,1,71
20972884,18,4,2,1,25
20988035,23,3,2,1,29
21000360,154,22,32,16,224
21011731,87,3,2,1,93
21027611,12,65,5,1,83
21037793,131,30,27,39,227
21037854,156,31,97,17,301
21043752,40,3,2,1,46
21052360,16,12,2,5,35
21054168,144,7,2,10,163
21065708,20,18,8,1,47
21099284,12,3,2,1,18
21114025,42,50,3,26,121
21129492,91,17,29,14,151
21140863,57,3,2,1,63
21140936,26,3,2,1,32
21152905,25,24,2,2,53
21154478,79,14,17,2,112
21160584,76,7,2,1,86
21213323,38,36,11,34,119
21217234,152,3,2,10,167
21241302,24,77,6,1,108
21261960,52,13,4,1,70
21263917,75,21,54,3,153
21305833,35,10,38,1,84
21315231,165,3,2,1,171
21323612,74,3,2,6,85
21352110,27,29,2,8,66
21353895,58,30,3,8,99
21386201,10,6,4,1,21
21387645,104,55,95,62,316
21391481,134,19,2,7,162
21393148,10,8,2,1,21
21403871,22,16,2,5,45
21427253,22,3,2,3,30
21429583,29,54,14,1,98
21437020,127,66,4,28,225
21460092,31,3,2,5,41
21464475,91,10,72,18,191
21468025,76,9,4,13,102
21499519,58,30,4,3,95
21515574,131,13,6,12,162
21515924,107,49,4,2,162
21522779,12,3,2,1,18
21524748,105,44,2,8,159
21540197,14,3,2,1,20
21563138,30,15,26,1,72
21564548,61,25,4,6,96
21585471,45,10,2,3,60
21601080,54,5,2,2,63
21607683,85,4,30,3,122
21625055,42,21,18,2,83
21626633,10,5,2,1,18
21629960,22,3,2,1,28
21643708,12,10,22,1,45
21645215,79,43,18,8,148
21646064,28,3,2,1,34
21646122,68,11,30,3,112
21668678,133,3,2,2,140
21669236,66,6,5,1,78
21669702,61,3,2,3,69
21681504,117,19,15,4,155
21695542,15,4,2,1,22
21713642,10,32,12,1,55
21732131,17,3,2,1,23
21739943,50,32,40,5,127
21754241,16,4,2,3,25
21763613,47,30,41,1,119
21780008,78,27,11,8,124
21789831,159,82,47,33,321
21790362,44,3,2,1,50
21798332,87,27,2,3,119
21805346,11,4,2,1,18
21828684,37,13,3,1,54
21832511,24,25,58,2,109
21837531,25,30,15,3,73
21849138,161,18,50,1,230
21851136,113,20,4,2,139
21851331,157,13,3,4,177
21858696,12,3,2,1,18
21868092,17,8,2,1,28
21873307,200,30,9,4,243
21874913,30,41,51,4,126
21883467,110,3,11,3,127
21885925,48,11,2,3,64
21894809,112,20,2,1,135
21895270,13,15,3,1,32
21905686,120,18,5,1,144
21918201,10,47,2,1,60
21930844,30,30,11,3,74
21932156,30,16,4,1,51
21941702,18,3,2,1,24
21943217,12,3,2,7,24
21949093,29,33,78,27,167
21961489,159,32,3,4,198
21962688,169,20,3,1,193
21993840,20,38,11,9,78
21998505,83,31,41,84,239
22006534,95,11,16,63,185
22013180,93,66,27,22,208
22020454,47,28,12,8,95
22022903,47,19,31,51,148
22025571,25,35,9,11,80
22032396,131,3,2,2,138
22034284,70,15,65,3,153
22043349,18,10,2,1,31
22093589,25,29,11,13,78
22103857,77,29,2,1,109
22112419,31,36,82,15,164
22115239,106,42,14,1,163
22143599,82,47,30,35,194
22149404,83,4,2,4,93
22153555,40,31,10,2,83
22161099,25,32,2,1,60
22171300,29,10,5,2,46
22188950,27,13,4,1,45
22203030,73,18,3,1,95
22203269,15,9,2,1,27
22211804,53,20,29,1,103
22213441,83,38,40,4,165
22213639,12,5,2,1,20
22229658,49,30,2,8,89
22242952,99,3,2,1,105
22268964,87,99,2,1,189
22276934,10,11,2,1,24
22300979,11,10,2,1,24
22302520,107,29,46,4,186
22305065,99,3,2,10,114
22326954,39,16,19,1,75
22329134,20,21,18,1,60
22332032,42,47,5,1,95
22332169,10,12,2,2,26
22371344,53,32,3,1,89
22381680,32,49,25,5,111
22386059,44,27,22,1,94
22389866,54,3,2,1,60
22394676,104,3,2,10,119
22401887,54,3,2,1,60
22410344,73,9,10,3,95
22427671,10,3,2,2,17
22432205,10,4,2,1,17
22434239,16,3,2,13,34
22436584,149,45,11,3,208
22437081,54,3,2,2,61
22446577,70,10,5,7,92
22449095,41,3,2,1,47
22458727,66,7,2,6,81
22459246,145,22,2,3,172
22459290,53,43,34,2,132
22496828,82,9,3,4,98
22505213,49,36,36,32,153
22517355,114,43,10,1,168
22526069,23,3,17,9,52
22542439,10,6,2,1,19
22543881,22,4,30,18,74
22549345,49,3,2,2,56
22550351,47,8,18,1,74
22564135,61,16,2,4,83
22567111,41,3,2,1,47
22570570,100,34,39,9,182
22581365,10,4,4,1,19
22583080,64,21,2,5,92
22590684,53,37,2,4,96
22620296,113,3,2,1,119
22650610,51,4,2,4,61
22653109,56,12,18,7,93
22660955,101,35,33,3,172
22664811,157,10,2,1,170
22679714,36,5,11,8,60
22698820,11,5,2,1,19
22706792,13,55,17,1,86
22712321,11,3,2,1,17
22726287,61,3,2,4,70
22730210,109,3,23,31,166
22734304,17,13,2,1,33
22734966,37,4,2,8,51
22747702,94,23,29,11,157
22749211,56,3,2,3,64
22768689,87,3,2,2,94
22775200,43,32,24,60,159
22776569,21,29,4,3,57
22798385,114,3,2,2,121
22802987,11,9,2,2,24
22808074,148,3,3,1,155
22815775,140,40,16,6,202
22818842,81,3,2,1,87
22821078,45,3,2,1,51
22832750,11,3,2,1,17
22848246,53,69,57,20,199
22849793,10,4,2,1,17
22854101,13,3,5,5,26
22856234,100,25,29,9,163
22878399,98,3,2,11,114
22880137,62,19,31,10,122
22890320,10,7,2,1,20
22892143,127,62,24,5,218
22896708,124,3,2,1,130
22898030,70,30,35,2,137
22901789,27,52,4,6,89
22905125,44,42,11,5,102
22905647,16,3,2,2,23
22921019,31,67,3,1,102
22931952,14,5,2,1,22
22935108,52,9,40,34,135
22937165,240,3,2,4,249
22946157,26,3,2,9,40
22948930,38,3,2,2,45
22952506,10,10,2,1,23
22952565,69,22,2,1,94
22968625,65,3,2,1,71
22971800,807,78,3,39,927
22976586,106,36,4,1,147
23020545,11,40,2,24,77
23023127,24,4,2,1,31
23038284,141,57,2,16,216
23039593,13,22,4,1,40
23043112,124,250,3,32,409
23045641,20,29,3,3,55
23052502,96,12,2,2,112
23089920,117,71,26,7,221
23104396,38,43,11,25,117
23105126,73,4,21,1,99
23105575,40,19,2,2,63
23106370,106,3,2,1,112
23118652,76,4,2,1,83
23123595,19,27,10,1,57
23127701,20,3,2,1,26
23141889,59,6,11,8,84
23148078,11,11,2,1,25
23150971,34,23,2,9,68
23156214,99,7,30,1,137
23160048,67,50,26,1,144
23161571,139,52,82,26,299
23174793,16,5,2,1,24
23184930,23,12,2,1,38
23194819,33,13,2,12,60
23195203,135,3,2,2,142
23195323,28,15,2,1,46
23196757,143,5,3,5,156
23200692,48,12,21,1,82
23210498,205,3,2,1,211
23213628,107,3,2,1,113
23215944,22,20,4,1,47
23216554,42,24,3,34,103
23216897,27,3,2,1,33
23225246,31,38,13,7,89
23240678,134,3,2,5,144
23265454,66,55,34,17,172
23275759,87,27,8,3,125
23281472,97,24,4,23,148
23293911,67,11,2,1,81
23299470,72,48,45,2,167
23302025,64,3,2,1,70
23304372,104,3,2,8,117
23313994,103,106,2,7,218
23317226,47,7,2,1,57
23317476,10,3,2,2,17
23324579,20,23,18,1,62
23339072,74,27,22,5,128
23365712,47,24,2,2,75
23367700,10,3,4,1,18
23370038,140,34,2,12,188
23371159,41,3,2,1,47
23379687,20,3,2,1,26
23387885,70,4,2,1,77
23392763,73,48,103,11,235
23396348,20,3,2,1,26
23400503,310,3,2,10,325
23403192,107,3,2,5,117
23405112,120,36,8,28,192
23407335,59,115,29,4,207
23428655,169,23,47,1,240
23431956,66,3,7,20,96
23437777,106,5,10,11,132
23487019,23,12,3,13,51
23493724,21,3,2,1,27
23494751,152,35,14,8,209
23504222,36,3,2,3,44
23509481,37,3,2,1,43
23510046,62,3,14,6,85
23512863,90,27,118,16,251
23536607,71,3,2,4,80
23548060,105,18,3,5,131
23563801,342,3,2,1,348
23579443,66,12,2,11,91
23587834,31,13,6,1,51
23594754,151,30,15,3,199
23597169,32,3,2,2,39
23600939,52,29,39,25,145
23632883,14,8,2,1,25
23639266,45,72,85,6,208
23639497,14,32,2,1,49
23653419,27,6,9,1,43
23671131,34,3,2,3,42
23675224,67,7,17,10,101
23677497,93,41,2,28,164
23680512,17,3,2,1,23
23681493,26,3,2,1,32
23686963,15,5,2,1,23
23696138,36,50,2,14,102
23707188,669,3,2,58,732
23711483,15,6,2,1,24
23730473,41,36,35,1,113
23737078,13,3,2,1,19
23737723,93,35,11,5,144
23742301,68,55,112,3,238
23746234,13,15,7,1,36
23748529,47,17,5,5,74
23754969,63,13,14,1,91
23780288,31,27,4,4,66
23786024,22,15,5,5,47
23786106,46,41,2,1,90
23787542,71,15,2,2,90
23787607,103,3,2,1,109
23805121,50,21,60,1,132
23828590,12,3,2,1,18
23836449,19,12,2,1,34
23859392,22,25,2,4,53
23882147,56,46,2,2,106
23883646,46,17,4,3,70
23884157,46,3,2,4,55
23885421,96,8,8,3,115
23893974,132,39,35,54,260
23896222,162,4,2,49,217
23904622,116,3,2,1,122
23904738,84,34,30,18,166
23905525,78,67,20,1,166
23928355,70,47,3,11,131
23930060,305,3,2,6,316
23931948,24,20,23,5,72
23956165,12,3,2,1,18
23962282,136,29,49,24,238
24006383,10,8,2,1,21
24011540,57,3,2,1,63
24014120,23,26,4,1,54
24014159,153,9,33,7,202
24018168,109,30,13,13,165
24021547,40,24,29,9,102
24029688,44,3,2,4,53
24041703,145,93,27,32,297
24073492,16,3,2,1,22
24092862,90,3,2,2,97
24102918,81,12,2,1,96
24109538,116,3,2,4,125
24112955,74,28,3,21,126
24126616,50,20,2,2,74
24132983,12,3,2,1,18
24133124,36,27,2,1,66
24154519,12,3,2,1,18
24168338,106,37,3,1,147
24168603,18,3,2,2,25
24185175,32,7,3,5,47
24186808,117,3,19,1,140
24187820,47,3,2,9,61
24190309,105,3,2,1,111
24208686,41,22,7,1,71
24213242,18,5,2,1,26
24233912,44,27,56,3,130
24236155,84,3,2,1,90
24246278,15,3,2,1,21
24254990,41,13,3,2,59
24262460,59,26,30,34,149
24289153,30,39,21,1,91
24290202,113,3,2,3,121
24295045,39,72,48,9,168
24298860,118,3,2,2,125
24309735,58,25,30,8,121
24314212,96,3,4,1,104
24325864,95,12,2,2,111
24331943,158,11,32,38,239
24336649,14,3,2,1,20
24351177,96,21,4,5,126
24377469,37,3,2,1,43
24383715,18,8,2,3,31
24385582,65,18,42,3,128
24389413,995,3,2,5,1005
24426985,10,6,2,1,19
24427848,52,15,4,1,72
24431192,291,3,27,14,335
24444419,63,3,2,2,70
24447050,203,23,4,20,250
24458201,39,32,18,12,101
24467732,40,17,15,46,118
24472488,87,3,2,2,94
24480028,37,45,25,1,108
24495089,57,3,2,1,63
24498502,24,3,3,1,31
24502782,18,3,2,1,24
24503924,61,40,39,35,175
24504669,18,4,2,1,25
24515226,112,3,2,10,127
24518705,40,8,2,10,60
24552913,26,52,37,3,118
24563882,39,3,2,1,45
24574017,159,37,84,18,298
24581222,88,45,8,3,144
24590719,10,3,2,2,17
24615677,102,20,2,3,127
24617131,88,5,2,1,96
24626438,71,3,2,1,77
24627285,86,3,2,1,92
24631655,43,3,2,10,58
24637411,314,3,2,3,322
24639342,11,3,2,1,17
24651693,49,31,6,5,91
24660348,11,3,2,1,17
24668759,10,5,2,1,18
24684404,40,33,6,2,81
24696046,30,10,2,21,63
24696216,157,21,4,6,188
24697002,29,24,60,8,121
24705533,40,9,6,14,69
24722117,12,4,2,1,19
24755096,54,69,67,12,202
24757351,180,3,2,47,232
24772839,49,35,32,2,118
24787151,26,42,2,5,75
24792578,64,13,73,1,151
24802763,89,30,10,9,138
24811549,35,3,2,1,41
24814796,67,15,2,2,86
24820198,10,4,2,1,17
24826435,85,3,2,1,91
24860059,197,5,2,24,228
24864986,40,62,7,1,110
24884728,94,11,16,1,122
24917880,71,24,3,8,106
24929359,21,22,5,8,56
24931973,17,3,2,1,23
24932799,18,26,2,4,50
24932807,104,31,63,3,201
24938610,69,3,2,1,75
24951710,126,52,8,8,194
24960857,96,3,2,15,116
24966091,13,3,2,1,19
24983608,16,18,2,1,37
24987152,36,24,2,3,65
24995046,55,24,69,4,152
25004636,88,36,2,12,138
25011618,61,37,13,28,139
25014266,11,4,2,1,18
25024010,29,9,3,8,49
25044854,26,87,2,1,116
25046097,152,66,3,16,237
25052664,90,18,25,18,151
25055361,194,3,2,42,241
25066557,14,3,2,4,23
25076136,83,57,40,17,197
25093758,163,74,5,1,243
25104882,198,3,2,1,204
25143315,66,19,20,9,114
25159393,26,3,2,1,32
25177127,167,77,108,7,359
25178202,94,3,2,3,102
25179410,161,48,10,4,223
25222214,106,3,2,4,115
25224373,67,39,16,14,136
25226475,65,9,3,4,81
25242610,121,13,2,1,137
25245026,87,5,35,4,131
25246177,176,38,9,60,283
25254918,123,73,15,27,238
25257581,135,10,36,5,186
25263400,31,3,2,1,37
25268099,110,15,2,1,128
25268666,79,37,7,35,158
25272284,71,37,3,6,117
25279830,13,3,2,1,19
25283728,11,3,2,1,17
25284930,14,3,2,2,21
25287395,11,3,2,1,17
25291995,59,3,2,1,65
25292933,25,3,2,1,31
25298723,46,23,4,1,74
25304821,24,3,2,1,30
25313329,55,10,24,3,92
25321782,15,3,2,1,21
25323118,180,3,2,4,189
25330680,204,3,2,50,259
25334442,10,4,2,1,17
25335329,70,43,130,1,244
25352714,32,26,3,1,62
25378938,13,3,2,1,19
25381904,20,27,10,1,58
25411013,48,3,2,1,54
25424622,15,3,2,1,21
25435676,131,3,2,1,137
25436988,39,31,26,7,103
25438729,76,5,12,6,99
25440800,84,19,14,17,134
25456995,163,3,2,1,169
25461470,52,48,22,9,131
25465097,48,11,2,2,63
25473513,57,33,10,3,103
25491517,103,6,13,2,124
25494572,12,13,2,1,28
25495777,21,6,6,1,34
25515936,35,24,3,12,74
25532098,13,25,2,1,41
25554113,103,31,5,12,151
25587068,95,3,2,7,107
25589424,62,32,2,1,97
25592644,71,24,34,4,133
25606242,13,9,2,5,29
25610556,10,5,2,1,18
25623543,10,5,2,1,18
25625641,112,3,2,1,118
25629702,14,3,2,1,20
25638899,21,15,9,1,46
25649519,73,10,2,8,93
25649605,56,3,2,2,63
25671848,35,16,21,2,74
25684745,93,3,2,15,113
25696256,28,14,14,5,61
25697954,52,31,6,2,91
25708620,72,10,39,1,122
25713349,458,3,2,67,530
25719617,21,3,2,1,27
25727108,19,6,3,2,30
25733386,46,9,2,1,58
25733889,138,3,2,3,146
25767735,98,103,8,1,210
25770014,15,7,2,1,25
25779766,22,38,2,1,63
25807044,28,3,2,4,37
25812448,53,46,14,2,115
25818312,11,3,2,1,17
25820903,110,3,2,1,116
25836535,29,19,2,1,51
25836985,16,13,2,1,32
25846804,17,14,2,10,43
25847084,71,3,2,1,77
25853133,30,12,2,4,48
25861769,104,90,8,18,220
25868828,93,57,2,1,153
25873368,17,7,2,1,27
25874836,45,3,2,1,51
25888046,42,12,2,4,60
25888876,101,12,2,6,121
25905462,121,15,2,12,150
25927222,55,15,2,3,75
25939792,17,5,2,1,25
25942038,37,43,37,97,214
25945182,28,33,7,1,69
25955400,156,55,2,14,227
25956489,117,16,23,61,217
25963989,48,33,26,3,110
25974885,32,14,120,1,167
25991076,94,10,4,4,112
25999706,22,10,7,3,42
25999978,40,33,9,20,102
26000471,29,25,30,3,87
26001862,13,3,2,1,19
26018164,69,35,3,14,121
26030413,65,4,2,5,76
26040484,27,59,29,1,116
26043880,103,15,2,19,139
26046779,24,11,2,1,38
26049308,71,25,5,7,108
26064430,21,20,2,1,44
26071610,47,3,2,4,56
26086061,149,3,2,1,155
26089104,10,4,2,1,17
26090586,137,3,2,2,144
26091132,71,28,2,1,102
26092436,90,21,2,14,127
26097458,101,52,41,1,195
26113166,109,3,2,7,121
26124909,26,11,8,3,48
26134665,31,6,2,5,44
26146058,38,68,7,7,120
26150551,44,11,2,1,58
26174550,14,3,2,1,20
26179261,53,3,2,5,63
26195718,78,4,2,4,88
26205549,46,3,2,2,53
26207916,89,15,2,19,125
26218267,45,3,2,1,51
26220882,24,30,51,1,106
26229465,11,15,2,1,29
26235901,246,67,93,51,457
26243286,25,30,4,2,61
26244870,23,20,2,1,46
26263460,15,28,7,2,52
26291258,22,21,2,19,64
26292352,48,4,8,9,69
26293898,77,3,2,4,86
26312073,42,5,2,1,50
26326414,15,3,2,1,21
26329406,159,32,2,14,207
26329739,100,5,2,1,108
26331891,15,3,2,1,21
26337881,40,35,5,3,83
26343795,16,3,2,1,22
26344080,76,8,2,3,89
26351981,88,18,31,8,145
26360324,18,3,2,3,26
26368920,61,53,8,14,136
26378328,137,20,2,8,167
26378726,10,3,2,2,17
26391010,61,27,2,1,91
26392069,67,34,7,2,110
26396736,14,19,2,1,36
26404688,113,12,2,1,128
26409827,36,5,2,7,50
26411760,61,40,65,1,167
26421241,86,4,2,7,99
26423357,36,18,3,16,73
26443299,93,25,5,2,125
26448534,49,23,19,2,93
26455258,106,3,2,9,120
26456014,13,14,7,1,35
26463096,24,3,2,17,46
26467177,38,24,22,5,89
26472439,14,3,2,2,21
26472699,102,77,12,26,217
26477709,38,3,2,1,44
26479531,18,29,7,1,55
26506047,61,54,2,6,123
26522664,74,23,2,2,101
26524204,114,29,49,1,193
26526185,76,25,3,2,106
26542848,24,17,9,1,51
26548643,24,24,11,1,60
26548797,42,3,2,5,52
26551392,118,3,2,10,133
26560288,14,3,2,1,20
26561235,39,45,2,12,98
26567843,17,114,41,1,173
26598635,11,3,2,1,17
26621346,36,17,40,1,94
26624438,137,37,43,1,218
26633950,17,29,2,1,49
26641118,71,26,57,3,157
26645575,11,3,2,1,17
26649780,65,22,62,2,151
26664669,48,17,5,4,74
26676530,106,3,2,6,117
26688372,41,9,2,14,66
26693241,12,14,2,1,29
26702110,19,3,2,1,25
26702884,113,34,99,8,254
26714310,79,60,32,12,183
26733148,75,12,32,2,121
26737757,56,4,2,2,64
26751892,136,57,12,3,208
26773605,18,29,2,1,50
26813363,30,3,2,1,36
26835547,33,50,4,5,92
26838383,28,3,2,3,36
26841828,78,3,2,1,84
26842930,10,8,2,1,21
26856706,67,8,4,1,80
26875286,38,3,2,1,44
26896825,105,59,9,5,178
26902750,47,24,6,1,78
26938440,287,3,2,9,301
26967708,46,6,2,1,55
26991921,53,3,2,1,59
27007265,20,20,2,3,45
27013745,119,35,58,3,215
27015949,104,17,2,1,124
27016478,10,3,2,4,19
27021882,50,3,2,1,56
27030151,95,3,2,1,101
27032011,121,3,3,10,137
27032278,60,18,2,14,94
27040189,12,5,2,1,20
27042731,43,27,2,8,80
27043581,47,15,107,29,198
27050141,52,3,2,9,66
27054778,180,3,2,4,189
27061550,21,3,2,1,27
27087807,78,3,2,10,93
27093740,10,7,2,1,20
27130537,10,6,2,1,19
27135216,54,7,2,2,65
27135292,65,16,2,7,90
27146933,170,16,2,7,195
27149992,145,3,2,1,151
27159559,83,28,2,2,115
27177002,25,3,2,1,31
27181285,54,41,12,1,108
27187175,97,65,3,14,179
27188809,61,12,2,34,109
27190375,11,3,2,3,19
27213635,88,27,2,3,120
27225048,66,44,23,3,136
27227462,34,36,48,2,120
27257516,80,43,57,1,181
27258100,12,3,2,1,18
27298851,130,45,2,2,179
27313788,128,48,3,10,189
27373336,178,20,4,5,207
27377191,53,64,2,3,122
27377901,104,3,2,2,111
27394250,105,56,67,12,240
27406189,68,35,47,25,175
27410556,67,3,2,2,74
27420534,20,3,2,1,26
27427960,109,48,3,1,161
27431095,54,3,2,10,69
27433536,59,28,30,23,140
27436088,14,3,2,2,21
27443536,31,53,21,1,106
27456310,104,100,2,3,209
27463370,37,15,32,3,87
27467266,138,15,36,70,259
27470273,31,32,6,1,70
27473747,23,38,2,2,65
27493712,57,14,2,1,74
27497943,11,3,2,6,22
27507223,50,38,11,11,110
27507331,319,3,2,10,334
27508056,33,3,2,1,39
27509784,183,3,2,1,189
27516598,101,36,3,29,169
27532506,24,3,2,6,35
27554385,47,62,4,6,119
27554926,10,28,4,1,43
27557226,272,3,2,4,281
27568074,11,5,2,1,19
27581160,45,11,2,2,60
27584333,62,12,21,32,127
27590149,75,18,50,27,170
27620548,166,47,42,1,256
27622023,113,26,3,27,169
27625486,21,18,11,1,51
27630793,40,10,7,1,58
27672335,31,3,2,1,37
27676043,56,5,177,20,258
27676967,25,3,2,1,31
27709641,90,15,93,1,199
27712896,110,4,7,3,124
27719906,73,115,49,5,242
27731377,22,8,2,1,33
27775695,21,33,4,1,59
27779316,49,59,4,9,121
27790455,26,9,2,2,39
27800272,45,10,2,8,65
27814968,155,6,2,2,165
27819289,40,46,15,1,102
27820979,96,28,4,11,139
27832610,37,11,70,1,119
27835327,108,29,23,18,178
27841785,55,33,69,56,213
27854871,501,3,2,18,524
27855148,27,4,2,4,37
27869022,55,12,2,3,72
27877387,101,35,2,6,144
27894830,66,18,13,1,98
27904954,26,26,2,1,55
27916528,82,15,2,1,100
27920327,28,9,2,1,40
27927836,119,18,7,11,155
27935043,112,15,2,3,132
27938355,110,3,2,6,121
27961642,17,16,2,1,36
27970741,68,28,4,1,101
27972792,39,36,23,29,127
27974671,71,3,2,1,77
27980065,137,24,2,8,171
27989262,20,65,2,1,88
27990478,23,16,2,1,42
27999833,76,3,2,4,85
28016421,163,10,3,2,178
28035931,145,24,41,2,212
28037642,871,8,2,10,891
28047448,14,24,2,3,43
28047555,58,3,2,2,65
28048306,10,45,2,1,58
28058236,10,5,2,2,19
28075498,75,66,42,2,185
28077023,82,23,2,2,109
28082763,13,42,2,3,60
28093131,77,37,10,7,131
28099752,20,6,2,1,29
28103387,33,64,4,14,115
28103768,171,6,36,4,217
28115840,36,3,2,1,42
28121456,162,3,2,7,174
28121960,15,15,2,1,33
28123386,83,21,60,4,168
28143133,23,35,5,14,77
28148291,21,10,2,1,34
28165508,49,54,2,5,110
28181052,21,12,2,1,36
28184821,48,37,2,14,101
28189026,17,3,2,1,23
28206484,49,3,2,10,64
28207035,80,19,15,2,116
28214794,72,12,42,2,128
28219088,48,3,2,5,58
28247716,94,3,12,1,110
28248696,454,5,2,19,480
28261249,102,8,2,9,121
28277404,199,8,9,6,222
28280114,127,99,63,14,303
28295495,54,3,2,1,60
28297810,49,6,56,8,119
28315373,44,3,2,1,50
28323310,64,3,2,1,70
28326311,14,6,2,2,24
28338241,44,15,2,1,62
28341185,64,74,4,11,153
28350310,23,5,24,2,54
28359716,19,18,2,1,40
28364474,87,22,51,10,170
28365899,34,3,2,1,40
28368910,78,35,10,1,124
28398058,13,3,2,1,19
28412118,13,6,2,1,22
28423008,32,3,2,1,38
28431966,71,6,15,1,93
28435288,11,3,2,4,20
28439331,10,3,2,3,18
28440683,89,3,2,1,95
28445517,72,3,2,11,88
28457114,198,16,23,5,242
28481699,28,12,2,8,50
28490209,65,18,9,9,101
28490311,163,3,2,1,169
28490925,36,18,2,13,69
28494827,21,3,2,1,27
28497400,76,16,2,6,100
28518159,97,33,30,11,171
28540989,80,42,4,67,193
28556020,101,3,2,1,107
28557739,42,21,16,3,82
28587782,12,3,2,1,18
28593218,40,29,2,10,81
28624329,51,9,2,2,64
28627625,82,43,56,17,198
28630314,67,24,8,7,106
28635949,17,19,2,1,39
28638512,67,26,2,3,98
28644446,45,3,2,1,51
28676207,195,4,2,1,202
28679657,89,46,53,1,189
28688424,10,3,2,5,20
28749709,73,3,2,1,79
28751737,42,20,2,1,65
28757551,27,27,2,18,74
28758827,36,28,45,2,111
28759512,23,36,4,1,64
28774179,26,16,22,13,77
28776148,123,3,2,2,130
28781662,64,28,18,9,119
28808026,27,31,2,6,66
28808492,37,23,29,13,102
28825478,46,3,2,36,87
28831598,13,24,2,1,40
28832707,134,3,2,1,140
28840021,28,4,5,1,38
28848477,36,4,2,4,46
28852006,67,30,2,2,101
28857275,11,3,2,1,17
28865867,173,16,11,1,201
28872250,13,3,2,1,19
28882616,73,12,4,1,90
28893831,20,75,9,1,105
28898155,129,4,2,1,136
28899915,98,3,5,21,127
28901635,49,38,13,1,101
28904244,59,3,3,1,66
28911613,10,11,2,2,25
28933947,12,4,2,1,19
28940497,29,13,3,1,46
28940676,135,37,7,6,185
28955784,90,49,28,32,199
28960911,145,36,11,61,253
28982872,11,3,2,1,17
28992555,44,20,3,10,77
29017490,32,19,2,1,54
29017850,31,18,2,1,52
29034365,11,3,2,1,17
29037322,30,16,15,1,62
29039694,78,26,16,8,128
29055828,91,27,2,1,121
29056324,79,46,46,127,298
29056780,164,85,2,1,252
29060686,13,12,2,8,35
29069430,31,22,10,11,74
29073862,118,3,2,5,128
29078171,20,4,2,7,33
29083737,25,34,4,1,64
29086556,13,3,2,1,19
29097652,28,3,2,1,34
29098113,64,40,4,4,112
29102496,114,3,2,1,120
29109382,20,3,2,2,27
29113369,73,8,2,2,85
29118388,10,20,2,1,33
29139053,23,27,2,5,57
29141985,95,35,61,33,224
29143508,57,41,14,13,125
29144189,60,4,47,10,121
29152518,31,3,2,2,38
29162131,200,3,2,42,247
29166277,39,5,2,1,47
29167416,23,17,3,14,57
29170356,51,3,2,1,57
29170408,51,29,14,15,109
29172398,12,3,2,1,18
29204637,35,4,2,1,42
29230396,88,10,2,1,101
29242744,61,25,2,1,89
29247327,302,69,2,15,388
29258666,17,3,2,1,23
29274256,136,3,2,2,143
29282872,142,26,2,5,175
29286675,70,8,2,1,81
29297207,11,8,2,1,22
29306492,108,4,2,1,115
29320012,38,32,14,29,113
29320128,255,36,2,13,306
29323617,101,17,47,33,198
29337274,34,53,12,27,126
29342959,19,3,2,1,25
29368898,71,48,3,19,141
29375231,61,15,3,4,83
29382029,22,3,2,1,28
29395218,37,53,2,1,93
29395385,44,3,2,1,50
29426682,48,3,2,1,54
29427992,49,58,37,14,158
29434826,17,11,2,1,31
29441194,26,20,2,1,49
29463208,10,13,2,1,26
29471401,55,43,4,34,136
29472644,57,3,2,1,63
29482855,34,3,2,1,40
29486068,62,58,21,51,192
29491686,36,18,22,16,92
29495785,12,3,2,1,18
29502550,45,7,2,1,55
29507024,67,3,2,1,73
29518831,60,19,28,6,113
29529683,27,20,2,1,50
29539738,32,3,2,2,39
29559677,94,3,2,1,100
29570421,149,3,2,1,155
29584039,56,37,107,1,201
29584164,41,45,2,6,94
29596450,60,3,2,3,68
29601394,83,16,5,1,105
29602637,50,44,14,1,109
29620276,27,26,2,8,63
29628697,14,3,2,1,20
29640072,54,45,2,2,103
29664572,335,3,2,3,343
29665864,37,3,3,1,44
29669653,53,8,17,4,82
29683545,175,8,5,7,195
29711074,12,19,2,1,34
29726820,102,42,39,15,198
29737188,11,12,2,1,26
29740019,42,32,6,5,85
29758432,14,3,2,1,20
29759191,17,9,2,1,29
29768632,73,9,21,3,106
29772514,96,3,2,5,106
29782179,77,3,2,1,83
29797500,35,40,4,3,82
29808567,137,28,2,16,183
29816355,181,3,2,27,213
29825815,11,3,2,1,17
29828967,23,6,7,1,37
29849740,18,8,5,1,32
29864689,43,32,23,1,99
29868490,20,26,2,1,49
29870431,131,85,2,12,230
29887281,91,29,2,1,123
29905840,44,3,2,1,50
29913847,25,3,2,1,31
29923280,114,3,2,3,122
29923936,17,5,2,4,28
29924236,92,3,8,1,104
29924585,58,41,3,1,103
29934853,10,10,2,1,23
29949941,41,7,7,9,64
29956196,59,21,27,4,111
29997523,42,38,18,6,104
29997938,10,4,2,1,17
30003636,39,15,2,2,58
30003648,15,14,2,1,32
30011440,164,12,11,17,204
30015937,48,23,2,3,76
30024843,34,38,4,12,88
30059688,45,4,2,5,56
30073348,18,5,8,1,32
30075905,52,11,12,1,76
30076141,11,6,2,1,20
30087178,402,40,84,52,578
30090175,142,20,28,30,220
30104076,89,3,2,7,101
30104871,170,21,2,44,237
30108101,134,4,2,2,142
30118554,84,12,15,14,125
30122967,14,3,2,1,20
30132958,36,3,2,4,45
30153009,68,29,13,5,115
30156965,36,41,2,1,80
30157132,135,20,2,1,158
30173326,37,43,2,2,84
30185585,159,30,2,5,196
30201184,20,9,2,1,32
30203807,182,3,2,13,200
30209048,11,3,2,1,17
30212794,87,36,2,9,134
30217597,15,33,3,1,52
30221413,16,19,2,1,38
30234061,114,10,44,23,191
30234354,76,35,11,1,123
30251220,85,34,8,5,132
30269576,73,9,2,6,90
30271980,276,3,2,4,285
30275631,85,3,2,2,92
30279198,19,3,2,1,25
30282052,76,49,42,27,194
30289520,80,3,2,1,86
30306530,141,3,2,8,154
30306657,28,15,2,1,46
30309080,107,10,26,36,179
30310223,17,3,2,1,23
30312963,76,3,2,1,82
30315077,71,25,2,1,99
30319194,12,3,3,1,19
30335697,105,43,2,16,166
30336855,181,3,2,3,189
30343879,11,3,2,1,17
30345727,181,40,2,5,228
30351162,26,44,3,9,82
30351655,79,3,2,1,85
30359741,51,17,2,1,71
30365053,80,3,2,2,87
30396497,11,3,2,1,17
30397937,103,28,10,59,200
30405442,57,93,19,4,173
30414590,21,8,2,1,32
30432965,72,3,2,1,78
30447339,36,27,2,6,71
30448755,98,5,2,1,106
30455113,40,6,29,3,78
30474416,65,62,7,5,139
30477401,122,13,29,9,173
30483891,106,12,2,1,121
30487627,75,63,86,7,231
30490869,24,15,4,5,48
30492608,48,3,2,2,55
30494327,35,32,25,9,101
30507031,56,3,2,3,64
30518819,55,4,2,8,69
30525391,120,55,61,58,294
30534410,12,3,2,1,18
30535951,54,16,2,1,73
30547299,14,10,2,1,27
30562690,28,3,2,4,37
30572332,144,51,26,56,277
30584304,13,3,2,2,20
30586484,22,21,2,3,48
30615195,196,45,21,31,293
30615900,52,27,2,1,82
30637271,19,3,2,1,25
30640364,16,11,2,2,31
30640804,38,61,27,5,131
30655044,59,18,4,2,83
30672979,25,31,2,8,66
30678292,234,52,2,11,299
30685164,75,3,2,1,81
30691808,213,33,16,2,264
30695658,101,29,28,2,160
30697139,83,17,5,12,117
30701269,36,14,7,1,58
30710532,37,23,2,15,77
30715591,198,8,2,2,210
30722057,41,35,12,3,91
30742230,73,59,145,1,278
30746177,192,17,68,1,278
30754046,115,50,99,17,281
30767781,172,3,2,1,178
30768549,62,12,2,8,84
30771624,10,6,2,1,19
30779797,60,93,140,2,295
30780182,92,18,7,2,119
30784559,33,24,20,1,78
30785466,54,3,2,17,76
30792705,128,17,2,2,149
30793380,123,19,40,13,195
30796050,64,9,23,6,102
30804847,64,22,2,2,90
30806033,70,18,2,3,93
30815362,11,3,2,1,17
30818377,14,3,2,1,20
30834712,44,42,19,7,112
30847866,46,19,2,1,68
30849911,77,50,5,61,193
30862074,18,3,2,1,24
30862920,66,10,6,6,88
30873561,80,4,2,1,87
30892257,65,4,2,6,77
30895111,71,13,2,2,88
30941252,53,3,2,1,59
30941926,97,18,2,1,118
30953638,27,10,2,1,40
30956263,61,29,23,15,128
30986036,108,5,2,1,116
31001013,42,18,2,1,63
31019474,16,3,2,1,22
31021978,24,3,2,1,30
31026889,46,30,69,9,154
31049908,11,3,2,1,17
31050864,226,3,2,4,235
31070368,13,3,2,1,19
31097307,12,26,2,1,41
31100636,59,11,3,1,74
31106101,48,32,38,5,123
31130598,50,21,2,3,76
31134497,89,19,8,3,119
31135543,13,5,2,1,21
31139840,111,50,5,1,167
31148461,69,15,12,32,128
31148599,18,20,2,1,41
31152121,26,36,2,2,66
31153836,65,100,37,8,210
31154206,48,32,7,22,109
31197716,28,3,2,1,34
31203185,90,9,2,1,102
31204026,25,18,17,1,61
31215921,14,3,2,2,21
31222094,21,11,2,1,35
31229688,92,62,32,26,212
31230883,16,3,2,1,22
31231781,167,3,7,1,178
31234706,29,15,5,11,60
31246864,69,20,6,2,97
31248647,44,3,2,1,50
31253659,11,3,2,1,17
31254944,51,21,24,30,126
31258902,14,3,2,1,20
31262588,124,3,2,1,130
31290001,17,3,2,1,23
31290310,207,3,2,1,213
31298231,128,61,10,12,211
31305913,21,33,2,1,57
31309725,99,11,2,1,113
31340541,13,21,2,1,37
31361698,20,29,2,1,52
31375519,98,3,2,2,105
31387979,119,37,2,1,159
31388535,12,3,2,1,18
31403472,125,23,30,10,188
31407015,54,26,71,31,182
31407418,84,3,2,1,90
31412883,11,8,2,3,24
31445928,11,3,2,1,17
31451853,105,10,2,11,128
31460606,62,14,24,32,132
31481476,43,65,56,22,186
31490883,58,11,42,10,121
31495852,51,19,2,3,75
31496670,72,40,6,2,120
31511178,75,3,2,1,81
31525364,23,12,2,1,38
31532231,11,4,2,1,18
31533875,81,101,3,1,186
31537229,43,3,2,6,54
31543000,98,16,2,15,131
31543775,12,3,2,2,19
31551971,78,64,2,15,159
31554258,57,44,2,8,111
31556713,33,16,2,1,52
31570083,97,24,2,1,124
31572681,79,19,2,9,109
31573623,125,3,2,1,131
31583661,23,3,2,1,29
31589903,165,6,2,30,203
31591212,52,69,3,9,133
31596662,34,25,2,21,82
31604755,76,3,2,8,89
31617160,17,8,5,9,39
31617169,131,36,8,6,181
31632952,106,31,46,1,184
31632991,47,19,12,5,83
31653147,10,6,2,1,19
31663362,46,27,14,22,109
31676838,24,28,22,16,90
31680617,70,3,2,1,76
31697365,22,3,2,1,28
31698550,52,28,2,1,83
31702587,108,25,2,1,136
31713343,48,7,2,3,60
31719442,67,20,47,1,135
31720804,49,43,2,1,95
31724036,111,32,111,1,255
31741526,126,16,15,16,173
31755142,91,9,2,1,103
31757906,600,3,11,1,615
31757922,13,15,2,2,32
31760788,11,3,2,1,17
31761196,27,5,2,1,35
31793233,46,10,2,1,59
31809960,21,3,2,1,27
31811443,21,16,34,18,89
31821180,74,4,4,14,96
31833710,28,35,15,1,79
31851762,11,3,3,1,18
31853658,16,3,2,1,22
31883922,69,25,22,90,206
31892694,80,14,17,7,118
31893813,20,3,2,10,35
31909117,32,11,2,76,121
31909382,82,11,34,5,132
31913907,111,21,7,6,145
31917730,196,13,32,3,244
31920423,35,22,2,1,60
31926257,117,17,2,10,146
31927133,53,3,2,1,59
31941809,11,3,2,1,17
31946227,28,24,3,16,71
31968988,110,3,2,9,124
31975621,47,69,17,6,139
31983027,193,4,11,14,222
31989138,55,34,72,27,188
31992413,38,37,22,3,100
32021164,21,33,2,1,57
32029651,21,3,2,1,27
32036536,60,14,2,4,80
32051427,113,18,2,1,134
32057741,18,3,2,1,24
32063991,80,36,30,6,152
32069989,39,18,2,1,60
32073210,44,3,2,1,50
32082907,57,11,4,1,73
32086101,35,6,2,1,44
32088279,114,31,3,4,152
32108707,14,3,2,1,20
32109508,57,43,74,1,175
32124724,15,3,2,3,23
32158037,110,30,57,9,206
32158286,51,14,2,5,72
32163988,110,26,2,17,155
32168298,99,11,2,3,115
32179975,17,3,2,1,23
32181664,31,46,11,1,89
32185904,233,23,2,9,267
32186977,113,31,104,4,252
32190755,11,4,2,1,18
32214051,71,27,57,10,165
32214562,81,3,2,3,89
32220844,22,3,2,1,28
32232052,10,4,2,1,17
32241641,49,17,2,46,114
32241843,76,10,32,15,133
32242563,72,88,71,1,232
32253016,43,5,2,1,51
32253431,145,17,42,6,210
32260086,59,3,2,1,65
32265299,30,21,9,2,62
32283440,115,3,2,2,122
32286716,72,3,2,1,78
32287187,15,107,2,1,125
32301312,20,3,2,1,26
32303545,21,7,2,1,31
32309529,59,21,2,1,83
32311574,48,35,30,7,120
32316469,121,26,23,7,177
32337748,48,6,2,3,59
32356024,15,17,2,1,35
32383415,70,16,8,11,105
32386938,80,28,48,26,182
32398735,11,3,2,1,17
32406761,81,28,2,1,112
32407566,11,4,2,1,18
32408434,264,10,5,4,283
32412672,14,58,15,1,88
32416489,115,31,3,1,150
32421151,26,39,3,3,71
32426172,14,3,2,1,20
32428555,77,28,5,2,112
32441008,28,23,7,1,59
32448900,31,35,3,2,71
32451926,36,4,2,2,44
32454362,84,11,52,4,151
32455983,87,3,2,5,97
32471867,109,31,38,15,193
32483286,44,20,6,1,71
32485227,28,40,18,2,88
32495914,17,5,2,2,26
32511818,25,53,11,17,106
32513143,143,3,2,1,149
32519255,82,7,2,9,100
32523134,32,33,3,7,75
32551727,84,16,2,3,105
32570675,32,3,2,1,38
32572939,12,30,2,1,45
32577251,271,47,16,13,347
32584962,109,18,4,1,132
32590846,10,31,2,1,44
32593827,47,27,2,12,88
32611271,120,30,16,13,179
32615960,16,3,2,2,23
32621031,172,3,2,3,180
32636844,51,22,4,1,78
32638901,200,42,2,26,270
32642168,15,6,2,1,24
32653138,341,8,2,16,367
32670930,482,3,2,5,492
32675319,23,16,28,5,72
32680563,98,3,2,1,104
32711733,49,29,2,1,81
32719604,19,3,2,2,26
32720495,55,18,18,1,92
32730607,42,59,8,9,118
32732959,56,10,55,5,126
32738843,42,19,6,1,68
32750008,55,11,2,1,69
32766171,24,3,2,1,30
32766749,15,3,2,2,22
32774938,27,11,12,1,51
32782102,32,16,20,11,79
32784042,176,32,19,59,286
32789108,18,17,14,1,50
32814847,75,3,2,1,81
32818452,21,8,2,9,40
32819449,57,37,62,29,185
32822136,47,14,2,1,64
32833972,107,3,2,1,113
32836203,69,43,22,1,135
32839885,53,21,41,20,135
32841851,45,15,3,1,64
32842793,43,8,19,2,72
32846343,10,3,2,3,18
32849152,41,3,2,1,47
32849943,185,68,12,41,306
32865846,35,34,3,1,73
32895247,41,15,2,1,59
32897624,27,51,8,2,88
32909834,12,3,2,2,19
32931689,72,3,2,1,78
32945887,12,9,2,2,25
32975711,38,16,8,9,71
32985252,231,3,2,1,237
32994670,58,16,2,2,78
32998831,44,7,7,11,69
32999025,19,17,33,1,70
33012041,101,10,2,2,115
33012773,94,9,3,3,109
33014208,33,3,14,11,61
33021842,35,3,2,7,47
33029022,321,3,2,3,329
33031828,78,3,2,4,87
33039021,91,13,21,19,144
33064277,76,4,2,1,83
33066090,52,6,2,5,65
33098008,14,17,6,1,38
33101398,18,3,2,1,24
33101565,11,3,2,1,17
33124723,22,6,14,10,52
33132010,85,4,2,5,96
33153075,20,3,2,1,26
33157771,169,31,29,7,236
33170449,29,21,3,1,54
33171706,62,8,86,9,165
33171811,11,3,2,1,17
33174251,29,58,17,1,105
33176072,11,3,2,1,17
33180837,11,3,2,2,18
33197760,24,10,11,3,48
33203974,133,3,7,3,146
33211809,216,24,7,13,260
33216325,195,42,11,8,256
33217531,14,17,2,1,34
33236001,31,4,12,3,50
33242567,10,11,2,1,24
33244464,55,109,31,7,202
33246106,36,19,2,1,58
33251105,65,3,2,1,71
33257234,118,17,88,7,230
33257421,115,4,2,2,123
33262296,55,18,2,6,81
33274563,10,18,2,1,31
33279784,47,3,7,3,60
33288495,14,90,2,4,110
33288776,223,121,54,6,404
33289930,88,16,3,1,108
33293845,11,3,2,1,17
33295372,51,3,2,1,57
33331393,177,21,2,3,203
33334985,10,5,2,1,18
33337183,67,80,27,6,180
33338274,25,25,2,1,53
33350304,80,38,26,15,159
33359110,35,22,2,1,60
33359727,37,18,3,1,59
33367786,92,3,2,1,98
33368316,13,3,2,1,19
33368318,48,18,22,1,89
33382290,42,35,23,6,106
33387787,80,35,14,7,136
33391812,105,170,8,23,306
33397664,37,14,2,4,57
33404822,99,34,46,1,180
33405995,26,3,2,2,33
33410420,14,3,2,1,20
33413196,142,23,2,1,168
33436771,126,3,2,3,134
33446393,63,29,23,1,116
33454044,67,25,6,7,105
33474356,15,3,2,2,22
33482256,65,33,2,1,101
33498229,59,8,2,1,70
33516315,56,16,67,5,144
33523674,87,18,6,3,114
33525970,160,12,24,43,239
33529764,169,41,3,4,217
33534699,47,3,2,1,53
33550520,13,29,6,16,64
33592138,12,3,2,1,18
33610052,95,26,2,1,124
33643418,89,37,50,2,178
33652124,45,34,35,3,117
33661167,54,33,14,5,106
33665679,138,3,2,1,144
33676794,45,75,20,4,144
33677595,18,21,3,16,58
33678589,66,13,7,3,89
33683621,44,15,2,1,62
33684599,33,52,50,15,150
33690574,58,3,2,5,68
33725046,11,3,2,3,19
33725492,40,3,2,1,46
33732200,60,16,27,2,105
33745179,50,3,2,1,56
33752398,143,23,2,7,175
33767656,119,20,3,2,144
33771432,78,15,2,1,96
33771540,10,9,2,1,22
33773505,48,3,2,8,61
33793443,77,15,2,40,134
33796669,67,7,6,11,91
33807131,12,9,2,1,24
33820921,18,14,2,1,35
33824495,10,6,2,1,19
33831712,51,13,22,1,87
33857981,70,24,70,1,165
33858710,13,14,5,2,34
33864821,82,27,2,4,115
33869489,15,3,2,2,22
33872820,205,61,7,4,277
33880575,36,3,2,1,42
33895182,179,8,8,28,223
33897497,77,20,2,1,100
33901012,14,3,2,1,20
33903637,37,5,2,3,47
33905712,46,3,2,1,52
33918776,33,3,2,1,39
33921907,65,36,11,1,113
33925958,57,20,13,8,98
33931009,31,29,2,2,64
33949496,82,5,3,1,91
33950976,93,6,2,1,102
33968647,17,3,2,1,23
33969195,116,3,2,1,122
33976525,54,3,2,2,61
33986440,128,3,2,6,139
33994677,155,18,33,2,208
33998226,315,18,22,1,356
34001132,45,27,3,2,77
34013235,100,17,18,6,141
34016708,66,10,2,1,79
34018033,57,3,2,8,70
34031393,200,10,8,1,219
34062743,57,102,2,1,162
34079527,38,3,2,2,45
34087884,23,43,2,1,69
34104863,60,53,52,42,207
34119997,90,4,2,2,98
34120800,41,12,12,1,66
34122364,122,26,55,1,204
34132194,84,20,2,16,122
34141819,146,31,2,2,181
34145024,10,3,2,3,18
34145167,87,14,5,3,109
34156438,44,64,10,16,134
34164839,119,34,2,6,161
34177694,45,17,2,1,65
34185460,123,15,15,23,176
34192876,11,7,2,1,21
34196747,99,69,7,2,177
34206233,46,3,2,1,52
34231613,43,3,2,1,49
34234255,72,37,4,1,114
34265040,85,3,2,1,91
34266796,21,86,2,1,110
34272827,32,23,5,21,81
34278476,10,27,2,1,40
34281762,85,19,2,2,108
34287289,17,3,2,1,23
34300154,23,21,31,59,134
34310071,66,55,23,41,185
34319706,107,3,87,6,203
34326154,94,27,31,33,185
34342151,15,3,2,1,21
34353836,128,13,2,3,146
34365860,235,40,2,5,282
34366497,35,3,2,1,41
34389384,167,14,7,3,191
34396003,10,4,2,1,17
34398008,19,3,2,1,25
34400036,63,16,28,1,108
34405632,25,17,4,2,48
34439306,32,25,15,9,81
34455660,127,16,2,3,148
34471082,66,50,4,1,121
34474436,11,3,2,1,17
34501294,12,9,13,1,35
34507357,420,3,2,16,441
34511755,38,7,2,1,48
34512703,11,3,2,2,18
34514865,13,5,2,1,21
34536093,127,12,2,1,142
34543846,68,3,2,1,74
34544652,376,3,2,1,382
34553776,77,42,20,77,216
34554060,20,13,2,1,36
34609142,114,12,70,26,222
34610960,49,3,2,1,55
34612536,36,37,4,3,80
34644493,12,3,2,1,18
34656293,70,21,7,3,101
34677027,22,3,2,1,28
34696810,85,64,25,7,181
34697687,19,3,2,1,25
34707327,82,40,33,4,159
34735564,25,3,2,1,31
34746532,54,50,135,1,240
34750246,16,49,23,1,89
34751605,160,48,212,4,424
34752153,10,43,2,1,56
34754843,13,7,2,1,23
34760715,86,32,2,7,127
34762500,11,3,2,1,17
34766494,211,91,2,1,305
34769331,37,3,5,4,49
34781913,30,3,2,1,36
34784292,173,11,2,4,190
34789714,151,103,31,68,353
34794541,36,3,2,1,42
34818394,130,45,36,12,223
34822165,73,22,6,12,113
34823819,27,5,4,1,37
34840063,31,3,2,1,37
34848030,41,39,19,10,109
34853369,21,10,2,1,34
34867820,52,45,3,8,108
34914263,51,45,2,4,102
34919168,72,11,2,12,97
34920624,19,19,2,1,41
34926279,70,8,14,1,93
34927851,107,55,6,40,208
34934529,52,11,2,15,80
34959451,42,24,4,1,71
34978138,66,5,2,2,75
34991156,200,3,2,1,206
34997449,145,19,173,92,429
35001617,29,45,2,8,84
35008041,13,10,3,1,27
35030101,25,15,10,3,53
35035668,11,3,2,1,17
35059755,81,24,7,10,122
35087464,41,3,2,1,47
35088650,20,3,2,1,26
35121799,68,15,2,1,86
35147241,11,13,2,1,27
35148340,10,7,2,2,21
35163306,29,28,18,4,79
35163789,21,51,2,5,79
35164046,53,40,2,2,97
35176147,13,3,2,1,19
35192618,45,4,2,11,62
35199549,50,11,2,1,64
35203447,48,102,2,3,155
35206738,67,14,56,1,138
35212517,121,3,2,4,130
35218095,12,33,2,1,48
35230659,17,5,5,1,28
35234235,63,11,6,16,96
35238307,110,29,6,4,149
35241744,43,17,58,8,126
35260030,30,3,2,18,53
35260506,104,3,2,5,114
35263880,17,29,2,4,52
35265367,282,64,44,22,412
35270334,124,18,2,12,156
35274026,11,3,2,1,17
35298267,41,30,2,91,164
35303353,77,54,111,34,276
35304328,14,24,2,1,41
35306962,131,39,76,8,254
35311528,79,31,2,2,114
35323834,87,30,4,14,135
35332897,108,21,108,25,262
35344671,11,6,2,1,20
35347807,63,3,12,2,80
35365325,71,10,28,2,111
35370062,89,86,31,9,215
35377981,62,20,25,1,108
35379122,23,3,2,1,29
35380954,13,10,2,3,28
35383092,12,3,2,1,18
35389834,11,3,2,1,17
35400877,62,3,2,2,69
35402010,61,61,2,1,125
35402215,84,4,2,11,101
35403363,23,3,2,1,29
35404221,41,22,12,6,81
35408221,17,7,2,2,28
35419199,82,12,3,15,112
35421191,80,25,2,3,110
35450869,16,5,2,2,25
35457256,37,60,55,2,154
35474321,101,11,2,1,115
35474936,61,40,28,10,139
35487264,60,22,33,9,124
35505129,290,7,7,27,331
35527417,76,35,4,3,118
35544543,39,25,7,7,78
35547141,21,3,2,1,27
35551440,10,3,2,2,17
35553650,10,3,2,3,18
35555461,19,43,2,1,65
35564049,39,42,3,6,90
35577138,15,3,2,1,21
35586370,101,3,2,1,107
35592162,138,34,2,1,175
35593289,155,66,117,1,339
35609928,40,3,2,1,46
35617835,45,16,2,3,66
35663689,73,36,12,15,136
35697227,56,22,15,22,115
35702110,82,3,2,33,120
35709790,51,35,3,4,93
35736921,205,20,2,2,229
35738074,21,5,2,1,29
35740646,11,6,2,1,20
35754690,82,12,6,11,111
35755760,35,3,2,1,41
35765691,55,22,2,1,80
35780317,62,24,10,14,110
35782286,72,3,2,5,82
35810662,78,12,2,1,93
35813076,93,3,2,11,109
35813904,150,30,10,22,212
35820085,135,23,54,9,221
35867242,82,49,3,2,136
35873979,67,53,12,11,143
35875991,40,12,2,2,56
35888892,14,3,2,1,20
35891735,88,84,34,1,207
35900024,75,33,9,2,119
35907041,131,4,26,11,172
35907834,64,66,36,8,174
35917033,91,20,110,24,245
35921781,69,19,48,13,149
35945221,223,34,3,2,262
35949617,132,3,2,38,175
35951864,35,50,3,5,93
35967905,75,16,2,3,96
35979658,12,4,2,1,19
35987834,50,5,16,10,81
35990607,54,19,42,1,116
35995920,58,12,44,1,115
36006823,85,3,2,8,98
36016160,15,3,2,3,23
36017401,40,5,5,21,71
36017435,32,3,2,1,38
36022135,11,3,2,1,17
36042002,31,12,2,7,52
36047289,19,3,2,1,25
36047593,36,3,2,4,45
36052980,110,10,2,3,125
36067505,56,11,89,1,157
36101362,21,3,2,5,31
36145087,38,22,17,34,111
36165543,64,22,28,16,130
36170003,51,11,4,1,67
36180555,254,3,2,1,260
36180975,10,3,2,2,17
36186448,67,11,2,15,95
36188948,486,3,2,3,494
36203152,113,5,2,6,126
36208806,112,3,2,3,120
36214951,31,3,2,1,37
36218731,48,18,2,2,70
36219052,42,3,2,1,48
36220039,22,18,9,1,50
36226133,23,4,2,2,31
36236960,129,30,57,4,220
36237090,14,18,2,1,35
36246349,121,3,2,17,143
36249486,88,3,2,2,95
36254783,40,3,2,1,46
36263952,73,3,2,1,79
36294973,90,5,3,16,114
36295311,63,23,2,1,89
36321209,159,17,3,1,180
36329431,547,3,2,3,555
36333351,20,41,22,1,84
36356091,31,6,2,1,40
36373621,97,23,15,4,139
36387526,106,10,10,4,130
36389072,16,3,2,1,22
36395037,11,5,2,1,19
36399117,52,23,28,9,112
36409729,17,9,2,5,33
36426086,75,54,5,12,146
36430080,22,69,2,1,94
36443907,12,3,2,1,18
36453043,75,24,8,2,109
36455837,106,35,2,6,149
36461236,37,67,10,1,115
36462061,97,11,2,2,112
36475313,180,51,24,16,271
36492490,60,72,2,4,138
36493329,18,6,2,1,27
36503850,49,97,27,2,175
36524992,24,3,2,2,31
36526169,50,3,2,1,56
36529768,85,29,6,1,121
36532277,135,20,2,7,164
36542303,14,10,2,1,27
36552073,38,23,2,7,70
36566776,12,8,2,1,23
36569553,202,6,28,1,237
36581566,10,25,2,1,38
36586000,146,33,6,41,226
36590103,26,90,71,1,188
36602758,10,4,2,1,17
36616913,11,3,2,1,17
36618139,68,5,2,1,76
36620634,17,28,9,13,67
36630275,71,41,7,18,137
36630524,13,3,2,1,19
36634333,49,3,2,8,62
36665482,10,9,2,1,22
36671605,61,17,2,1,81
36681930,14,28,2,1,45
36691441,203,3,2,2,210
36705037,41,19,6,8,74
36722369,17,21,2,1,41
36727629,16,3,2,1,22
36731929,10,4,2,1,17
36740461,13,3,2,1,19
36742540,91,14,11,12,128
36744101,165,17,2,1,185
36759505,117,3,2,7,129
36761622,118,18,10,4,150
36771517,22,31,76,1,130
36777238,11,3,2,1,17
36783864,117,59,13,91,280
36788411,127,24,37,104,292
36792654,53,3,2,1,59
36797401,47,40,10,1,98
36799504,10,4,2,1,17
36835771,19,10,11,6,46
36841127,15,3,2,1,21
36852114,74,3,2,1,80
36855523,151,14,3,6,174
36855665,26,9,6,27,68
36864113,78,40,45,13,176
36867320,158,27,3,8,196
36875453,86,40,50,12,188
36876210,10,3,2,3,18
36886669,21,31,25,1,78
36892141,122,74,4,9,209
36907085,60,3,2,10,75
36946735,24,6,11,1,42
36947098,52,12,3,3,70
36947847,84,16,5,21,126
36962680,221,61,18,12,312
36969480,145,21,36,35,237
36979675,267,10,58,4,339
36985696,31,51,39,3,124
36986219,10,3,2,2,17
36996887,79,3,2,4,88
37004843,27,3,2,2,34
37013215,33,3,2,1,39
37015688,44,3,14,4,65
37019972,153,36,2,2,193
37033823,28,98,18,3,147
37049530,84,3,2,1,90
37058301,10,28,2,1,41
37065506,50,27,2,1,80
37073478,21,4,2,1,28
37075601,63,43,14,1,121
37085257,20,31,2,1,54
37098912,19,9,2,2,32
37099500,30,10,6,17,63
37101453,93,3,2,1,99
37102767,15,13,2,1,31
37108228,18,3,2,1,24
37127713,30,77,9,1,117
37135343,94,17,2,1,114
37139100,64,8,36,1,109
37142611,37,19,9,1,66
37147376,17,20,2,1,40
37150528,27,15,3,14,59
37180457,56,25,2,6,89
37184132,21,3,2,1,27
37187872,14,3,2,3,22
37202389,44,33,7,1,85
37206455,71,15,2,1,89
37214638,21,3,2,1,27
37218805,73,42,14,1,130
37219496,38,3,2,1,44
37227670,44,5,2,1,52
37231182,117,38,2,5,162
37243596,28,48,5,1,82
37243599,127,8,17,18,170
37256890,88,57,19,2,166
37262455,10,5,2,1,18
37270153,82,13,4,11,110
37270455,41,22,2,78,143
37291354,48,15,2,17,82
37295579,24,83,24,1,132
37296299,49,24,2,1,76
37296933,10,4,2,1,17
37299100,106,3,2,2,113
37299697,31,5,2,3,41
37306262,109,3,2,4,118
37309947,89,27,2,2,120
37310505,105,47,46,1,199
37318568,45,3,2,5,55
37323996,32,47,2,31,112
37325310,27,17,2,6,52
37336289,93,57,2,20,172
37336457,10,7,2,1,20
37342270,112,20,149,3,284
37351727,35,35,32,8,110
37369124,10,42,2,1,55
37370569,62,28,2,1,93
37390691,38,14,3,9,64
37416148,20,30,2,1,53
37420344,91,60,120,1,272
37434006,36,3,2,1,42
37447341,38,3,2,1,44
37447706,57,6,3,1,67
37456443,108,6,3,1,118
37463487,132,36,25,2,195
37469120,102,91,32,90,315
37475642,71,19,12,4,106
37492701,61,3,2,1,67
37504924,13,3,2,1,19
37506874,11,3,2,1,17
37533481,53,17,23,3,96
37566748,15,3,2,2,22
37573512,27,47,2,14,90
37575499,25,47,67,6,145
37582941,107,3,2,1,113
37583759,18,39,2,1,60
37587575,115,3,2,1,121
37594396,118,32,61,3,214
37603630,35,3,2,1,41
37611664,65,20,46,4,135
37620513,68,49,7,18,142
37624968,203,3,2,15,223
37625351,15,16,2,2,35
37628518,81,5,2,1,89
37633748,53,12,2,19,86
37639456,40,13,2,1,56
37643739,13,4,2,3,22
37651686,23,40,5,9,77
37652305,95,21,84,25,225
37660177,52,4,2,3,61
37681629,65,11,9,46,131
37683992,34,29,14,1,78
37683995,49,28,6,4,87
37689616,18,3,2,1,24
37694127,13,3,2,3,21
37696697,14,29,12,25,80
37711302,94,31,17,5,147
37725462,19,3,2,3,27
37727121,59,35,5,6,105
37753882,100,17,4,14,135
37760360,174,3,2,1,180
37761044,81,28,51,25,185
37770761,66,12,31,6,115
37774376,107,3,2,1,113
37781829,36,3,2,1,42
37793310,65,18,2,1,86
37796146,113,16,2,1,132
37797229,19,3,2,1,25
37800557,95,38,23,7,163
37812799,85,3,2,1,91
37816168,64,52,57,3,176
37819804,83,12,19,5,119
37827828,105,3,50,1,159
37830870,82,36,3,1,122
37834720,11,28,2,1,42
37877331,29,4,2,5,40
37879417,95,45,31,21,192
37886043,52,76,42,26,196
37894447,83,46,7,11,147
37895513,14,3,2,1,20
37914240,184,14,2,3,203
37921262,27,3,2,6,38
37926492,45,43,70,4,162
37930644,85,49,2,1,137
37931287,173,49,51,6,279
37952902,214,3,2,9,228
37960897,87,21,19,1,128
37967650,174,3,6,5,188
37968535,16,68,17,3,104
37971395,58,30,7,14,109
37972876,69,19,2,5,95
37977703,142,23,2,1,168
37991411,150,10,17,15,192
37996071,29,12,9,10,60
38016231,10,3,2,2,17
38020282,55,4,2,1,62
38029848,42,23,2,7,74
38044426,37,46,3,5,91
38046417,117,50,110,2,279
38046956,176,20,5,36,237
38057415,97,38,25,10,170
38057481,31,3,2,1,37
38068910,28,29,17,6,80
38076065,36,22,2,1,61
38084016,31,32,103,4,170
38091321,35,6,2,1,44
38107649,22,30,3,1,56
38120537,32,38,2,1,73
38121006,19,14,4,3,40
38127093,11,3,2,1,17
38131647,35,6,10,1,52
38152558,57,25,35,1,118
38170881,114,7,4,3,128
38176431,62,3,11,1,77
38183815,129,20,3,6,158
38184754,27,46,5,9,87
38199035,63,41,15,9,128
38204149,24,25,2,1,52
38206588,56,48,2,1,107
38209043,62,5,2,1,70
38217691,46,16,20,1,83
38220565,20,4,2,3,29
38223739,95,8,3,10,116
38224459,142,16,10,48,216
38232405,97,3,2,1,103
38260879,108,3,2,14,127
38277049,14,3,2,3,22
38280817,123,10,2,3,138
38284234,40,49,23,12,124
38296121,28,3,2,1,34
38303640,11,3,2,1,17
38307480,97,7,2,1,107
38308633,159,3,2,5,169
38311005,84,3,2,1,90
38312727,12,3,2,1,18
38324832,16,3,2,3,24
38343796,35,51,7,22,115
38362879,35,51,3,5,94
38374619,74,3,2,4,83
38378305,166,3,2,5,176
38387350,127,35,2,1,165
38396800,41,24,2,1,68
38405489,82,72,20,19,193
38413155,94,31,29,6,160
38415346,108,26,25,1,160
38418367,93,79,37,20,229
38430692,98,16,2,1,117
38433613,11,3,2,1,17
38436404,139,3,2,1,145
38449101,50,19,3,4,76
38450799,26,3,2,1,32
38458875,72,17,19,12,120
38467213,23,3,2,1,29
38470850,161,3,2,1,167
38480581,66,31,129,23,249
38493682,106,3,2,1,112
38499978,43,36,33,3,115
38500253,23,3,2,1,29
38505030,53,9,2,1,65
38518899,41,3,2,6,52
38526697,125,3,2,5,135
38528548,28,19,28,5,80
38532154,60,20,11,9,100
38561990,25,5,2,1,33
38570533,28,17,14,2,61
38576433,31,11,4,1,47
38578899,24,4,3,1,32
38588664,49,57,117,46,269
38600826,14,9,2,1,26
38609256,78,22,2,2,104
38620777,44,14,3,1,62
38622501,59,25,5,43,132
38645141,102,3,2,1,108
38654976,90,3,2,1,96
38678565,108,12,2,1,123
38698832,43,3,2,2,50
38706124,59,18,16,5,98
38706844,198,12,19,60,289
38726778,112,10,2,1,125
38730213,98,22,10,22,152
38744905,20,3,2,1,26
38775744,58,46,5,16,125
38777974,29,19,2,1,51
38779819,11,18,2,1,32
38784358,23,3,2,2,30
38784817,32,182,30,2,246
38791229,28,3,2,2,35
38802453,81,3,2,1,87
38802529,93,3,2,15,113
38804869,77,14,20,19,130
38805316,78,20,3,37,138
38808079,13,4,2,1,20
38837338,33,31,2,1,67
38860702,129,3,2,1,135
38866457,29,39,2,1,71
38878297,42,8,2,1,53
38893871,54,36,24,1,115
38894905,40,13,2,4,59
38930459,29,3,2,5,39
38944109,24,3,2,1,30
38954196,35,3,2,1,41
38965007,58,17,32,4,111
38967372,198,24,3,18,243
38969057,98,3,2,1,104
38972223,53,5,2,6,66
38974035,27,3,2,11,43
38982814,70,53,22,4,149
38987761,38,11,2,1,52
38994286,57,3,2,1,63
38995672,21,3,2,4,30
39000284,24,38,6,15,83
39005522,79,25,93,4,201
39014328,100,9,2,5,116
39035175,46,22,3,6,77
39044398,20,3,2,1,26
39044776,36,3,2,6,47
39060312,136,11,19,9,175
39061958,60,3,2,1,66
39073419,94,3,2,1,100
39074357,27,16,16,2,61
39087304,79,13,2,2,96
39095629,82,16,17,1,116
39118717,111,107,38,46,302
39152750,42,23,7,12,84
39153375,54,3,2,2,61
39169373,76,3,13,1,93
39185905,72,9,19,3,103
39187056,87,14,2,4,107
39207006,11,3,2,1,17
39220440,89,3,2,2,96
39220810,157,3,2,12,174
39222173,55,3,2,1,61
39233089,13,3,2,1,19
39238779,157,28,96,1,282
39251959,70,9,4,15,98
39276531,12,3,2,1,18
39278832,57,37,10,19,123
39293746,10,5,2,1,18
39297490,11,14,2,1,28
39307702,799,3,2,90,894
39307954,88,57,20,11,176
39311876,78,28,2,7,115
39333894,82,3,2,1,88
39334858,13,3,2,1,19
39362656,19,35,8,5,67
39384198,28,27,22,1,78
39397478,104,23,2,5,134
39405216,28,10,2,1,41
39414325,39,25,29,5,98
39414877,73,23,121,1,218
39417113,101,62,63,5,231
39421031,11,3,2,1,17
39423390,77,3,3,6,89
39434989,165,3,3,1,172
39440602,38,30,2,33,103
39462511,173,52,22,4,251
39482022,109,47,13,68,237
39490808,51,25,9,3,88
39497224,121,9,2,23,155
39502142,43,31,15,6,95
39511812,13,3,2,1,19
39518386,144,21,2,8,175
39526415,185,14,32,7,238
39531569,16,3,2,1,22
39542910,14,18,6,1,39
39550487,11,24,2,1,38
39553088,29,9,65,1,104
39554950,33,17,3,1,54
39556321,384,39,2,1,426
39567086,72,13,5,2,92
39599665,81,4,2,1,88
39601833,24,23,4,3,54
39605812,15,4,2,1,22
39611272,13,3,2,1,19
39614447,64,20,15,11,110
39624656,54,28,39,106,227
39643428,17,19,2,1,39
39647440,10,22,10,1,43
39650386,85,22,38,33,178
39662647,72,5,2,1,80
39681850,15,3,2,1,21
39694425,29,37,14,7,87
39696636,123,3,2,7,135
39700127,72,30,5,1,108
39712112,48,4,2,1,55
39726823,33,5,2,9,49
39732574,31,17,2,9,59
39735186,62,44,4,1,111
39736225,35,11,21,5,72
39738271,11,3,2,1,17
39742828,195,22,2,3,222
39749796,67,3,2,1,73
39750040,127,13,2,4,146
39765792,47,3,2,4,56
39778086,30,17,2,1,50
39779005,69,15,2,4,90
39780986,18,3,2,1,24
39783292,60,3,2,4,69
39803801,65,3,2,1,71
39810308,21,3,2,1,27
39862752,29,22,17,72,140
39874658,28,33,8,1,70
39879386,21,3,2,13,39
39885841,81,24,2,1,108
39888459,11,3,2,2,18
39914498,45,3,2,2,52
39916919,44,32,56,3,135
39944868,88,13,2,5,108
39946541,91,28,2,8,129
39948582,90,15,2,2,109
39956917,11,3,2,1,17
39975272,103,3,2,2,110
39976693,57,22,2,4,85
39996714,16,3,2,1,22
39997672,505,3,2,14,524
40007655,106,20,2,3,131
40011256,76,17,4,1,98
40021359,22,3,2,1,28
40027116,54,51,2,1,108
40032290,29,3,2,1,35
40033460,53,11,2,1,67
40049849,46,16,2,1,65
40083338,50,23,2,1,76
40088159,138,5,2,1,146
40089820,35,3,2,1,41
40091275,77,57,67,74,275
40106774,74,77,167,5,323
40135776,105,38,2,3,148
40140685,12,11,2,1,26
40143151,128,109,2,20,259
40146191,93,31,4,1,129
40146345,102,14,2,7,125
40146507,147,68,30,80,325
40151509,73,7,13,1,94
40155164,95,3,2,1,101
40156325,63,25,27,7,122
40187588,11,3,2,3,19
40192977,91,16,2,2,111
40199071,81,20,36,17,154
40202621,99,3,22,6,130
40213563,70,33,48,2,153
40217942,78,3,2,2,85
40244170,43,55,18,3,119
40244199,45,56,33,2,136
40253764,73,3,2,12,90
40254636,39,3,2,1,45
40282377,19,3,2,2,26
40284331,24,3,2,1,30
40303175,14,13,2,1,30
40312585,56,26,15,2,99
40328736,119,3,2,2,126
40331173,26,3,2,4,35
40354006,11,3,2,1,17
40369415,37,59,54,2,152
40377145,132,3,2,1,138
40428450,35,3,2,1,41
40431877,47,11,2,11,71
40439589,30,39,21,9,99
40444579,95,3,2,1,101
40453374,116,30,37,15,198
40464011,110,16,5,6,137
40464981,48,45,8,1,102
40474286,96,3,2,1,102
40474684,101,26,2,3,132
40476125,30,12,43,6,91
40482024,119,19,7,11,156
40490295,12,3,2,1,18
40512025,21,20,29,1,71
40512356,61,25,6,1,93
40524929,13,11,2,1,27
40528037,132,18,47,31,228
40533666,19,6,2,1,28
40540853,23,5,2,2,32
40553754,151,4,2,1,158
40573959,32,54,2,4,92
40577326,85,6,16,11,118
40579207,96,3,2,1,102
40583500,103,4,2,14,123
40614994,37,7,2,1,47
40619344,53,25,25,3,106
40619452,28,77,31,4,140
40619827,28,30,24,2,84
40630008,62,15,16,3,96
40632003,63,7,11,1,82
40634547,166,3,2,4,175
40649642,41,21,6,1,69
40651075,23,26,2,1,52
40653787,36,10,8,10,64
40664096,98,3,2,1,104
40666640,19,29,3,1,52
40669022,56,31,43,1,131
40670688,12,9,2,1,24
40682137,11,3,2,1,17
40714708,44,42,2,27,115
40723545,48,12,13,11,84
40727734,50,23,25,24,122
40732745,20,7,2,2,31
40736016,12,3,2,1,18
40749042,40,51,3,1,95
40753977,86,3,2,1,92
40755488,181,30,2,1,214
40777313,59,20,61,25,165
40807527,77,3,2,3,85
40810417,32,26,37,1,96
40821605,20,11,2,2,35
40859506,29,54,35,1,119
40864594,12,3,2,1,18
40879734,33,27,11,12,83
40889881,195,5,2,13,215
40897702,11,3,2,1,17
40899640,56,14,2,2,74
40901612,63,18,4,2,87
40905031,21,16,2,1,40
40921194,73,40,2,1,116
40922908,99,35,5,4,143
40922912,19,20,2,2,43
40947771,13,14,2,1,30
40954696,42,40,2,33,117
40964581,118,52,32,16,218
40971234,99,13,2,4,118
40979453,94,3,2,4,103
40983920,38,14,2,2,56
40987337,48,17,5,1,71
40989326,16,20,2,1,39
40989333,12,24,2,1,39
40990613,43,3,2,4,52
40991278,39,18,2,1,60
40996884,162,28,5,4,199
40997736,41,81,14,7,143
41001622,31,56,50,1,138
41012597,76,3,2,1,82
41018126,65,8,8,4,85
41053711,29,10,3,9,51
41087684,19,6,2,1,28
41095688,27,3,2,1,33
41097513,50,24,3,4,81
41112844,106,20,2,3,131
41145724,16,17,2,1,36
41164738,52,42,2,39,135
41179633,12,6,2,1,21
41202329,52,3,2,1,58
41220357,113,18,2,6,139
41221804,37,4,5,4,50
41239971,10,11,2,1,24
41268387,112,25,8,17,162
41292160,33,3,2,1,39
41300093,120,36,3,4,163
41300601,22,3,2,1,28
41313586,60,23,2,5,90
41331058,10,4,2,6,22
41332379,22,3,2,1,28
41339118,21,3,2,1,27
41354673,54,41,27,7,129
41360104,11,3,2,1,17
41370064,75,25,2,2,104
41375358,105,3,2,3,113
41400971,46,3,2,1,52
41403527,50,29,8,1,88
41407199,41,51,22,1,115
41430458,109,3,2,5,119
41433167,43,45,4,6,98
41448306,530,32,2,10,574
41453630,64,3,2,1,70
41455727,45,48,14,1,108
41460956,140,51,37,44,272
41465428,25,3,2,2,32
41474539,50,19,27,26,122
41474883,56,21,9,1,87
41491664,11,3,2,2,18
41496840,87,3,2,1,93
41507435,227,26,4,11,268
41535505,10,34,2,1,47
41542849,71,9,2,1,83
41555053,96,16,6,8,126
41556663,16,18,29,1,64
41564825,39,20,20,5,84
41589398,49,9,17,14,89
41590842,88,3,2,4,97
41598950,100,6,2,2,110
41610593,29,60,2,7,98
41614876,238,3,2,4,247
41628375,18,7,2,7,34
41638930,31,13,2,1,47
41642271,93,14,19,2,128
41644047,18,7,2,2,29
41648212,16,3,2,2,23
41651543,47,37,49,1,134
41658506,77,3,2,4,86
41662420,73,27,14,3,117
41689481,109,40,163,2,314
41690137,12,9,2,18,41
41691760,13,18,2,1,34
41702924,35,3,2,1,41
41719229,47,30,29,3,109
41729682,33,4,2,1,40
41747430,67,75,27,1,170
41760131,18,3,2,1,24
41769499,12,3,2,1,18
41776496,72,3,2,5,82
41819275,62,15,10,18,105
41819794,46,3,2,1,52
41821656,69,12,33,3,117
41832497,24,19,2,1,46
41836738,52,3,2,1,58
41842869,174,33,3,6,216
41846773,40,8,2,1,51
41848193,130,24,19,2,175
41849424,109,51,2,3,165
41853956,66,3,2,1,72
41855840,50,16,3,33,102
41860542,53,40,18,6,117
41883832,45,15,2,15,77
41919477,101,20,2,5,128
41928638,53,15,2,2,72
41935451,49,31,17,21,118
41955788,60,3,15,7,85
41961813,60,29,13,3,105
41962304,137,42,40,51,270
41969501,63,32,32,25,152
41993358,86,4,3,5,98
41995133,43,7,2,15,67
41997771,164,3,2,14,183
42052802,17,7,5,2,31
42099779,14,4,3,1,22
42106249,104,3,2,2,111
42108216,38,22,2,1,63
42125746,25,6,2,1,34
42126467,45,70,29,48,192
42127720,46,32,23,5,106
42130856,146,3,2,1,152
42132462,100,9,2,6,117
42146221,62,47,26,11,146
42148812,168,65,2,1,236
42148897,126,10,2,6,144
42149392,41,3,2,1,47
42171984,23,18,6,1,48
42197415,97,3,2,5,107
42212066,21,12,2,2,37
42225281,12,3,2,1,18
42239654,13,3,2,1,19
42240175,28,14,20,1,63
42259618,110,13,2,2,127
42292958,95,44,2,1,142
42321538,33,8,2,2,45
42322699,73,43,95,1,212
42330304,41,12,9,6,68
42360554,11,13,2,1,27
42376165,28,3,2,1,34
42383510,37,110,4,8,159
42387128,11,3,2,1,17
42390991,61,3,2,14,80
42411049,56,13,27,5,101
42437414,14,35,2,1,52
42443718,14,3,2,2,21
42469007,129,39,31,1,200
42476377,77,35,2,3,117
42479858,50,17,2,3,72
42488490,1606,3,2,30,1641
42493053,25,9,2,1,37
42531880,19,3,2,1,25
42571470,16,3,2,1,22
42575621,49,16,34,1,100
42577565,67,42,36,3,148
42592876,82,26,68,16,192
42594441,72,33,32,1,138
42595348,106,27,24,7,164
42610456,124,3,2,1,130
42611232,14,3,2,1,20
42614666,42,19,4,1,66
42664863,36,3,2,1,42
42682445,48,32,18,1,99
42714680,52,6,2,4,64
42726280,42,31,44,1,118
42740285,35,47,5,1,88
42750202,101,25,2,17,145
42751959,21,3,4,1,29
42755563,11,3,2,1,17
42761384,34,3,2,1,40
42780763,116,42,6,20,184
42796880,21,47,40,1,109
42802806,140,29,2,5,176
42805469,56,51,2,16,125
42810845,22,102,5,1,130
42815651,83,6,61,1,151
42816539,62,3,2,2,69
42825360,69,31,2,7,109
42825526,199,3,2,23,227
42833553,143,7,2,1,153
42836479,50,34,45,4,133
42878467,11,3,2,1,17
42880389,33,3,2,1,39
42883182,99,56,9,6,170
42890068,118,22,29,3,172
42892321,155,44,72,4,275
42895228,79,3,2,1,85
42896829,172,27,4,29,232
42902280,111,57,22,26,216
42903712,103,52,6,9,170
42919121,10,17,2,1,30
42925551,56,35,15,1,107
42927990,146,14,25,1,186
42932382,175,29,20,13,237
42936780,104,33,2,2,141
42956707,16,11,2,1,30
42982399,17,5,2,1,25
42993154,93,14,12,6,125
42999240,60,25,2,2,89
43004005,38,15,3,1,57
43008020,11,5,2,1,19
43010107,93,9,12,7,121
43012224,60,28,35,2,125
43013486,139,3,28,1,171
43027303,31,3,2,1,37
43030234,181,142,6,1,330
43032787,29,36,27,1,93
43050536,20,8,2,1,31
43058758,39,60,31,22,152
43086417,57,18,13,5,93
43093410,87,14,123,12,236
43094839,357,8,4,14,383
43095690,74,28,101,71,274
43098251,30,48,9,1,88
43102630,85,10,22,2,119
43109932,20,55,3,1,79
43110811,70,26,30,4,130
43116379,61,21,2,1,85
43120503,42,81,29,1,153
43121760,116,40,2,2,160
43144909,47,55,3,1,106
43153832,23,3,2,1,29
43160028,58,3,2,9,72
43166320,34,39,35,1,109
43168737,13,3,2,1,19
43170247,138,8,2,15,163
43174158,19,3,2,1,25
43177016,191,21,95,32,339
43213050,64,54,57,8,183
43214608,87,10,16,9,122
43226156,13,13,2,1,29
43234085,67,29,18,55,169
43249446,371,3,2,17,393
43253686,142,64,82,1,289
43256870,55,66,23,30,174
43276777,58,3,2,1,64
43289056,36,5,3,1,45
43304261,13,16,4,5,38
43316466,14,3,2,1,20
43328438,56,26,6,24,112
43332857,29,9,13,4,55
43338813,73,15,14,2,104
43344036,45,3,2,4,54
43366827,212,3,2,2,219
43374085,38,7,37,1,83
43381654,35,3,2,1,41
43386371,26,3,2,1,32
43408015,12,3,2,1,18
43408405,81,19,5,26,131
43409328,33,3,2,1,39
43412629,14,7,2,1,24
43413961,11,3,2,1,17
43414359,152,3,3,1,159
43419814,43,27,2,9,81
43422193,24,3,2,2,31
43422343,81,3,2,2,88
43428642,52,3,2,1,58
43431882,69,24,22,1,116
43433623,115,62,38,1,216
43436430,61,28,3,1,93
43458751,115,45,48,4,212
43463825,43,28,2,1,74
43464593,102,3,2,1,108
43470457,36,47,25,3,111
43479687,12,23,2,1,38
43491753,112,23,180,41,356
43501143,67,10,2,9,88
43504367,36,11,74,13,134
43505679,39,17,12,3,71
43510439,56,3,4,1,64
43525910,196,28,11,6,241
43531856,145,61,41,26,273
43532139,81,70,51,1,203
43534397,101,18,33,14,166
43547351,70,25,2,10,107
43554001,152,17,26,9,204
43555327,84,3,2,1,90
43559926,107,8,4,14,133
43564012,83,11,14,12,120
43572991,48,3,2,1,54
43576228,73,12,2,9,96
43589466,10,6,2,1,19
43591146,61,19,2,3,85
43604442,35,16,2,4,57
43610745,27,69,65,1,162
43614404,501,3,2,3,509
43630903,156,3,2,1,162
43631851,145,30,40,28,243
43632788,181,3,2,1,187
43645257,128,3,2,1,134
43649501,18,3,2,1,24
43666260,10,4,2,3,19
43670136,16,3,2,2,23
43688699,11,27,2,1,41
43697763,113,14,31,4,162
43701997,24,6,2,1,33
43722881,28,4,2,7,41
43723348,60,26,2,4,92
43724095,90,35,2,1,128
43750605,263,51,37,36,387
43759331,16,18,2,1,37
43764075,25,3,2,2,32
43766975,71,13,45,1,130
43767640,13,3,2,2,20
43780881,129,32,2,1,164
43792554,103,30,23,3,159
43806633,127,21,62,3,213
43809326,74,39,6,2,121
43825136,108,10,2,5,125
43827524,12,31,2,1,46
43837302,37,3,2,5,47
43848923,12,4,2,1,19
43856221,26,3,2,1,32
43890320,147,68,55,17,287
43895532,41,18,2,2,63
43904467,31,50,6,1,88
43918923,55,35,2,3,95
43921696,13,3,2,1,19
43927191,22,3,9,1,35
43937885,18,3,2,3,26
43964618,13,5,2,4,24
43964867,54,13,2,1,70
43965895,10,5,2,1,18
43973550,80,66,25,22,193
43985396,218,3,2,91,314
43985991,53,3,2,1,59
43987934,69,11,2,9,91
44000949,11,3,2,1,17
44012195,74,8,2,1,85
44020409,19,4,2,1,26
44033807,11,4,2,1,18
44046406,98,25,3,6,132
44056000,10,5,2,1,18
44075033,54,57,39,14,164
44075191,81,11,7,3,102
44082523,193,3,2,15,213
44088988,17,3,2,3,25
44100888,35,57,33,3,128
44102348,29,3,2,1,35
44108318,61,18,4,6,89
44113260,228,25,34,12,299
44123579,103,3,2,3,111
44127015,353,3,2,27,385
44140195,10,3,2,3,18
44140709,25,29,6,3,63
44150445,64,3,2,1,70
44152912,23,4,2,5,34
44155171,86,9,2,3,100
44162919,29,3,18,2,52
44167841,78,12,8,1,99
44177692,158,9,15,2,184
44191342,49,12,4,4,69
44235086,41,6,2,3,52
44262065,11,5,2,1,19
44279626,62,33,30,7,132
44280611,14,28,2,1,45
44284650,67,12,2,2,83
44291548,37,11,2,1,51
44304254,15,8,2,1,26
44307340,108,3,12,1,124
44308411,66,16,13,1,96
44338557,123,48,38,6,215
44340976,23,3,2,1,29
44350174,75,60,2,1,138
44353967,16,12,2,1,31
44359808,31,24,8,3,66
44363312,39,20,2,1,62
44366746,49,14,2,3,68
44390227,206,33,6,8,253
44390840,49,46,17,4,116
44401601,101,25,32,3,161
44414951,50,20,12,3,85
44425374,208,3,2,1,214
44428693,92,5,11,4,112
44428749,101,13,2,1,117
44437321,11,3,2,1,17
44438806,119,12,2,4,137
44444171,65,3,2,3,73
44446460,20,3,2,1,26
44451092,70,78,3,1,152
44452324,107,5,2,1,115
44456123,23,30,25,1,79
44462702,33,241,9,1,284
44465161,79,14,3,35,131
44479641,53,46,5,1,105
44490210,11,18,2,9,40
44499264,175,3,2,1,181
44516573,211,32,4,2,249
44528631,168,67,50,21,306
44532375,98,3,2,1,104
44535493,159,11,2,3,175
44544707,209,50,3,2,264
44547586,91,9,2,12,114
44562667,38,3,2,1,44
44564436,10,3,2,2,17
44567477,247,10,20,4,281
44577450,111,3,2,1,117
44582515,70,27,12,25,134
44585676,27,3,2,1,33
44590472,41,23,8,1,73
44605156,77,9,2,5,93
44625443,66,26,25,13,130
44635078,78,10,7,2,97
44644954,15,3,2,5,25
44664294,50,72,26,64,212
44667050,14,3,2,1,20
44671189,123,32,23,24,202
44672594,107,12,2,61,182
44672798,119,12,29,2,162
44691218,64,3,2,4,73
44695455,12,24,2,1,39
44697840,23,55,2,1,81
44699358,11,3,2,3,19
44706194,93,3,2,3,101
44714078,116,4,2,1,123
44720382,137,53,2,8,200
44721764,136,7,5,17,165
44726358,62,24,31,17,134
44728139,11,3,2,1,17
44730057,87,3,2,5,97
44732791,124,3,2,1,130
44733230,15,6,2,5,28
44740425,78,13,28,3,122
44743819,119,23,17,31,190
44760074,34,20,4,1,59
44768400,11,3,2,1,17
44778141,74,26,7,5,112
44786642,133,3,2,1,139
44788712,66,50,24,11,151
44800673,174,36,2,1,213
44800689,134,3,2,4,143
44802008,22,27,3,1,53
44805054,163,3,2,11,179
44808390,13,3,2,3,21
44811032,121,44,31,3,199
44829028,29,3,2,1,35
44834677,10,5,2,1,18
44837198,153,6,20,1,180
44839282,75,25,56,31,187
44839502,193,8,2,9,212
44852175,53,19,4,31,107
44852627,11,5,2,1,19
44862512,10,4,2,1,17
44869583,18,11,2,1,32
44869730,50,32,14,4,100
44871931,73,4,2,7,86
44878009,46,83,5,11,145
44892299,42,3,2,1,48
44899916,10,5,2,1,18
44911487,38,7,81,3,129
44916720,18,73,2,2,95
44948893,40,19,2,3,64
44949385,53,49,23,16,141
44950311,44,3,6,1,54
44961045,115,33,2,10,160
44961960,96,37,12,2,147
44970252,168,32,2,3,205
44970977,147,56,9,1,213
44980475,89,69,25,29,212
44986744,32,3,2,3,40
44998746,19,3,2,1,25
45000149,128,22,7,17,174
45004705,38,60,2,2,102
45010650,191,44,4,2,241
45024063,14,15,2,1,32
45029609,25,3,2,2,32
45035353,27,8,2,1,38
45038363,17,3,2,1,23
45056174,74,39,3,25,141
45081079,87,34,2,27,150
45095444,30,51,4,19,104
45100198,68,19,71,12,170
45101614,49,18,15,6,88
45103928,88,38,27,3,156
45105732,116,47,2,1,166
45120116,21,34,20,8,83
45122494,40,23,10,9,82
45132175,15,3,2,6,26
45139126,107,37,2,20,166
45169546,72,18,5,2,97
45171248,101,20,2,1,124
45185432,24,5,2,1,32
45191904,43,37,55,2,137
45200038,73,9,24,19,125
45208281,19,3,2,1,25
45223956,163,18,2,1,184
45235570,12,10,8,10,40
45235789,59,3,2,7,71
45244277,31,62,41,1,135
45245874,70,12,3,2,87
45248453,13,3,2,1,19
45248488,17,3,2,1,23
45262846,44,3,2,2,51
45294562,89,37,7,31,164
45294992,379,3,2,42,426
45330084,12,10,3,2,27
45344997,11,5,2,1,19
45345228,74,14,18,5,111
45364896,54,12,3,21,90
45378451,55,8,11,1,75
45380289,137,33,4,3,177
45381634,50,33,35,5,123
45388477,11,3,2,1,17
45390782,168,26,2,1,197
45398271,33,3,2,1,39
45407828,102,3,2,1,108
45409446,92,8,42,6,148
45426858,185,3,2,8,198
45430620,51,13,4,1,69
45431228,92,32,19,5,148
45433607,91,15,10,1,117
45464668,16,34,2,5,57
45466888,45,3,2,5,55
45468358,39,39,67,10,155
45476967,21,14,3,5,43
45484652,16,10,2,1,29
45492467,57,12,2,4,75
45505360,169,15,10,3,197
45505924,10,5,2,1,18
45525192,14,12,10,1,37
45527690,216,22,137,4,379
45534153,58,10,5,10,83
45541437,19,10,2,1,32
45547488,93,6,6,1,106
45552335,28,31,2,1,62
45562454,10,12,2,1,25
45565695,11,3,2,1,17
45582714,71,3,2,6,82
45583340,125,3,2,1,131
45592061,113,33,31,22,199
45599592,17,28,3,1,49
45601840,48,27,3,1,79
45603386,41,3,18,7,69
45607235,31,3,2,9,45
45609224,85,18,31,1,135
45626029,145,3,13,1,162
45632174,90,25,2,1,118
45637822,226,3,2,7,238
45645869,64,19,2,2,87
45646072,34,14,2,6,56
45652556,73,61,41,3,178
45664236,95,48,9,55,207
45665125,40,3,2,6,51
45665614,25,15,7,1,48
45669124,173,22,18,17,230
45672340,54,11,2,16,83
45692114,33,34,2,1,70
45702846,106,26,2,2,136
45705474,29,128,6,5,168
45727677,14,12,22,1,49
45727945,30,21,35,12,98
45746409,72,3,2,1,78
45748245,41,3,2,1,47
45759519,38,22,47,11,118
45762545,21,4,2,1,28
45775536,134,74,2,1,211
45800759,59,3,2,3,67
45803657,104,15,2,8,129
45827701,42,3,2,10,57
45834614,37,26,36,1,100
45835827,81,3,12,2,98
45837819,26,3,2,4,35
45839430,68,7,3,2,80
45839847,62,29,9,21,121
45848466,62,7,2,1,72
45855893,205,35,35,8,283
45862118,116,3,2,6,127
45894641,10,6,2,1,19
45897009,38,14,2,5,59
45898902,77,11,30,12,130
45906069,11,3,2,3,19
45913542,100,13,68,23,204
45924881,13,12,2,1,28
45928672,13,3,2,1,19
45930279,59,38,6,1,104
45933012,78,17,21,16,132
45960863,121,23,2,3,149
45962335,72,17,2,1,92
45963422,142,3,2,4,151
45975545,60,120,19,3,202
45980511,63,3,2,1,69
46019651,49,10,83,21,163
46028376,53,29,37,10,129
46032486,150,48,78,47,323
46033320,80,23,95,3,201
46043103,90,18,2,1,111
46056236,60,6,14,1,81
46057423,88,59,47,21,215
46068913,97,3,2,1,103
46068939,26,15,2,1,44
46072381,49,9,2,6,66
46087588,37,31,3,17,88
46092808,15,3,2,3,23
46093873,22,3,2,2,29
46095722,114,22,3,6,145
46106178,52,42,3,18,115
46108133,81,15,2,5,103
46116672,132,3,2,2,139
46123288,107,42,10,5,164
46138639,23,27,2,17,69
46146214,39,40,2,3,84
46152349,14,72,30,1,117
46153142,89,53,2,15,159
46167460,91,9,36,6,142
46168009,85,6,2,1,94
46182628,11,3,2,1,17
46186123,87,3,2,1,93
46186909,33,29,2,1,65
46190182,16,3,2,2,23
46199564,75,18,16,11,120
46204033,29,3,2,1,35
46217727,82,3,2,1,88
46218073,28,12,2,3,45
46218743,12,3,2,2,19
46220602,68,3,2,19,92
46223697,25,3,2,6,36
46227448,50,7,2,2,61
46234110,217,43,2,28,290
46238372,53,12,18,1,84
46264088,11,3,2,1,17
46275458,45,37,18,9,109
46289624,54,24,5,7,90
46296167,50,45,2,3,100
46358178,100,3,2,3,108
46359729,13,3,2,2,20
46365665,87,3,2,3,95
46396978,188,13,4,2,207
46420523,71,34,22,40,167
46427785,99,3,2,1,105
46455061,41,24,3,7,75
46457071,87,3,2,1,93
46464082,32,3,2,1,38
46471227,10,4,2,1,17
46478929,42,68,21,2,133
46490380,19,25,15,7,66
46534022,37,18,22,1,78
46545394,10,46,2,1,59
46559348,60,3,2,4,69
46562155,28,15,2,5,50
46577058,41,28,3,2,74
46584272,97,18,58,3,176
46590735,152,24,2,1,179
46590817,91,57,7,15,170
46591480,38,3,2,2,45
46598441,58,16,3,1,78
46602177,112,3,2,1,118
46603871,90,42,75,7,214
46605170,53,3,2,2,60
46609009,92,23,28,5,148
46613599,24,10,35,5,74
46617894,85,3,9,1,98
46619978,24,3,2,9,38
46634168,20,50,7,1,78
46634931,58,3,2,1,64
46649503,59,48,2,1,110
46661990,28,27,29,3,87
46662072,17,8,2,1,28
46663743,93,29,3,14,139
46685924,105,17,7,1,130
46715825,38,32,3,1,74
46745829,118,3,2,2,125
46750108,104,6,2,3,115
46754160,33,20,36,1,90
46756217,12,20,2,1,35
46770653,24,4,2,12,42
46781658,31,98,2,1,132
46784113,82,32,125,70,309
46792171,12,3,2,1,18
46798538,119,3,2,2,126
46799283,19,6,5,2,32
46809005,206,3,2,1,212
46810905,37,14,2,2,55
46836614,32,23,5,1,61
46837021,127,45,150,22,344
46850659,11,3,2,3,19
46860407,101,12,7,11,131
46890307,153,23,47,3,226
46890766,11,3,2,1,17
46900155,14,4,2,1,21
46923833,13,3,2,4,22
46934497,39,19,6,2,66
46935999,75,3,2,14,94
46938149,14,3,2,1,20
46939845,55,14,3,3,75
46948132,57,3,2,1,63
46979961,38,18,35,1,92
47019047,91,34,32,2,159
47019387,50,13,23,51,137
47021773,11,5,2,1,19
47034335,12,6,2,6,26
47034751,16,3,2,1,22
47036802,63,29,6,6,104
47047647,23,3,2,1,29
47048613,15,21,2,1,39
47048863,10,3,2,2,17
47048995,36,3,2,1,42
47052538,87,3,19,1,110
47054803,46,5,2,5,58
47063752,272,8,39,1,320
47080859,56,12,53,3,124
47100542,167,3,2,1,173
47113732,82,36,25,24,167
47122747,47,3,2,3,55
47138065,35,37,9,15,96
47143595,156,47,21,18,242
47144691,19,3,2,1,25
47154341,41,3,2,20,66
47168695,55,66,63,18,202
47170252,113,47,59,12,231
47210472,71,16,11,11,109
47211389,147,3,2,8,160
47214125,19,21,2,1,43
47231118,103,5,2,5,115
47263542,84,43,13,2,142
47266811,16,3,2,1,22
47267109,152,3,2,7,164
47269575,41,11,4,3,59
47295964,80,41,70,24,215
47299732,368,3,2,8,381
47302313,62,59,61,25,207
47306072,132,53,2,14,201
47360922,68,23,2,12,105
47361560,12,4,2,2,20
47366160,47,22,4,4,77
47368686,67,39,19,4,129
47389536,19,32,2,1,54
47391031,158,37,2,5,202
47406550,50,37,13,1,101
47413169,13,3,2,1,19
47420756,13,3,2,1,19
47428052,32,8,2,1,43
47428391,35,22,2,2,61
47428844,127,36,99,11,273
47457648,17,11,2,2,32
47463712,140,113,14,7,274
47470808,19,20,4,12,55
47471377,60,22,6,32,120
47473688,70,3,2,12,87
47489438,14,11,2,1,28
47513575,87,32,2,1,122
47519038,86,11,18,5,120
47527194,57,3,2,10,72
47533089,136,8,31,1,176
47550119,57,4,2,2,65
47552616,23,8,2,1,34
47552885,47,32,2,1,82
47576494,278,61,30,27,396
47577784,37,42,7,48,134
47587811,192,38,57,24,311
47590288,98,3,2,2,105
47597770,21,3,2,1,27
47615466,61,4,2,1,68
47629166,18,50,11,1,80
47640800,43,18,2,11,74
47648940,87,66,4,14,171
47655351,14,26,2,1,43
47666350,12,34,12,2,60
47668715,53,35,64,177,329
47697785,106,21,35,20,182
47702846,112,3,2,1,118
47727106,86,13,12,5,116
47739483,30,3,2,1,36
47747742,289,3,2,1,295
47755126,60,33,4,16,113
47769941,58,3,2,1,64
47770397,53,22,2,9,86
47777131,46,31,16,10,103
47777833,26,9,15,3,53
47788636,33,14,6,5,58
47795387,105,11,58,1,175
47795556,221,35,8,40,304
47803372,76,45,23,12,156
47807547,72,32,28,8,140
47826331,24,3,4,8,39
47828319,16,3,2,1,22
47837015,63,49,25,1,138
47838863,14,3,2,1,20
47852909,147,3,2,8,160
47867867,58,3,2,1,64
47869729,214,3,2,34,253
47873877,132,39,7,1,179
47879532,10,23,12,1,46
47885697,36,26,9,1,72
47886277,81,3,2,31,117
47886862,11,3,2,1,17
47913943,142,12,4,2,160
47920420,99,3,2,1,105
47925870,41,42,7,7,97
47928494,72,13,2,1,88
47938415,53,23,2,2,80
47941408,32,38,10,1,81
47946156,27,3,2,6,38
47971836,130,10,34,1,175
47989172,61,6,2,1,70
47995614,76,18,2,8,104
48002659,163,26,40,1,230
48016898,122,3,2,4,131
48032811,81,3,2,3,89
48075442,19,16,3,1,39
48084661,65,38,2,21,126
48100511,224,12,2,15,253
48110608,15,3,3,1,22
48118342,69,3,2,1,75
48162223,11,3,2,1,17
48162741,28,78,5,21,132
48179621,119,103,78,1,301
48183262,10,4,2,1,17
48191217,74,14,2,2,92
48209890,129,3,2,1,135
48216863,18,3,2,1,24
48225908,10,19,2,1,32
48234415,95,3,2,28,128
48235792,11,3,2,1,17
48241718,22,3,2,1,28
48263947,145,14,31,8,198
48268034,12,3,2,1,18
48273422,15,3,2,1,21
48279125,96,5,21,13,135
48291758,125,30,35,55,245
48303644,12,18,2,3,35
48309736,131,3,2,6,142
48312103,73,24,43,24,164
48312391,56,40,23,1,120
48318044,113,64,20,20,217
48319215,45,64,22,13,144
48326136,24,10,2,1,37
48330983,62,3,2,4,71
48331410,52,3,2,1,58
48335003,48,37,6,21,112
48338610,13,5,5,1,24
48346011,134,3,2,1,140
48347834,38,3,25,1,67
48349573,13,8,2,1,24
48349860,69,78,55,21,223
48359780,169,40,16,2,227
48365407,12,3,2,1,18
48377139,26,44,2,1,73
48379843,49,36,43,25,153
48389777,91,21,12,4,128
48399156,27,13,2,1,43
48403259,95,3,23,2,123
48431856,25,15,21,2,63
48433325,17,3,2,1,23
48462738,117,6,2,7,132
48467812,88,6,51,2,147
48472066,116,32,15,9,172
48482689,138,7,35,15,195
48497305,10,6,2,1,19
48498374,46,35,34,1,116
48498587,20,3,2,3,28
48504678,103,13,33,1,150
48511714,67,34,4,7,112
48511913,103,3,2,11,119
48528594,123,28,46,10,207
48530337,199,128,3,7,337
48534477,11,3,2,1,17
48536414,47,6,2,1,56
48536596,157,41,62,44,304
48541409,146,5,2,6,159
48552287,55,3,8,10,76
48573526,35,3,2,12,52
48575403,241,6,2,2,251
48577888,69,34,2,2,107
48580642,64,3,32,2,101
48594222,50,18,12,4,84
48604691,13,3,2,2,20
48623041,15,10,2,1,28
48629656,73,7,2,2,84
48642770,40,3,2,1,46
48648736,10,3,2,2,17
48677477,98,16,2,2,118
48686711,30,3,2,2,37
48695942,34,30,11,8,83
48707959,165,30,2,4,201
48727085,32,3,2,1,38
48739004,126,15,49,9,199
48755438,151,16,2,3,172
48756667,93,3,2,1,99
48763873,20,13,2,1,36
48771085,72,26,2,1,101
48771307,58,12,53,1,124
48771512,17,3,2,1,23
48794401,56,66,20,1,143
48805757,10,3,2,4,19
48806781,35,15,2,3,55
48810875,17,25,2,1,45
48813921,13,18,5,1,37
48824784,98,24,12,19,153
48828470,25,13,8,11,57
48828841,51,22,5,10,88
48835470,26,3,2,2,33
48835822,11,3,2,1,17
48837567,90,37,33,2,162
48854237,64,17,15,2,98
48854460,96,44,2,1,143
48864525,64,10,60,3,137
48864645,48,28,5,1,82
48866577,31,44,4,2,81
48869186,219,3,2,1,225
48876784,44,3,2,3,52
48879783,41,3,2,1,47
48882877,67,3,2,1,73
48890075,14,3,2,1,20
48905833,17,8,2,2,29
48911978,45,8,2,1,56
48919380,15,15,2,1,33
48945159,66,3,2,1,72
48953493,48,22,3,3,76
48963335,19,12,2,4,37
48963511,35,3,2,1,41
48965755,101,49,11,10,171
48983295,399,3,2,4,408
48997046,15,3,2,1,21
48998642,51,41,8,2,102
49003494,48,3,2,1,54
49021812,38,13,38,40,129
49024547,78,3,2,4,87
49027796,81,22,4,2,109
49037685,16,54,6,1,77
49040138,153,33,17,3,206
49040287,82,3,2,4,91
49042441,31,18,23,1,73
49043966,94,3,2,1,100
49055447,42,16,19,10,87
49064331,116,29,2,2,149
49064372,12,25,2,1,40
49071699,85,54,2,1,142
49071810,35,25,2,1,63
49076868,85,16,2,3,106
49078613,71,26,67,29,193
49094543,103,15,2,1,121
49111682,10,3,2,2,17
49116109,66,47,111,107,331
49125820,98,38,8,31,175
49126709,46,27,4,27,104
49136749,65,5,2,4,76
49149368,55,3,4,22,84
49151629,49,24,13,1,87
49156442,133,3,2,1,139
49165712,110,3,2,2,117
49187602,97,19,4,17,137
49188472,71,48,17,6,142
49194729,25,3,2,1,31
49200190,56,20,19,1,96
49203920,73,36,83,1,193
49204973,11,3,2,1,17
49212685,27,61,65,9,162
49237967,93,3,2,4,102
49261133,37,14,206,2,259
49280516,96,10,3,1,110
49288366,36,34,19,6,95
49294662,110,7,2,11,130
49295430,150,30,2,15,197
49298598,30,6,53,38,127
49309247,25,20,5,1,51
49311155,93,57,12,14,176
49317669,132,35,26,28,221
49319326,24,18,2,1,45
49320876,40,19,26,1,86
49321854,17,3,2,3,25
49332134,87,3,2,2,94
49338019,13,9,2,1,25
49342221,181,21,2,2,206
49361539,194,26,12,4,236
49367048,23,3,2,1,29
49371761,46,77,51,51,225
49372659,21,9,11,2,43
49374743,170,106,24,3,303
49416177,10,3,2,2,17
49418480,62,39,47,49,197
49419042,100,22,30,4,156
49423234,37,94,5,1,137
49426382,85,9,5,57,156
49426584,69,3,2,1,75
49427504,13,3,2,2,20
49445011,48,20,12,1,81
49451758,198,8,6,12,224
49457106,23,3,4,3,33
49457197,170,3,2,10,185
49475388,120,46,40,4,210
49493928,102,22,3,1,128
49498521,10,4,2,1,17
49502486,11,3,2,1,17
49517263,147,3,3,1,154
49520718,12,13,16,1,42
49522147,79,43,14,2,138
49534497,34,60,14,3,111
49535560,70,3,2,1,76
49536699,11,3,2,1,17
49545658,47,8,5,3,63
49557723,25,33,13,16,87
49560384,17,4,2,2,25
49564270,10,19,2,1,32
49583172,60,3,2,5,70
49588707,29,20,13,1,63
49603969,39,3,2,36,80
49617350,69,19,4,2,94
49621712,11,34,2,1,48
49623372,46,3,2,2,53
49628741,41,3,2,1,47
49631026,35,3,2,1,41
49631293,32,60,2,2,96
49639602,132,3,2,1,138
49646383,45,50,19,15,129
49665553,12,13,2,1,28
49672320,78,3,2,4,87
49691692,106,3,2,6,117
49721814,92,9,2,1,104
49745396,13,3,2,1,19
49750890,10,4,2,1,17
49753948,201,16,5,4,226
49754748,31,21,26,3,81
49759556,105,30,2,1,138
49761140,85,40,24,1,150
49763272,20,3,2,2,27
49777515,71,14,2,27,114
49782175,134,3,2,1,140
49783367,25,9,2,1,37
49784196,99,28,67,3,197
49784204,33,30,5,2,70
49784422,77,23,64,5,169
49785008,23,21,2,1,47
49785315,29,31,15,2,77
49785975,81,3,2,2,88
49788662,46,15,41,6,108
49794026,107,33,2,4,146
49821542,55,22,4,1,82
49824412,39,5,2,1,47
49825606,15,3,2,6,26
49834883,85,79,61,66,291
49853771,63,47,3,18,131
49879735,33,35,2,26,96
49889177,195,26,61,1,283
49890673,10,7,2,3,22
49904076,72,3,2,1,78
49911651,48,4,3,2,57
49911867,164,44,49,40,297
49921883,16,5,2,5,28
49923030,18,21,2,4,45
49944169,68,15,3,2,88
49947961,11,10,3,1,25
49953757,13,9,3,1,26
49960490,134,26,29,34,223
49978121,92,11,22,1,126
49979974,332,3,2,4,341
50001651,70,3,2,1,76
50035486,29,12,26,1,68
50053143,26,3,2,1,32
50091800,14,3,2,1,20
50092455,68,11,2,1,82
50094180,20,7,11,9,47
50106040,23,22,2,1,48
50108918,36,15,15,19,85
50121853,23,25,18,1,67
50137524,33,3,2,1,39
50149991,35,3,2,1,41
50151289,23,3,2,2,30
50151853,11,19,2,1,33
50178639,76,15,78,5,174
50197297,62,20,37,21,140
50202092,10,3,2,3,18
50203003,173,51,90,4,318
50220831,10,42,2,2,56
50235627,32,14,45,1,92
50248308,58,3,2,2,65
50252796,52,3,2,1,58
50254487,68,12,31,32,143
50254658,46,4,2,2,54
50270925,14,5,2,7,28
50279370,34,3,2,1,40
50279471,155,3,2,2,162
50279821,11,3,2,2,18
50315723,93,23,3,1,120
50318703,42,9,2,2,55
50326181,13,19,2,1,35
50329639,172,59,50,9,290
50336017,14,8,2,1,25
50342707,82,66,8,7,163
50346761,36,9,2,1,48
50347204,31,33,2,1,67
50350113,90,3,2,1,96
50358302,25,3,2,1,31
50362103,122,3,2,3,130
50363139,154,3,2,3,162
50365231,119,60,3,7,189
50365922,16,3,2,1,22
50386890,140,3,2,36,181
50403159,104,13,40,28,185
50404567,13,14,2,1,30
50417354,20,70,6,1,97
50420070,32,3,2,1,38
50424520,11,3,2,1,17
50441128,117,16,2,7,142
50443595,19,13,47,1,80
50454459,74,3,2,9,88
50455649,169,3,2,3,177
50465837,13,3,2,1,19
50478783,77,24,2,6,109
50486495,46,7,13,3,69
50488977,10,3,2,2,17
50490169,27,43,30,4,104
50494658,245,3,2,5,255
50525134,32,3,2,6,43
50526090,105,3,2,1,111
50534007,144,15,9,3,171
50535381,106,8,7,10,131
50553496,374,3,2,1,380
50557524,32,54,52,2,140
50573610,55,40,46,75,216
50574094,11,3,2,3,19
50583884,70,53,21,27,171
50593571,167,35,12,32,246
50597361,307,3,2,1,313
50603343,88,52,10,23,173
50603883,20,15,4,1,40
50607026,34,9,2,1,46
50609375,41,25,22,2,90
50625538,13,3,2,1,19
50635350,160,6,4,3,173
50636030,62,6,2,2,72
50637999,13,3,2,1,19
50642341,51,3,2,1,57
50646794,18,26,7,4,55
50656068,80,10,2,1,93
50657313,46,3,5,1,55
50666634,33,3,2,2,40
50673269,76,21,21,1,119
50678698,25,23,2,1,51
50679874,31,47,11,3,92
50686748,31,6,2,22,61
50692055,16,22,2,7,47
50714834,10,25,2,1,38
50719366,30,3,2,1,36
50725509,28,3,2,1,34
50737124,13,5,2,1,21
50748108,72,11,4,14,101
50750541,103,41,3,5,152
50758497,60,5,5,12,82
50758904,110,62,51,5,228
50785489,93,11,2,1,107
50807541,109,5,2,12,128
50818396,31,35,17,6,89
50828498,55,3,2,1,61
50830776,90,50,70,23,233
50836071,166,3,17,28,214
50847970,10,38,2,6,56
50850614,15,4,5,3,27
50856494,84,3,2,2,91
50859120,59,3,26,6,94
50859301,112,21,2,1,136
50859372,12,3,2,1,18
50860272,112,124,17,1,254
50871623,74,33,86,55,248
50883677,61,11,51,3,126
50891150,13,3,2,1,19
50898121,17,4,2,1,24
50900436,16,3,2,1,22
50912716,155,89,31,4,279
50913275,28,3,2,2,35
50928235,69,11,4,4,88
50939470,79,14,2,1,96
50940354,163,16,49,55,283
50950010,49,30,57,67,203
50958365,113,22,4,3,142
50965753,48,23,2,34,107
50967576,54,46,2,1,103
50976249,25,3,2,15,45
50983437,19,54,2,1,76
50995042,67,30,46,15,158
51001303,13,7,2,3,25
51001702,67,13,12,6,98
51004936,11,3,2,1,17
51005595,65,3,2,1,71
51011689,91,65,2,1,159
51031991,10,57,2,2,71
51035099,13,3,2,1,19
51060345,93,3,2,1,99
51063293,12,3,2,1,18
51074504,45,4,21,9,79
51118263,116,5,4,3,128
51137846,38,7,2,1,48
51150651,60,17,39,5,121
51158864,10,3,2,3,18
51173043,10,6,2,1,19
51173045,58,22,26,6,112
51206386,47,35,16,4,102
51213608,93,27,19,22,161
51215343,27,3,2,1,33
51226893,127,56,12,29,224
51227389,15,49,2,26,92
51233575,131,45,32,42,250
51249524,29,8,2,1,40
51250139,42,3,2,6,53
51257149,45,52,10,1,108
51258132,44,12,2,3,61
51260544,146,27,3,4,180
51271504,20,5,2,4,31
51277996,11,4,2,1,18
51301020,75,22,2,7,106
51302368,13,8,2,1,24
51303796,22,9,2,2,35
51306311,57,15,3,4,79
51308055,20,10,2,1,33
51332125,10,9,2,1,22
51333478,36,70,13,36,155
51355067,188,26,33,23,270
51356882,11,20,2,1,34
51361159,79,5,39,7,130
51365540,63,7,2,1,73
51375677,33,3,2,1,39
51380248,95,19,13,26,153
51381582,97,6,11,63,177
51387784,70,29,9,7,115
51399697,19,6,2,1,28
51424381,55,13,4,9,81
51437065,124,30,39,9,202
51450033,136,56,40,12,244
51452505,12,24,2,1,39
51472006,292,4,2,18,316
51487817,13,3,2,3,21
51496711,75,34,26,23,158
51500582,113,29,48,24,214
51500741,108,12,74,7,201
51504198,84,8,2,2,96
51506746,53,4,2,1,60
51512492,55,16,2,3,76
51552276,32,27,7,25,91
51559249,63,3,2,1,69
51605416,208,3,2,12,225
51630986,82,126,27,34,269
51645016,215,4,2,1,222
51650413,41,5,2,1,49
51652029,113,7,46,2,168
51652948,53,35,3,9,100
51665647,15,11,2,1,29
51675735,79,23,3,2,107
51683232,74,3,2,1,80
51687282,31,49,36,6,122
51700252,59,3,2,2,66
51701099,43,3,2,1,49
51703513,18,21,16,1,56
51711454,65,27,2,32,126
51712557,18,13,2,2,35
51719580,11,31,2,1,45
51730031,33,27,5,9,74
51733725,26,3,2,1,32
51734295,11,3,2,1,17
51761017,51,26,2,1,80
51774090,23,8,3,1,35
51777437,31,20,2,1,54
51777720,262,3,2,32,299
51783441,79,14,2,1,96
51794522,172,5,2,23,202
51805456,48,23,59,13,143
51819597,76,22,5,4,107
51833696,235,20,4,17,276
51846146,75,20,77,13,185
51851613,58,22,23,1,104
51861028,76,3,2,2,83
51873745,52,3,2,3,60
51876660,85,98,57,5,245
51922527,23,3,2,2,30
51922554,22,3,2,1,28
51937121,12,13,2,1,28
51957675,66,23,62,1,152
51987271,21,38,2,3,64
51992745,68,51,71,18,208
51993167,41,28,55,2,126
51994125,107,45,57,3,212
52015728,13,3,2,2,20
52022372,100,10,2,3,115
52041230,37,3,2,1,43
52042473,14,5,2,1,22
52044082,12,3,2,1,18
52045052,37,3,2,1,43
52050347,58,11,49,7,125
52053422,149,19,32,1,201
52060404,44,3,2,1,50
52063734,41,26,10,13,90
52067964,218,46,12,23,299
52076452,10,15,2,1,28
52094444,36,3,2,3,44
52094779,68,23,24,40,155
52096298,39,3,2,2,46
52097108,122,21,2,5,150
52097647,65,21,21,1,108
52132597,19,25,2,1,47
52133966,75,3,2,1,81
52159471,86,3,2,2,93
52161577,52,12,2,7,73
52166449,138,45,3,32,218
52173491,65,105,27,23,220
52176747,52,9,23,1,85
52177849,74,53,28,3,158
52212051,11,22,2,1,36
52216930,109,4,2,1,116
52219408,140,18,26,7,191
52221282,38,3,2,1,44
52231120,119,3,2,12,136
52257335,107,3,2,1,113
52258858,73,18,42,1,134
52259719,141,24,45,62,272
52272525,63,6,25,1,95
52278188,80,9,2,1,92
52290563,187,3,2,1,193
52290816,119,46,3,15,183
52298429,15,34,2,1,52
52301700,41,19,9,6,75
52304349,37,30,2,18,87
52308054,57,35,2,14,108
52314015,89,22,13,8,132
52324123,47,60,20,15,142
52326283,16,3,2,1,22
52329174,71,3,2,1,77
52330455,126,23,3,3,155
52337741,71,25,2,3,101
52344686,54,20,66,4,144
52345758,14,3,2,1,20
52353710,128,54,47,28,257
52367343,11,17,3,1,32
52398142,47,3,2,1,53
52406458,55,15,3,1,74
52408146,18,3,2,3,26
52415019,13,3,2,1,19
52415154,66,4,2,1,73
52417367,246,20,3,15,284
52420733,71,9,4,1,85
52428224,36,55,2,10,103
52430675,33,10,4,4,51
52435953,49,13,2,1,65
52445352,131,6,2,1,140
52458946,86,7,40,2,135
52479461,151,118,63,4,336
52482489,183,47,83,31,344
52492796,12,3,2,1,18
52494955,31,27,32,3,93
52499540,32,6,2,2,42
52503394,45,49,3,2,99
52504978,64,6,60,35,165
52507759,165,36,3,1,205
52520996,10,7,2,1,20
52524409,21,62,18,1,102
52531955,196,9,14,1,220
52536299,16,3,2,1,22
52545154,47,94,15,9,165
52551806,57,18,2,2,79
52554717,47,30,12,6,95
52575842,58,3,2,1,64
52597712,64,19,53,3,139
52607965,43,3,2,5,53
52614798,83,32,2,4,121
52620763,107,29,15,12,163
52622648,82,19,21,8,130
52626934,94,3,2,36,135
52631958,332,3,2,81,418
52638156,33,5,2,14,54
52662177,47,27,23,15,112
52666557,111,3,2,1,117
52668698,34,23,12,8,77
52671020,32,3,2,4,41
52685855,106,3,2,1,112
52686402,83,22,2,2,109
52688188,62,22,2,3,89
52695299,12,20,2,2,36
52699090,46,14,2,3,65
52699321,129,30,3,1,163
52708513,20,3,2,1,26
52723685,83,33,5,24,145
52726811,65,37,35,16,153
52729748,19,30,13,1,63
52734965,10,4,2,6,22
52767300,18,3,2,1,24
52773854,13,9,2,1,25
52776097,55,11,2,4,72
52778660,11,3,2,1,17
52788748,43,19,52,3,117
52791146,71,3,2,1,77
52791904,184,56,44,93,377
52805274,143,3,2,1,149
52820280,48,14,17,3,82
52834170,115,15,124,3,257
52851270,58,13,57,14,142
52853417,81,6,2,1,90
52855596,30,5,8,8,51
52872160,153,57,166,23,399
52879078,55,68,25,1,149
52884139,93,64,3,7,167
52889271,143,4,7,6,160
52900499,88,16,2,1,107
52900537,38,8,2,1,49
52904407,48,3,2,4,57
52913706,45,34,3,36,118
52914439,87,3,2,1,93
52917575,65,5,5,3,78
52919134,74,14,70,7,165
52932161,91,3,2,8,104
52936048,11,3,2,1,17
52938498,106,3,2,1,112
52944415,77,10,4,6,97
52949782,172,23,2,8,205
52966674,37,3,2,1,43
52979672,18,3,2,1,24
52981440,11,3,2,1,17
52984575,36,18,2,46,102
53010599,35,12,44,5,96
53015925,12,3,2,1,18
53027751,55,3,2,2,62
53031145,25,56,18,2,101
53061761,192,35,11,2,240
53074575,45,28,3,1,77
53085215,58,35,3,4,100
53089757,13,3,2,1,19
53091506,48,19,26,7,100
53092379,34,42,2,7,85
53107599,152,33,68,19,272
53111365,135,48,18,21,222
53137061,24,8,22,1,55
53142241,52,3,2,1,58
53145199,155,45,2,7,209
53152184,103,12,41,10,166
53154679,139,3,2,1,145
53186655,69,18,11,2,100
53203909,69,49,88,19,225
53209450,61,12,7,4,84
53215971,11,4,2,3,20
53218232,99,10,18,1,128
53218753,10,6,2,1,19
53223480,88,3,2,15,108
53226314,182,32,2,18,234
53232603,78,37,32,21,168
53256323,110,3,2,1,116
53262965,76,32,2,3,113
53286854,41,7,2,1,51
53290006,41,95,13,18,167
53296851,48,17,6,1,72
53307402,17,3,2,1,23
53315858,89,17,78,1,185
53316168,27,32,2,4,65
53317108,19,44,8,19,90
53319525,27,12,118,10,167
53347488,58,3,2,26,89
53348676,30,40,7,5,82
53353701,67,28,21,18,134
53357942,44,64,22,1,131
53375976,11,14,3,1,29
53379065,107,26,54,1,188
53381201,82,31,25,3,141
53397132,16,3,2,1,22
53397157,152,6,57,28,243
53400841,38,10,6,5,59
53422457,74,4,2,1,81
53425670,62,36,20,7,125
53432743,62,21,7,8,98
53434275,45,3,2,1,51
53439952,43,66,62,18,189
53447575,76,21,2,2,101
53464643,10,22,34,1,67
53481362,83,27,2,1,113
53482940,26,53,3,2,84
53489644,92,32,96,2,222
53494217,16,22,4,4,46
53494318,72,3,2,1,78
53505201,89,8,14,24,135
53506431,10,4,2,1,17
53508748,244,38,13,5,300
53513999,146,33,101,5,285
53543574,76,8,19,1,104
53543956,29,33,59,3,124
53544920,25,15,4,7,51
53555639,35,32,12,23,102
53556116,10,4,2,1,17
53556129,111,34,2,5,152
53557684,63,32,2,2,99
53561009,12,15,2,9,38
53567474,30,13,2,5,50
53581425,106,15,2,7,130
53586410,18,10,29,28,85
53589734,21,13,5,1,40
53590407,111,39,2,1,153
53592376,93,84,73,8,258
53593617,11,3,2,2,18
53593921,10,3,2,2,17
53602658,11,3,2,1,17
53615222,89,231,5,34,359
53619637,13,7,2,1,23
53626955,122,58,51,1,232
53635051,83,30,2,5,120
53637863,17,5,2,9,33
53651657,50,32,25,24,131
53654148,52,5,7,6,70
53664287,83,3,2,7,95
53669406,11,17,2,1,31
53682753,16,3,2,2,23
53704678,18,21,2,9,50
53711471,12,4,2,1,19
53716224,58,3,2,1,64
53737916,19,35,26,3,83
53741101,29,38,12,2,81
53744928,49,8,2,7,66
53745249,483,3,2,67,555
53751233,47,40,64,22,173
53755780,117,3,2,1,123
53756417,13,4,2,1,20
53756920,94,53,2,18,167
53758059,20,38,2,1,61
53768416,58,3,2,3,66
53781643,92,3,2,2,99
53788688,74,9,5,17,105
53841890,15,9,27,1,52
53842814,68,3,2,1,74
53863898,15,33,3,12,63
53866427,29,3,2,13,47
53891382,90,94,110,53,347
53891567,43,83,7,6,139
53907184,14,3,2,1,20
53913105,10,3,2,4,19
53920105,105,22,2,27,156
53925077,16,4,4,2,26
53926471,151,35,9,27,222
53932920,51,41,4,2,98
53939336,11,3,2,1,17
53947714,10,4,2,1,17
53948260,67,28,2,2,99
53954209,33,40,29,1,103
53964851,22,59,5,1,87
53967656,37,22,20,17,96
53978935,170,30,8,10,218
53982404,27,11,2,20,60
53989512,251,50,2,2,305
53993909,112,34,2,3,151
54009014,43,6,35,1,85
54010802,36,87,6,4,133
54012277,11,4,2,1,18
54014331,55,18,2,2,77
54016455,85,3,2,1,91
54031145,189,3,2,7,201
54040490,65,33,39,6,143
54059603,10,7,2,1,20
54067711,176,36,2,7,221
54067717,114,25,21,1,161
54074754,193,12,2,2,209
54096969,84,6,11,1,102
54100986,66,3,2,3,74
54106874,20,14,2,2,38
54109868,32,32,17,8,89
54120557,36,3,2,3,44
54135648,12,3,2,1,18
54140721,42,41,3,8,94
54146208,84,17,19,2,122
54155102,20,5,2,1,28
54156255,87,3,2,1,93
54161818,102,103,45,1,251
54170173,48,29,3,1,81
54179671,166,3,2,1,172
54188033,52,5,2,1,60
54192604,11,3,2,1,17
54209745,20,47,29,1,97
54219541,12,22,2,1,37
54232570,76,25,2,11,114
54244474,106,34,38,4,182
54249248,111,12,4,19,146
54254702,97,12,2,4,115
54277628,30,9,11,7,57
54296246,155,3,2,3,163
54312115,14,3,2,1,20
54317064,40,51,67,1,159
54321153,41,31,15,12,99
54326518,42,34,5,4,85
54331211,122,125,51,82,380
54333283,84,8,2,1,95
54350455,51,40,49,1,141
54355418,20,12,20,1,53
54370348,17,3,2,1,23
54379814,96,24,16,1,137
54400646,318,31,7,1,357
54403838,20,6,2,2,30
54421668,161,11,2,5,179
54424539,25,8,23,1,57
54433664,110,3,2,5,120
54444298,144,46,30,1,221
54447460,39,21,24,12,96
54452643,27,3,2,1,33
54457217,36,3,2,1,42
54471857,26,17,6,13,62
54475771,46,19,2,4,71
54476059,15,3,2,1,21
54478616,55,3,2,3,63
54483110,53,134,57,14,258
54489412,33,3,2,2,40
54493626,44,3,2,6,55
54494363,148,3,2,2,155
54497067,68,16,25,11,120
54498030,45,30,2,1,78
54501107,33,7,2,5,47
54501667,232,3,2,7,244
54503080,10,20,7,1,38
54506678,39,4,2,2,47
54507341,119,19,2,1,141
54511705,76,40,2,19,137
54535959,49,37,13,2,101
54539681,52,3,2,2,59
54562454,12,3,2,1,18
54563470,19,34,4,1,58
54597707,39,6,3,9,57
54598642,99,28,2,17,146
54606885,44,18,9,52,123
54607562,152,77,11,31,271
54612196,114,5,2,3,124
54618750,22,26,2,2,52
54619871,61,3,2,10,76
54625495,48,13,3,2,66
54626174,95,3,2,1,101
54627686,228,30,2,1,261
54643785,73,4,11,1,89
54643848,46,28,25,1,100
54651285,36,6,17,1,60
54653272,90,18,64,1,173
54684103,18,8,68,11,105
54689850,53,29,7,10,99
54706931,39,18,3,1,61
54719922,84,21,37,5,147
54721933,48,26,3,1,78
54723253,102,3,2,2,109
54728826,51,3,2,1,57
54743595,91,3,2,2,98
54751238,36,37,37,26,136
54757452,102,5,7,1,115
54764817,92,3,2,2,99
54765483,12,9,2,1,24
54768472,196,28,27,60,311
54781402,46,3,2,1,52
54784200,59,3,2,1,65
54787709,153,45,43,2,243
54790034,2428,3,2,12,2445
54837250,55,34,19,1,109
54845109,18,54,11,8,91
54848298,134,20,60,10,224
54886730,79,15,20,7,121
54894445,12,3,2,2,19
54896478,56,7,2,8,73
54899988,52,13,3,9,77
54905728,85,8,16,12,121
54910833,51,14,8,12,85
54916764,61,3,2,5,71
54944086,58,3,2,5,68
54949456,35,11,2,1,49
54992233,88,40,2,7,137
55001338,14,3,2,6,25
55004227,13,3,2,3,21
55008915,112,7,2,8,129
55017458,72,153,20,9,254
55025056,31,32,2,1,66
55032311,84,3,2,1,90
55035862,91,3,2,16,112
55044114,13,16,2,1,32
55044611,57,22,2,16,97
55054993,34,17,4,4,59
55061278,94,13,2,1,110
55065721,73,30,109,41,253
55076466,20,92,3,1,116
55078118,75,63,47,30,215
55088779,54,11,7,67,139
55091453,65,3,2,1,71
55116629,17,21,2,7,47
55126440,42,32,12,4,90
55154043,80,16,57,4,157
55171032,96,29,2,14,141
55178582,38,6,3,3,50
55192821,124,3,2,5,134
55193849,17,3,2,1,23
55198503,36,3,2,1,42
55203738,89,27,77,4,197
55204637,96,21,2,2,121
55207529,97,3,2,2,104
55210591,15,3,2,1,21
55214525,33,70,26,1,130
55217206,11,3,2,1,17
55239455,56,3,2,3,64
55243435,89,45,36,12,182
55250376,36,28,2,7,73
55262310,49,19,2,3,73
55278545,168,3,2,5,178
55301876,19,16,4,4,43
55306583,95,3,2,1,101
55315096,17,40,10,1,68
55318831,13,3,2,1,19
55331846,75,21,46,7,149
55357299,110,56,62,18,246
55368312,14,3,2,1,20
55372758,59,5,18,7,89
55373047,47,3,2,2,54
55377147,10,6,2,1,19
55380763,21,8,5,7,41
55381715,43,49,2,1,95
55399403,143,3,2,1,149
55406570,16,19,7,1,43
55429442,70,22,2,1,95
55447883,61,3,2,1,67
55451172,34,21,36,2,93
55454039,272,9,2,24,307
55466883,10,4,2,1,17
55467639,63,52,24,16,155
55473034,95,35,55,5,190
55474893,13,3,2,1,19
55506221,52,3,13,1,69
55525258,20,28,7,4,59
55528053,21,10,2,1,34
55541150,155,10,24,8,197
55542021,67,19,2,1,89
55557532,13,6,2,1,22
55569624,30,15,2,1,48
55570220,48,33,4,1,86
55593595,74,39,7,12,132
55612030,59,14,18,2,93
55616793,64,19,20,12,115
55621712,46,3,2,1,52
55626258,141,91,14,1,247
55626601,21,20,25,53,119
55628186,354,3,2,5,364
55643225,26,42,2,1,71
55644812,26,25,49,1,101
55648009,27,3,2,2,34
55658139,11,4,2,1,18
55659622,72,4,2,16,94
55661618,71,9,64,13,157
55663850,56,64,31,27,178
55678130,19,20,9,1,49
55681798,21,23,2,1,47
55687069,119,3,2,3,127
55688183,109,3,2,1,115
55700458,10,23,16,1,50
55731175,44,4,18,3,69
55735851,11,3,2,4,20
55737631,95,58,55,1,209
55739573,100,24,53,7,184
55741461,15,3,2,1,21
55777724,23,4,2,2,31
55794865,53,81,22,1,157
55796181,171,22,2,7,202
55814122,100,3,5,2,110
55845364,97,14,2,3,116
55870057,37,26,37,6,106
55870859,70,38,47,4,159
55872122,46,3,2,1,52
55875151,95,32,10,1,138
55879482,126,3,2,6,137
55885180,40,21,3,1,65
55891401,10,20,2,1,33
55910924,37,29,28,9,103
55917195,12,4,2,1,19
55922419,29,60,13,1,103
55925345,114,10,2,2,128
55925778,12,3,2,1,18
55935739,34,15,2,17,68
55944880,19,23,2,8,52
55954359,56,15,32,50,153
55975896,70,3,2,1,76
55983487,13,3,2,1,19
55995864,159,3,2,1,165
55996004,58,62,41,5,166
55996695,88,21,15,2,126
55997456,68,3,2,11,84
55999921,66,3,14,1,84
56002377,110,38,16,3,167
56006204,16,11,2,3,32
56006754,390,3,2,5,400
56015427,10,3,2,3,18
56021779,64,9,4,1,78
56025337,73,31,77,12,193
56032905,112,71,4,8,195
56038619,14,10,7,1,32
56040181,33,3,2,1,39
56044648,161,18,59,43,281
56047799,19,3,2,1,25
56069703,52,45,38,38,173
56119386,111,14,2,2,129
56120181,30,102,11,2,145
56139555,349,3,2,3,357
56148457,71,76,3,7,157
56160419,28,53,2,3,86
56167898,23,13,2,1,39
56183321,10,9,2,1,22
56193006,111,34,7,1,153
56197382,104,15,2,3,124
56205289,18,3,2,1,24
56225428,10,10,2,1,23
56233512,86,4,3,6,99
56244822,46,39,13,15,113
56259697,71,20,36,14,141
56263650,125,13,94,2,234
56279814,36,7,2,3,48
56299382,52,7,9,1,69
56309549,163,25,2,10,200
56310312,34,4,3,2,43
56316756,96,26,2,3,127
56317618,143,19,3,1,166
56329730,13,4,2,1,20
56346560,120,36,58,4,218
56349064,106,29,38,2,175
56356660,60,3,2,4,69
56356800,17,55,2,10,84
56357662,76,30,50,4,160
56358319,108,30,2,13,153
56358563,10,3,2,3,18
56366948,57,34,14,10,115
56375328,115,5,2,4,126
56387298,21,42,2,1,66
56394586,125,21,2,1,149
56394759,56,46,2,4,108
56399283,131,28,16,2,177
56402477,38,6,2,4,50
56413043,45,42,3,5,95
56416302,71,44,8,18,141
56423739,70,3,2,1,76
56424100,16,7,2,1,26
56436391,20,3,6,1,30
56436822,249,46,2,1,298
56444387,10,3,2,2,17
56445656,28,60,2,5,95
56456379,28,18,8,1,55
56498029,53,72,31,5,161
56502929,34,17,22,5,78
56504208,10,4,2,1,17
56505177,148,7,2,1,158
56512201,121,13,7,2,143
56530288,10,4,2,1,17
56541762,146,26,5,19,196
56549511,39,35,2,1,77
56565412,46,15,4,6,71
56570580,121,3,2,1,127
56578154,11,3,2,1,17
56578389,12,3,2,1,18
56578488,125,17,18,3,163
56603770,18,3,2,1,24
56604770,188,19,2,2,211
56613485,74,25,32,1,132
56616004,15,31,2,1,49
56616562,63,15,32,1,111
56621884,36,3,2,1,42
56624809,94,22,65,5,186
56624960,138,3,17,1,159
56625501,151,37,16,5,209
56639290,14,7,2,1,24
56650574,56,32,16,48,152
56652030,19,57,12,1,89
56664805,74,46,80,30,230
56677594,72,19,20,12,123
56678702,40,28,2,1,71
56684590,148,10,2,1,161
56686325,11,3,2,1,17
56686965,11,6,2,1,20
56696213,143,5,2,5,155
56697791,17,65,50,20,152
56712151,74,18,4,1,97
56712552,99,23,38,7,167
56712963,113,48,27,47,235
56713172,103,3,2,1,109
56723281,115,3,2,3,123
56727420,60,3,2,9,74
56729489,52,5,3,5,65
56732697,33,19,4,1,57
56761050,134,3,2,1,140
56764064,81,17,2,1,101
56774098,17,19,2,20,58
56781928,14,3,2,1,20
56786601,13,3,2,5,23
56790367,52,3,2,1,58
56793414,142,21,44,4,211
56806599,80,8,95,20,203
56808771,32,3,2,1,38
56816151,25,46,35,1,107
56816590,24,28,30,28,110
56817234,69,40,77,19,205
56825049,28,16,8,1,53
56827595,18,3,2,1,24
56828285,13,3,2,1,19
56833321,87,108,37,2,234
56845080,13,6,2,1,22
56854056,80,5,2,3,90
56862851,131,3,2,5,141
56892768,14,27,4,2,47
56895689,176,3,2,13,194
56904998,119,20,13,5,157
56914686,93,22,4,3,122
56918870,101,38,2,1,142
56919417,88,3,3,3,97
56922290,47,12,29,31,119
56922982,11,3,2,1,17
56923187,18,16,19,11,64
56923740,155,10,34,4,203
56937025,11,55,2,3,71
56958605,18,3,2,1,24
56971986,90,3,2,1,96
56980882,139,15,2,7,163
56982664,80,3,2,8,93
56983807,86,11,2,12,111
56987071,69,27,5,3,104
56987407,47,59,3,1,110
56989383,28,51,50,1,130
57016168,13,3,2,1,19
57018633,99,12,4,21,136
57023825,43,3,2,1,49
57029821,26,3,2,1,32
57044989,35,19,2,4,60
57046080,10,3,2,2,17
57053661,69,26,2,15,112
57061129,30,5,2,1,38
57063931,16,29,5,1,51
57066141,205,36,25,1,267
57072588,67,34,65,1,167
57079871,10,4,2,1,17
57092778,60,3,2,1,66
57116760,184,3,2,2,191
57123411,43,21,2,1,67
57125088,71,22,16,8,117
57140772,128,8,85,3,224
57148622,32,5,2,5,44
57159408,150,6,12,1,169
57168585,35,3,2,19,59
57170337,103,48,28,8,187
57172307,24,8,40,7,79
57183833,37,27,27,3,94
57213527,63,19,6,1,89
57213597,128,3,2,1,134
57232243,55,31,47,37,170
57244585,13,4,2,1,20
57247755,36,7,2,2,47
57257067,16,5,2,2,25
57257943,38,45,6,66,155
57266363,109,3,2,1,115
57274933,139,3,2,6,150
57277041,195,9,2,35,241
57285087,89,15,17,10,131
57309002,90,3,2,1,96
57313811,45,3,2,2,52
57317009,25,21,2,2,50
57322786,29,8,2,1,40
57335986,40,6,2,1,49
57367865,39,14,2,2,57
57373912,72,28,15,17,132
57392247,16,3,2,1,22
57393289,17,48,2,1,68
57403936,17,37,2,1,57
57425200,12,3,2,4,21
57426947,23,3,2,3,31
57429700,51,23,34,4,112
57430356,221,3,2,1,227
57438547,62,3,2,1,68
57442302,334,34,2,8,378
57443054,135,20,2,5,162
57460358,44,5,2,3,54
57461964,45,34,38,4,121
57480313,84,45,14,13,156
57490898,74,71,4,5,154
57493501,68,22,3,4,97
57503223,128,35,8,10,181
57511047,74,3,2,1,80
57523386,30,15,18,8,71
57527364,104,44,58,19,225
57535237,87,54,13,46,200
57536875,138,25,133,68,364
57547555,11,3,2,2,18
57556224,17,16,2,1,36
57559069,10,7,2,1,20
57565823,10,12,2,1,25
57571698,82,25,58,7,172
57573027,16,3,2,2,23
57581680,48,4,2,1,55
57592155,57,3,2,2,64
57599048,32,42,4,12,90
57612198,64,12,2,1,79
57617212,21,5,2,1,29
57620778,64,3,2,1,70
57629314,66,3,2,1,72
57648557,34,3,2,3,42
57655209,10,8,2,1,21
57656472,231,26,98,1,356
57661937,116,48,6,5,175
57681330,13,3,2,1,19
57714953,50,17,2,1,70
57724434,37,11,2,1,51
57737460,118,31,61,12,222
57739828,10,3,2,2,17
57743774,77,3,2,18,100
57746716,79,30,33,4,146
57747528,97,13,2,1,113
57751305,18,25,15,1,59
57755576,28,59,2,1,90
57765792,18,32,2,8,60
57768647,61,42,27,10,140
57773527,69,18,3,19,109
57779443,86,8,23,16,133
57806529,75,17,5,4,101
57810325,67,3,2,1,73
57816648,20,37,5,3,65
57817483,140,36,13,13,202
57838663,10,6,2,1,19
57850257,19,3,2,1,25
57852514,39,57,2,5,103
57865702,62,20,5,55,142
57867433,23,47,2,1,73
57871237,74,7,2,8,91
57875020,150,25,11,10,196
57875065,179,3,2,6,190
57875664,41,13,12,3,69
57911745,12,20,2,3,37
57912495,13,3,2,2,20
57912983,42,3,2,1,48
57913983,113,31,23,18,185
57924655,37,30,6,33,106
57935001,59,24,13,1,97
57955798,110,45,2,3,160
57959325,12,3,2,1,18
57966001,12,3,2,2,19
57980877,14,9,2,2,27
57994959,108,41,21,5,175
58002854,11,7,17,4,39
58009533,11,3,2,1,17
58069519,52,60,2,26,140
58079723,10,4,5,2,21
58083061,11,3,2,3,19
58085063,27,10,9,2,48
58085871,153,30,2,1,186
58091446,26,3,2,1,32
58092969,54,16,2,3,75
58104775,11,3,2,1,17
58106235,112,3,2,21,138
58107481,165,47,43,10,265
58110692,25,16,36,15,92
58123901,11,3,2,2,18
58129159,140,6,26,1,173
58131789,89,10,2,4,105
58140023,54,3,2,1,60
58141070,77,48,105,4,234
58143264,24,10,2,1,37
58149621,91,26,2,8,127
58161966,136,13,2,3,154
58163317,36,125,25,6,192
58170572,49,3,2,1,55
58173662,116,44,6,6,172
58185477,37,3,2,7,49
58195429,176,4,2,1,183
58198364,66,40,2,11,119
58198449,148,47,3,9,207
58202487,57,28,45,5,135
58208257,81,3,2,1,87
58209749,135,17,18,19,189
58214098,45,24,13,1,83
58217678,80,39,54,9,182
58217900,21,3,2,1,27
58228171,91,18,28,1,138
58229231,61,25,63,45,194
58239444,157,40,32,7,236
58248085,26,31,2,4,63
58252268,209,47,100,28,384
58256902,36,46,3,5,90
58264690,87,46,3,23,159
58271389,36,12,25,5,78
58271947,39,3,2,2,46
58275967,89,15,2,4,110
58290454,24,3,2,1,30
58294957,55,38,14,6,113
58302215,100,25,4,39,168
58308491,35,15,15,63,128
58321437,35,3,2,4,44
58346809,24,30,2,1,57
58360816,20,3,2,25,50
58366261,104,3,2,6,115
58366831,95,34,48,35,212
58372075,54,73,5,7,139
58375600,67,3,2,1,73
58390284,115,76,34,13,238
58393033,68,44,2,1,115
58417790,48,8,2,2,60
58421140,96,13,24,40,173
58429511,63,23,54,8,148
58430287,101,10,73,6,190
58432915,64,47,47,98,256
58448399,25,13,10,2,50
58479057,80,39,110,11,240
58480134,10,26,2,1,39
58488427,67,3,3,5,78
58489200,60,5,2,1,68
58505683,10,3,2,2,17
58506703,34,3,2,1,40
58513900,28,8,21,14,71
58527296,82,20,2,1,105
58536652,33,48,33,4,118
58539127,32,13,2,5,52
58545777,12,28,2,2,44
58550763,11,5,2,1,19
58551957,11,3,2,1,17
58562044,109,49,33,35,226
58570479,30,62,25,14,131
58570583,232,3,2,3,240
58570692,79,28,8,13,128
58601021,13,18,2,1,34
58623567,138,18,96,1,253
58630527,12,3,2,1,18
58634475,92,35,36,5,168
58636094,16,3,2,1,22
58640331,59,37,14,1,111
58650453,58,3,2,1,64
58651754,84,14,3,17,118
58663322,27,10,2,1,40
58679564,30,3,2,1,36
58683698,77,3,2,1,83
58685748,161,11,8,1,181
58687166,17,3,2,2,24
58693579,36,10,2,1,49
58694942,71,18,14,2,105
58698249,111,6,2,1,120
58698340,16,35,19,1,71
58701184,100,27,2,6,135
58704151,29,3,2,1,35
58758613,24,3,2,6,35
58768895,30,35,19,7,91
58771072,56,74,38,23,191
58779072,56,39,17,35,147
58780850,143,17,2,1,163
58793749,52,12,3,12,79
58805465,68,10,2,1,81
58819916,16,13,11,1,41
58822678,65,3,2,1,71
58823039,40,3,2,2,47
58827260,44,3,2,2,51
58831069,46,98,12,9,165
58833852,13,7,2,10,32
58834571,61,44,19,4,128
58836917,10,3,2,2,17
58840689,73,42,2,34,151
58852126,13,6,2,1,22
58852250,180,36,11,2,229
58856909,104,29,76,8,217
58858224,18,3,2,1,24
58878824,15,4,2,1,22
58890741,59,7,4,1,71
58897052,116,45,18,6,185
58911084,23,3,2,1,29
58932533,131,12,2,6,151
58955359,58,9,3,3,73
58973678,112,19,50,5,186
58985620,72,6,18,5,101
59040268,11,10,2,7,30
59042418,32,3,2,1,38
59049654,44,3,2,1,50
59062356,122,17,9,2,150
59068862,104,3,2,2,111
59069321,246,59,2,31,338
59078122,11,3,2,1,17
59092179,61,19,2,1,83
59096094,43,27,2,1,73
59098798,41,12,2,1,56
59101835,69,3,2,1,75
59104525,38,20,41,2,101
59109494,154,84,36,23,297
59114182,51,3,2,1,57
59120106,16,12,2,1,31
59120929,99,69,39,34,241
59129901,102,20,20,101,243
59150220,110,21,12,7,150
59155702,34,4,25,1,64
59158922,118,3,2,2,125
59160277,32,13,2,2,49
59164353,47,51,50,1,149
59172445,25,77,21,1,124
59178802,18,3,2,1,24
59193573,70,15,2,1,88
59203104,13,9,2,1,25
59214185,16,104,9,3,132
59215227,155,3,2,3,163
59217754,13,3,2,1,19
59223047,71,3,2,1,77
59232006,44,29,70,1,144
59246690,18,3,2,1,24
59251265,47,3,2,1,53
59256820,55,6,61,3,125
59260997,124,38,2,4,168
59261506,50,3,2,1,56
59261723,191,3,3,3,200
59263319,83,3,2,1,89
59264717,11,3,2,1,17
59268412,93,14,14,3,124
59278958,16,3,2,1,22
59308683,44,67,28,4,143
59319033,24,13,2,8,47
59323034,67,11,2,7,87
59326248,20,3,2,1,26
59358255,89,24,66,66,245
59360437,37,6,2,1,46
59367600,143,3,2,19,167
59391445,33,65,2,35,135
59391771,20,57,2,1,80
59396038,11,13,2,1,27
59401804,11,3,2,2,18
59417829,83,18,9,2,112
59424034,11,3,2,3,19
59432797,55,51,46,63,215
59434773,10,3,2,2,17
59447141,10,52,2,1,65
59465615,44,15,2,11,72
59468365,44,20,2,1,67
59469631,89,38,5,11,143
59496262,41,5,2,1,49
59499412,82,20,22,23,147
59504202,92,73,39,5,209
59507408,256,3,2,2,263
59539304,28,10,2,2,42
59543520,139,22,5,8,174
59572905,163,13,2,6,184
59579142,85,3,2,2,92
59585968,11,3,2,1,17
59587284,60,32,2,14,108
59598044,11,3,2,1,17
59599592,53,35,13,13,114
59605794,91,13,11,27,142
59611292,53,3,2,2,60
59611496,12,3,2,1,18
59612664,114,40,5,15,174
59633346,46,26,2,2,76
59634306,78,56,10,48,192
59636618,47,7,2,6,62
59637928,28,4,2,1,35
59642175,80,25,6,4,115
59642517,16,7,2,3,28
59673938,68,55,31,8,162
59681943,38,20,9,14,81
59684940,77,3,2,1,83
59689824,125,20,79,4,228
59698610,88,35,105,1,229
59700653,177,3,2,16,198
59707207,22,3,2,1,28
59709877,25,13,2,1,41
59723084,64,3,2,5,74
59728702,68,9,4,8,89
59732363,12,3,2,1,18
59738981,45,3,2,1,51
59742108,90,55,8,1,154
59778637,115,49,56,1,221
59786900,52,9,19,1,81
59794713,85,3,3,1,92
59802506,10,4,2,1,17
59814568,61,19,2,1,83
59822193,31,3,2,1,37
59826538,56,40,61,7,164
59829660,12,3,2,1,18
59842393,49,3,2,1,55
59846655,34,3,2,2,41
59850519,70,3,2,5,80
59853281,38,15,2,7,62
59866308,33,23,2,1,59
59874412,138,3,2,18,161
59878887,18,53,5,9,85
59883623,11,4,2,1,18
59891336,38,3,2,1,44
59900129,52,10,3,10,75
59905108,13,8,2,2,25
59913837,16,3,2,1,22
59914044,264,3,2,2,271
59918791,17,10,2,4,33
59932670,32,8,6,1,47
59932740,99,20,22,2,143
59933803,207,67,28,16,318
59946074,11,3,2,1,17
59947977,89,18,9,1,117
59950188,61,4,16,2,83
59964219,69,11,15,15,110
59964280,14,3,2,1,20
59980666,42,17,2,6,67
59993064,78,27,21,44,170
60008590,39,84,70,1,194
60020673,120,5,19,7,151
60023550,117,3,2,3,125
60023716,82,17,13,2,114
60041114,22,11,12,11,56
60051935,13,9,2,2,26
60052728,177,45,8,5,235
60055340,20,14,5,1,40
60060354,54,49,18,11,132
60095480,59,4,2,3,68
60103780,19,3,17,14,53
60116571,17,3,2,4,26
60120444,57,26,4,30,117
60121026,11,3,2,1,17
60127582,126,39,23,18,206
60128394,41,22,5,5,73
60141621,19,7,2,1,29
60163902,28,3,2,1,34
60177995,56,64,3,7,130
60178697,12,3,2,1,18
60184299,21,18,3,4,46
60188331,51,3,2,4,60
60199448,22,18,34,56,130
60200023,13,10,6,2,31
60201398,123,6,2,2,133
60207893,13,3,2,2,20
60211745,47,37,15,6,105
60221053,12,18,2,1,33
60235514,53,78,12,4,147
60239880,21,7,3,4,35
60249558,43,47,2,1,93
60250054,77,19,8,1,105
60251140,47,51,68,31,197
60260722,90,5,2,8,105
60268632,96,18,5,11,130
60292002,50,9,2,2,63
60320767,13,3,2,1,19
60326508,61,29,12,2,104
60341797,31,67,7,1,106
60355070,213,3,2,1,219
60355822,42,44,19,10,115
60358478,172,24,28,21,245
60367530,31,17,6,4,58
60386973,21,4,2,1,28
60392469,51,43,12,1,107
60396216,55,32,3,1,91
60402616,17,54,10,1,82
60405306,138,27,2,24,191
60415430,63,45,7,1,116
60434604,92,31,19,16,158
60445453,71,25,2,1,99
60445840,41,3,2,3,49
60462570,46,39,2,1,88
60468514,121,37,2,5,165
60471089,22,31,32,1,86
60507596,112,22,6,23,163
60516961,180,3,2,2,187
60523532,80,9,2,14,105
60563461,93,31,3,18,145
60579374,25,3,2,1,31
60628842,77,3,2,1,83
60630843,24,3,2,1,30
60633386,50,47,59,12,168
60635753,17,3,2,1,23
60639074,74,3,2,2,81
60645152,16,20,2,5,43
60652427,138,61,4,3,206
60654457,10,3,2,4,19
60658271,15,3,2,1,21
60672685,119,22,15,11,167
60678643,45,33,47,2,127
60695316,27,18,3,1,49
60700362,169,31,39,1,240
60710427,116,53,23,1,193
60714168,70,3,2,2,77
60717108,60,3,2,1,66
60728767,97,12,2,7,118
60733173,84,3,2,2,91
60737685,22,17,2,1,42
60738928,37,73,60,4,174
60740778,146,3,2,1,152
60751181,69,3,2,1,75
60755046,10,5,2,2,19
60789154,165,3,2,1,171
60791184,30,3,2,3,38
60804878,656,3,2,154,815
60805813,92,3,2,1,98
60806652,10,16,2,3,31
60814863,36,16,9,10,71
60818019,10,24,2,2,38
60820777,51,13,31,26,121
60827685,87,3,2,1,93
60832527,65,22,19,4,110
60837178,58,29,49,121,257
60844531,228,9,14,5,256
60858150,106,19,38,21,184
60864463,12,3,2,1,18
60871705,24,3,2,6,35
60878319,19,13,2,1,35
60879164,182,3,2,3,190
60925729,28,24,2,1,55
60930978,98,3,2,1,104
60932093,57,39,78,1,175
60947011,25,15,8,17,65
60951556,24,9,2,1,36
60952468,80,23,33,2,138
60955336,62,5,33,3,103
60960535,57,21,10,16,104
60962057,51,3,2,5,61
60962519,28,6,11,7,52
60963099,16,13,2,1,32
60967006,38,35,3,19,95
60970378,107,3,2,1,113
60974495,17,6,2,1,26
60976629,69,36,34,38,177
60979326,49,18,5,2,74
60980828,10,3,2,2,17
60986848,24,24,2,5,55
61017181,28,45,70,3,146
61023257,35,35,2,3,75
61026653,120,11,12,6,149
61077804,75,6,2,1,84
61079052,102,33,3,14,152
61079681,27,42,17,31,117
61079823,47,14,9,1,71
61082949,49,3,2,1,55
61083881,92,18,4,1,115
61084261,91,45,13,57,206
61085253,83,55,47,1,186
61085351,76,7,2,1,86
61129320,53,26,6,1,86
61132585,11,3,2,9,25
61132873,43,32,45,1,121
61143906,149,16,2,1,168
61156963,23,8,2,4,37
61159685,36,18,3,4,61
61163075,11,6,2,1,20
61165188,87,3,2,1,93
61209977,26,50,2,6,84
61213368,14,47,2,6,69
61219599,26,30,12,37,105
61224766,24,21,9,1,55
61225738,14,32,27,18,91
61230525,38,31,11,23,103
61231880,11,6,2,1,20
61232112,74,29,32,11,146
61233997,46,59,7,1,113
61240557,49,51,112,1,213
61246419,63,7,4,1,75
61253872,17,3,2,1,23
61259503,30,6,3,1,40
61259690,70,4,2,1,77
61263467,59,22,40,5,126
61272478,76,29,21,10,136
61275753,30,44,16,5,95
61276414,65,22,33,7,127
61280860,29,53,6,1,89
61297226,52,16,2,3,73
61299843,82,145,10,89,326
61326809,28,14,5,3,50
61331435,12,8,2,3,25
61360460,4115,41,2,21,4179
61366098,47,32,5,4,88
61367692,25,68,71,1,165
61397166,78,3,2,1,84
61400326,20,3,2,1,26
61401441,29,3,2,1,35
61414103,91,4,3,6,104
61425595,109,3,2,1,115
61427117,98,7,26,2,133
61429151,91,21,2,5,119
61430220,126,10,12,7,155
61433623,59,3,2,4,68
61445535,96,30,4,16,146
61455503,76,3,2,1,82
61463165,38,3,2,4,47
61471927,31,52,57,12,152
61472139,19,26,19,3,67
61473958,44,3,2,1,50
61474954,24,10,2,7,43
61478333,112,3,2,1,118
61488734,13,3,2,1,19
61492481,25,31,2,12,70
61492847,81,16,17,1,115
61500758,90,3,2,1,96
61518576,11,3,2,4,20
61539640,86,43,21,2,152
61541582,44,41,6,5,96
61545149,12,3,2,1,18
61552294,18,7,3,1,29
61582388,164,28,34,14,240
61589279,68,8,2,1,79
61600193,127,3,2,9,141
61602052,139,45,48,1,233
61604969,12,4,2,1,19
61617441,74,53,17,15,159
61631460,39,52,45,1,137
61631994,36,3,2,1,42
61645689,44,31,24,58,157
61653648,14,3,2,1,20
61655965,34,73,14,1,122
61665865,245,91,2,9,347
61666484,43,3,2,2,50
61689848,58,7,10,1,76
61708897,11,3,2,1,17
61715254,66,33,2,1,102
61732139,76,6,2,5,89
61732400,157,3,2,1,163
61732679,53,3,2,1,59
61735577,11,4,2,2,19
61744180,118,64,34,2,218
61772590,35,31,32,1,99
61774403,48,3,2,7,60
61783630,45,19,9,21,94
61785535,82,27,13,16,138
61788661,23,3,2,5,33
61795524,10,7,2,1,20
61797773,107,13,68,15,203
61800201,59,22,6,15,102
61803874,334,26,44,8,412
61805669,40,39,97,1,177
61813469,48,20,3,1,72
61813621,53,18,2,1,74
61820904,46,19,2,6,73
61827123,64,8,41,12,125
61831203,129,29,2,1,161
61836748,11,3,2,1,17
61848157,40,20,4,9,73
61864280,62,41,2,3,108
61866029,66,3,2,1,72
61878054,74,61,99,3,237
61879032,20,9,2,5,36
61882481,14,3,2,1,20
61885453,100,35,97,2,234
61893904,94,31,6,15,146
61934461,41,3,18,2,64
61944085,26,22,2,6,56
61962223,104,47,45,25,221
61970673,150,50,10,11,221
61979322,26,19,2,1,48
61984267,207,3,3,7,220
61984919,17,8,19,4,48
61986943,44,41,2,56,143
61990039,85,80,16,22,203
61992037,31,3,2,1,37
61997151,21,3,2,1,27
62000930,25,3,2,1,31
62003051,69,3,2,1,75
62011595,120,84,25,26,255
62013052,16,3,2,2,23
62017864,18,12,7,2,39
62040458,14,3,2,1,20
62045003,56,3,2,3,64
62053564,30,13,4,3,50
62062978,11,3,2,1,17
62084867,10,31,2,1,44
62086383,126,34,3,1,164
62095141,55,19,2,1,77
62099405,33,27,12,10,82
62099486,273,3,2,4,282
62103674,46,53,10,3,112
62105389,12,3,2,1,18
62106622,36,52,18,1,107
62108426,88,29,5,2,124
62113609,30,26,13,8,77
62133946,35,25,42,19,121
62144935,10,12,2,5,29
62146770,11,3,2,1,17
62149352,204,3,2,1,210
62153859,112,33,19,12,176
62154134,129,27,81,1,238
62159285,79,9,3,15,106
62173756,11,3,2,4,20
62184148,64,6,2,7,79
62189999,122,3,2,2,129
62190144,90,47,33,8,178
62200302,80,61,5,2,148
62210328,61,6,39,3,109
62211152,72,72,2,4,150
62219830,23,3,2,4,32
62229747,116,3,2,4,125
62239809,26,3,2,6,37
62243621,13,23,2,1,39
62247123,88,3,2,1,94
62264469,153,15,2,3,173
62270780,122,44,146,12,324
62276620,46,8,9,4,67
62294731,10,11,2,4,27
62308303,66,3,2,1,72
62328834,28,19,2,14,63
62330739,22,3,2,1,28
62334931,34,9,36,1,80
62338819,216,3,2,1,222
62357955,34,10,2,10,56
62367261,70,10,6,2,88
62368798,45,7,3,4,59
62368921,127,23,58,10,218
62370153,78,3,2,4,87
62377886,186,52,83,37,358
62381154,32,17,5,7,61
62420760,48,20,14,10,92
62421193,131,48,27,6,212
62422423,66,27,2,4,99
62439404,41,3,2,1,47
62456410,131,3,2,3,139
62456736,35,15,36,2,88
62460804,126,34,7,1,168
62469394,180,35,3,25,243
62478158,40,3,2,1,46
62496298,13,3,2,5,23
62501640,33,7,5,1,46
62501796,16,35,8,24,83
62523343,70,9,3,1,83
62524500,56,15,29,3,103
62537614,51,19,2,16,88
62539092,13,15,2,1,31
62545516,68,23,2,7,100
62554464,83,17,19,5,124
62555238,30,3,2,1,36
62556519,14,28,2,1,45
62559394,85,15,2,1,103
62568025,158,3,2,1,164
62568887,32,26,2,9,69
62577267,85,5,5,4,99
62585266,113,20,20,6,159
62588786,115,3,2,3,123
62596852,13,25,2,3,43
62625125,30,20,31,1,82
62638623,18,3,2,1,24
62653259,13,8,2,1,24
62658720,16,19,13,1,49
62662184,22,5,2,2,31
62663185,190,25,2,1,218
62685701,52,3,2,5,62
62686102,47,8,14,7,76
62686499,22,32,15,1,70
62710755,36,20,6,9,71
62728036,68,36,11,2,117
62737416,172,6,5,2,185
62753554,172,7,6,1,186
62753730,127,11,16,1,155
62753880,10,5,2,1,18
62772112,128,13,13,12,166
62774214,19,20,2,2,43
62820809,24,9,2,1,36
62821753,3364,3,2,18,3387
62827848,31,22,2,37,92
62828633,19,3,2,1,25
62844253,33,11,3,2,49
62852919,182,43,35,32,292
62862044,13,17,21,1,52
62869511,213,7,19,1,240
62869562,43,7,2,1,53
62897136,288,3,2,24,317
62897887,57,24,34,24,139
62901571,42,15,25,2,84
62904937,65,21,2,27,115
62915639,140,25,49,18,232
62918089,34,47,2,1,84
62924382,10,6,2,1,19
62927460,169,14,3,7,193
62946286,96,18,2,8,124
62971534,100,24,2,2,128
62974821,171,45,2,3,221
62990287,19,9,28,13,69
62990916,41,51,26,1,119
63005416,49,16,10,31,106
63011293,51,42,48,5,146
63030007,22,48,38,14,122
63048176,55,20,3,1,79
63048545,85,12,82,19,198
63055449,49,20,38,84,191
63084541,29,36,2,7,74
63088656,92,10,2,1,105
63092477,60,63,27,12,162
63125189,79,3,2,1,85
63127802,69,3,2,9,83
63142171,65,18,23,9,115
63146911,106,26,2,10,144
63158648,17,3,2,3,25
63165487,128,3,2,2,135
63181889,10,18,2,1,31
63188585,13,12,2,12,39
63191609,41,40,47,11,139
63196698,136,29,21,1,187
63199649,84,73,84,7,248
63225246,299,3,2,3,307
63226021,45,49,20,20,134
63232488,23,3,2,9,37
63234868,37,14,8,1,60
63237099,104,3,2,1,110
63241654,10,24,4,1,39
63247366,11,6,27,14,58
63248834,79,3,2,1,85
63251088,52,7,23,2,84
63251998,47,48,2,4,101
63252629,54,51,2,1,108
63258447,39,3,2,3,47
63262661,66,18,17,8,109
63275449,115,11,2,1,129
63320319,51,7,2,1,61
63337976,57,7,2,1,67
63338801,91,50,30,2,173
63339397,21,3,2,1,27
63356098,11,3,2,1,17
63358584,68,21,3,2,94
63366429,145,3,2,1,151
63368945,75,3,2,4,84
63369526,175,8,6,2,191
63377527,66,120,124,17,327
63380688,98,16,74,4,192
63390303,50,35,7,6,98
63394967,97,41,14,1,153
63397473,11,3,2,2,18
63397793,39,11,6,5,61
63405249,148,3,2,7,160
63408633,105,18,2,7,132
63416101,11,9,2,1,23
63422720,10,3,2,2,17
63427376,10,5,2,1,18
63433767,11,3,2,1,17
63437063,17,3,2,1,23
63461630,43,30,7,16,96
63466854,31,5,2,1,39
63475978,30,24,12,1,67
63487084,33,3,2,2,40
63492766,49,36,11,7,103
63499432,249,3,2,1,255
63506055,72,3,2,1,78
63516317,36,6,4,7,53
63521576,92,8,14,3,117
63539644,84,30,2,7,123
63543224,51,7,46,1,105
63572902,37,3,2,3,45
63588390,13,3,2,1,19
63609522,56,12,2,1,71
63616457,12,3,2,1,18
63622784,162,3,2,1,168
63634295,41,3,2,11,57
63641070,44,15,15,9,83
63641557,23,55,19,1,98
63641813,167,3,2,3,175
63651747,13,11,2,1,27
63655529,59,28,17,13,117
63672236,37,18,42,12,109
63673867,53,31,2,2,88
63673885,93,16,2,4,115
63682889,67,36,24,5,132
63684091,104,27,11,1,143
63688787,12,4,3,2,21
63699107,17,3,2,1,23
63700809,18,3,2,1,24
63702552,53,16,2,5,76
63714524,13,5,2,1,21
63718689,73,64,31,46,214
63734328,110,3,2,14,129
63741046,48,6,10,6,70
63743196,69,35,43,7,154
63749662,12,3,2,2,19
63771994,10,3,2,2,17
63782792,56,39,5,8,108
63788505,81,38,46,42,207
63791163,60,17,29,1,107
63798348,10,27,2,4,43
63811732,66,3,2,1,72
63819363,13,40,2,1,56
63822674,146,7,5,1,159
63822816,25,4,2,2,33
63824231,56,6,35,1,98
63837907,34,9,2,1,46
63842368,16,3,2,1,22
63851697,44,31,61,31,167
63854911,140,22,5,8,175
63858790,37,16,2,1,56
63862016,33,39,6,4,82
63864389,723,4,2,16,745
63869017,146,52,18,4,220
63869086,25,27,29,5,86
63869798,27,4,2,4,37
63876352,137,6,3,1,147
63879626,56,26,33,7,122
63880703,35,3,3,1,42
63885163,129,3,3,1,136
63886019,33,9,3,3,48
63900578,10,5,2,3,20
63906568,11,3,2,1,17
63910970,13,3,2,2,20
63928387,12,3,2,1,18
63940802,90,3,2,4,99
63944363,59,3,2,1,65
63947761,12,10,6,1,29
63957618,47,37,3,4,91
63961947,10,3,2,7,22
63966111,75,7,2,1,85
63966257,32,18,8,1,59
63973870,178,11,3,30,222
63976133,11,3,2,1,17
63977991,88,13,85,19,205
63981181,17,3,2,1,23
63982077,84,17,4,14,119
63987535,59,18,98,5,180
64010842,55,22,73,22,172
64015520,186,44,2,5,237
64018593,90,15,9,1,115
64022467,19,15,3,4,41
64031085,88,13,21,2,124
64032513,68,3,2,1,74
64032641,36,30,2,1,69
64056766,93,31,24,3,151
64057743,92,4,54,43,193
64065106,81,5,2,4,92
64066118,46,45,14,2,107
64078375,66,11,12,4,93
64089823,31,25,54,13,123
64092316,76,60,2,11,149
64105635,13,5,2,1,21
64107015,32,3,2,1,38
64128160,43,25,30,13,111
64130575,47,47,30,76,200
64131344,63,3,2,1,69
64131397,53,39,31,2,125
64134368,26,26,3,1,56
64135730,62,17,4,3,86
64137754,24,61,34,3,122
64145281,24,22,41,2,89
64168395,17,7,2,2,28
64186226,14,11,3,15,43
64194328,19,3,2,1,25
64198565,18,11,2,1,32
64199590,95,3,2,32,132
64216224,10,8,2,2,22
64247362,43,3,2,2,50
64263139,103,24,71,1,199
64267001,42,30,10,18,100
64273339,78,9,2,1,90
64283813,158,3,2,1,164
64287177,68,30,10,23,131
64287420,189,27,16,1,233
64290364,89,3,12,3,107
64292776,105,3,2,7,117
64295089,80,3,2,1,86
64297062,15,9,2,1,27
64307382,40,60,48,3,151
64319761,11,3,2,2,18
64321863,112,16,28,3,159
64329224,10,8,2,1,21
64337467,102,3,2,4,111
64338627,162,3,2,3,170
64342479,66,3,2,5,76
64344929,104,137,39,29,309
64348129,12,4,2,1,19
64349111,44,3,2,1,50
64360701,63,3,2,1,69
64370609,127,33,2,3,165
64371929,68,82,72,25,247
64377400,12,4,2,5,23
64386300,39,15,3,3,60
64386595,135,32,6,12,185
64392766,100,37,31,25,193
64403140,29,3,2,1,35
64434110,173,3,6,4,186
64463878,18,65,10,1,94
64467904,36,28,7,3,74
64474828,82,62,16,19,179
64487845,11,4,2,1,18
64490845,72,26,9,1,108
64499653,14,3,2,1,20
64509503,44,3,2,1,50
64514809,81,34,61,2,178
64531711,100,41,5,33,179
64535941,148,35,2,6,191
64553331,11,3,2,1,17
64554167,122,3,2,2,129
64555856,91,3,2,1,97
64563129,84,30,3,58,175
64594352,98,6,2,1,107
64602679,77,53,15,5,150
64614606,37,3,2,1,43
64624457,40,21,42,4,107
64628369,23,17,5,1,46
64635236,34,10,65,7,116
64653975,69,30,10,1,110
64658791,10,23,2,1,36
64659696,104,3,2,2,111
64659757,19,25,2,18,64
64665035,53,62,2,42,159
64666873,18,3,2,1,24
64670479,106,103,4,20,233
64681511,180,70,38,1,289
64695220,167,41,37,1,246
64714997,90,9,49,4,152
64716361,17,13,19,1,50
64719160,11,6,2,1,20
64724877,94,31,16,18,159
64725281,93,21,2,6,122
64729108,126,3,2,3,134
64740596,12,3,2,1,18
64741675,132,19,43,10,204
64747773,48,12,2,7,69
64757574,76,3,2,1,82
64759033,21,11,2,9,43
64759645,87,24,35,20,166
64767099,18,3,2,7,30
64772784,146,39,58,5,248
64778759,13,5,2,1,21
64783243,58,20,2,1,81
64783867,21,3,2,1,27
64785051,56,27,8,7,98
64804590,120,3,2,3,128
64806053,11,3,2,1,17
64809074,89,3,2,3,97
64813059,23,39,8,4,74
64814147,95,18,35,19,167
64817884,124,44,55,7,230
64819703,133,10,17,15,175
64820090,21,14,2,1,38
64828995,54,6,9,6,75
64831096,45,3,2,1,51
64837074,11,3,2,1,17
64841087,31,79,9,37,156
64843028,24,3,2,1,30
64845448,44,7,8,33,92
64866109,31,3,2,5,41
64875228,14,3,2,1,20
64893604,15,3,2,1,21
64893736,227,43,24,86,380
64899262,57,16,13,1,87
64900198,38,3,2,2,45
64903206,56,22,15,1,94
64912119,129,7,56,6,198
64920969,134,3,2,4,143
64938003,17,46,2,1,66
64946515,94,7,2,3,106
64955998,38,10,2,7,57
64957156,170,98,45,1,314
64961158,22,29,2,1,54
64963487,12,24,2,1,39
64979334,268,5,4,1,278
65014922,11,3,2,1,17
65021870,154,33,5,3,195
65039885,21,16,2,3,42
65044187,26,27,38,11,102
65045146,113,45,81,22,261
65046740,44,21,23,3,91
65051215,10,3,2,2,17
65059792,77,11,3,4,95
65059814,111,9,85,1,206
65077207,18,3,2,1,24
65089979,13,3,2,1,19
65090728,77,3,2,9,91
65094096,15,17,2,3,37
65099290,16,16,7,2,41
65103835,41,20,75,1,137
65106305,312,36,2,8,358
65131977,74,5,2,10,91
65133550,143,38,13,3,197
65134717,112,7,2,7,128
65138035,75,3,2,2,82
65144133,12,44,2,1,59
65150799,12,16,2,1,31
65168195,13,3,2,1,19
65174933,182,3,2,3,190
65176070,22,3,2,1,28
65184318,11,3,2,1,17
65204613,118,3,2,22,145
65209056,173,63,32,49,317
65209324,11,3,2,1,17
65215273,65,3,2,1,71
65220730,35,54,8,16,113
65222579,60,3,10,4,77
65230887,80,16,2,1,99
65237873,102,9,19,16,146
65241192,17,3,3,2,25
65258742,76,11,4,2,93
65269778,23,3,2,1,29
65272199,82,3,2,1,88
65295472,44,22,19,3,88
65298499,10,3,2,2,17
65307638,26,31,5,1,63
65329468,26,3,2,1,32
65341343,17,48,15,1,81
65344704,13,3,2,1,19
65348680,31,3,2,10,46
65355069,128,24,46,13,211
65355482,64,17,19,5,105
65356081,96,51,17,24,188
65364395,33,3,2,3,41
65381094,163,29,42,1,235
65395399,11,3,2,1,17
65395415,26,9,17,24,76
65411738,14,4,2,1,21
65425158,28,13,39,10,90
65427993,50,3,2,1,56
65467473,14,5,2,1,22
65479117,54,38,2,3,97
65500365,12,3,2,7,24
65515334,27,3,2,4,36
65522163,47,3,2,1,53
65529063,96,16,4,3,119
65530511,95,25,4,4,128
65533693,124,16,8,3,151
65536336,62,14,2,5,83
65540365,36,3,2,1,42
65548142,93,68,17,7,185
65558022,25,15,2,1,43
65569072,49,3,2,2,56
65580787,11,3,2,1,17
65588531,110,59,20,1,190
65599395,51,27,40,39,157
65606969,54,31,2,3,90
65630381,112,26,2,3,143
65635126,10,5,2,1,18
65644798,11,3,2,1,17
65655573,75,3,2,1,81
65684930,27,4,2,5,38
65692552,10,3,2,2,17
65693659,14,3,2,1,20
65693839,55,19,6,5,85
65720984,17,3,2,1,23
65727027,139,11,3,1,154
65736789,37,20,2,1,60
65745706,130,43,22,12,207
65745898,253,35,2,18,308
65748720,31,3,2,1,37
65756759,70,20,31,6,127
65767586,55,38,42,17,152
65786579,26,7,2,1,36
65807894,60,5,26,6,97
65808672,28,3,2,1,34
65829178,18,3,2,1,24
65835305,51,3,2,1,57
65841627,809,3,2,23,837
65843345,20,44,2,1,67
65860119,56,10,5,1,72
65869590,71,16,2,2,91
65876140,61,5,24,15,105
65883190,62,49,23,8,142
65890195,20,14,2,5,41
65890562,19,5,2,1,27
65896610,58,3,2,5,68
65898451,78,13,9,5,105
65910690,162,44,2,32,240
65920676,55,3,2,1,61
65927227,10,4,2,2,18
65946403,97,3,2,1,103
65954201,75,9,17,6,107
65978589,51,49,33,13,146
65982734,13,20,2,1,36
66008620,118,21,39,7,185
66011548,62,21,2,8,93
66030105,149,36,35,4,224
66035276,33,10,2,1,46
66035908,110,3,2,53,168
66043663,16,13,2,3,34
66050860,22,9,9,1,41
66051070,86,40,9,14,149
66051100,21,3,2,1,27
66051384,85,3,2,1,91
66086582,104,28,2,3,137
66086952,53,19,22,1,95
66091643,39,3,7,2,51
66103763,11,3,2,1,17
66105997,47,16,6,3,72
66106911,10,13,2,1,26
66120866,111,3,2,9,125
66122311,34,10,2,15,61
66138148,91,3,2,1,97
66152467,52,8,67,12,139
66156260,40,26,33,6,105
66179260,107,3,2,1,113
66182048,99,16,12,2,129
66185806,11,20,31,1,63
66189038,52,13,10,3,78
66222390,155,6,2,1,164
66231786,67,46,2,7,122
66234206,73,23,3,16,115
66238583,135,39,5,7,186
66241154,83,33,39,28,183
66242211,40,3,2,3,48
66254350,73,33,5,3,114
66260361,100,19,2,1,122
66273472,56,48,2,6,112
66278378,17,3,2,3,25
66302292,264,21,33,5,323
66306790,10,10,2,3,25
66309906,113,10,2,34,159
66336541,22,12,2,1,37
66350476,124,3,2,29,158
66356514,15,6,2,2,25
66383860,28,3,2,1,34
66395877,36,3,2,6,47
66418122,35,9,37,13,94
66432968,11,3,2,1,17
66438932,59,15,46,21,141
66444292,44,3,2,1,50
66467932,52,3,2,1,58
66482197,13,3,2,1,19
66505511,23,3,2,9,37
66506578,10,36,2,1,49
66509167,41,31,36,3,111
66511508,99,3,2,3,107
66514693,128,3,2,1,134
66532775,13,3,2,1,19
66536760,47,3,2,9,61
66541825,54,15,56,29,154
66544390,127,3,2,1,133
66564595,47,41,50,27,165
66566552,74,3,2,12,91
66568904,83,4,10,9,106
66576653,85,44,14,17,160
66576773,10,6,2,2,20
66589443,11,11,2,4,28
66595237,44,10,3,18,75
66604679,79,21,37,2,139
66609942,62,82,27,2,173
66630279,65,30,48,50,193
66632620,10,3,26,2,41
66642526,54,3,2,5,64
66646511,20,3,2,1,26
66667758,57,61,32,5,155
66668929,24,30,19,32,105
66669567,88,5,2,1,96
66671262,108,32,145,6,291
66674287,12,3,2,3,20
66679378,152,3,2,4,161
66691938,60,34,3,1,98
66692303,28,3,2,1,34
66701435,14,13,3,1,31
66717705,32,30,2,1,65
66721305,38,24,71,2,135
66725962,122,16,19,20,177
66740288,85,4,2,1,92
66757995,128,68,56,21,273
66771354,32,9,2,3,46
66786087,80,3,2,7,92
66786309,204,36,21,15,276
66790628,107,7,2,1,117
66791313,151,3,2,5,161
66797733,53,47,40,2,142
66802015,59,7,2,3,71
66808372,76,24,48,21,169
66824863,56,3,2,4,65
66831674,32,3,2,2,39
66842011,130,20,22,12,184
66842488,57,9,7,9,82
66864640,102,3,2,1,108
66878263,221,3,2,5,231
66880309,53,16,2,9,80
66893087,15,33,2,1,51
66897146,58,3,2,12,75
66900697,35,3,2,1,41
66938548,82,3,2,4,91
66945104,53,3,2,2,60
66966208,130,33,2,2,167
66970675,10,18,4,3,35
66979292,19,21,6,1,47
66991081,183,8,67,1,259
66994764,110,4,2,1,117
67005364,136,33,122,4,295
67013254,82,23,14,4,123
67024345,130,15,12,17,174
67037930,67,11,31,10,119
67052056,162,8,2,18,190
67060651,57,49,2,1,109
67069284,12,5,2,1,20
67099168,58,21,21,1,101
67102497,59,3,2,1,65
67103816,59,37,2,1,99
67114215,54,37,13,9,113
67115498,184,44,91,3,322
67122235,53,3,2,1,59
67123499,34,3,2,2,41
67128605,71,43,15,6,135
67142262,49,18,4,5,76
67175332,112,11,3,8,134
67178725,101,26,22,6,155
67181749,24,3,2,3,32
67184577,73,3,2,3,81
67185201,139,3,2,17,161
67191254,67,12,4,8,91
67193226,13,3,2,1,19
67219075,84,13,11,22,130
67227214,129,12,23,2,166
67231223,13,4,2,1,20
67255690,114,3,3,9,129
67261200,30,3,2,1,36
67261522,55,23,2,3,83
67271877,18,49,10,33,110
67273857,21,36,7,11,75
67283645,101,3,2,1,107
67302656,156,33,17,4,210
67308610,109,19,2,1,131
67309535,106,28,18,5,157
67310072,40,5,9,3,57
67310614,15,3,2,2,22
67312160,133,4,4,2,143
67312226,30,16,8,2,56
67315084,95,24,22,18,159
67315099,69,30,69,3,171
67329307,93,24,9,35,161
67329589,66,3,83,1,153
67336487,22,40,3,1,66
67339215,13,29,2,2,46
67339570,29,3,2,5,39
67364284,75,14,15,1,105
67369550,180,3,4,5,192
67376860,111,25,18,6,160
67384449,30,23,3,51,107
67385037,65,21,14,5,105
67388032,29,6,2,4,41
67395874,74,13,19,23,129
67396428,83,3,2,1,89
67408300,69,34,33,32,168
67418045,77,23,14,21,135
67422826,13,8,2,1,24
67431405,103,65,16,4,188
67457314,44,26,36,2,108
67460359,130,30,51,9,220
67465385,102,53,35,23,213
67470621,63,17,23,1,104
67475986,233,41,4,2,280
67487826,116,85,68,2,271
67488601,101,24,2,6,133
67491255,74,6,2,11,93
67498058,31,7,11,14,63
67499007,95,23,7,1,126
67499710,26,3,2,1,32
67509347,66,36,2,2,106
67529733,12,8,2,2,24
67531085,46,31,22,16,115
67534681,19,3,2,1,25
67537737,64,3,2,8,77
67540645,15,3,2,1,21
67544804,187,13,2,2,204
67573185,132,3,2,7,144
67576818,43,8,2,1,54
67581822,38,3,2,7,50
67584752,73,3,2,1,79
67589893,25,7,2,5,39
67590622,10,4,2,1,17
67630468,59,28,4,5,96
67636184,13,3,2,3,21
67637458,175,3,2,63,243
67648509,172,43,2,2,219
67651656,103,30,31,31,195
67657620,177,63,21,1,262
67667061,14,3,2,3,22
67678916,298,3,2,1,304
67681268,41,22,30,1,94
67694347,14,5,2,9,30
67695886,89,3,2,7,101
67720850,81,3,2,5,91
67725036,23,54,3,1,81
67736599,25,3,2,4,34
67752601,53,6,16,1,76
67784788,52,3,2,2,59
67791577,69,12,13,3,97
67791655,32,3,2,1,38
67803756,131,82,13,20,246
67816750,75,38,14,24,151
67818451,66,3,2,4,75
67821385,36,3,3,3,45
67826271,85,3,2,1,91
67830124,49,27,14,8,98
67840627,82,13,24,27,146
67841378,10,23,10,1,44
67845373,103,30,3,15,151
67847247,41,17,10,4,72
67847363,73,3,5,4,85
67850319,30,22,6,2,60
67862907,22,24,3,1,50
67862930,54,16,21,7,98
67867768,11,3,2,1,17
67876848,18,5,2,1,26
67877958,36,23,41,1,101
67890113,63,35,15,42,155
67897035,22,32,8,1,63
67900037,17,3,2,1,23
67908329,52,12,29,15,108
67910014,50,5,2,1,58
67911828,78,49,27,22,176
67919783,32,16,4,1,53
67928127,36,66,28,4,134
67948836,11,3,2,3,19
67966846,121,33,45,1,200
67968936,49,13,7,1,70
67985530,100,41,2,3,146
67995286,44,9,2,1,56
68004810,124,90,2,44,260
68007838,43,24,2,7,76
68010697,73,44,24,14,155
68017404,19,99,2,11,131
68029627,46,32,2,6,86
68033508,62,18,17,19,116
68063832,86,134,2,37,259
68064874,63,11,34,15,123
68070252,129,49,3,1,182
68073522,60,3,2,4,69
68109563,33,26,15,24,98
68125709,174,3,2,4,183
68133618,16,18,16,2,52
68142797,23,36,14,2,75
68143910,11,3,2,4,20
68148073,12,3,2,1,18
68158352,58,9,7,1,75
68188687,105,16,5,19,145
68208983,87,33,2,1,123
68217809,42,25,17,1,85
68224764,177,3,2,9,191
68225908,10,3,2,2,17
68227578,16,3,2,1,22
68232895,65,31,5,1,102
68235031,71,21,24,3,119
68262952,74,35,2,7,118
68289862,47,42,4,11,104
68292505,19,3,2,1,25
68294278,89,15,17,16,137
68294538,15,91,12,2,120
68312039,14,3,2,1,20
68312923,23,3,2,1,29
68315491,12,3,2,1,18
68317193,24,23,4,3,54
68317510,18,25,7,2,52
68325213,81,19,3,9,112
68325714,90,14,43,23,170
68327928,26,3,2,1,32
68340112,93,32,19,1,145
68341396,11,3,2,1,17
68344366,34,3,2,5,44
68352900,26,3,2,1,32
68357969,45,16,2,2,65
68360000,10,19,2,1,32
68370872,12,4,2,4,22
68372323,47,3,2,5,57
68372830,57,22,81,2,162
68394734,12,3,2,1,18
68402775,51,7,14,5,77
68406392,48,105,26,19,198
68408638,36,3,2,1,42
68425987,78,3,2,4,87
68427378,108,9,17,2,136
68431626,66,21,63,14,164
68450997,95,14,2,1,112
68465467,78,4,2,1,85
68467831,96,3,2,4,105
68468723,21,3,3,1,28
68503104,108,23,81,16,228
68507994,36,3,2,1,42
68532300,17,6,6,1,30
68533432,97,3,2,10,112
68546760,14,18,2,3,37
68553201,71,24,45,2,142
68572122,28,10,7,1,46
68577297,119,3,2,27,151
68594621,33,3,2,1,39
68596979,87,11,33,16,147
68613678,26,38,11,2,77
68613870,69,33,14,7,123
68618369,109,32,3,21,165
68650118,53,85,2,1,141
68653157,33,48,2,6,89
68658018,43,17,4,5,69
68663105,17,17,15,1,50
68668519,133,45,138,20,336
68697872,17,3,2,3,25
68702931,160,14,2,9,185
68713131,38,22,2,1,63
68718858,18,4,2,1,25
68730102,18,8,2,2,30
68735243,15,3,2,1,21
68739530,80,3,2,13,98
68759180,80,26,25,21,152
68759760,11,3,2,1,17
68762841,95,16,3,5,119
68765491,32,6,2,3,43
68770860,13,13,7,4,37
68775484,166,3,2,1,172
68788637,28,28,28,3,87
68789783,40,59,3,2,104
68795076,138,28,32,25,223
68801847,75,24,2,6,107
68804748,45,3,2,1,51
68812155,211,50,83,53,397
68827159,130,3,2,2,137
68832379,112,17,4,4,137
68847881,36,36,7,23,102
68860702,64,3,2,2,71
68861671,10,3,2,2,17
68863785,186,7,2,2,197
68868907,74,3,2,4,83
68874782,15,3,2,4,24
68881172,20,5,2,1,28
68896396,73,12,3,16,104
68898459,18,3,2,9,32
68909392,122,24,46,5,197
68910833,157,3,2,6,168
68926303,56,33,2,6,97
68938710,47,26,21,3,97
68949406,14,9,4,1,28
68950326,108,10,4,1,123
68961205,13,3,2,3,21
68961753,224,17,59,8,308
68977025,37,3,2,1,43
68986235,59,4,15,28,106
68988974,11,3,2,11,27
68993485,19,15,3,1,38
69005319,109,22,3,8,142
69010112,40,24,51,17,132
69011997,19,7,5,7,38
69012275,64,44,46,1,155
69029091,137,3,3,3,146
69029704,48,11,3,1,63
69031552,10,4,2,1,17
69063020,23,6,3,3,35
69070134,12,3,2,1,18
69072728,19,3,2,3,27
69072975,59,16,2,9,86
69076508,32,51,2,29,114
69089106,12,3,2,1,18
69132468,34,9,8,1,52
69135683,11,11,2,1,25
69141146,17,3,2,1,23
69146624,14,3,2,1,20
69156866,54,22,2,3,81
69163575,20,18,2,2,42
69171005,88,99,83,1,271
69173011,38,16,4,38,96
69177003,25,13,11,1,50
69212451,87,11,2,4,104
69217655,134,59,8,4,205
69240131,16,3,2,1,22
69250967,29,15,30,15,89
69254480,20,3,2,1,26
69262229,117,3,2,1,123
69264008,21,48,4,1,74
69277904,18,9,2,1,30
69278025,39,3,2,1,45
69290682,23,4,3,12,42
69293032,160,6,27,8,201
69318595,13,3,2,2,20
69329166,35,3,2,17,57
69339037,119,6,26,54,205
69363554,65,6,25,2,98
69365627,12,3,2,1,18
69373937,11,3,2,1,17
69374713,92,3,2,1,98
69375342,36,6,7,1,50
69381521,39,47,11,4,101
69387784,40,22,26,6,94
69390165,48,72,25,3,148
69404435,115,63,83,1,262
69427092,57,21,2,2,82
69430855,20,3,2,1,26
69438770,183,18,24,6,231
69466162,10,4,2,1,17
69469264,108,80,12,7,207
69470907,38,19,18,1,76
69490112,64,21,2,1,88
69499142,57,29,2,1,89
69504646,70,16,2,1,89
69513846,15,3,2,1,21
69515901,33,11,22,1,67
69541057,37,9,2,1,49
69544332,37,59,4,20,120
69576938,65,3,2,5,75
69584012,87,33,2,1,123
69589240,19,3,2,1,25
69594466,10,4,2,2,18
69607456,12,3,2,1,18
69640656,65,86,5,91,247
69645759,41,14,2,2,59
69646142,70,21,3,2,96
69654684,14,15,2,2,33
69657310,14,7,2,1,24
69669445,127,18,4,31,180
69669545,53,44,2,1,100
69685229,135,3,2,1,141
69685296,196,32,10,1,239
69687393,48,49,43,33,173
69696862,33,3,2,7,45
69702904,45,11,2,2,60
69705351,78,5,47,1,131
69708828,33,30,17,3,83
69716860,43,21,2,1,67
69719809,11,3,2,1,17
69728314,153,3,2,1,159
69735494,52,37,17,1,107
69749849,97,20,2,1,120
69753863,63,20,2,2,87
69755097,78,35,2,9,124
69771661,87,3,2,1,93
69775830,105,33,66,53,257
69780778,83,86,89,49,307
69808201,35,3,2,1,41
69810126,38,45,34,4,121
69821760,11,4,2,1,18
69822202,17,62,7,1,87
69823863,13,11,2,1,27
69824878,133,8,2,2,145
69831714,47,29,39,22,137
69840737,61,32,19,12,124
69841729,20,60,2,1,83
69855563,11,5,4,1,21
69888987,11,8,2,1,22
69913957,133,31,18,1,183
69932323,81,14,7,2,104
69934320,22,64,25,1,112
69957746,20,23,2,1,46
69974047,11,5,2,1,19
69996317,187,46,2,7,242
70002846,20,11,2,1,34
70026978,23,12,2,1,38
70044919,12,3,2,1,18
70061988,19,3,2,1,25
70067161,37,30,4,1,72
70074349,150,17,3,1,171
70076334,20,7,2,1,30
70082338,80,3,2,1,86
70093759,93,37,58,24,212
70094191,13,3,2,1,19
70095309,12,3,2,1,18
70132745,50,3,2,1,56
70132976,190,134,53,64,441
70144853,130,3,2,1,136
70153477,35,11,2,1,49
70155288,79,3,23,3,108
70170912,199,3,2,3,207
70174653,67,3,2,1,73
70189222,313,3,6,39,361
70190837,12,3,2,1,18
70196640,47,13,62,2,124
70198197,125,3,2,21,151
70221445,132,6,2,5,145
70224066,34,77,7,2,120
70240172,66,40,11,2,119
70255601,12,3,2,1,18
70268280,119,3,2,1,125
70272628,55,21,12,1,89
70278258,53,20,2,1,76
70285506,13,4,7,2,26
70285917,83,17,2,1,103
70295095,124,32,95,13,264
70308024,12,14,2,3,31
70315662,103,3,2,2,110
70323690,53,8,2,1,64
70326721,110,3,2,1,116
70345373,66,24,2,11,103
70347693,102,3,2,1,108
70365895,83,3,2,1,89
70368811,83,16,2,2,103
70371139,57,16,2,2,77
70378233,27,4,4,5,40
70378851,123,3,2,1,129
70383244,21,3,3,3,30
70385006,52,54,73,7,186
70393919,51,58,11,16,136
70403744,33,46,4,22,105
70407558,413,3,2,6,424
70409972,80,10,2,1,93
70411427,15,3,2,2,22
70419808,82,3,2,3,90
70438428,22,21,19,1,63
70446678,23,53,51,1,128
70467781,11,8,2,1,22
70468685,35,6,2,2,45
70477394,74,21,13,5,113
70478494,25,58,2,7,92
70481508,11,46,7,5,69
70485893,82,27,2,2,113
70493877,12,3,2,1,18
70507641,183,3,2,5,193
70508199,18,5,2,1,26
70508488,53,16,2,1,72
70512999,37,23,7,70,137
70544259,114,4,34,2,154
70547695,73,14,71,1,159
70547809,10,41,7,12,70
70551951,78,11,2,1,92
70567946,20,24,3,1,48
70571119,196,47,50,7,300
70600211,24,20,13,10,67
70602023,44,42,6,4,96
70608294,91,3,28,1,123
70629074,76,32,51,122,281
70633574,143,3,3,36,185
70647866,37,8,49,9,103
70658779,40,3,2,1,46
70664268,14,3,2,2,21
70673876,14,3,2,2,21
70705897,61,15,2,10,88
70711135,69,3,2,1,75
70730606,135,33,12,41,221
70743365,151,34,4,1,190
70746640,93,33,2,1,129
70761826,33,3,2,2,40
70777487,13,3,2,2,20
70787468,77,17,38,21,153
70791431,105,3,23,1,132
70798922,11,3,2,1,17
70807489,115,23,69,58,265
70809837,16,3,2,4,25
70815199,167,3,2,1,173
70839056,15,19,19,1,54
70840694,90,17,8,12,127
70857442,13,25,2,1,41
70858199,124,16,2,3,145
70893948,27,27,2,1,57
70898237,34,43,2,1,80
70898350,66,3,2,1,72
70911277,137,13,4,1,155
70912700,169,13,2,1,185
70917786,51,38,26,11,126
70933268,19,3,2,1,25
70953910,21,30,14,2,67
70955536,144,3,2,1,150
70967441,41,24,88,1,154
70973820,51,3,2,14,70
70980952,13,3,2,1,19
70984507,121,23,2,5,151
71004588,24,50,2,35,111
71004879,112,35,25,51,223
71027418,60,56,45,1,162
71033533,48,23,84,1,156
71033622,99,11,2,1,113
71040980,192,12,4,15,223
71055938,159,44,13,9,225
71065659,13,3,2,1,19
71069646,34,49,18,6,107
71073528,32,3,2,1,38
71075705,159,45,10,20,234
71083081,27,7,3,1,38
71091090,61,7,4,5,77
71094834,15,4,2,1,22
71096434,30,18,4,5,57
71103798,12,3,2,1,18
71107464,21,34,4,3,62
71112322,149,42,6,3,200
71119997,69,9,2,1,81
71121160,78,4,2,1,85
71126021,21,53,2,1,77
71127042,90,3,2,2,97
71139603,25,50,16,8,99
71158845,85,3,2,1,91
71171110,87,24,5,29,145
71177762,65,3,2,1,71
71189454,21,3,2,3,29
71191515,22,3,2,3,30
71208064,12,11,2,1,26
71223639,98,37,3,1,139
71227294,27,25,7,2,61
71238720,109,3,2,1,115
71248267,10,18,2,2,32
71301191,144,33,2,23,202
71302936,11,3,2,1,17
71307522,74,59,31,61,225
71333946,40,7,2,1,50
71337951,77,14,39,12,142
71348155,71,3,2,6,82
71361297,13,13,2,1,29
71362577,59,3,2,1,65
71363622,54,50,25,1,130
71377185,159,57,53,59,328
71396983,18,25,2,1,46
71416800,12,17,2,1,32
71428818,11,6,2,1,20
71436243,75,16,41,9,141
71445501,35,3,2,1,41
71454081,69,16,2,6,93
71455834,15,3,2,1,21
71457221,27,3,2,1,33
71467386,30,36,7,6,79
71472214,123,37,3,11,174
71484783,16,11,2,1,30
71496249,114,34,2,15,165
71497783,66,31,2,3,102
71500777,31,24,3,1,59
71501817,94,68,19,10,191
71510185,78,70,49,11,208
71533065,120,16,5,9,150
71552181,102,28,2,1,133
71559530,13,12,2,13,40
71562023,50,11,2,23,86
71562096,72,3,2,13,90
71562980,79,31,2,1,113
71569298,88,3,2,1,94
71571480,59,5,2,1,67
71592929,45,13,2,1,61
71597185,261,23,5,3,292
71599022,70,33,76,5,184
71601391,60,8,2,7,77
71620000,131,22,2,1,156
71642526,28,3,2,1,34
71661315,173,5,2,1,181
71664772,37,28,13,2,80
71671842,12,3,2,1,18
71678413,79,14,2,9,104
71682925,43,3,2,1,49
71690002,91,25,3,1,120
71691449,16,3,2,1,22
71693684,13,3,2,1,19
71720263,60,3,2,2,67
71722632,179,3,39,1,222
71737144,42,3,2,1,48
71749908,33,47,15,3,98
71751258,98,34,2,1,135
71774556,88,24,59,2,173
71785713,40,27,4,2,73
71787756,141,3,2,1,147
71792354,31,3,2,1,37
71797268,10,3,2,3,18
71804323,15,4,2,1,22
71811737,41,9,2,1,53
71831554,15,3,2,1,21
71836286,70,3,4,4,81
71838120,55,21,2,15,93
71838717,16,10,2,1,29
71842102,206,3,2,48,259
71843098,72,7,2,6,87
71857221,17,6,2,2,27
71860419,106,19,2,2,129
71862530,16,39,2,20,77
71866717,79,3,2,1,85
71894235,50,53,26,1,130
71898957,17,3,2,1,23
71901840,81,3,2,1,87
71913681,87,90,2,12,191
71915483,16,5,2,1,24
71916390,38,15,9,8,70
71936999,12,3,2,3,20
71953182,34,28,2,1,65
71964931,15,3,2,1,21
71965135,128,12,17,2,159
71965854,12,15,2,3,32
71970366,11,3,2,1,17
71979798,130,43,8,3,184
71982136,112,4,2,1,119
71987304,271,23,41,68,403
71992538,141,94,2,9,246
71996285,92,17,39,32,180
72005575,121,53,45,2,221
72009482,34,3,2,5,44
72035100,68,20,2,5,95
72041502,14,5,2,1,22
72050902,45,35,2,1,83
72061164,147,27,5,4,183
72061626,12,3,2,1,18
72061771,21,22,2,1,46
72079546,32,14,19,7,72
72083206,95,19,2,2,118
72085213,10,41,2,1,54
72093692,92,27,11,2,132
72117294,132,46,26,45,249
72125516,71,12,2,1,86
72145694,64,3,2,1,70
72155829,53,11,2,7,73
72161570,109,32,143,13,297
72175792,60,3,2,1,66
72190782,26,25,14,9,74
72194406,36,12,35,5,88
72199706,178,3,2,1,184
72265310,11,3,2,1,17
72287848,11,3,2,3,19
72304371,78,3,2,8,91
72305503,45,39,2,3,89
72358605,10,3,2,2,17
72361824,115,20,69,4,208
72365921,11,10,2,1,24
72367254,10,6,2,1,19
72374260,46,100,28,19,193
72397509,22,27,4,19,72
72409150,116,3,2,3,124
72448292,74,61,2,34,171
72450494,89,26,3,2,120
72452493,111,3,2,3,119
72475584,124,22,11,2,159
72481452,80,18,8,8,114
72485374,64,24,14,4,106
72506013,50,106,43,15,214
72516807,115,24,21,5,165
72516871,21,27,107,18,173
72518855,149,6,3,37,195
72519170,11,3,2,1,17
72531549,16,62,2,4,84
72542537,10,15,2,1,28
72542774,28,33,10,30,101
72544469,21,17,2,1,41
72560950,38,3,2,1,44
72565916,30,43,5,9,87
72576019,96,3,2,1,102
72576190,37,3,2,1,43
72578790,69,22,28,13,132
72584063,70,30,2,1,103
72585541,27,3,2,1,33
72588956,20,7,12,1,40
72590396,88,45,4,2,139
72595222,124,29,88,28,269
72599960,11,61,23,3,98
72609065,89,3,2,6,100
72614091,76,66,107,35,284
72615184,18,3,2,1,24
72622203,53,18,4,6,81
72633106,13,3,2,2,20
72636014,114,9,18,3,144
72637625,53,33,19,3,108
72668779,29,29,21,3,82
72705010,112,6,2,1,121
72720183,55,3,2,12,72
72728496,54,32,5,1,92
72729623,73,7,2,2,84
72732378,39,3,2,3,47
72745581,12,9,2,3,26
72748743,38,3,2,1,44
72761267,88,6,2,1,97
72767949,109,78,67,43,297
72769739,13,15,2,1,31
72769947,115,12,2,1,130
72774751,53,10,2,24,89
72797884,71,47,17,8,143
72799541,11,4,2,1,18
72805231,26,32,31,9,98
72812852,12,15,14,2,43
72821747,21,40,42,1,104
72827961,63,10,36,2,111
72833947,101,35,2,2,140
72837242,158,8,5,21,192
72841049,32,5,2,3,42
72844719,29,3,2,1,35
72851660,169,22,25,2,218
72864534,107,3,2,1,113
72878021,133,24,48,3,208
72881793,40,3,2,4,49
72885515,14,13,2,1,30
72889857,59,3,2,2,66
72891119,68,6,41,2,117
72910531,52,5,10,1,68
72912000,10,4,2,1,17
72941597,69,29,2,1,101
72964394,11,11,2,1,25
72975067,82,35,18,5,140
72981614,70,3,2,10,85
72986007,97,22,47,4,170
72994921,100,3,2,1,106
73000548,82,14,2,1,99
73001077,147,3,2,4,156
73007751,107,3,3,14,127
73023972,90,26,11,6,133
73025654,12,3,2,1,18
73030730,86,3,2,1,92
73037770,13,13,2,1,29
73054205,38,21,4,10,73
73065981,16,18,2,12,48
73066356,58,6,32,15,111
73066502,148,7,24,18,197
73074936,105,33,38,37,213
73078215,49,8,2,1,60
73086853,46,3,2,2,53
73092163,202,41,2,8,253
73109716,10,20,2,1,33
73121614,85,24,2,17,128
73122161,56,48,7,10,121
73130723,34,32,27,10,103
73131539,11,13,2,1,27
73141054,12,3,2,1,18
73146625,254,9,2,7,272
73163178,105,10,2,16,133
73182821,55,26,2,1,84
73189633,59,3,2,1,65
73225836,49,23,5,10,87
73236640,183,51,76,47,357
73248874,87,40,27,9,163
73251895,38,23,10,7,78
73254559,60,61,9,21,151
73257403,38,87,10,3,138
73270493,86,45,11,15,157
73284320,59,45,39,27,170
73294446,10,20,2,1,33
73305558,42,30,8,9,89
73320676,104,30,47,3,184
73333351,95,66,2,1,164
73372150,336,35,4,86,461
73373080,36,11,2,1,50
73382732,10,12,2,2,26
73384051,84,6,60,6,156
73384697,120,21,13,2,156
73403737,78,3,2,1,84
73407698,76,13,2,6,97
73410919,14,6,2,1,23
73424912,134,14,2,1,151
73428595,15,3,2,1,21
73457312,150,41,44,31,266
73460341,14,3,2,1,20
73475514,292,3,2,3,300
73487987,69,3,2,1,75
73523238,106,14,8,4,132
73524743,25,7,2,4,38
73536172,21,45,2,1,69
73538846,62,3,2,1,68
73539897,19,3,2,1,25
73550056,14,20,2,3,39
73551269,11,3,2,1,17
73553610,163,26,24,39,252
73569932,109,96,6,7,218
73570529,148,42,54,5,249
73576415,67,60,13,15,155
73597464,12,3,2,5,22
73598762,69,15,9,1,94
73602915,35,25,2,1,63
73618892,13,11,4,1,29
73646833,217,71,12,18,318
73655487,296,3,2,1,302
73664433,84,24,30,1,139
73673144,33,3,2,3,41
73679580,29,52,4,25,110
73681671,81,30,53,3,167
73683817,10,5,2,2,19
73685182,167,3,2,1,173
73685381,19,4,2,1,26
73686618,23,3,2,1,29
73694175,13,14,3,3,33
73713836,18,4,7,7,36
73718909,84,3,2,25,114
73743677,62,3,2,1,68
73746984,27,3,2,1,33
73753851,11,17,2,1,31
73760105,119,3,2,6,130
73762639,59,4,8,1,72
73784080,17,10,2,3,32
73801559,39,6,2,2,49
73808551,14,3,2,1,20
73819577,16,3,2,2,23
73826658,62,117,2,13,194
73842139,27,7,3,1,38
73852287,52,32,13,29,126
73852661,39,10,64,13,126
73853462,57,15,12,6,90
73857820,52,27,2,1,82
73871020,12,3,2,1,18
73899054,15,23,2,1,41
73903544,18,14,2,1,35
73905680,115,18,2,2,137
73911150,10,9,2,1,22
73920441,37,3,2,9,51
73944357,10,13,9,1,33
73974822,205,42,11,2,260
73982281,51,14,3,2,70
73989075,76,42,32,9,159
73993210,72,41,8,4,125
73998761,169,3,2,1,175
74015410,10,3,2,2,17
74024236,56,15,9,10,90
74048066,26,209,72,1,308
74050876,59,6,2,1,68
74074909,14,3,2,1,20
74076705,52,21,2,3,78
74079614,38,25,2,15,80
74093939,165,9,4,37,215
74106000,26,31,4,3,64
74109616,46,16,39,3,104
74111321,30,3,2,1,36
74117655,81,41,50,2,174
74144765,10,5,2,1,18
74155546,40,41,77,30,188
74165171,150,3,2,2,157
74174177,19,20,2,1,42
74177751,10,21,2,1,34
74185862,65,6,3,6,80
74212974,106,5,5,5,121
74216570,54,40,13,5,112
74227841,169,7,3,20,199
74230368,788,3,2,9,802
74237988,131,11,13,3,158
74242560,117,13,9,105,244
74247134,20,3,2,1,26
74267114,89,3,2,1,95
74267283,24,8,7,7,46
74269035,36,22,6,1,65
74275380,33,21,2,1,57
74280348,13,3,2,1,19
74293025,50,3,2,2,57
74293456,15,21,16,1,53
74294183,18,11,2,1,32
74320159,69,25,3,1,98
74320264,68,36,2,1,107
74324753,11,6,2,1,20
74342988,95,37,4,1,137
74357659,139,22,23,26,210
74361620,73,3,2,1,79
74368460,19,3,2,1,25
74372912,89,16,2,1,108
74377279,25,78,2,1,106
74379253,42,44,9,1,96
74383980,10,5,2,1,18
74384833,64,3,2,1,70
74386790,28,40,2,4,74
74402664,11,59,14,1,85
74405756,62,3,2,1,68
74412516,370,3,2,23,398
74422548,38,15,2,2,57
74422836,13,3,2,1,19
74429281,23,47,11,35,116
74446247,10,4,2,1,17
74463901,75,20,2,1,98
74490412,62,61,74,1,198
74510014,13,12,2,1,28
74519131,117,5,2,1,125
74536426,60,55,22,15,152
74540358,88,3,2,1,94
74554853,38,41,24,28,131
74556629,51,3,2,1,57
74557631,75,20,6,17,118
74563401,154,10,76,4,244
74587979,14,3,2,1,20
74600339,70,3,2,2,77
74603297,62,23,73,8,166
74626897,25,3,7,1,36
74644880,68,3,2,1,74
74654091,12,3,2,1,18
74656036,18,13,2,1,34
74661799,67,7,12,4,90
74662093,36,52,2,1,91
74665741,22,3,2,1,28
74667071,35,15,2,1,53
74674333,11,3,2,1,17
74680406,151,37,16,2,206
74682036,111,69,2,22,204
74684787,40,34,2,12,88
74692376,143,28,2,1,174
74699360,22,44,7,4,77
74700031,35,15,56,5,111
74705543,139,3,2,2,146
74721506,40,32,12,29,113
74744880,59,34,2,2,97
74760322,62,33,19,4,118
74761605,15,3,2,1,21
74803545,18,3,2,3,26
74804020,40,10,22,18,90
74814268,102,8,30,2,142
74814854,72,100,2,1,175
74821991,64,11,56,1,132
74833969,18,18,2,1,39
74833993,18,21,11,1,51
74835215,14,3,2,10,29
74836365,117,47,27,7,198
74856022,25,20,2,1,48
74873523,54,23,40,2,119
74881124,142,32,2,3,179
74883678,17,3,2,1,23
74886921,42,15,31,1,89
74887796,31,24,2,1,58
74899977,58,41,167,10,276
74900214,47,36,8,9,100
74901957,89,3,2,1,95
74904343,29,3,2,1,35
74905922,11,3,2,1,17
74949263,28,25,2,31,86
74949569,11,3,2,1,17
74953434,64,19,2,16,101
74961284,17,20,2,1,40
74968912,11,8,2,1,22
74969660,29,18,2,1,50
74982980,118,3,2,7,130
74985664,25,3,2,1,31
75005683,125,80,11,69,285
75006844,51,5,11,1,68
75049241,19,13,4,1,37
75060596,11,3,2,1,17
75061731,30,26,3,1,60
75098489,46,3,2,3,54
75113701,51,34,2,2,89
75114321,43,24,7,9,83
75131009,49,72,25,11,157
75147925,223,45,2,2,272
75154530,118,20,9,2,149
75166805,13,3,2,2,20
75171771,69,25,2,17,113
75180236,37,34,32,5,108
75208013,159,45,2,13,219
75218014,28,12,21,2,63
75218212,16,3,3,2,24
75237321,11,3,2,1,17
75240820,41,26,15,3,85
75263101,130,3,2,2,137
75269399,109,3,2,14,128
75278716,121,7,10,8,146
75300397,291,3,2,1,297
75326607,57,68,25,13,163
75340902,91,16,36,2,145
75352940,13,3,2,1,19
75367766,68,20,2,1,91
75419145,12,3,2,1,18
75423997,91,3,2,4,100
75426431,26,3,2,2,33
75434821,58,29,14,2,103
75438764,122,7,2,2,133
75440208,87,24,35,10,156
75460583,43,43,4,51,141
75468554,131,3,2,12,148
75468702,82,9,4,1,96
75472064,75,3,2,1,81
75476044,117,14,2,1,134
75486914,68,3,2,1,74
75494934,157,15,2,7,181
75500808,32,42,2,6,82
75509807,34,77,2,5,118
75523331,51,19,19,13,102
75524087,64,3,7,12,86
75526441,14,3,2,1,20
75536552,37,27,104,1,169
75547437,201,37,60,14,312
75570909,15,42,2,1,60
75583511,81,41,51,20,193
75591668,41,22,26,35,124
75592024,71,31,55,2,159
75599574,85,31,13,58,187
75632582,23,3,6,1,33
75639794,182,30,2,2,216
75644516,12,6,2,1,21
75655863,144,3,2,3,152
75657220,47,15,2,1,65
75659649,32,11,2,2,47
75670171,27,13,11,31,82
75674590,24,52,19,2,97
75683837,44,3,32,17,96
75684658,190,31,79,1,301
75689469,57,30,16,1,104
75691424,70,15,2,1,88
75697057,131,3,2,1,137
75699701,60,29,8,23,120
75729182,11,3,2,2,18
75730807,83,20,12,7,122
75740868,10,14,2,1,27
75752135,67,3,2,6,78
75785829,431,18,2,11,462
75791969,88,87,72,9,256
75801012,125,11,2,2,140
75805285,17,71,4,1,93
75810627,34,5,2,1,42
75816574,135,36,6,33,210
75821580,84,44,32,2,162
75829803,43,3,2,1,49
75837867,80,3,2,1,86
75849290,94,3,2,1,100
75849688,87,24,24,2,137
75853916,34,15,6,1,56
75858675,17,3,2,1,23
75860368,21,42,2,1,66
75863421,26,12,30,2,70
75869146,115,3,2,1,121
75883289,30,3,2,1,36
75915929,59,12,48,11,130
75928517,41,14,30,2,87
75938892,85,10,121,1,217
75945400,21,25,15,3,64
75953198,41,44,3,4,92
75992445,386,54,2,6,448
76040430,77,3,2,1,83
76062231,62,3,2,1,68
76062776,58,59,16,25,158
76110340,86,15,52,1,154
76110559,66,18,2,14,100
76121163,35,3,2,1,41
76121660,59,3,40,10,112
76125124,49,3,2,1,55
76128515,10,12,2,1,25
76140871,50,25,2,5,82
76141654,39,15,29,1,84
76148871,117,85,8,13,223
76161937,27,3,2,1,33
76176109,99,11,2,2,114
76180005,41,3,2,1,47
76192153,67,38,65,10,180
76193448,194,15,7,13,229
76195719,101,20,38,1,160
76203973,19,3,2,1,25
76205684,103,3,2,1,109
76228356,29,6,2,1,38
76238006,28,3,2,5,38
76244218,24,60,2,1,87
76244491,72,3,2,4,81
76254115,23,6,2,1,32
76256618,88,62,4,1,155
76260021,11,9,2,4,26
76263032,43,57,15,4,119
76270885,51,26,22,5,104
76272959,39,3,2,1,45
76286064,105,25,38,5,173
76291817,30,30,11,18,89
76299981,21,3,2,1,27
76326061,110,20,20,1,151
76328454,309,55,9,30,403
76328535,22,32,3,1,58
76333125,134,3,2,1,140
76339935,39,3,2,1,45
76364621,11,3,2,1,17
76370715,120,11,2,7,140
76387972,55,3,2,2,62
76389886,38,3,2,2,45
76417747,18,27,16,1,62
76443653,26,3,2,1,32
76447296,36,29,5,1,71
76468433,60,30,17,2,109
76472307,14,3,2,1,20
76473555,51,16,2,4,73
76502351,18,28,29,13,88
76502364,94,15,2,9,120
76504808,11,7,2,3,23
76505952,24,27,9,14,74
76526835,154,38,2,12,206
76528547,230,25,82,16,353
76531531,32,21,3,3,59
76542791,16,26,2,5,49
76554851,45,3,2,1,51
76558295,57,41,2,20,120
76565094,99,51,10,11,171
76570922,19,11,2,1,33
76574101,34,53,15,19,121
76578222,137,37,93,34,301
76595845,29,46,13,3,91
76598361,72,15,3,1,91
76606023,30,3,2,1,36
76653280,133,3,2,8,146
76669825,42,3,5,1,51
76677409,65,3,2,2,72
76708959,92,29,2,11,134
76729024,109,34,4,1,148
76733401,240,3,2,12,257
76745757,10,3,2,3,18
76752759,73,13,10,1,97
76756490,106,3,2,1,112
76760897,68,26,27,1,122
76764664,88,26,15,3,132
76789837,11,7,2,1,21
76792822,125,39,2,1,167
76811008,43,34,3,15,95
76820515,62,3,2,1,68
76826659,43,38,33,2,116
76829520,19,16,2,11,48
76837384,27,20,29,14,90
76849354,25,21,4,1,51
76850193,75,31,4,16,126
76856670,56,23,2,7,88
76857288,23,47,6,81,157
76869866,14,3,2,10,29
76883175,104,60,16,24,204
76888516,130,24,2,1,157
76907311,45,7,28,10,90
76914476,59,21,2,1,83
76923359,13,3,2,1,19
76933376,36,7,7,14,64
76946472,199,30,2,1,232
76946964,322,95,44,70,531
76949067,72,3,2,1,78
76977895,158,7,5,2,172
76979462,16,6,11,2,35
76985641,11,3,2,4,20
76988706,14,3,2,1,20
76998332,25,3,2,1,31
77004642,55,26,5,1,87
77015983,11,3,2,1,17
77017513,49,11,3,10,73
77018985,144,34,2,1,181
77025047,100,3,2,3,108
77027035,101,32,2,1,136
77032781,41,8,12,1,62
77034134,15,32,8,10,65
77040806,150,8,128,68,354
77043287,49,38,2,1,90
77055474,24,3,2,1,30
77059551,29,7,4,2,42
77062223,31,3,10,3,47
77064124,105,38,24,6,173
77070871,45,5,11,1,62
77080719,97,3,2,3,105
77118712,174,47,31,6,258
77138861,174,5,7,1,187
77139023,103,24,12,3,142
77156146,29,71,16,1,117
77156297,62,3,2,1,68
77167981,17,3,2,1,23
77171583,67,5,2,1,75
77172911,13,17,3,1,34
77179780,13,19,5,2,39
77188339,83,55,6,2,146
77188813,55,69,22,4,150
77196191,26,3,2,1,32
77211753,11,4,2,1,18
77222970,46,47,7,18,118
77229308,81,3,2,1,87
77234231,60,32,34,4,130
77240260,43,34,21,2,100
77245726,214,19,2,2,237
77260966,155,40,2,14,211
77262502,13,3,2,1,19
77265658,62,6,2,12,82
77267212,76,4,3,3,86
77268597,43,26,2,11,82
77269061,86,7,2,12,107
77274354,59,45,18,8,130
77278239,73,8,33,2,116
77278848,159,47,4,20,230
77283068,23,3,2,4,32
77293233,42,32,5,7,86
77298054,25,6,36,10,77
77321194,51,62,5,12,130
77336309,10,7,2,1,20
77351736,11,3,2,1,17
77370152,86,48,130,29,293
77413059,47,13,8,1,69
77419041,35,13,3,5,56
77432296,21,21,2,3,47
77434399,269,8,2,104,383
77436538,191,47,33,5,276
77442509,53,4,2,6,65
77444275,63,16,6,1,86
77447251,128,16,3,27,174
77461342,38,15,9,4,66
77483298,94,6,2,7,109
77491063,20,3,2,1,26
77491394,108,3,2,1,114
77497731,43,3,2,1,49
77502008,189,19,19,11,238
77503654,60,99,24,4,187
77575270,13,12,2,1,28
77590168,99,3,2,5,109
77603644,31,55,3,3,92
77607391,42,44,2,1,89
77613554,13,3,2,1,19
77620569,99,31,11,7,148
77629456,108,31,43,10,192
77646202,49,22,18,39,128
77658591,31,3,2,1,37
77659793,81,7,12,1,101
77663299,13,6,2,4,25
77663554,63,85,16,1,165
77672312,159,108,24,13,304
77681182,81,17,2,3,103
77681954,111,4,2,7,124
77687993,76,3,2,3,84
77696540,43,54,3,1,101
77700534,104,50,2,2,158
77712560,99,77,46,63,285
77713530,68,23,29,1,121
77719328,55,51,2,4,112
77725143,67,9,3,6,85
77737731,30,19,2,1,52
77742169,12,24,2,1,39
77743791,73,26,2,3,104
77745922,28,4,2,1,35
77762810,81,3,2,1,87
77767459,26,3,2,1,32
77772225,14,3,2,1,20
77772928,26,4,3,6,39
77773534,87,20,2,1,110
77784187,32,7,13,4,56
77786800,75,24,5,1,105
77788722,47,11,2,4,64
77793995,252,38,15,23,328
77805553,45,33,3,1,82
77810052,122,28,3,12,165
77822400,136,6,2,2,146
77825478,177,78,16,5,276
77833622,66,3,2,10,81
77838864,78,26,10,1,115
77847094,12,3,2,2,19
77851563,60,3,2,2,67
77866957,37,3,2,1,43
77874154,49,36,59,17,161
77874894,26,25,88,6,145
77876105,19,21,2,1,43
77886661,120,33,91,2,246
77904993,29,19,8,1,57
77908014,50,3,2,4,59
77911456,61,3,2,1,67
77913357,60,70,13,39,182
77913907,25,19,2,1,47
77921346,64,3,2,1,70
77923184,23,28,2,43,96
77923280,30,10,13,2,55
77954137,48,8,3,1,60
77958475,27,26,4,15,72
77974897,11,21,2,5,39
77982198,297,128,2,94,521
78028022,143,14,3,1,161
78029031,28,54,12,29,123
78029888,68,9,4,97,178
78036357,44,11,2,4,61
78037320,59,37,2,1,99
78063042,10,4,2,1,17
78068986,14,4,2,1,21
78073529,17,21,2,6,46
78097395,10,25,2,1,38
78106080,12,9,3,1,25
78108239,37,24,55,1,117
78111233,43,25,4,5,77
78125342,113,12,20,1,146
78148959,41,3,2,1,47
78152605,130,24,2,6,162
78155528,18,3,2,3,26
78157260,100,46,44,5,195
78174540,44,7,2,1,54
78176755,71,15,2,5,93
78179328,71,21,12,3,107
78179706,19,3,2,1,25
78183943,40,47,48,4,139
78191817,112,18,9,4,143
78199849,119,3,2,2,126
78201630,15,49,16,1,81
78205448,54,3,2,1,60
78216679,16,3,2,1,22
78219036,118,74,21,10,223
78225241,29,10,5,1,45
78227779,93,25,23,15,156
78235444,10,35,2,5,52
78239406,49,37,11,1,98
78245388,48,3,2,1,54
78248524,111,16,2,4,133
78250646,92,3,2,1,98
78252517,54,59,2,1,116
78253808,74,44,6,20,144
78266155,108,35,28,24,195
78284777,12,3,2,2,19
78287041,45,34,44,36,159
78300901,66,70,33,5,174
78303902,112,25,23,2,162
78322473,74,19,2,2,97
78333337,39,3,2,1,45
78348289,37,3,2,1,43
78355995,156,5,2,1,164
78369916,17,14,2,1,34
78374256,41,9,2,15,67
78383704,82,17,15,3,117
78396915,18,14,2,1,35
78412627,11,3,2,1,17
78434011,41,28,31,18,118
78434791,80,3,2,1,86
78437653,79,3,41,25,148
78441607,64,20,27,4,115
78445139,36,3,2,1,42
78446364,11,7,2,1,21
78452678,17,41,2,2,62
78457795,96,3,2,14,115
78461775,94,3,2,2,101
78478658,24,3,2,1,30
78478857,36,12,7,24,79
78496647,55,3,2,3,63
78538275,142,3,2,20,167
78538757,50,43,9,25,127
78540353,88,52,94,18,252
78544323,43,58,6,1,108
78546178,90,36,56,2,184
78547743,15,7,2,1,25
78557473,19,24,2,9,54
78566405,13,8,2,1,24
78592033,16,27,2,3,48
78594932,51,3,2,3,59
78612493,92,18,8,4,122
78627681,32,27,2,47,108
78629582,74,15,11,1,101
78689875,78,17,30,1,126
78717800,11,5,2,1,19
78721728,47,7,51,44,149
78725206,105,13,40,3,161
78755433,24,11,2,1,38
78769040,68,40,25,21,154
78773099,13,37,11,3,64
78777841,67,29,24,4,124
78810804,15,5,2,2,24
78814450,246,3,2,69,320
78834525,62,16,96,17,191
78842028,118,29,41,6,194
78843760,30,15,2,6,53
78861225,85,3,2,1,91
78864536,131,22,49,27,229
78864728,14,33,2,1,50
78873922,162,30,11,12,215
78883022,36,24,5,1,66
78885780,36,3,2,1,42
78898171,16,19,2,12,49
78910603,103,15,16,1,135
78912132,16,36,2,2,56
78912552,428,3,2,18,451
78920979,121,20,2,10,153
78926178,39,32,26,1,98
78936252,46,14,10,21,91
78937395,52,27,3,8,90
78942747,119,3,2,24,148
78946125,20,98,10,2,130
78955102,81,3,30,29,143
78964933,11,3,2,3,19
78982802,51,28,11,11,101
78988924,98,15,2,4,119
78996205,21,3,2,1,27
79004429,32,22,13,3,70
79014910,78,7,2,1,88
79024294,55,65,3,7,130
79028710,174,3,2,1,180
79030321,119,20,2,14,155
79034538,270,32,126,12,440
79040507,64,29,11,7,111
79048841,69,16,2,7,94
79057086,111,10,18,1,140
79061003,328,3,2,1,334
79064798,93,32,2,3,130
79088835,19,3,2,1,25
79090113,69,19,3,8,99
79128797,53,28,2,3,86
79132393,22,23,2,1,48
79138873,113,141,3,44,301
79148167,11,29,2,1,43
79149022,41,35,39,4,119
79163243,74,35,6,6,121
79164805,30,7,2,5,44
79168720,36,14,34,17,101
79189085,31,24,17,13,85
79190704,54,112,61,8,235
79195163,191,14,2,9,216
79195541,32,3,2,1,38
79197410,41,3,2,2,48
79207907,14,35,4,1,54
79228255,18,19,2,1,40
79235953,97,24,67,3,191
79246056,105,18,16,2,141
79268237,93,28,20,2,143
79273656,28,3,2,1,34
79275329,117,3,2,4,126
79298236,98,3,2,9,112
79347749,77,6,23,33,139
79361033,19,3,2,1,25
79371161,83,19,8,1,111
79375605,63,20,26,11,120
79392990,60,10,2,2,74
79410738,165,22,2,1,190
79421071,15,4,2,2,23
79424393,78,79,124,2,283
79432223,147,75,28,28,278
79432849,15,21,15,21,72
79439378,276,3,2,4,285
79453138,22,9,2,2,35
79455217,10,3,2,2,17
79468178,10,3,2,2,17
79477414,20,3,2,1,26
79502683,41,20,3,3,67
79505380,78,15,9,10,112
79510815,10,3,2,3,18
79516404,18,27,3,5,53
79516762,13,22,2,3,40
79523415,212,9,11,7,239
79533209,90,6,2,1,99
79554717,34,8,2,2,46
79569076,98,3,2,7,110
79574518,108,19,5,3,135
79577156,23,12,34,21,90
79577752,110,26,2,8,146
79594043,75,25,36,16,152
79626348,104,33,9,12,158
79627778,56,57,10,19,142
79632646,90,9,2,4,105
79636088,22,23,2,1,48
79667253,46,17,8,1,72
79680419,171,56,28,4,259
79682676,92,21,2,1,116
79685102,89,3,2,5,99
79688316,20,9,2,4,35
79695875,41,30,48,33,152
79697286,91,3,2,6,102
79707448,63,27,27,13,130
79712275,22,3,2,1,28
79727539,108,10,2,5,125
79728950,29,63,2,1,95
79729755,130,20,70,2,222
79750236,107,35,46,44,232
79750364,16,37,2,1,56
79764067,35,29,2,1,67
79766897,36,10,2,1,49
79770164,70,23,10,1,104
79788811,62,16,2,2,82
79792547,123,14,88,4,229
79794484,88,45,65,1,199
79795654,21,18,5,1,45
79801711,16,15,2,1,34
79810776,22,47,10,6,85
79810873,35,8,2,4,49
79816078,13,3,2,1,19
79824594,53,27,20,1,101
79827096,112,57,52,13,234
79829304,71,3,2,1,77
79839589,108,3,2,1,114
79852485,43,3,2,11,59
79859453,122,3,2,2,129
79861632,53,87,9,8,157
79894315,185,3,2,1,191
79896343,70,57,30,14,171
79904680,56,6,44,16,122
79924569,14,3,2,1,20
79928646,26,3,2,4,35
79937740,184,38,6,3,231
80002177,19,3,2,1,25
80014844,117,22,14,2,155
80036516,15,3,2,4,24
80039987,21,3,2,2,28
80045285,46,42,17,8,113
80055278,60,26,12,46,144
80063028,42,18,2,4,66
80063568,52,14,5,15,86
80072276,36,9,27,6,78
80072412,107,5,32,3,147
80078401,46,14,23,2,85
80081278,14,3,2,1,20
80081889,17,14,2,1,34
80093728,38,5,3,2,48
80096241,66,24,47,4,141
80098873,103,10,2,1,116
80100228,47,3,2,1,53
80101106,61,3,2,6,72
80103817,72,15,43,9,139
80108249,82,18,2,2,104
80123262,20,3,2,7,32
80124916,25,3,2,13,43
80131156,82,53,48,5,188
80162101,96,8,60,20,184
80173919,33,57,17,7,114
80175682,28,3,2,1,34
80176030,102,92,2,1,197
80197690,45,3,2,1,51
80217714,67,16,2,13,98
80219463,16,3,2,4,25
80232972,130,27,4,1,162
80244785,38,50,3,1,92
80249273,17,12,2,1,32
80260179,24,21,2,2,49
80260771,24,36,17,1,78
80292705,106,35,2,4,147
80299758,22,28,2,2,54
80301108,128,24,2,1,155
80309379,108,11,14,22,155
80319081,11,3,2,1,17
80326905,12,8,2,1,23
80328917,23,3,2,1,29
80340029,49,31,21,22,123
80343476,82,21,30,6,139
80346804,75,25,2,2,104
80348608,87,52,29,7,175
80349208,18,3,2,1,24
80377621,201,41,12,13,267
80381059,49,3,2,8,62
80381470,35,3,2,3,43
80431279,56,3,2,1,62
80431408,72,3,2,1,78
80433575,99,17,2,1,119
80442041,92,55,2,1,150
80456409,11,3,2,1,17
80456818,38,35,2,1,76
80458174,11,88,2,2,103
80468797,10,14,2,2,28
80470908,28,27,2,2,59
80485102,12,3,2,1,18
80511245,62,23,6,3,94
80511747,77,32,22,18,149
80518050,20,95,18,2,135
80527418,86,37,141,2,266
80532151,45,38,34,4,121
80540146,66,18,7,1,92
80548781,40,3,2,9,54
80561926,16,3,2,1,22
80562833,77,37,51,13,178
80570948,136,25,5,5,171
80581284,17,8,3,4,32
80588726,11,9,14,3,37
80636642,11,3,2,1,17
80637252,189,3,2,2,196
80640722,217,3,2,1,223
80656500,56,3,2,1,62
80664634,24,7,2,1,34
80665591,34,44,27,2,107
80682411,12,12,2,1,27
80687062,49,4,2,1,56
80695598,64,24,10,5,103
80705731,63,48,24,7,142
80722031,36,46,32,2,116
80722770,195,3,2,10,210
80723034,96,29,5,3,133
80739844,32,15,16,1,64
80741683,27,5,2,1,35
80742773,151,17,2,11,181
80759860,24,3,2,9,38
80762444,73,49,33,29,184
80783407,44,7,2,1,54
80784364,27,79,20,1,127
80813206,41,26,14,7,88
80825910,29,11,2,1,43
80842884,65,27,2,3,97
80864940,13,3,2,1,19
80894462,71,81,119,17,288
80899149,229,3,2,28,262
80904251,40,60,3,11,114
80916304,12,3,2,1,18
80918733,179,39,2,4,224
80945757,11,3,2,2,18
80952898,127,53,52,10,242
80959467,59,58,3,8,128
80981430,188,85,7,7,287
80984294,96,3,2,12,113
81019980,32,27,18,1,78
81035068,15,3,2,1,21
81037322,146,3,10,7,166
81039309,19,3,4,1,27
81044104,11,3,2,1,17
81046385,51,8,2,1,62
81051716,37,47,16,34,134
81066424,19,19,2,1,41
81070935,178,47,12,14,251
81072466,102,3,2,5,112
81079449,12,3,2,1,18
81083268,264,75,25,36,400
81090578,12,3,2,3,20
81096550,30,10,6,3,49
81105982,74,7,2,1,84
81126692,82,25,2,39,148
81127490,18,12,2,1,33
81133310,44,40,26,6,116
81154555,18,26,7,33,84
81164656,42,12,2,1,57
81165824,10,3,2,2,17
81165861,77,19,49,2,147
81167665,177,38,84,10,309
81172218,10,4,2,1,17
81187390,86,6,2,1,95
81217963,88,3,2,3,96
81235281,95,3,2,27,127
81240876,37,55,2,30,124
81241975,10,5,3,1,19
81244711,73,42,12,3,130
81247185,25,3,2,2,32
81256238,54,31,43,4,132
81259428,43,3,2,1,49
81259836,46,5,5,21,77
81270655,47,3,2,1,53
81274284,128,23,3,3,157
81309765,47,17,29,5,98
81315002,171,30,23,1,225
81328447,29,3,2,1,35
81348124,53,3,2,26,84
81351885,49,20,5,23,97
81358477,61,24,38,7,130
81361353,69,10,15,1,95
81380673,214,17,25,1,257
81383192,12,3,2,1,18
81392659,135,25,82,3,245
81394035,11,3,2,2,18
81398860,15,24,2,18,59
81407335,26,30,8,1,65
81413350,23,4,2,15,44
81431722,18,29,7,6,60
81431934,42,49,3,12,106
81449574,39,3,2,4,48
81452182,18,26,80,2,126
81464526,21,3,2,1,27
81470824,96,37,20,80,233
81471061,88,9,2,1,100
81473873,126,3,2,27,158
81481329,52,3,2,1,58
81499693,27,3,2,1,33
81510522,61,30,2,4,97
81522514,15,3,2,1,21
81530131,66,26,3,1,96
81553584,190,79,9,6,284
81559929,126,52,22,36,236
81564226,16,3,2,1,22
81574015,11,12,2,3,28
81583316,143,21,4,5,173
81589175,191,3,2,1,197
81592462,96,17,2,1,116
81593164,13,3,2,1,19
81599900,45,3,2,1,51
81611718,13,3,2,1,19
81616872,19,3,2,1,25
81622225,104,39,50,14,207
81633717,281,3,2,1,287
81635986,15,3,2,1,21
81636468,71,3,2,4,80
81638026,11,12,2,1,26
81644479,99,17,102,1,219
81667037,26,23,11,35,95
81680280,96,15,2,2,115
81683031,58,13,113,4,188
81683158,22,21,2,2,47
81697278,25,6,2,1,34
81716204,58,5,57,10,130
81741683,93,11,4,1,109
81749286,59,14,22,9,104
81766184,158,3,2,2,165
81782903,130,3,2,7,142
81788785,10,10,2,1,23
81795851,23,3,2,1,29
81805633,92,64,19,6,181
81815977,16,7,2,1,26
81822247,73,33,36,14,156
81829750,84,5,2,1,92
81830982,16,3,2,1,22
81833581,31,3,2,1,37
81840330,28,18,6,1,53
81841616,11,3,2,1,17
81847170,10,5,2,1,18
81857166,138,34,2,9,183
81862708,45,3,2,1,51
81863410,158,3,2,13,176
81865692,101,24,4,18,147
81871422,45,63,26,1,135
81875790,73,10,15,37,135
81888674,181,30,10,6,227
81890144,43,30,41,29,143
81903709,44,8,15,2,69
81927305,10,5,2,1,18
81931369,19,28,2,2,51
81941459,16,7,2,5,30
81951632,13,3,2,3,21
81955534,70,28,6,30,134
81961896,61,22,24,3,110
81961907,10,5,2,1,18
81965872,17,6,2,1,26
81986173,145,13,2,1,161
82007252,23,62,2,3,90
82010916,11,12,2,7,32
82017742,10,8,2,1,21
82020857,15,3,2,1,21
82041098,75,34,2,2,113
82048446,79,28,2,1,110
82058348,55,31,3,6,95
82058642,53,5,2,1,61
82069042,112,18,42,96,268
82076942,25,3,2,1,31
82079959,122,25,30,4,181
82086910,42,23,2,1,68
82087641,11,3,2,1,17
82088402,12,20,16,1,49
82107671,23,34,19,2,78
82115808,162,43,36,33,274
82145070,15,3,2,1,21
82165610,89,53,80,9,231
82167874,19,33,2,3,57
82178417,25,25,27,7,84
82179718,56,4,2,1,63
82180045,19,3,2,1,25
82181725,41,11,2,1,55
82193353,21,3,2,1,27
82194906,25,48,3,2,78
82205970,179,6,2,2,189
82212636,224,27,2,25,278
82228920,60,32,2,62,156
82233558,53,28,2,6,89
82247383,77,47,10,8,142
82252966,40,14,3,3,60
82264809,37,24,64,10,135
82294006,47,3,2,1,53
82298943,196,3,15,1,215
82312878,16,19,4,21,60
82316325,17,12,2,9,40
82322248,13,3,2,2,20
82335919,108,6,5,5,124
82354893,27,14,2,1,44
82359964,42,38,40,7,127
82370342,105,13,2,8,128
82382207,34,24,13,10,81
82384776,10,3,2,2,17
82389771,87,14,9,2,112
82413838,69,62,51,5,187
82413856,69,11,6,7,93
82417321,55,19,17,77,168
82419643,58,3,2,1,64
82421399,20,3,2,1,26
82423787,92,3,33,30,158
82429442,16,16,2,1,35
82446329,27,83,8,2,120
82462238,44,3,2,2,51
82465372,62,50,34,14,160
82467344,27,43,20,10,100
82471532,131,29,5,1,166
82477854,24,41,2,1,68
82478262,34,9,2,1,46
82488892,49,27,4,6,86
82504237,16,3,2,1,22
82508423,29,17,21,1,68
82536744,17,3,2,1,23
82538157,55,3,2,1,61
82569201,47,3,2,1,53
82576619,64,27,34,2,127
82578429,75,3,2,3,83
82581046,87,39,32,1,159
82582570,109,3,2,13,127
82589735,28,13,2,10,53
82592016,69,11,2,6,88
82593902,55,12,7,3,77
82655971,13,4,2,2,21
82660448,84,62,2,19,167
82672606,67,3,2,3,75
82687504,12,6,2,8,28
82697074,41,14,9,5,69
82702571,89,3,2,2,96
82722148,819,45,2,57,923
82727977,45,25,21,8,99
82737980,92,34,12,1,139
82743538,22,3,2,1,28
82755519,60,20,2,6,88
82759623,81,3,2,1,87
82764630,15,3,2,2,22
82769133,75,20,2,1,98
82775701,16,5,2,1,24
82778784,23,3,2,1,29
82789347,74,14,2,16,106
82794942,64,3,2,1,70
82800138,101,3,2,14,120
82802517,117,3,2,3,125
82803176,125,14,36,5,180
82807470,101,12,53,4,170
82808645,24,17,2,1,44
82811822,186,3,2,1,192
82814836,33,14,18,3,68
82831688,50,8,2,1,61
82837811,11,3,2,1,17
82850589,71,5,2,1,79
82855306,92,31,19,13,155
82863575,29,21,2,1,53
82895017,11,3,2,1,17
82944174,59,15,33,1,108
82945727,112,11,39,25,187
82957621,22,11,2,4,39
82966061,17,9,2,1,29
82975347,37,32,2,1,72
83005402,10,3,2,2,17
83009745,56,22,12,1,91
83012167,14,21,2,1,38
83028204,38,45,53,1,137
83045417,14,8,2,2,26
83052925,33,3,2,1,39
83055860,71,26,2,1,100
83059561,83,10,2,2,97
83070271,39,61,31,1,132
83072414,20,36,2,1,59
83080023,104,20,31,3,158
83081521,113,84,45,30,272
83099658,59,42,19,1,121
83101443,104,28,82,16,230
83103209,140,36,2,3,181
83115895,43,27,28,1,99
83116958,44,3,2,12,61
83119411,39,25,30,1,95
83130456,13,5,2,1,21
83145951,10,24,2,1,37
83150750,40,40,23,2,105
83179986,116,17,75,1,209
83184700,38,55,11,9,113
83185041,80,33,11,5,129
83191792,28,45,12,3,88
83197424,24,9,8,2,43
83216833,40,3,2,1,46
83240976,56,12,2,6,76
83258684,30,72,34,1,137
83287633,99,14,41,1,155
83294697,120,9,2,3,134
83300187,13,45,21,1,80
83300455,11,3,2,1,17
83308494,10,33,2,3,48
83317753,45,20,8,16,89
83317847,107,26,6,49,188
83321439,14,3,2,1,20
83325908,33,43,3,54,133
83338689,166,22,63,1,252
83340755,21,6,25,1,53
83348736,80,3,2,10,95
83350197,37,47,9,1,94
83350438,72,25,60,1,158
83352330,55,3,2,1,61
83365837,18,3,2,1,24
83366399,81,9,25,6,121
83370159,33,10,42,35,120
83372518,44,3,2,1,50
83373532,24,5,2,3,34
83375858,56,3,2,4,65
83380212,58,26,13,4,101
83384675,53,33,58,11,155
83399214,37,17,6,5,65
83413071,109,20,2,1,132
83433298,11,4,2,4,21
83439000,61,4,2,2,69
83442076,24,6,2,1,33
83453785,26,11,10,6,53
83462193,96,66,10,1,173
83468866,57,22,16,1,96
83468986,152,24,82,51,309
83473021,52,28,54,4,138
83480014,88,11,2,53,154
83481965,39,4,2,2,47
83490068,255,38,51,14,358
83534434,147,25,13,5,190
83556247,82,3,2,5,92
83558465,213,9,17,3,242
83569468,12,3,2,2,19
83594745,145,3,2,9,159
83598693,279,3,2,8,292
83606664,22,4,2,1,29
83606930,44,3,2,1,50
83614162,97,7,58,10,172
83623898,12,3,2,1,18
83644879,361,3,2,1,367
83645382,146,3,2,6,157
83648702,16,3,2,1,22
83662647,112,43,2,9,166
83693381,13,19,2,1,35
83713928,109,3,2,2,116
83716007,19,3,2,3,27
83738886,10,4,2,1,17
83743198,24,3,2,1,30
83746571,59,3,2,2,66
83749757,24,3,2,1,30
83754450,55,91,24,3,173
83769012,13,3,2,1,19
83777530,48,11,5,5,69
83802250,17,35,4,7,63
83804170,45,61,19,12,137
83813661,64,34,30,10,138
83817536,52,3,2,1,58
83834556,24,13,2,1,40
83835542,145,23,8,10,186
83837133,11,3,2,1,17
83855087,115,11,10,1,137
83870081,347,3,2,2,354
83898141,57,31,14,25,127
83908421,16,3,2,1,22
83920302,112,13,83,26,234
83921172,49,22,7,3,81
83923245,112,28,24,4,168
83933958,63,38,34,3,138
83939063,111,24,2,1,138
83954399,43,15,16,20,94
83993034,24,8,2,7,41
84009465,11,3,2,1,17
84024745,12,6,2,2,22
84026511,20,31,2,2,55
84038698,10,5,2,1,18
84062917,10,5,2,1,18
84069967,10,6,2,1,19
84100873,69,3,2,1,75
84115462,22,15,2,1,40
84121166,34,34,18,4,90
84121493,90,19,6,13,128
84122266,11,3,2,1,17
84130039,182,3,2,2,189
84137986,54,42,47,31,174
84165311,46,52,3,8,109
84174560,43,44,6,27,120
84189004,80,45,2,2,129
84209073,79,51,2,3,135
84211452,23,3,2,1,29
84212613,12,4,2,1,19
84235178,107,3,2,3,115
84238240,29,31,78,16,154
84243407,96,3,2,4,105
84250210,11,11,2,1,25
84252629,81,93,55,99,328
84259529,12,6,2,1,21
84267025,36,3,2,1,42
84269560,36,39,2,23,100
84290650,101,46,80,7,234
84293145,72,7,2,2,83
84298306,99,48,3,1,151
84305912,163,3,2,2,170
84308704,25,4,3,1,33
84309483,58,45,42,14,159
84339122,37,3,2,1,43
84356806,178,3,2,8,191
84373501,49,89,49,4,191
84379504,225,28,27,9,289
84385527,63,31,20,16,130
84391324,46,3,2,1,52
84396141,60,9,4,9,82
84404088,93,28,14,10,145
84413922,80,12,20,9,121
84415579,59,25,9,1,94
84416084,18,3,2,1,24
84431407,34,3,2,5,44
84435499,18,3,2,1,24
84440545,21,15,2,4,42
84451507,43,10,35,3,91
84471597,63,31,5,2,101
84472575,33,38,17,17,105
84478863,17,3,2,1,23
84483251,65,3,2,1,71
84490690,94,3,2,3,102
84503386,76,59,78,17,230
84516150,111,13,50,8,182
84517339,130,3,2,1,136
84523056,37,20,2,1,60
84525096,42,4,19,1,66
84530375,32,3,2,1,38
84537088,19,15,4,13,51
84539911,34,41,3,4,82
84579296,62,19,30,5,116
84587955,39,4,3,5,51
84614402,11,3,2,1,17
84618218,183,22,5,11,221
84620472,22,5,2,1,30
84625160,86,3,2,3,94
84640601,67,65,46,1,179
84652467,121,3,2,5,131
84658927,46,48,2,1,97
84661745,88,48,53,7,196
84674989,64,54,31,27,176
84683802,43,47,3,28,121
84689276,47,4,4,1,56
84695446,34,13,3,1,51
84708829,266,34,2,19,321
84734222,31,4,2,1,38
84735695,51,36,8,1,96
84739744,42,15,10,1,68
84763234,79,47,47,12,185
84765407,50,3,2,2,57
84775022,52,3,2,1,58
84775585,56,39,2,23,120
84778194,61,17,2,1,81
84786229,94,26,3,1,124
84787178,39,10,20,3,72
84805233,11,3,2,2,18
84817219,30,10,2,1,43
84848302,11,3,2,1,17
84863969,18,4,2,1,25
84869522,44,36,2,15,97
84874922,58,5,2,8,73
84891019,10,8,2,1,21
84913672,17,5,2,2,26
84918865,70,3,2,20,95
84925683,63,3,2,1,69
84925744,17,3,2,1,23
84929153,135,54,3,2,194
84938790,118,13,2,1,134
84944544,49,27,31,1,108
84946162,35,17,2,1,55
84954191,115,15,2,1,133
84954675,80,22,3,5,110
84960676,25,20,2,1,48
84961838,11,3,2,1,17
84971165,80,35,2,1,118
84976092,14,3,2,1,20
84988587,11,3,2,1,17
84995242,50,14,11,7,82
84996831,74,16,70,1,161
85001878,123,11,26,1,161
85005038,29,3,2,1,35
85010972,189,12,7,2,210
85020849,37,3,2,1,43
85025606,199,3,2,6,210
85036264,10,21,2,1,34
85045048,11,3,2,12,28
85045748,81,7,5,9,102
85051178,33,9,2,7,51
85056733,24,25,2,1,52
85059228,43,22,4,5,74
85069449,167,3,2,1,173
85084379,10,3,2,5,20
85098928,13,3,2,5,23
85099734,94,3,2,2,101
85101327,11,4,3,1,19
85108535,77,25,10,6,118
85109520,32,28,7,1,68
85136943,60,51,2,6,119
85138670,23,18,2,3,46
85145409,26,41,11,1,79
85149576,19,8,6,1,34
85167020,70,6,29,25,130
85174315,103,8,2,1,114
85177030,181,3,2,1,187
85188100,87,8,6,4,105
85189974,183,19,78,10,290
85198449,84,38,79,8,209
85198577,151,32,60,54,297
85205318,64,33,20,1,118
85215624,10,5,2,1,18
85219889,10,42,2,1,55
85224061,152,31,65,30,278
85241642,51,16,2,5,74
85258234,53,6,2,1,62
85274762,91,13,2,1,107
85275739,49,9,2,2,62
85291787,47,3,2,1,53
85307522,12,26,2,11,51
85319856,73,3,2,1,79
85340721,119,25,69,1,214
85358978,51,31,11,9,102
85359726,40,3,10,1,54
85372453,44,3,2,1,50
85380528,10,31,2,1,44
85397866,42,26,49,1,118
85421366,32,60,6,4,102
85422582,33,35,10,2,80
85434536,39,10,2,1,52
85434655,43,21,18,29,111
85462157,29,38,7,2,76
85471727,10,3,2,3,18
85475514,116,19,51,16,202
85482646,12,12,4,2,30
85490060,32,29,34,2,97
85493890,59,38,2,5,104
85499154,132,22,111,10,275
85515698,24,59,22,2,107
85525339,73,53,20,113,259
85528361,55,55,50,12,172
85536988,21,10,2,1,34
85542730,11,3,2,1,17
85556237,341,94,2,3,440
85569311,13,3,2,1,19
85575015,18,29,24,1,72
85577506,40,25,2,3,70
85577949,20,3,2,1,26
85579655,116,7,109,5,237
85583802,42,15,2,2,61
85593128,68,3,2,2,75
85603377,59,33,6,1,99
85620430,91,23,2,1,117
85626567,22,57,4,1,84
85627070,34,35,6,1,76
85636164,19,14,2,1,36
85646431,59,5,6,1,71
85647692,181,57,26,1,265
85647869,16,3,2,1,22
85661581,200,7,2,4,213
85680892,73,3,2,1,79
85683329,102,3,2,1,108
85684945,110,3,2,2,117
85696687,132,19,2,1,154
85702335,39,44,2,10,95
85702761,66,3,2,3,74
85707664,56,10,8,1,75
85710723,23,27,17,2,69
85711149,54,7,27,9,97
85720237,41,3,2,1,47
85724028,93,27,12,3,135
85726723,19,9,3,1,32
85752738,45,36,34,8,123
85763838,134,24,4,21,183
85776415,82,11,13,3,109
85782528,29,35,14,1,79
85789491,105,31,8,3,147
85822388,110,8,2,1,121
85826945,108,47,49,22,226
85827986,11,3,2,1,17
85836443,12,3,2,1,18
85836698,241,27,41,5,314
85848832,75,60,2,1,138
85858870,34,51,3,12,100
85890334,121,3,2,1,127
85891750,92,23,5,12,132
85897025,80,21,2,1,104
85899716,14,3,2,1,20
85906313,85,7,31,2,125
85907220,215,3,2,6,226
85917580,104,25,32,25,186
85919508,250,3,2,3,258
85933016,71,41,8,12,132
85957889,69,27,6,16,118
85965721,17,8,2,1,28
85971791,56,3,2,6,67
85975198,14,3,2,6,25
85980380,62,43,29,39,173
85980537,98,5,2,3,108
85981389,56,3,2,50,111
86007294,19,44,43,5,111
86008106,12,3,2,1,18
86013704,36,39,9,3,87
86014561,47,27,2,5,81
86020123,58,48,47,10,163
86035329,18,11,2,4,35
86046408,62,46,30,1,139
86046809,44,3,2,3,52
86051465,95,3,2,4,104
86051722,54,55,2,5,116
86055927,97,14,2,1,114
86064134,12,6,2,1,21
86073719,36,42,2,3,83
86074389,71,79,2,1,153
86084074,91,22,30,71,214
86095935,49,3,2,2,56
86097050,22,4,2,5,33
86117630,38,15,2,7,62
86128287,15,3,2,1,21
86142331,41,11,2,1,55
86160174,12,3,2,1,18
86170007,95,9,6,1,111
86172115,43,3,2,1,49
86178049,54,46,4,12,116
86191230,64,14,3,8,89
86193514,78,38,62,18,196
86201495,84,25,52,3,164
86205404,111,3,2,1,117
86225414,35,75,2,21,133
86228285,93,70,106,52,321
86233174,37,3,2,1,43
86240756,62,3,2,4,71
86241385,11,3,2,1,17
86242314,11,3,2,1,17
86259460,10,11,2,4,27
86271777,37,3,2,2,44
86294773,71,34,3,1,109
86295055,25,10,6,21,62
86295582,250,52,2,13,317
86303860,50,3,2,1,56
86306626,57,45,17,2,121
86316654,51,51,2,1,105
86321586,60,3,2,7,72
86325812,10,14,2,1,27
86330161,93,25,12,3,133
86334023,16,3,2,1,22
86336191,10,3,2,3,18
86343714,81,18,12,9,120
86383886,21,3,2,1,27
86386339,36,5,3,1,45
86416742,66,20,24,2,112
86439572,80,23,2,24,129
86478653,35,17,2,3,57
86503700,83,3,2,1,89
86512385,67,10,2,1,80
86531246,10,7,2,1,20
86540714,58,3,2,3,66
86544819,13,3,2,1,19
86551830,77,12,2,20,111
86562895,226,14,2,45,287
86577771,108,19,2,1,130
86578401,146,26,56,58,286
86600919,21,31,13,3,68
86601215,148,3,2,3,156
86617704,60,23,32,14,129
86620355,99,59,11,18,187
86621254,34,9,16,1,60
86632208,152,6,2,1,161
86646178,95,23,2,1,121
86656521,58,52,25,1,136
86658469,50,21,47,6,124
86672372,23,76,41,1,141
86679001,47,3,2,2,54
86686297,79,23,15,62,179
86714700,73,23,4,9,109
86724361,104,24,36,5,169
86732079,52,18,5,1,76
86740511,161,59,2,10,232
86746678,140,3,2,3,148
86749204,17,3,2,1,23
86757232,26,3,2,5,36
86762257,56,3,14,1,74
86765237,27,45,2,3,77
86789693,33,21,61,1,116
86810094,18,35,7,1,61
86816540,25,15,15,1,56
86827180,384,3,2,8,397
86831717,58,121,2,1,182
86845567,71,44,4,27,146
86855737,11,3,2,2,18
86856664,12,3,2,1,18
86872232,12,31,2,12,57
86879532,113,21,28,12,174
86885322,46,57,2,3,108
86889727,190,13,8,10,221
86896875,82,27,44,24,177
86898776,81,8,2,1,92
86900184,52,33,37,1,123
86900340,55,38,11,41,145
86907753,76,3,2,1,82
86909925,53,25,14,2,94
86916657,24,3,2,1,30
86921600,184,33,6,1,224
86926204,123,3,2,1,129
86941280,21,20,2,1,44
86950399,11,3,2,1,17
86997063,81,16,38,12,147
86998601,14,4,2,1,21
87017376,56,93,20,28,197
87018114,142,26,3,1,172
87022727,172,26,3,3,204
87043990,64,8,2,1,75
87068992,40,30,2,1,73
87079492,41,56,64,25,186
87079635,27,9,2,9,47
87081797,37,33,32,1,103
87081864,26,3,2,1,32
87082877,161,3,2,11,177
87084576,23,19,3,1,46
87107954,38,6,2,16,62
87116128,43,54,2,43,142
87117572,92,6,2,6,106
87126353,60,6,2,3,71
87137100,16,4,2,2,24
87155032,55,65,10,19,149
87169724,83,31,2,9,125
87175802,11,7,2,1,21
87190751,16,3,2,1,22
87193071,35,3,2,1,41
87201248,115,31,50,21,217
87203712,105,9,9,11,134
87204046,45,31,27,22,125
87241863,62,97,34,12,205
87244092,26,3,2,3,34
87250140,32,8,2,3,45
87251760,72,3,2,1,78
87254324,58,21,2,38,119
87259814,62,4,2,1,69
87278418,30,32,25,1,88
87288274,18,3,2,5,28
87297539,12,3,2,2,19
87297943,150,11,2,5,168
87301494,13,6,12,2,33
87305865,50,9,43,1,103
87326232,188,20,38,6,252
87329417,23,21,2,4,50
87330855,181,29,2,13,225
87339927,24,3,2,1,30
87357736,99,3,2,3,107
87361627,14,3,2,1,20
87365152,60,17,36,3,116
87386191,13,3,2,1,19
87387757,66,25,2,26,119
87392806,33,44,16,1,94
87401970,197,66,28,14,305
87402762,61,34,3,2,100
87409071,70,36,8,12,126
87415794,87,22,2,8,119
87419739,42,28,2,1,73
87428559,46,96,21,3,166
87434634,48,3,2,7,60
87441426,152,37,27,17,233
87446103,15,6,2,1,24
87447418,81,3,2,1,87
87457402,29,10,2,2,43
87458752,10,4,2,1,17
87468491,73,89,3,29,194
87469185,74,3,2,1,80
87469631,144,24,2,1,171
87487965,221,4,2,2,229
87492050,87,17,8,2,114
87493375,40,34,9,1,84
87521757,22,16,55,4,97
87529303,56,13,36,2,107
87551482,36,16,19,8,79
87553945,68,11,4,19,102
87554805,100,61,2,1,164
87589620,10,3,3,1,17
87595095,71,3,2,14,90
87616426,16,9,2,1,28
87626547,149,13,97,4,263
87631704,26,3,2,1,32
87652314,31,3,2,1,37
87695905,50,43,9,6,108
87701243,17,17,2,1,37
87707750,12,3,2,1,18
87708585,97,5,2,18,122
87734014,50,34,37,10,131
87742776,16,17,8,3,44
87749091,49,24,57,1,131
87754162,36,43,53,10,142
87755303,47,31,9,2,89
87757614,119,32,61,9,221
87783455,45,20,2,1,68
87790239,127,3,2,6,138
87792788,96,28,4,10,138
87801276,85,31,2,6,124
87803606,85,18,2,1,106
87804694,99,3,2,3,107
87806318,155,20,52,19,246
87823989,22,9,2,2,35
87837153,90,15,2,2,109
87841360,70,26,7,20,123
87879038,99,12,50,1,162
87886264,39,72,12,1,124
87890100,116,3,3,1,123
87903002,117,21,7,3,148
87907301,59,53,43,13,168
87908197,11,3,2,1,17
87911309,78,13,44,1,136
87924011,24,18,4,3,49
87929896,93,66,52,114,325
87934521,11,3,2,1,17
87942191,13,15,2,2,32
87942764,31,12,2,7,52
87946959,157,10,5,23,195
87948262,10,12,4,1,27
87949847,66,4,39,1,110
87979485,50,13,4,1,68
88006586,171,8,2,6,187
88017593,101,3,20,4,128
88017923,13,3,2,3,21
88030052,186,78,6,105,375
88030604,10,18,2,1,31
88032471,50,22,2,3,77
88033257,42,18,2,5,67
88035041,48,34,3,3,88
88047112,20,69,10,8,107
88052928,10,3,2,3,18
88071101,11,3,2,1,17
88080726,169,96,2,2,269
88101414,34,20,2,5,61
88104683,27,3,2,1,33
88105241,46,3,11,1,61
88117507,54,19,68,5,146
88118461,11,3,2,1,17
88122821,126,3,2,1,132
88123424,42,3,2,1,48
88137331,38,42,3,2,85
88146165,58,9,3,2,72
88183202,12,3,2,1,18
88195906,50,3,2,1,56
88209978,112,3,2,1,118
88227859,71,20,2,2,95
88236563,67,3,2,3,75
88247789,240,52,20,1,313
88256490,46,19,2,1,68
88257887,54,110,10,8,182
88264948,70,44,2,1,117
88268240,29,3,8,2,42
88271484,144,3,2,1,150
88277702,10,50,2,4,66
88281067,23,3,2,4,32
88285657,63,6,21,20,110
88294056,41,75,2,2,120
88316429,51,10,2,2,65
88327866,21,11,2,1,35
88331606,56,83,26,10,175
88338328,17,3,2,1,23
88354593,69,10,50,1,130
88363095,96,16,2,4,118
88363409,11,3,2,1,17
88374411,54,3,2,2,61
88389732,76,8,21,21,126
88400259,69,8,2,51,130
88406657,56,3,2,1,62
88431045,13,5,2,1,21
88433485,77,3,2,5,87
88434440,71,12,2,13,98
88436828,13,3,2,1,19
88442826,31,13,2,1,47
88443859,13,7,2,1,23
88456091,111,3,13,9,136
88457246,170,6,36,22,234
88457491,20,3,2,1,26
88458257,25,3,2,1,31
88480526,61,21,2,12,96
88483464,83,23,9,6,121
88492371,113,6,2,8,129
88504747,46,3,2,8,59
88507564,87,4,7,4,102
88515433,38,3,2,18,61
88519744,13,15,7,1,36
88527659,10,3,2,5,20
88530216,13,4,2,1,20
88537586,64,3,2,1,70
88538520,30,9,2,15,56
88542653,13,4,2,1,20
88550592,141,3,2,63,209
88551705,12,3,2,1,18
88560145,54,25,14,3,96
88566139,16,11,2,2,31
88579193,17,5,2,1,25
88586718,43,3,2,1,49
88607237,13,10,2,4,29
88620149,78,35,59,17,189
88627202,57,40,32,1,130
88640752,65,6,2,1,74
88652889,22,3,2,5,32
88662995,47,5,40,8,100
88670283,604,4,6,28,642
88697181,50,9,2,1,62
88701432,60,4,2,1,67
88701980,109,36,10,16,171
88705433,67,6,2,1,76
88726295,107,11,2,3,123
88730096,153,20,30,3,206
88734135,32,22,7,1,62
88734445,58,54,4,22,138
88741620,268,3,2,18,291
88756372,81,36,58,2,177
88757210,125,21,11,5,162
88763549,17,16,2,1,36
88765605,52,22,15,22,111
88769501,79,24,2,7,112
88786305,59,19,2,9,89
88793528,13,13,2,1,29
88810399,96,20,5,7,128
88824093,10,11,2,1,24
88846767,38,4,5,1,48
88849987,14,88,3,1,106
88863315,13,4,2,4,23
88877909,59,44,64,16,183
88887202,52,52,2,1,107
88889073,162,149,58,3,372
88893949,93,15,7,1,116
88901586,41,3,2,1,47
88904767,17,3,2,1,23
88910682,113,19,2,1,135
88919311,26,29,2,3,60
88920639,112,10,2,1,125
88929391,81,22,17,14,134
88929574,104,3,2,4,113
88933457,97,12,18,2,129
88943026,20,36,5,3,64
88955738,43,33,43,4,123
88955833,18,14,2,2,36
88960362,26,3,2,5,36
88966264,15,19,2,1,37
88969963,83,3,37,12,135
88970938,27,3,2,1,33
88975220,41,50,53,1,145
88984337,27,3,2,1,33
88989153,79,3,2,2,86
88989412,20,30,2,2,54
89013844,29,21,4,3,57
89017361,25,29,2,11,67
89054561,40,37,3,3,83
89059731,32,40,42,5,119
89074191,65,26,16,11,118
89083850,114,12,100,1,227
89087393,19,3,2,6,30
89088746,68,28,2,9,107
89095769,41,21,8,27,97
89111820,53,67,17,18,155
89127937,16,17,2,1,36
89138301,104,8,27,7,146
89140966,134,16,3,1,154
89144154,63,12,20,1,96
89165917,12,3,2,1,18
89183816,41,17,3,1,62
89186849,116,37,99,21,273
89189721,75,17,2,1,95
89192762,71,3,2,6,82
89193820,13,3,2,1,19
89195730,21,3,2,1,27
89198085,148,3,2,21,174
89224205,32,19,5,2,58
89234231,65,3,2,29,99
89234408,89,31,28,2,150
89235408,10,3,2,3,18
89247409,23,38,18,12,91
89257843,82,30,16,2,130
89262045,48,3,2,1,54
89265998,148,39,14,3,204
89269821,11,37,2,3,53
89292127,99,70,14,1,184
89306119,11,10,2,1,24
89318772,214,3,2,4,223
89335900,58,3,2,3,66
89336474,21,3,2,1,27
89351060,77,4,27,11,119
89364540,26,4,2,1,33
89388154,31,58,21,2,112
89390891,116,3,3,1,123
89391484,12,6,2,1,21
89399909,19,47,4,3,73
89412994,59,23,38,46,166
89414638,203,3,2,11,219
89426461,67,48,65,4,184
89426999,110,13,2,2,127
89429950,11,4,2,1,18
89434688,44,23,13,5,85
89437768,29,3,2,11,45
89439114,21,18,2,6,47
89440389,96,3,2,2,103
89446337,60,3,2,1,66
89446995,32,55,32,39,158
89447683,38,3,4,1,46
89450281,18,7,2,1,28
89457258,65,17,3,1,86
89463686,53,20,94,12,179
89478910,26,9,2,2,39
89485816,54,33,2,6,95
89495619,22,11,2,2,37
89497581,96,79,50,33,258
89497616,70,13,31,4,118
89499814,162,26,2,1,191
89519945,77,3,2,3,85
89523233,16,3,2,1,22
89538009,117,80,26,2,225
89543087,70,75,10,32,187
89552970,79,47,11,1,138
89561033,14,3,2,1,20
89563227,102,3,2,10,117
89576143,139,3,2,1,145
89578060,91,3,2,1,97
89579329,60,3,2,1,66
89579579,24,50,17,6,97
89585908,13,3,2,1,19
89588638,19,10,2,7,38
89591479,171,3,2,7,183
89599820,92,11,2,2,107
89599892,50,4,2,7,63
89608523,95,11,2,4,112
89616802,211,18,52,1,282
89619491,68,5,2,2,77
89643160,47,3,2,1,53
89644547,13,3,2,2,20
89644856,11,5,2,1,19
89653587,215,5,10,9,239
89654912,69,3,2,1,75
89661557,14,3,2,2,21
89662044,18,4,2,1,25
89667438,43,3,2,1,49
89675577,11,5,2,1,19
89677012,16,3,2,1,22
89686203,13,81,2,1,97
89711639,153,60,24,4,241
89713462,20,3,9,1,33
89717583,47,79,22,8,156
89717926,188,5,2,1,196
89720880,82,26,27,6,141
89726239,30,5,2,3,40
89730026,12,3,2,1,18
89736104,27,15,2,26,70
89738434,53,3,2,2,60
89740184,16,3,2,3,24
89751557,13,3,2,1,19
89754779,18,16,2,1,37
89757388,92,25,3,5,125
89772886,90,9,5,1,105
89789396,36,14,30,4,84
89793131,38,66,3,4,111
89799732,48,11,3,1,63
89802339,17,20,3,2,42
89819170,14,3,2,1,20
89820785,110,43,20,57,230
89832819,63,28,57,22,170
89838957,38,3,2,1,44
89854268,18,3,2,1,24
89878406,17,5,2,1,25
89879944,88,14,2,1,105
89889608,77,25,20,11,133
89892415,12,3,2,2,19
89906184,92,3,2,12,109
89912869,57,8,2,23,90
89929435,135,8,18,2,163
89935711,63,26,74,22,185
89944895,187,35,87,11,320
89946879,89,14,2,20,125
89958603,387,3,2,12,404
89962692,48,33,35,22,138
89964542,36,4,10,1,51
89988341,29,9,2,9,49
90007532,121,7,3,8,139
90009587,52,17,13,1,83
90021548,50,30,6,1,87
90033824,52,14,2,1,69
90053769,10,3,2,2,17
90074444,87,3,2,3,95
90074726,11,3,2,1,17
90075961,12,3,2,1,18
90078264,110,33,26,5,174
90116617,61,7,2,1,71
90120796,41,3,26,9,79
90125823,34,12,2,11,59
90126453,11,3,2,1,17
90132244,89,3,2,10,104
90142419,36,56,37,4,133
90164040,18,15,9,4,46
90171123,59,20,2,1,82
90178512,10,13,3,1,27
90188915,56,36,40,9,141
90202644,29,3,2,1,35
90202900,72,137,25,5,239
90209370,217,61,2,44,324
90214417,165,3,2,10,180
90222501,66,14,39,101,220
90224450,49,3,2,1,55
90231494,15,9,2,1,27
90232893,17,19,2,1,39
90247794,83,4,59,40,186
90249341,66,3,2,1,72
90268533,140,3,2,19,164
90271721,35,3,2,8,48
90272252,47,28,12,7,94
90274241,57,11,2,2,72
90279860,22,50,2,2,76
90281314,57,53,3,1,114
90288432,457,3,2,4,466
90309556,113,91,2,1,207
90311679,68,3,2,3,76
90311830,47,14,2,1,64
90314773,39,21,3,14,77
90319729,21,18,10,19,68
90321052,25,24,20,3,72
90321990,126,3,2,69,200
90328713,22,63,23,8,116
90350630,66,13,19,1,99
90360560,118,59,19,31,227
90373907,24,14,73,1,112
90397971,128,15,35,2,180
90411984,11,3,2,1,17
90423717,32,3,3,11,49
90426815,34,12,2,1,49
90429496,12,3,2,1,18
90439398,91,16,111,3,221
90446364,34,3,2,1,40
90469256,22,3,2,2,29
90476867,44,26,4,2,76
90496405,217,12,51,21,301
90505356,52,28,2,20,102
90508001,44,3,2,1,50
90527899,19,4,2,1,26
90543010,31,17,2,2,52
90543360,14,3,2,1,20
90557579,64,10,2,31,107
90562846,221,3,19,1,244
90563459,95,20,2,3,120
90588077,82,3,2,1,88
90617228,35,3,2,1,41
90620075,58,3,2,1,64
90622524,29,26,16,7,78
90626451,79,45,6,26,156
90628634,83,20,4,17,124
90642081,84,4,2,11,101
90644283,19,9,9,13,50
90647350,43,9,2,3,57
90658944,79,23,71,25,198
90664981,128,3,2,1,134
90690700,90,3,2,1,96
90697556,20,15,2,1,38
90701265,109,3,2,10,124
90701404,212,61,15,22,310
90718354,124,10,17,16,167
90726785,30,35,4,4,73
90730402,17,3,2,1,23
90741726,106,3,2,1,112
90748237,66,17,3,3,89
90749839,11,7,2,1,21
90757388,86,3,2,1,92
90758102,25,9,2,11,47
90785016,32,14,22,9,77
90792972,21,5,2,1,29
90793142,54,3,2,2,61
90795699,116,9,5,21,151
90811165,70,43,2,33,148
90821061,175,39,5,14,233
90825854,24,59,2,1,86
90846168,24,3,2,1,30
90857476,10,3,2,2,17
90895627,42,3,2,1,48
90900371,25,4,2,4,35
90911735,56,21,96,3,176
90914302,225,43,105,1,374
90915244,119,37,2,1,159
90925337,140,55,63,45,303
90930163,84,14,2,8,108
90933209,10,5,2,1,18
90951842,32,22,3,1,58
90958308,115,25,28,47,215
90978638,132,34,12,80,258
90980075,33,33,2,1,69
90983332,35,20,25,9,89
90990186,71,10,2,1,84
90990383,43,3,2,2,50
91010475,92,14,2,1,109
91011793,78,7,71,1,157
91017897,34,14,2,1,51
91018074,30,77,2,1,110
91020989,25,16,28,1,70
91024087,124,52,82,2,260
91039738,76,7,12,1,96
91047708,17,4,2,1,24
91053719,47,14,79,1,141
91056323,46,28,36,1,111
91062721,17,12,2,3,34
91065142,84,8,2,17,111
91070737,201,4,2,1,208
91089263,22,16,2,6,46
91094951,43,10,11,2,66
91099555,126,74,23,11,234
91111425,10,25,2,1,38
91116770,59,4,2,4,69
91147577,64,18,44,33,159
91149491,76,22,50,1,149
91170108,31,7,5,6,49
91180496,12,9,2,2,25
91183646,10,8,2,1,21
91194326,28,3,2,1,34
91196225,74,24,3,45,146
91214573,159,3,2,1,165
91216306,62,12,9,7,90
91229977,50,21,5,8,84
91232708,46,13,20,5,84
91243380,58,46,46,13,163
91277655,330,3,2,7,342
91280886,73,3,2,16,94
91291701,27,38,2,1,68
91298662,106,9,2,2,119
91299729,22,3,2,1,28
91303492,12,3,2,1,18
91304280,135,3,2,3,143
91314699,24,22,31,5,82
91331475,45,93,2,1,141
91331917,70,53,8,41,172
91334933,83,17,12,9,121
91335104,17,3,2,1,23
91338057,10,11,2,1,24
91339844,117,27,14,1,159
91348967,19,47,18,12,96
91361672,52,37,7,6,102
91367529,33,10,32,20,95
91372055,97,39,14,2,152
91388376,11,3,2,1,17
91400859,20,15,5,4,44
91408656,78,3,2,1,84
91416534,177,4,2,6,189
91423129,53,23,83,4,163
91446994,11,3,2,1,17
91449320,75,18,18,43,154
91465906,46,40,16,22,124
91466018,105,3,2,17,127
91475527,80,3,2,1,86
91476169,47,20,52,7,126
91478234,52,3,2,4,61
91494484,16,24,4,34,78
91499168,63,44,26,2,135
91503847,10,3,2,2,17
91508033,59,28,18,2,107
91511270,166,17,6,10,199
91513235,28,3,2,1,34
91517680,53,23,35,26,137
91518641,94,3,2,10,109
91519035,112,22,34,12,180
91520872,12,26,11,16,65
91535004,95,22,6,34,157
91545528,42,74,44,8,168
91547014,55,3,2,2,62
91553689,73,14,3,7,97
91572142,109,17,5,4,135
91575049,12,11,2,1,26
91591063,66,3,38,1,108
91596224,13,33,3,3,52
91597105,69,3,2,1,75
91610637,44,3,2,5,54
91624064,212,9,4,4,229
91635403,11,13,2,1,27
91639037,23,3,2,1,29
91644997,77,3,2,1,83
91654300,35,28,30,28,121
91669019,101,13,6,6,126
91677966,58,3,2,1,64
91678770,158,3,2,4,167
91686252,54,37,2,2,95
91686911,85,24,99,7,215
91687944,23,27,3,5,58
91688610,37,29,2,4,72
91690650,41,3,2,2,48
91697971,22,5,4,5,36
91706595,100,56,71,4,231
91738269,111,24,30,1,166
91771055,39,3,2,17,61
91780339,89,13,2,2,106
91791522,47,103,34,1,185
91798059,16,16,18,2,52
91802937,13,9,2,9,33
91811014,11,3,2,1,17
91819387,172,3,2,1,178
91827440,23,3,2,1,29
91828504,50,51,3,7,111
91838513,65,3,2,1,71
91848427,35,30,3,3,71
91855635,45,75,8,11,139
91860462,55,75,67,22,219
91869997,16,3,2,1,22
91872524,56,64,56,8,184
91882485,78,24,8,9,119
91892640,49,43,2,7,101
91897787,74,49,18,31,172
91899441,28,9,2,1,40
91909650,18,54,2,1,75
91915927,50,3,2,2,57
91935915,96,32,5,1,134
91952328,17,32,2,6,57
91954249,54,3,2,1,60
91961349,12,14,2,4,32
91973035,32,18,3,3,56
91985430,67,18,16,8,109
91988302,45,55,2,1,103
91989497,119,3,3,3,128
91994976,31,39,24,5,99
92000220,10,8,2,1,21
92002840,48,3,2,1,54
92007674,90,3,2,4,99
92029132,27,34,11,1,73
92044322,17,38,3,1,59
92056782,72,21,2,1,96
92064870,88,8,10,14,120
92072522,23,3,2,1,29
92072740,13,3,2,1,19
92081528,25,28,2,3,58
92098578,15,3,2,1,21
92106952,66,3,2,5,76
92114698,48,21,43,5,117
92124677,11,3,2,1,17
92140703,47,56,5,12,120
92153711,79,25,38,4,146
92155797,16,36,30,5,87
92164049,35,41,29,26,131
92188777,16,3,2,1,22
92197766,79,48,31,5,163
92199897,47,24,6,4,81
92242285,100,3,2,1,106
92266124,76,16,68,1,161
92269431,11,3,2,11,27
92270612,30,3,2,1,36
92278074,13,3,2,1,19
92282306,13,16,2,1,32
92286770,44,9,9,2,64
92292712,47,16,4,7,74
92297490,83,15,3,4,105
92301961,350,60,9,2,421
92321240,95,9,6,1,111
92327271,102,27,52,2,183
92345649,88,3,2,1,94
92356178,14,16,2,1,33
92359905,80,91,16,11,198
92377063,10,6,2,1,19
92392639,10,17,2,1,30
92401500,36,31,2,1,70
92404870,45,73,18,4,140
92411331,122,33,2,1,158
92412839,30,3,2,1,36
92417637,44,3,2,2,51
92420813,138,15,2,3,158
92442155,119,3,2,8,132
92453505,13,9,2,1,25
92462235,11,3,2,1,17
92476877,83,66,74,79,302
92478039,37,33,8,3,81
92478884,104,14,29,59,206
92497626,126,3,2,2,133
92516486,52,41,21,9,123
92522012,65,40,4,8,117
92533721,89,3,2,5,99
92536846,16,12,2,1,31
92536881,11,3,2,1,17
92541791,10,6,2,2,20
92550615,52,3,2,1,58
92568370,35,17,2,1,55
92574419,96,19,3,3,121
92585612,47,19,22,1,89
92592123,21,3,2,19,45
92602148,15,3,2,1,21
92606664,27,3,2,3,35
92634929,56,3,2,2,63
92653884,40,26,14,2,82
92686368,91,27,14,3,135
92689772,33,21,3,4,61
92692180,12,16,2,1,31
92707092,23,9,2,1,35
92707413,14,9,2,18,43
92719937,73,3,2,1,79
92725930,11,3,2,8,24
92731501,64,3,2,3,72
92739674,45,21,5,2,73
92749578,47,12,30,15,104
92750267,152,76,61,1,290
92754627,90,3,2,1,96
92757477,30,3,2,1,36
92763738,108,11,2,2,123
92772554,51,5,25,4,85
92779757,23,16,2,4,45
92788427,195,3,2,1,201
92789789,23,3,2,2,30
92790533,84,3,2,5,94
92802966,37,3,2,1,43
92827027,21,4,2,1,28
92831697,12,3,2,3,20
92840114,52,31,70,11,164
92855196,10,3,2,2,17
92855608,46,3,2,1,52
92863575,167,27,25,7,226
92868639,29,3,2,1,35
92893358,34,3,18,1,56
92898608,41,3,3,5,52
92967772,57,3,11,11,82
92972433,28,86,47,16,177
92990177,68,29,2,4,103
93004971,12,3,2,1,18
93030270,85,18,19,9,131
93044522,16,13,2,2,33
93057956,81,64,7,53,205
93078052,19,22,2,1,44
93078864,50,76,3,15,144
93079518,16,3,2,10,31
93085012,28,3,2,5,38
93095494,216,182,5,22,425
93096572,202,22,2,5,231
93101025,61,18,12,83,174
93103703,23,11,36,1,71
93106528,66,5,44,1,116
93128142,36,15,44,7,102
93135844,116,57,21,7,201
93149518,20,3,2,4,29
93166524,34,20,6,10,70
93173814,140,9,2,7,158
93178514,11,3,2,1,17
93229856,10,28,3,1,42
93231042,196,3,51,3,253
93231814,63,62,44,5,174
93232565,12,3,2,1,18
93233943,17,13,2,13,45
93241391,133,30,11,9,183
93242414,18,37,13,3,71
93242604,57,38,25,13,133
93247102,16,5,2,1,24
93248822,81,32,33,10,156
93259329,43,6,2,13,64
93261346,31,22,22,10,85
93262749,74,19,2,1,96
93264456,60,13,6,10,89
93269738,34,4,2,1,41
93270174,55,12,71,26,164
93275029,168,42,2,16,228
93281942,27,18,2,20,67
93282350,55,78,55,65,253
93290532,24,9,2,12,47
93321720,11,3,2,1,17
93339100,234,3,2,1,240
93343066,21,3,2,3,29
93347468,35,26,24,9,94
93348347,32,8,5,13,58
93350884,41,59,2,1,103
93352564,105,26,19,14,164
93361863,10,18,2,1,31
93369923,99,3,2,1,105
93393005,50,9,2,10,71
93401656,44,39,4,41,128
93406641,12,24,2,2,40
93413245,186,79,69,55,389
93416943,32,16,2,1,51
93440104,105,30,6,9,150
93450935,121,49,2,1,173
93468011,61,3,2,1,67
93483334,105,3,2,8,118
93483781,91,15,2,7,115
93490393,30,51,5,2,88
93493174,121,3,2,1,127
93494372,13,14,3,1,31
93504367,801,3,2,3,809
93528849,54,7,6,6,73
93533065,140,29,3,1,173
93538686,28,55,26,1,110
93539057,109,23,5,47,184
93547191,88,142,75,41,346
93556953,54,14,32,10,110
93567222,40,5,16,1,62
93570293,108,12,2,6,128
93572851,48,3,2,1,54
93581693,21,3,2,3,29
93582936,26,7,17,1,51
93597119,119,48,9,14,190
93600215,72,40,3,4,119
93604460,74,62,29,30,195
93606833,18,16,2,1,37
93608544,52,3,3,1,59
93624291,166,21,58,19,264
93632028,52,16,2,1,71
93643757,33,3,2,1,39
93657485,10,3,2,2,17
93659301,71,29,28,5,133
93659323,10,12,2,1,25
93670124,26,9,20,1,56
93683694,11,3,2,1,17
93691989,33,17,2,9,61
93696336,182,30,10,2,224
93716123,28,7,4,1,40
93716726,71,3,2,2,78
93717179,71,7,2,1,81
93727942,52,17,6,4,79
93728737,148,3,2,1,154
93735852,49,41,13,16,119
93738291,97,62,38,12,209
93749856,62,27,4,16,109
93774388,16,6,2,1,25
93775091,27,36,4,7,74
93776616,34,67,22,5,128
93783317,107,29,28,9,173
93788313,66,3,2,1,72
93808924,59,33,6,5,103
93808951,32,3,2,1,38
93812157,124,5,4,1,134
93822279,131,27,40,14,212
93835369,11,37,2,1,51
93849155,14,23,2,1,40
93857463,31,35,2,1,69
93871898,29,31,22,44,126
93881956,62,22,2,4,90
93893579,47,3,2,1,53
93919038,155,8,2,1,166
93926526,102,31,3,1,137
93926741,38,13,2,18,71
93936831,105,24,2,3,134
93944069,66,9,10,12,97
93953464,58,3,2,9,72
93978130,105,7,2,2,116
93978264,85,50,21,17,173
93984513,60,104,25,9,198
93988542,43,64,11,12,130
94004699,348,3,2,3,356
94019241,45,44,63,13,165
94025833,11,3,2,1,17
94031586,86,3,3,8,100
94057532,58,29,15,12,114
94058090,24,10,3,1,38
94061432,12,3,2,1,18
94078871,12,3,2,1,18
94092951,64,21,2,2,89
94108588,10,3,2,3,18
94109611,184,3,2,11,200
94109712,22,3,2,1,28
94128711,149,3,2,1,155
94140451,94,45,2,3,144
94141016,76,8,15,1,100
94145325,28,52,18,25,123
94158711,128,10,6,1,145
94166299,37,9,2,1,49
94170739,111,62,29,15,217
94170862,40,35,3,2,80
94179761,20,33,13,8,74
94185963,11,3,2,1,17
94190257,31,3,2,3,39
94193975,182,8,3,1,194
94197459,17,3,2,1,23
94198031,80,38,10,4,132
94199404,12,3,2,1,18
94199570,39,3,2,2,46
94205003,96,16,2,23,137
94217761,32,3,10,4,49
94261377,52,3,2,1,58
94270418,43,11,3,1,58
94275652,63,41,24,2,130
94277613,32,3,2,1,38
94278785,63,32,39,11,145
94282881,10,15,2,6,33
94289908,319,3,2,4,328
94305083,165,23,2,5,195
94317983,107,8,2,1,118
94321206,13,14,2,1,30
94335872,137,3,3,6,149
94336776,96,3,2,10,111
94338278,32,3,2,5,42
94341922,143,18,75,2,238
94342866,19,4,2,1,26
94352773,67,8,4,1,80
94354326,105,49,63,43,260
94355298,53,3,2,2,60
94376102,20,27,42,32,121
94384512,155,29,26,15,225
94392411,50,32,22,1,105
94404270,19,8,2,1,30
94404651,130,16,2,17,165
94407076,16,3,2,5,26
94407555,13,3,2,1,19
94412712,149,32,23,32,236
94426149,20,16,2,3,41
94429748,10,35,2,1,48
94450263,84,26,23,6,139
94459378,25,3,2,5,35
94463164,66,3,2,7,78
94491075,14,3,2,2,21
94498076,19,3,7,5,34
94500956,100,3,2,1,106
94500998,24,3,2,1,30
94522473,26,17,5,3,51
94541478,58,11,8,3,80
94554582,48,36,9,10,103
94573908,70,123,2,60,255
94576568,10,4,2,1,17
94583486,95,3,2,6,106
94583508,70,3,2,1,76
94589680,54,3,2,6,65
94592536,66,24,32,1,123
94596474,82,3,2,1,88
94614791,94,16,2,26,138
94646383,29,3,2,1,35
94660718,12,69,4,1,86
94662827,266,70,25,23,384
94673053,47,31,2,10,90
94682087,122,19,2,3,146
94697193,72,18,2,10,102
94705108,24,8,2,2,36
94705319,415,3,2,1,421
94705440,38,8,3,1,50
94718062,35,3,2,1,41
94718420,109,63,12,10,194
94725518,11,3,2,1,17
94733820,73,29,15,10,127
94739849,25,3,2,2,32
94760982,12,10,2,4,28
94774770,66,3,2,5,76
94775200,120,50,43,13,226
94786456,14,3,2,1,20
94790213,34,3,2,4,43
94798889,66,10,2,7,85
94809528,46,6,46,5,103
94815469,54,30,18,3,105
94819721,22,3,2,1,28
94822181,111,13,26,3,153
94830688,89,86,28,33,236
94833082,42,17,6,4,69
94846722,58,19,13,1,91
94857064,185,39,8,1,233
94862928,59,80,2,1,142
94871176,61,19,41,1,122
94874549,15,3,18,1,37
94875326,92,5,2,3,102
94915150,142,37,24,3,206
94924452,137,26,2,5,170
94928226,66,3,2,1,72
94956522,59,3,2,4,68
94964347,87,30,14,2,133
94967254,87,3,2,2,94
94974468,14,32,2,4,52
94974638,124,8,2,1,135
94978800,160,15,2,2,179
94981275,297,3,2,6,308
95003978,44,32,18,49,143
95011593,85,3,9,1,98
95030043,43,14,16,18,91
95038006,82,29,64,5,180
95072982,14,3,2,1,20
95083321,45,22,2,17,86
95094396,11,3,2,1,17
95097140,47,3,2,1,53
95104844,11,3,2,1,17
95116131,69,16,7,14,106
95117162,77,6,2,1,86
95132220,83,3,2,3,91
95137083,100,15,2,1,118
95138761,30,32,10,10,82
95140157,58,14,9,2,83
95149278,61,3,2,1,67
95149567,75,10,2,1,88
95156549,27,3,2,1,33
95162899,23,8,2,1,34
95171991,12,5,2,1,20
95184260,61,12,5,23,101
95184778,48,24,2,1,75
95190551,41,3,2,1,47
95194087,15,23,2,1,41
95208803,104,24,2,9,139
95213197,31,9,8,21,69
95222131,67,32,5,20,124
95236734,111,21,15,32,179
95245809,306,3,2,5,316
95246402,93,39,4,4,140
95248002,125,5,2,1,133
95263438,75,28,4,5,112
95302455,17,3,2,1,23
95316824,56,3,2,2,63
95317241,112,35,124,11,282
95320173,32,35,25,1,93
95328925,47,13,2,1,63
95340594,192,3,2,4,201
95341726,15,3,2,2,22
95344086,19,3,2,1,25
95349050,259,56,62,58,435
95359911,50,15,74,1,140
95374935,27,5,5,1,38
95376696,336,53,3,1,393
95380787,50,3,2,2,57
95397506,13,4,2,1,20
95403245,92,15,2,3,112
95412645,19,5,2,4,30
95422770,107,3,2,18,130
95423806,81,48,2,9,140
95439284,16,3,2,1,22
95451158,23,11,2,1,37
95451634,84,3,2,1,90
95460194,94,48,14,10,166
95466126,64,8,39,5,116
95486440,31,7,2,3,43
95503786,69,17,6,27,119
95512300,82,3,2,1,88
95547743,58,3,2,2,65
95549990,46,3,2,2,53
95551977,36,50,3,5,94
95591327,24,21,5,9,59
95614871,150,32,4,1,187
95633181,88,197,75,3,363
95648108,53,7,8,6,74
95650157,18,39,8,1,66
95660676,185,120,2,1,308
95660681,42,3,2,1,48
95662032,27,25,2,3,57
95671003,23,3,2,6,34
95679417,50,3,2,1,56
95682206,10,10,2,1,23
95687510,16,48,4,1,69
95692998,106,3,2,1,112
95693542,161,29,74,4,268
95708342,48,3,2,1,54
95712313,10,4,2,1,17
95721081,11,3,2,1,17
95727345,68,17,20,1,106
95732898,13,3,2,1,19
95735019,91,19,2,3,115
95735308,20,52,13,3,88
95737577,142,34,2,2,180
95758495,10,3,2,4,19
95764261,39,25,2,2,68
95766355,153,5,2,18,178
95781122,174,26,18,4,222
95793499,56,14,30,13,113
95809541,24,13,22,1,60
95813378,122,26,2,19,169
95823317,76,12,23,1,112
95843778,181,17,12,17,227
95844626,23,6,24,10,63
95857332,112,3,2,4,121
95875773,37,17,33,4,91
95878671,62,22,2,1,87
95899669,67,10,2,1,80
95904815,20,3,2,6,31
95913621,15,12,2,2,31
95919667,34,8,2,2,46
95923509,74,58,28,1,161
95924510,42,3,2,5,52
95926751,32,8,3,4,47
95932846,90,20,2,1,113
95952254,79,19,2,13,113
95965992,56,3,2,1,62
95983257,43,3,2,1,49
96008757,61,3,2,1,67
96032362,15,4,2,9,30
96044710,10,94,2,3,109
96048912,65,26,2,1,94
96051750,242,3,2,2,249
96051989,20,11,2,1,34
96061375,44,3,2,2,51
96074744,45,44,26,3,118
96086689,47,3,2,1,53
96093756,165,15,3,5,188
96117076,78,3,2,1,84
96128711,54,40,12,1,107
96131210,148,33,2,2,185
96166142,11,5,2,1,19
96171318,13,7,2,2,24
96173776,42,27,31,1,101
96176614,50,35,3,15,103
96183538,90,23,2,5,120
96197431,171,26,2,10,209
96210724,41,17,2,7,67
96226551,161,3,2,9,175
96231887,47,3,22,1,73
96235873,44,94,2,15,155
96237259,97,3,2,4,106
96239778,46,3,2,2,53
96241221,104,29,71,21,225
96244453,19,3,2,1,25
96260036,84,66,7,1,158
96273578,161,12,4,18,195
96289164,89,3,2,2,96
96298179,27,3,2,1,33
96301122,25,11,2,1,39
96321262,30,3,2,13,48
96326279,27,4,2,1,34
96326662,10,8,2,1,21
96359009,56,42,59,25,182
96366549,130,39,34,25,228
96369100,57,14,30,1,102
96377715,90,46,26,22,184
96377773,28,3,2,1,34
96403624,81,3,2,8,94
96407651,25,37,15,1,78
96408733,16,6,2,1,25
96410147,13,3,2,1,19
96415027,102,3,2,3,110
96422629,39,25,19,1,84
96434428,14,3,2,4,23
96452126,22,3,2,9,36
96461241,121,3,2,1,127
96472208,25,3,2,1,31
96500205,24,3,2,1,30
96505426,126,3,2,1,132
96514256,84,4,35,18,141
96528626,31,24,16,4,75
96534905,108,19,4,35,166
96546588,25,47,2,1,75
96547292,21,12,2,1,36
96574635,144,33,9,9,195
96575680,45,5,6,5,61
96575724,18,3,2,1,24
96578871,55,36,2,9,102
96591028,54,12,32,11,109
96594428,28,58,16,1,103
96599740,73,3,2,4,82
96604412,101,19,16,1,137
96611416,26,49,11,1,87
96611647,19,3,2,1,25
96626897,90,3,2,1,96
96627883,560,3,2,2,567
96654291,94,26,10,1,131
96655376,10,14,2,6,32
96667375,23,3,2,1,29
96667392,106,3,2,1,112
96669880,71,3,2,1,77
96673675,22,3,2,1,28
96679129,34,17,2,1,54
96704230,10,6,2,1,19
96716886,16,3,2,1,22
96731884,60,4,33,9,106
96745117,32,3,2,1,38
96756551,130,24,77,8,239
96756933,13,4,2,1,20
96766333,13,3,2,1,19
96789485,87,7,7,2,103
96796246,50,26,44,4,124
96801196,48,30,18,4,100
96805062,24,35,2,1,62
96808929,37,11,2,1,51
96816494,31,94,9,4,138
96817788,136,10,3,16,165
96817919,56,42,4,8,110
96821928,46,3,2,6,57
96839158,11,3,2,1,17
96853285,22,28,5,20,75
96865971,180,3,2,1,186
96871499,39,3,2,1,45
96872211,42,12,35,4,93
96873748,19,3,2,1,25
96894110,18,8,2,1,29
96896933,36,25,8,17,86
96919477,10,4,2,1,17
96923341,150,71,4,31,256
96938303,30,24,23,2,79
96941329,65,3,2,1,71
96944543,151,23,9,19,202
96945307,37,3,2,1,43
96957109,183,97,3,22,305
96958487,10,3,44,2,59
96965139,37,9,20,14,80
96971562,56,3,2,6,67
96972717,13,6,2,3,24
96976605,60,3,2,1,66
96986376,32,43,3,1,79
96992539,10,5,2,1,18
97001640,48,3,2,5,58
97016185,64,6,13,33,116
97019075,20,3,2,1,26
97021401,12,4,2,1,19
97023898,12,3,2,1,18
97029394,51,36,26,5,118
97029449,26,50,6,3,85
97031997,82,36,47,20,185
97053582,48,61,28,10,147
97064398,103,19,4,10,136
97065097,167,3,2,1,173
97074175,145,3,2,3,153
97079478,16,25,2,1,44
97090963,220,46,10,12,288
97097603,17,4,2,1,24
97104037,13,5,2,1,21
97107007,10,3,2,3,18
97119991,26,3,2,1,32
97126629,10,11,2,1,24
97140729,10,4,2,2,18
97142683,57,40,11,1,109
97169818,64,28,8,29,129
97196331,28,3,2,1,34
97196760,40,3,2,1,46
97198498,38,3,2,1,44
97211426,13,15,2,1,31
97220643,55,40,3,1,99
97220833,19,5,6,10,40
97221057,197,46,82,3,328
97223354,20,16,2,1,39
97226386,209,19,2,2,232
97272451,113,18,2,9,142
97280883,18,29,22,1,70
97281636,18,10,2,1,31
97290092,10,27,2,1,40
97290421,121,35,14,1,171
97302332,136,21,27,14,198
97305363,29,13,2,1,45
97309678,29,3,2,3,37
97315527,95,3,2,1,101
97325020,13,3,2,1,19
97333145,43,20,47,2,112
97333676,100,27,23,6,156
97383328,51,57,23,17,148
97388186,44,10,2,1,57
97389072,145,47,64,10,266
97409876,186,3,2,10,201
97418619,92,14,2,5,113
97419049,68,14,13,5,100
97431322,10,5,2,1,18
97458883,85,4,72,1,162
97459973,83,3,2,1,89
97480484,60,3,2,1,66
97486464,68,8,4,1,81
97487199,108,15,22,1,146
97493427,53,37,5,13,108
97504157,29,48,6,2,85
97504558,14,3,2,1,20
97506119,16,3,2,1,22
97507723,35,15,11,9,70
97511046,164,7,4,7,182
97519352,51,13,2,1,67
97527837,10,22,2,1,35
97527926,101,3,2,12,118
97531076,118,14,204,2,338
97533517,19,3,2,1,25
97551407,48,20,2,1,71
97551968,62,54,22,1,139
97576674,10,4,2,1,17
97581999,199,31,49,14,293
97590565,45,53,6,7,111
97592067,99,15,45,16,175
97593554,95,3,2,1,101
97604951,56,3,2,1,62
97606810,44,18,3,45,110
97607828,59,8,2,1,70
97625336,98,24,4,10,136
97636401,10,17,2,2,31
97641490,26,23,2,5,56
97649824,54,14,2,1,71
97654489,112,30,16,39,197
97656920,12,20,2,1,35
97665486,50,27,32,6,115
97670555,161,27,68,9,265
97695675,62,26,8,21,117
97711325,184,3,2,1,190
97719914,11,3,2,1,17
97724479,20,3,2,2,27
97739818,30,52,2,3,87
97739849,53,3,2,1,59
97750137,38,3,2,5,48
97751269,36,17,20,1,74
97773222,206,3,2,1,212
97782093,24,9,2,3,38
97785396,35,71,4,3,113
97787575,45,38,2,3,88
97789615,74,15,2,1,92
97790884,71,18,83,1,173
97796695,47,3,3,1,54
97804654,151,6,19,1,177
97808932,65,10,2,1,78
97809287,38,25,23,1,87
97818769,35,15,2,2,54
97830006,94,39,16,29,178
97830177,97,3,2,1,103
97839098,139,4,2,3,148
97863631,11,7,2,1,21
97864079,92,33,3,11,139
97890188,35,25,2,4,66
97901432,12,3,2,3,20
97905384,126,32,2,3,163
97908883,66,3,2,1,72
97921477,101,13,4,1,119
97937494,98,3,2,2,105
97939654,66,21,5,2,94
97941844,68,33,19,3,123
97959467,22,14,2,1,39
97961427,23,22,20,1,66
97982876,17,3,2,1,23
98005408,100,48,53,21,222
98014263,20,3,2,1,26
98019150,27,12,2,25,66
98022698,42,31,2,2,77
98035715,48,9,31,18,106
98037959,27,4,6,7,44
98040457,105,3,2,6,116
98046118,39,23,50,13,125
98048372,17,12,2,1,32
98066087,10,4,2,1,17
98071449,16,6,2,4,28
98076263,39,19,4,12,74
98076829,64,3,2,1,70
98083894,129,109,33,12,283
98125054,67,24,5,16,112
98133233,16,3,2,1,22
98155023,37,30,8,12,87
98156831,47,3,2,1,53
98160836,19,6,2,1,28
98188091,45,14,89,1,149
98189543,37,27,2,1,67
98189836,24,36,3,1,64
98220041,16,3,2,1,22
98223655,50,3,2,6,61
98231135,17,14,2,5,38
98231254,50,9,2,5,66
98234117,10,19,2,3,34
98254055,108,22,2,1,133
98275507,70,36,9,3,118
98285730,61,3,2,1,67
98287308,22,3,2,4,31
98288517,76,20,84,14,194
98305602,20,10,2,1,33
98312053,153,32,18,4,207
98319272,10,19,2,1,32
98331879,97,115,66,1,279
98342718,274,3,2,10,289
98351014,89,13,2,1,105
98359906,67,76,17,11,171
98383923,10,11,2,1,24
98394829,194,49,12,25,280
98401397,160,18,13,11,202
98402103,10,3,2,3,18
98402123,217,51,38,48,354
98409940,137,10,2,5,154
98411491,68,7,24,8,107
98411814,97,21,33,7,158
98423186,99,10,8,2,119
98428546,176,3,2,4,185
98431760,74,25,6,11,116
98439181,162,37,2,7,208
98442322,68,23,43,19,153
98458928,50,3,2,13,68
98462304,77,40,23,8,148
98464005,28,36,2,1,67
98480726,98,11,5,19,133
98481309,10,4,2,1,17
98488839,80,11,2,3,96
98495351,116,11,2,6,135
98505762,58,3,2,1,64
98516257,61,3,2,1,67
98517805,30,3,2,1,36
98519286,69,3,2,1,75
98520774,46,58,2,3,109
98529924,60,8,3,8,79
98531656,173,6,6,1,186
98538854,70,3,2,3,78
98539921,72,37,2,8,119
98549170,97,38,2,22,159
98552013,97,5,5,23,130
98576566,298,3,2,1,304
98590551,13,6,2,3,24
98592223,64,19,35,3,121
98595717,324,42,3,13,382
98598768,26,15,5,20,66
98625921,29,6,2,1,38
98634020,180,20,3,13,216
98635309,45,3,2,1,51
98637587,141,3,2,4,150
98642764,167,13,2,1,183
98647801,82,42,10,27,161
98655229,12,3,2,1,18
98661049,11,3,2,1,17
98686790,129,45,5,2,181
98692078,189,3,2,1,195
98699984,98,33,5,7,143
98715860,75,5,2,1,83
98780204,33,20,3,1,57
98785380,95,18,2,1,116
98796803,12,3,2,1,18
98799722,104,29,23,21,177
98813588,32,28,52,29,141
98826210,11,3,2,1,17
98832456,14,71,2,30,117
98834013,97,3,2,1,103
98850578,102,53,2,10,167
98851152,97,3,2,1,103
98852484,37,28,8,1,74
98853476,12,3,2,1,18
98860867,94,26,104,3,227
98885626,84,27,16,18,145
98895198,10,79,18,2,109
98912856,18,9,2,1,30
98917038,84,5,35,10,134
98918418,63,40,3,14,120
98931191,28,71,2,1,102
98945546,118,22,4,8,152
98954137,13,55,39,3,110
98960075,25,65,2,4,96
98960650,27,4,2,1,34
98976777,90,3,2,2,97
98984803,41,15,5,5,66
98988350,17,3,2,1,23
99022327,33,52,6,4,95
99024006,176,66,22,22,286
99026476,498,3,2,11,514
99027147,36,12,2,1,51
99046004,13,17,2,1,33
99047797,80,34,12,9,135
99048754,62,27,23,5,117
99054713,36,18,6,10,70
99072815,125,16,36,2,179
99075608,102,3,2,16,123
99084409,22,3,2,1,28
99091983,41,19,9,3,72
99097280,62,3,2,19,86
99098980,44,23,17,16,100
99114052,24,18,19,41,102
99124043,99,60,23,2,184
99136022,66,3,2,1,72
99142327,36,11,2,1,50
99149271,10,31,12,1,54
99152896,221,37,2,8,268
99165532,49,3,28,8,88
99165549,35,5,2,4,46
99166300,179,3,2,9,193
99168980,123,70,20,91,304
99187771,117,20,32,4,173
99205141,13,3,2,1,19
99212420,46,15,2,5,68
99213487,90,32,17,3,142
99221530,82,11,43,1,137
99228985,168,79,4,58,309
99240203,241,10,8,25,284
99249093,385,6,14,7,412
99253290,57,21,19,1,98
99270972,37,32,3,7,79
99283042,99,3,2,3,107
99287919,35,12,2,1,50
99300772,464,3,8,46,521
99302501,40,37,63,15,155
99310163,10,4,2,1,17
99318598,96,43,26,34,199
99319672,62,16,7,7,92
99329564,48,3,2,7,60
99330360,64,3,2,1,70
99351455,10,49,27,1,87
99375133,77,31,59,4,171
99376123,58,40,2,11,111
99382153,158,13,4,6,181
99385484,50,3,2,3,58
99389370,65,15,21,44,145
99389703,51,26,9,1,87
99399609,162,49,3,13,227
99404442,104,3,2,3,112
99423018,119,35,2,44,200
99427945,14,14,2,1,31
99431106,88,3,2,1,94
99445090,18,17,7,3,45
99450920,18,3,2,1,24
99502971,115,3,2,3,123
99505531,41,4,2,1,48
99505636,25,20,2,3,50
99509395,44,7,2,2,55
99513195,10,6,2,1,19
99534563,148,87,8,1,244
99539230,234,3,2,4,243
99540229,154,28,9,1,192
99542846,13,3,2,5,23
99542851,31,3,2,2,38
99543964,16,3,2,1,22
99548618,42,3,2,1,48
99552915,48,51,27,7,133
99585872,65,53,2,10,130
99590731,12,3,2,1,18
99590842,66,17,27,3,113
99600656,58,14,2,4,78
99616040,15,3,2,1,21
99621414,29,3,2,1,35
99627344,145,37,2,2,186
99630938,73,37,4,4,118
99648910,62,3,2,1,68
99651578,57,42,2,2,103
99658332,48,15,2,1,66
99660202,141,4,52,3,200
99664228,37,48,7,1,93
99667638,12,3,2,1,18
99685420,72,45,51,2,170
99690102,46,3,2,1,52
99735921,90,42,14,22,168
99737431,22,8,6,6,42
99737702,11,3,2,1,17
99740290,206,3,2,1,212
99777911,80,3,2,1,86
99783933,14,3,2,1,20
99789253,24,11,8,12,55
99796748,60,28,16,5,109
99799166,35,3,2,1,41
99808276,56,26,35,4,121
99809038,92,20,15,15,142
99809838,24,5,39,1,69
99829453,28,11,3,1,43
99831433,45,12,4,14,75
99831868,50,56,27,86,219
99834946,46,42,2,11,101
99843922,65,39,19,4,127
99848140,33,68,2,6,109
99870286,107,3,2,38,150
99881381,113,3,2,1,119
99883840,46,44,10,38,138
99894382,53,14,7,5,79
99895039,42,26,45,4,117
99896934,53,54,17,18,142
99910182,72,45,75,15,207
99929112,86,45,15,3,149
99936890,11,3,2,1,17
99937257,23,7,5,1,36
99949728,39,7,2,1,49
99952947,43,23,11,2,79
99970565,19,28,2,1,50
99983098,128,29,30,17,204
99984746,71,3,2,1,77
99996569,12,3,2,1,18
100016458,89,18,68,12,187
100020249,44,36,14,1,95
100026037,99,23,10,22,154
100031008,10,3,2,2,17
100046457,51,129,24,9,213
100050907,61,3,2,1,67
100055898,63,30,3,16,112
100059793,67,13,11,2,93
100060878,29,3,6,1,39
100063452,80,30,2,6,118
100085551,12,3,2,1,18
100107560,82,3,2,2,89
100108125,33,3,2,1,39
100110238,69,11,2,14,96
100117182,18,17,2,1,38
100124432,121,93,15,16,245
100128862,10,7,2,1,20
100132052,164,3,2,3,172
100133484,64,8,4,9,85
100137268,53,27,2,17,99
100148290,61,8,2,2,73
100153131,56,9,2,1,68
100154215,75,3,2,2,82
100154433,34,26,2,3,65
100198866,10,17,2,1,30
100218890,94,19,31,2,146
100231270,85,3,2,5,95
100241322,30,61,2,3,96
100250676,15,4,2,1,22
100253316,71,42,30,1,144
100257653,77,40,31,4,152
100289348,60,33,82,1,176
100302532,47,5,2,1,55
100313531,134,10,47,35,226
100324165,13,3,2,1,19
100325250,26,3,2,5,36
100357445,30,24,3,1,58
100364384,96,19,2,6,123
100378921,16,12,2,1,31
100389130,34,28,9,3,74
100406363,11,3,2,1,17
100414269,22,8,2,1,33
100421878,60,3,2,2,67
100423730,89,92,2,8,191
100426829,40,4,2,4,50
100440722,227,13,3,1,244
100445787,44,57,24,20,145
100450400,15,3,5,1,24
100461219,161,19,5,8,193
100463469,11,3,2,1,17
100474024,1025,3,2,3,1033
100480662,50,50,59,26,185
100498032,32,16,6,32,86
100506071,171,17,9,1,198
100507154,28,15,2,1,46
100511021,68,17,32,15,132
100518329,114,3,2,1,120
100525745,56,30,74,23,183
100526502,11,3,2,1,17
100528149,10,8,2,1,21
100552900,16,33,2,1,52
100556472,116,14,2,58,190
100560277,10,9,2,1,22
100569344,100,139,2,38,279
100571151,139,36,11,6,192
100571154,81,34,34,7,156
100588204,31,44,2,46,123
100588466,32,3,2,1,38
100605881,49,20,11,1,81
100605981,15,3,2,2,22
100606183,22,3,2,1,28
100610032,117,29,69,8,223
100611960,73,3,2,1,79
100613668,22,3,2,1,28
100623683,14,16,2,2,34
100628476,83,11,8,4,106
100630201,101,35,18,18,172
100635791,52,19,5,18,94
100650006,18,19,14,3,54
100650404,116,52,47,1,216
100658129,22,8,2,1,33
100661958,10,55,17,1,83
100663612,25,32,14,5,76
100679682,10,6,2,1,19
100692304,12,3,2,1,18
100693942,105,15,2,1,123
100695370,68,44,2,1,115
100697666,66,12,5,1,84
100700075,10,23,2,4,39
100718938,112,5,2,15,134
100723627,57,29,11,64,161
100743028,43,3,2,1,49
100749827,135,3,2,2,142
100751828,47,28,47,23,145
100761867,68,13,39,7,127
100763590,31,31,29,1,92
100765155,32,54,28,1,115
100770715,238,3,2,3,246
100783431,31,3,2,1,37
100786335,83,11,8,10,112
100788835,81,60,21,34,196
100789503,41,5,2,7,55
100795422,139,127,7,32,305
100804104,636,3,2,4,645
100805925,39,43,43,34,159
100810889,85,48,8,6,147
100812403,27,6,2,1,36
100820117,81,6,5,1,93
100834495,155,3,2,1,161
100836486,46,3,2,1,52
100863835,101,25,2,6,134
100909940,38,50,22,2,112
100910002,31,3,2,3,39
100915349,35,42,12,1,90
100918484,118,26,28,1,173
100923779,29,18,4,1,52
100926976,62,34,28,1,125
100929780,83,19,2,2,106
100931940,53,27,16,1,97
100944400,130,48,36,18,232
100958675,37,18,2,1,58
100967718,76,19,2,1,98
100972481,115,3,2,3,123
100987498,48,14,2,21,85
101000517,10,3,2,2,17
101001248,191,93,2,9,295
101005345,19,51,6,12,88
101016195,111,7,108,5,231
101052087,88,16,2,3,109
101058055,30,36,9,2,77
101060648,82,20,24,8,134
101069224,128,12,6,14,160
101075794,45,27,3,13,88
101076582,37,11,37,2,87
101099515,40,24,7,1,72
101109097,30,28,2,5,65
101119098,115,3,2,1,121
101122738,126,3,2,2,133
101122789,70,3,2,21,96
101124040,67,6,2,1,76
101129456,50,26,2,2,80
101150166,12,3,2,3,20
101152975,19,21,9,16,65
101162776,10,5,2,4,21
101173556,51,118,2,1,172
101185012,13,15,8,1,37
101186722,70,14,9,3,96
101210562,100,19,14,1,134
101218601,90,31,2,1,124
101228870,12,4,2,1,19
101234663,78,26,12,2,118
101239568,136,9,2,60,207
101271871,45,3,2,1,51
101272082,85,52,2,7,146
101277199,89,3,2,4,98
101285767,74,6,8,7,95
101292073,159,3,2,7,171
101323268,93,13,2,8,116
101335752,70,28,24,25,147
101339428,17,3,2,4,26
101365550,56,9,9,1,75
101374969,176,17,21,22,236
101376926,33,3,2,1,39
101385209,22,83,22,3,130
101385391,72,34,9,22,137
101406421,169,23,7,1,200
101407296,43,16,166,1,226
101418492,57,52,4,10,123
101420984,68,15,40,1,124
101421136,13,4,2,1,20
101446935,19,11,3,2,35
101454944,13,3,2,1,19
101465434,35,33,69,1,138
101468097,105,75,4,4,188
101477209,18,12,7,2,39
101515767,11,3,2,4,20
101523059,78,3,2,1,84
101524914,48,23,2,1,74
101538239,25,32,2,2,61
101548107,58,10,27,10,105
101556407,10,3,2,2,17
101562084,10,3,2,3,18
101565170,15,3,2,1,21
101575037,99,14,2,10,125
101582430,68,13,10,1,92
101594638,62,14,22,9,107
101605492,256,3,2,1,262
101644569,148,52,4,9,213
101647009,137,3,2,1,143
101661090,68,3,9,3,83
101670589,28,86,2,3,119
101681862,45,39,4,7,95
101707327,119,23,75,13,230
101708462,87,29,61,2,179
101765107,106,3,2,1,112
101773677,20,3,2,1,26
101782148,34,3,2,1,40
101791548,68,3,2,3,76
101792062,97,18,2,1,118
101795335,71,14,2,6,93
101819867,53,33,24,2,112
101826585,204,3,2,18,227
101835942,54,4,2,6,66
101844087,22,3,2,1,28
101874053,104,7,19,2,132
101896947,84,17,21,1,123
101897239,33,62,18,1,114
101911728,108,13,2,1,124
101916433,46,35,35,1,117
101922841,23,17,2,1,43
101928226,46,19,66,2,133
101929906,21,3,2,1,27
101930338,121,16,2,1,140
101932353,38,42,2,1,83
101945266,50,24,2,1,77
101950550,95,20,118,4,237
101964454,85,13,38,1,137
101966249,77,26,58,20,181
101985966,98,3,2,1,104
102007945,110,12,3,1,126
102008928,12,3,2,1,18
102026818,29,10,2,1,42
102032788,83,19,18,19,139
102035558,82,37,2,44,165
102037124,50,3,2,1,56
102042621,174,4,2,26,206
102062110,40,3,2,1,46
102062421,16,3,2,2,23
102071807,38,23,12,16,89
102081477,11,11,2,1,25
102084165,10,6,2,1,19
102085041,81,15,8,5,109
102096006,289,3,2,44,338
102115540,241,27,34,23,325
102116095,61,21,2,8,92
102143300,49,19,28,8,104
102150113,152,22,2,1,177
102172985,15,47,4,1,67
102173222,47,51,37,2,137
102184688,86,26,2,1,115
102190889,17,4,5,1,27
102222994,41,13,17,1,72
102229395,95,74,12,4,185
102250829,86,3,2,3,94
102256798,26,33,10,26,95
102257506,11,3,2,1,17
102263887,139,74,7,5,225
102271258,113,16,111,34,274
102274105,13,3,2,2,20
102285700,79,34,5,1,119
102294319,13,3,2,1,19
102321734,18,8,2,2,30
102329791,126,68,2,15,211
102332810,117,27,2,1,147
102334155,17,3,2,3,25
102340640,17,30,2,1,50
102346322,76,3,2,1,82
102350836,210,3,2,3,218
102356013,20,25,2,1,48
102363894,62,29,3,2,96
102367933,158,50,25,4,237
102371430,12,3,2,1,18
102372449,42,17,3,2,64
102390907,81,38,3,13,135
102428799,64,3,2,1,70
102430728,18,9,5,3,35
102441695,72,31,3,3,109
102443019,10,3,2,2,17
102446090,92,8,2,2,104
102452002,78,9,43,9,139
102453216,117,15,12,1,145
102454047,12,3,2,1,18
102461148,62,15,24,3,104
102463058,54,23,9,1,87
102466094,16,17,2,1,36
102476322,22,47,2,3,74
102487991,37,43,2,5,87
102489903,14,3,2,1,20
102496686,53,3,2,2,60
102499813,68,7,2,3,80
102517928,76,10,8,1,95
102523329,46,19,3,1,69
102524117,42,25,2,33,102
102528928,252,23,2,2,279
102531673,42,3,5,1,51
102532201,55,15,2,1,73
102542460,12,18,2,15,47
102543724,45,71,64,1,181
102547357,91,22,12,10,135
102549064,163,46,8,9,226
102550583,133,3,2,1,139
102553972,136,14,11,1,162
102555449,76,3,2,2,83
102557873,85,25,5,1,116
102563656,37,7,2,2,48
102563927,26,14,3,3,46
102569316,60,3,2,1,66
102571494,65,3,2,1,71
102572802,13,37,3,1,54
102572917,222,99,2,57,380
102626688,121,27,13,3,164
102636292,12,11,2,1,26
102646873,28,3,2,1,34
102649862,21,3,2,1,27
102661099,110,3,2,4,119
102669128,200,5,17,2,224
102669714,48,34,2,4,88
102672487,12,3,2,1,18
102677578,118,19,2,13,152
102677883,15,3,2,5,25
102679331,24,3,2,5,34
102684168,45,24,5,1,75
102690414,103,27,2,15,147
102691986,42,25,24,2,93
102692978,24,3,2,1,30
102693557,14,9,2,2,27
102732241,22,8,2,1,33
102744932,19,3,2,1,25
102753786,23,37,2,1,63
102760989,67,12,7,1,87
102761874,10,3,2,2,17
102769240,41,16,3,1,61
102774418,86,30,12,6,134
102777320,16,23,14,3,56
102792491,109,29,6,1,145
102799028,189,22,29,7,247
102801791,28,6,5,1,40
102815465,154,3,2,3,162
102820514,63,11,74,4,152
102839152,31,3,2,4,40
102852603,32,3,2,4,41
102852725,70,13,28,6,117
102858224,15,3,2,1,21
102858705,24,21,2,1,48
102883740,19,3,2,1,25
102886122,12,9,2,1,24
102890100,42,10,2,6,60
102899097,63,63,31,3,160
102909320,197,15,2,18,232
102913380,36,4,2,1,43
102976072,29,41,11,1,82
102983567,74,3,2,1,80
103001787,51,91,31,28,201
103003173,258,3,2,1,264
103012431,66,3,2,13,84
103044254,48,57,3,3,111
103054600,29,3,2,7,41
103061725,62,14,4,15,95
103066777,85,94,34,35,248
103071297,100,109,10,28,247
103071574,60,17,35,5,117
103118843,46,15,2,1,64
103123973,10,13,2,1,26
103131008,76,18,10,1,105
103133419,27,20,4,1,52
103137922,13,25,2,1,41
103139440,171,53,56,1,281
103141582,107,45,161,11,324
103146457,49,7,2,5,63
103147648,75,3,2,1,81
103162974,60,3,2,1,66
103186234,109,3,2,2,116
103194536,38,14,82,5,139
103209915,61,13,2,1,77
103217722,42,3,2,14,61
103221331,120,3,2,1,126
103224712,58,10,2,1,71
103232933,85,18,40,8,151
103253518,13,14,2,1,30
103272743,113,3,5,1,122
103291995,194,18,92,3,307
103306261,63,3,2,33,101
103308630,27,3,2,2,34
103309288,89,16,19,5,129
103311035,53,16,2,4,75
103322791,69,7,3,11,90
103337824,132,19,45,3,199
103348874,68,3,2,5,78
103351505,60,3,2,1,66
103355150,97,14,2,1,114
103357718,148,3,2,1,154
103393797,63,38,40,23,164
103396071,91,25,2,2,120
103399253,32,23,2,1,58
103413621,42,3,2,5,52
103426089,10,5,2,1,18
103428554,173,22,2,2,199
103430059,13,3,2,2,20
103440677,30,27,11,24,92
103442000,10,3,2,3,18
103446643,218,21,13,2,254
103451680,27,4,2,4,37
103459897,13,5,2,1,21
103465049,50,6,3,1,60
103474405,21,3,2,3,29
103476403,19,4,2,1,26
103486077,39,24,2,3,68
103522580,12,3,2,1,18
103551968,81,65,31,11,188
103584579,88,34,55,30,207
103588561,232,3,2,3,240
103596585,15,28,2,2,47
103601987,119,3,2,18,142
103612108,23,3,2,1,29
103620287,76,8,15,1,100
103626993,51,14,3,4,72
103658613,45,3,2,5,55
103662773,11,3,2,1,17
103678012,48,3,2,3,56
103687946,11,3,2,2,18
103714927,41,26,16,23,106
103722064,139,3,2,2,146
103728904,74,26,3,5,108
103735369,52,39,6,6,103
103743006,79,44,2,3,128
103786897,112,8,3,3,126
103792901,142,27,2,5,176
103795829,155,5,2,2,164
103798331,125,16,27,2,170
103806839,38,19,2,2,61
103834168,85,3,2,1,91
103834723,28,33,3,21,85
103847554,74,9,8,2,93
103868258,146,3,2,6,157
103872469,83,3,2,1,89
103873952,39,13,2,11,65
103886539,13,3,2,1,19
103911534,149,44,3,1,197
103933316,22,3,2,1,28
103937485,394,20,3,47,464
103953267,20,4,2,1,27
103955362,11,7,2,1,21
103958184,67,28,30,2,127
103968272,23,3,2,1,29
103981559,16,46,2,1,65
104003055,78,30,3,1,112
104003802,10,11,2,1,24
104011739,48,41,3,1,93
104012411,55,40,31,3,129
104012694,83,3,2,2,90
104018662,79,19,2,4,104
104019033,50,8,2,10,70
104019122,66,17,2,1,86
104021404,60,3,2,3,68
104044611,92,16,53,4,165
104059221,31,57,8,1,97
104065936,56,39,4,1,100
104077837,30,19,21,1,71
104083478,24,33,2,1,60
104086325,28,7,2,4,41
104087772,33,44,41,3,121
104093327,43,64,20,1,128
104095949,12,3,2,1,18
104097648,20,4,2,1,27
104099509,70,4,2,2,78
104103405,89,3,2,1,95
104104808,63,23,11,16,113
104143064,91,3,2,1,97
104143432,20,24,6,1,51
104146595,177,55,2,1,235
104151905,14,3,2,1,20
104178989,115,3,2,6,126
104183997,80,19,36,1,136
104196725,45,3,2,2,52
104198972,32,3,2,3,40
104209492,139,14,2,24,179
104214529,12,3,2,1,18
104219033,39,3,3,1,46
104231519,18,3,2,1,24
104246986,80,3,2,1,86
104257061,66,33,29,10,138
104264817,18,13,14,1,46
104291177,84,7,187,2,280
104292232,12,3,2,2,19
104297524,11,38,2,1,52
104301809,187,57,12,1,257
104309939,74,17,2,1,94
104312156,60,6,22,3,91
104330401,65,3,2,1,71
104338727,10,7,2,1,20
104348735,144,27,5,3,179
104350319,12,7,2,1,22
104352115,16,3,2,1,22
104354830,62,36,15,28,141
104371271,69,8,33,1,111
104382145,21,3,2,1,27
104394652,16,48,2,1,67
104406182,76,7,12,2,97
104410119,44,40,3,1,88
104411794,20,6,2,1,29
104412865,108,81,31,3,223
104417557,11,5,2,1,19
104422457,65,7,2,1,75
104426607,53,21,11,2,87
104435566,101,5,12,2,120
104436155,51,35,3,1,90
104436519,25,3,4,7,39
104439408,73,19,13,7,112
104439493,59,30,8,6,103
104454401,96,28,56,69,249
104489870,40,32,20,14,106
104491653,125,72,60,22,279
104504000,32,15,12,3,62
104504818,113,34,13,68,228
104505733,51,40,22,1,114
104539570,42,22,22,11,97
104543684,81,32,8,13,134
104553508,112,14,20,4,150
104553900,21,3,2,1,27
104566590,12,3,2,1,18
104585432,40,3,2,1,46
104591399,46,7,2,1,56
104605284,16,43,26,28,113
104619306,139,18,18,5,180
104626572,75,43,10,12,140
104627287,131,86,2,39,258
104645464,20,3,2,1,26
104651607,47,20,17,1,85
104653533,168,5,8,4,185
104666628,18,14,8,1,41
104668992,11,7,2,1,21
104683037,14,3,2,1,20
104685888,36,6,15,3,60
104691535,49,31,47,3,130
104698810,16,26,5,2,49
104700542,17,3,2,2,24
104707961,57,79,29,15,180
104729716,10,3,2,2,17
104733901,87,10,39,16,152
104747183,222,33,31,16,302
104754660,11,3,2,1,17
104762509,99,24,10,3,136
104768129,41,41,5,2,89
104779477,111,24,107,5,247
104806819,176,3,2,4,185
104815403,10,8,2,1,21
104816611,12,3,2,1,18
104819113,45,6,2,5,58
104843766,75,6,2,5,88
104858340,27,3,2,4,36
104858733,126,3,2,1,132
104872547,10,3,2,4,19
104877421,114,24,54,66,258
104893684,40,12,2,2,56
104922650,30,3,16,1,50
104936159,98,32,44,17,191
104945262,53,67,35,6,161
104948574,97,8,21,10,136
104948583,72,28,2,8,110
104956715,33,22,5,1,61
104964069,10,9,3,1,23
104966465,134,37,2,1,174
104976996,23,7,3,1,34
104989665,101,3,2,1,107
105007533,66,22,2,1,91
105023303,23,3,2,1,29
105023634,47,3,2,1,53
105029464,41,10,2,3,56
105035775,15,8,6,1,30
105047558,56,39,10,6,111
105053569,21,59,21,3,104
105080593,39,3,2,1,45
105080681,16,5,2,1,24
105094435,54,60,41,24,179
105096168,59,4,2,2,67
105103356,27,16,14,1,58
105104868,18,6,4,1,29
105133733,46,3,2,1,52
105136605,101,48,227,87,463
105143005,12,8,2,1,23
105154831,50,3,2,1,56
105159199,11,9,2,1,23
105161196,42,29,2,14,87
105167989,20,41,12,2,75
105176809,123,12,2,27,164
105179679,68,34,12,68,182
105196264,15,3,2,1,21
105200819,61,3,2,3,69
105201571,24,40,3,3,70
105251135,14,6,2,3,25
105252153,16,5,2,1,24
105270094,29,17,4,7,57
105288680,67,30,3,1,101
105297796,82,12,34,1,129
105300067,11,3,2,1,17
105307462,10,24,2,1,37
105308752,30,9,3,3,45
105323630,131,3,2,14,150
105329983,35,10,7,2,54
105331633,22,5,2,1,30
105352402,94,47,39,1,181
105353533,10,25,2,1,38
105353672,80,15,6,13,114
105354365,12,37,2,3,54
105374313,57,19,16,1,93
105383139,45,31,11,5,92
105399297,45,20,2,4,71
105402217,54,23,23,6,106
105405083,11,3,2,1,17
105411881,59,5,2,1,67
105412020,35,27,2,2,66
105424029,45,42,45,1,133
105431655,32,3,2,7,44
105437395,181,12,58,2,253
105440352,97,3,2,20,122
105449387,51,28,2,5,86
105476844,10,5,2,1,18
105483132,25,3,2,1,31
105487174,63,13,14,2,92
105508964,12,39,2,1,54
105509905,71,12,2,4,89
105518447,76,70,21,21,188
105519632,62,11,4,3,80
105525338,41,50,19,18,128
105529110,53,3,2,6,64
105550060,88,4,2,1,95
105555989,16,3,2,1,22
105558473,32,19,2,1,54
105559542,47,3,2,1,53
105566693,22,3,2,1,28
105568123,67,3,2,3,75
105571894,66,3,2,2,73
105593310,66,16,20,1,103
105596385,49,27,11,19,106
105604599,74,25,22,6,127
105621340,33,3,2,1,39
105623578,35,35,9,2,81
105647977,58,3,2,1,64
105655058,19,3,2,1,25
105656032,98,3,2,7,110
105661798,28,3,3,1,35
105669359,48,10,4,1,63
105670701,21,3,2,1,27
105672967,73,13,15,1,102
105673065,69,3,2,1,75
105678108,15,25,2,2,44
105694957,455,3,2,2,462
105701786,24,3,2,1,30
105727433,27,3,2,2,34
105742763,12,3,2,1,18
105755287,41,15,2,1,59
105758253,45,28,23,26,122
105765190,42,12,13,4,71
105774355,127,3,2,7,139
105820690,11,3,2,1,17
105825515,69,3,2,3,77
105830268,24,16,2,1,43
105837801,61,11,2,1,75
105840217,21,8,2,2,33
105840774,19,76,47,1,143
105846670,99,14,2,1,116
105851947,81,3,3,1,88
105852012,42,27,32,27,128
105862042,57,16,19,1,93
105862723,57,20,6,2,85
105862868,11,46,2,1,60
105866869,12,23,2,4,41
105887961,10,10,2,1,23
105888342,70,3,2,2,77
105888607,24,9,3,3,39
105895760,99,3,2,3,107
105916898,83,18,93,5,199
105941251,19,47,6,1,73
105979567,40,16,2,13,71
105980803,141,3,12,7,163
105985020,47,37,13,23,120
105985799,28,11,4,2,45
105994849,14,3,2,1,20
105995811,110,37,51,16,214
106000757,78,22,2,3,105
106020493,54,3,3,1,61
106023591,70,63,13,5,151
106027457,58,26,19,5,108
106027938,111,36,57,21,225
106033233,22,18,3,5,48
106034890,29,47,6,1,83
106042898,96,51,6,16,169
106044699,10,23,2,2,37
106053790,11,3,2,2,18
106070510,359,3,2,47,411
106074136,45,3,2,11,61
106081125,29,4,2,1,36
106091418,19,4,2,1,26
106094430,15,10,2,1,28
106095815,67,20,2,3,92
106097583,48,20,9,12,89
106098888,17,23,2,1,43
106123983,110,3,2,2,117
106129254,13,3,2,11,29
106143657,245,17,53,3,318
106144161,13,7,3,1,24
106149821,14,5,2,1,22
106154188,26,9,2,1,38
106157005,20,30,2,1,53
106162786,50,14,2,3,69
106174130,36,3,2,1,42
106199124,106,14,16,19,155
106208372,10,3,2,4,19
106231746,20,3,2,1,26
106239371,96,5,2,3,106
106247203,10,3,2,2,17
106249142,28,3,2,1,34
106251062,49,26,11,15,101
106257101,64,6,2,6,78
106261446,162,36,2,9,209
106264043,56,23,8,7,94
106270694,168,26,2,1,197
106271621,28,3,2,1,34
106283679,30,43,4,1,78
106287896,117,3,2,1,123
106290499,30,3,2,1,36
106297317,17,8,2,40,67
106298786,155,14,67,6,242
106299416,80,3,2,5,90
106304825,32,16,3,1,52
106309434,92,7,2,1,102
106310556,499,3,2,2,506
106312370,13,3,2,1,19
106345001,77,3,2,1,83
106347226,50,61,2,1,114
106356967,38,93,17,2,150
106363113,220,21,8,39,288
106364956,72,27,4,10,113
106379566,217,31,3,6,257
106388366,82,7,2,1,92
106390219,80,27,2,11,120
106402409,39,32,17,2,90
106408247,180,9,23,1,213
106411368,49,3,2,2,56
106438858,95,34,9,41,179
106439423,81,21,40,53,195
106452379,11,3,2,3,19
106463839,91,30,3,2,126
106487637,89,3,2,1,95
106493109,25,6,14,4,49
106493363,60,3,2,1,66
106505634,59,3,2,7,71
106514002,22,23,2,1,48
106518635,42,13,8,1,64
106523575,54,3,2,7,66
106530828,31,48,11,1,91
106531718,11,3,2,1,17
106536287,28,19,31,1,79
106543507,11,5,2,1,19
106561612,172,11,2,11,196
106563212,84,16,92,1,193
106571793,93,23,27,3,146
106574105,55,15,4,11,85
106575471,11,8,3,1,23
106577819,28,3,2,3,36
106583866,176,12,19,2,209
106599567,81,3,2,12,98
106602598,77,40,16,2,135
106629057,233,36,37,4,310
106638602,105,25,3,7,140
106639235,160,25,17,14,216
106642527,13,3,2,2,20
106666737,107,3,2,1,113
106674948,176,18,2,1,197
106675371,11,3,2,1,17
106678988,23,68,2,7,100
106683963,29,16,2,1,48
106692171,98,53,2,2,155
106694686,24,3,2,7,36
106695077,49,8,2,4,63
106700462,116,71,345,11,543
106716333,72,45,2,4,123
106742856,18,10,10,1,39
106746612,128,42,41,13,224
106746802,11,43,2,2,58
106749019,11,36,2,3,52
106760769,24,6,2,1,33
106774338,84,10,11,2,107
106780125,40,27,52,5,124
106782300,19,3,2,2,26
106788821,121,20,2,1,144
106802519,46,48,2,1,97
106819850,51,3,2,5,61
106820668,26,3,2,1,32
106821557,27,3,2,5,37
106830137,221,14,35,13,283
106836909,38,25,25,1,89
106846380,87,5,2,1,95
106852666,42,20,26,13,101
106859577,104,22,59,15,200
106860780,71,3,2,1,77
106869778,11,3,2,1,17
106881512,126,19,2,1,148
106900561,113,27,51,2,193
106907567,63,40,11,1,115
106923523,43,35,39,1,118
106923866,26,38,3,3,70
106939206,85,3,2,1,91
106941302,23,20,5,1,49
106955836,20,52,2,1,75
106961390,18,28,2,9,57
106961696,29,8,2,6,45
106972390,64,29,5,7,105
106980401,61,16,31,6,114
107007886,17,3,2,1,23
107012351,44,30,13,1,88
107016122,86,59,35,10,190
107022995,77,4,2,7,90
107024933,40,3,5,1,49
107041431,10,4,2,2,18
107046586,29,20,4,2,55
107048612,88,31,5,16,140
107053977,40,14,2,1,57
107077974,12,3,2,1,18
107091198,26,22,3,7,58
107095338,166,39,6,29,240
107132751,185,12,2,15,214
107134858,95,40,40,5,180
107164666,88,3,2,4,97
107165446,110,35,7,40,192
107167241,44,3,2,1,50
107174967,50,34,2,15,101
107202158,233,3,2,7,245
107205358,75,3,20,3,101
107208655,123,24,2,21,170
107209564,22,3,2,1,28
107209992,50,36,19,11,116
107228165,20,5,2,1,28
107233274,79,42,2,2,125
107233478,265,4,56,13,338
107235857,45,22,2,2,71
107237608,54,13,5,1,73
107282517,58,37,2,8,105
107300386,11,3,2,1,17
107310229,16,3,2,1,22
107313753,10,4,2,2,18
107317950,10,8,2,1,21
107322022,99,42,13,2,156
107342679,25,72,2,38,137
107349842,42,17,14,17,90
107354230,24,7,2,8,41
107358890,65,42,22,8,137
107360642,124,93,65,45,327
107367037,143,36,10,26,215
107374638,14,9,2,5,30
107377787,67,3,2,1,73
107392676,70,35,9,41,155
107403687,166,44,3,2,215
107412306,23,17,12,1,53
107413913,28,30,12,3,73
107426906,115,33,20,8,176
107428684,15,3,2,5,25
107436907,150,42,47,32,271
107438873,11,6,2,1,20
107448949,17,8,2,1,28
107462052,32,30,7,8,77
107474065,18,29,6,28,81
107486254,134,39,13,9,195
107487276,17,14,2,1,34
107499164,12,3,2,1,18
107506596,97,3,2,1,103
107507417,171,3,2,1,177
107510599,10,12,3,1,26
107514575,28,18,6,18,70
107527629,159,3,2,1,165
107531205,16,8,2,1,27
107540640,27,32,55,2,116
107544505,65,7,2,1,75
107561996,79,25,5,1,110
107563768,22,67,22,5,116
107567926,34,35,18,25,112
107568626,27,28,3,1,59
107571341,24,3,2,3,32
107582146,97,22,4,10,133
107603188,48,3,2,5,58
107618619,146,10,2,1,159
107620973,59,60,44,7,170
107621445,89,54,23,34,200
107624333,79,15,31,4,129
107624609,57,45,51,3,156
107624965,26,3,2,1,32
107625836,46,28,17,1,92
107633587,105,3,2,11,121
107641997,18,7,3,2,30
107650476,28,3,2,1,34
107656497,40,33,2,1,76
107657487,60,75,74,18,227
107662586,10,13,2,1,26
107668650,15,3,2,1,21
107694353,40,3,2,13,58
107696589,71,8,2,1,82
107706709,25,10,9,1,45
107713780,88,3,2,2,95
107728405,65,30,26,2,123
107730285,98,15,2,4,119
107745224,76,12,52,10,150
107757583,22,24,2,4,52
107774159,99,5,3,5,112
107797740,118,62,2,18,200
107808544,69,3,2,1,75
107814686,113,54,29,2,198
107823719,17,32,16,2,67
107824631,58,30,5,15,108
107828715,37,14,2,27,80
107876776,46,29,7,4,86
107876910,74,3,2,1,80
107883500,144,50,3,10,207
107892828,17,3,2,1,23
107902089,46,18,2,1,67
107919710,56,23,52,1,132
107929802,12,3,2,1,18
107959481,20,27,13,1,61
107960702,42,21,2,2,67
107961970,30,3,2,1,36
107967493,104,3,2,1,110
107967760,39,24,38,17,118
107970607,48,25,24,3,100
107975557,145,21,3,3,172
107976864,100,12,25,2,139
107977170,119,36,2,7,164
107981104,40,8,29,1,78
107986831,26,4,2,8,40
107994520,93,90,61,40,284
107999993,71,3,2,3,79
108008147,11,3,2,1,17
108009674,15,11,49,1,76
108018674,21,3,2,1,27
108018676,24,3,2,1,30
108020741,82,39,104,26,251
108024025,147,19,64,15,245
108044976,39,9,5,7,60
108053797,143,15,13,1,172
108074203,17,10,2,1,30
108082291,47,10,16,3,76
108084254,63,50,15,3,131
108099443,15,56,2,5,78
108112453,39,3,2,8,52
108128072,62,8,5,6,81
108133303,62,13,21,10,106
108140166,53,3,2,1,59
108145346,57,6,11,24,98
108154738,45,55,3,11,114
108172012,120,3,2,1,126
108172314,55,3,2,1,61
108177490,102,3,2,1,108
108178276,12,3,2,1,18
108195990,10,6,2,1,19
108198830,29,60,38,4,131
108204335,42,20,21,5,88
108204647,91,3,2,2,98
108220826,102,13,2,15,132
108245925,48,27,13,1,89
108249015,156,81,3,14,254
108254500,52,10,2,4,68
108258292,134,40,87,10,271
108288222,57,3,31,1,92
108293144,11,3,2,1,17
108305355,27,15,2,3,47
108318914,60,13,7,1,81
108332328,16,6,2,1,25
108340580,32,13,2,3,50
108341211,27,3,2,1,33
108344826,101,27,2,7,137
108358683,83,21,35,3,142
108358837,37,26,6,3,72
108391075,52,21,2,12,87
108393459,35,11,4,5,55
108412157,120,106,86,12,324
108423781,90,3,2,32,127
108455666,41,42,4,1,88
108462470,110,37,204,22,373
108463590,27,21,19,22,89
108465842,378,3,2,1,384
108469871,47,20,6,15,88
108483423,31,34,25,2,92
108486801,17,9,3,1,30
108497495,25,36,17,9,87
108498662,26,69,7,21,123
108510003,32,3,2,1,38
108516750,42,69,23,71,205
108518150,68,3,2,2,75
108536766,62,11,2,38,113
108539613,70,3,2,6,81
108558240,14,52,10,5,81
108560063,93,53,71,12,229
108571278,94,3,12,7,116
108599939,11,3,2,1,17
108626585,72,70,23,10,175
108661548,15,3,2,1,21
108669317,10,32,9,3,54
108710935,93,25,5,6,129
108726550,107,15,124,1,247
108748725,20,54,61,3,138
108750052,129,42,5,13,189
108759205,24,54,2,1,81
108781273,104,81,11,2,198
108789261,16,6,2,1,25
108792950,110,34,42,1,187
108810309,49,23,4,1,77
108817579,175,7,3,2,187
108821568,10,7,2,2,21
108823400,155,32,31,11,229
108830330,85,57,30,1,173
108830710,43,30,2,5,80
108832654,16,3,2,2,23
108834170,43,3,2,4,52
108838985,81,32,2,20,135
108873247,17,106,3,3,129
108883966,94,6,6,10,116
108888227,224,38,20,5,287
108896753,114,44,12,4,174
108901177,188,56,28,37,309
108902023,10,14,2,1,27
108909060,12,3,2,2,19
108920523,16,21,2,1,40
108924959,10,3,2,3,18
108925942,61,18,2,16,97
108946073,21,4,3,4,32
108956398,13,3,2,1,19
108969019,10,21,2,1,34
108973871,100,3,2,1,106
108982315,147,49,2,32,230
108990569,115,9,17,4,145
108992517,67,3,2,2,74
108993131,61,44,13,10,128
108993345,262,6,2,1,271
109001976,63,4,16,4,87
109013252,11,4,2,1,18
109024386,28,20,8,8,64
109036130,20,3,2,7,32
109036204,196,3,2,2,203
109036573,54,3,2,1,60
109047913,76,39,15,4,134
109047968,37,38,3,10,88
109070970,49,7,3,6,65
109071069,14,35,26,19,94
109071623,149,25,17,4,195
109083786,15,6,2,1,24
109093241,13,6,2,1,22
109096570,59,5,24,27,115
109097935,42,3,2,1,48
109099199,23,30,21,1,75
109102952,20,40,56,4,120
109106439,69,21,35,6,131
109106953,69,14,3,2,88
109111300,13,9,2,1,25
109112453,10,3,2,2,17
109112745,68,29,2,1,100
109114233,52,21,3,2,78
109124363,33,52,32,2,119
109124697,212,3,2,6,223
109124740,67,3,2,13,85
109141383,66,3,5,3,77
109143634,125,69,10,11,215
109154078,18,48,2,3,71
109163215,99,3,5,2,109
109175588,91,3,2,2,98
109176454,59,21,2,1,83
109188711,63,8,3,1,75
109205394,17,3,2,1,23
109220238,17,3,2,1,23
109245235,64,31,16,13,124
109248326,84,10,2,1,97
109250929,69,3,2,1,75
109256072,13,9,2,1,25
109260875,49,12,2,2,65
109263829,203,187,2,52,444
109269593,18,18,2,5,43
109282001,21,3,2,1,27
109291237,121,16,35,14,186
109297567,14,6,2,1,23
109309657,49,22,30,12,113
109318954,116,15,2,2,135
109328398,153,52,21,3,229
109336793,55,28,5,3,91
109354242,145,4,2,38,189
109369524,17,27,2,1,47
109371110,109,39,84,1,233
109392304,146,34,49,3,232
109396827,136,4,2,1,143
109397385,108,44,14,8,174
109412260,65,3,2,2,72
109419782,10,8,2,1,21
109422498,17,33,10,20,80
109428296,17,14,18,4,53
109434615,12,12,9,13,46
109436991,51,3,2,1,57
109437803,144,20,35,26,225
109453697,95,86,44,56,281
109462098,74,3,2,1,80
109467111,136,29,52,2,219
109472555,42,41,19,8,110
109491027,70,18,10,1,99
109492598,10,6,2,2,20
109503206,10,4,2,1,17
109514260,19,17,2,3,41
109515027,11,3,2,1,17
109516732,11,3,2,1,17
109518728,17,10,2,1,30
109520724,35,44,14,3,96
109527865,181,3,2,1,187
109536709,86,26,11,14,137
109544932,58,3,2,1,64
109552326,30,3,2,1,36
109553910,148,43,2,2,195
109555917,28,57,43,42,170
109562268,20,3,2,2,27
109591354,15,3,2,1,21
109628365,76,58,50,5,189
109636545,16,3,2,2,23
109647359,27,3,2,6,38
109649058,11,3,2,1,17
109655941,44,57,2,1,104
109657025,16,9,2,1,28
109670651,94,23,61,3,181
109683824,617,3,2,10,632
109685128,80,17,24,3,124
109697291,139,8,2,4,153
109697755,29,37,110,1,177
109710376,254,23,2,7,286
109712643,68,81,24,8,181
109717025,58,29,2,1,90
109720185,25,22,2,7,56
109735405,88,18,18,16,140
109740611,16,31,3,1,51
109751251,58,50,4,1,113
109779506,64,3,2,1,70
109782707,47,28,21,20,116
109787197,10,3,2,4,19
109789901,44,61,2,3,110
109797482,18,3,2,1,24
109807867,10,7,2,1,20
109817477,62,23,3,1,89
109833730,27,3,2,3,35
109834928,88,3,2,1,94
109872440,40,3,2,3,48
109873255,36,52,15,4,107
109882256,10,23,6,8,47
109884163,26,40,21,39,126
109887934,143,15,2,3,163
109888843,89,3,2,1,95
109892204,28,3,2,1,34
109895634,72,13,56,9,150
109899096,180,97,4,4,285
109909867,160,3,2,1,166
109913454,148,14,37,2,201
109923574,13,75,2,1,91
109930877,97,25,70,76,268
109940220,73,22,2,3,100
109954015,29,21,15,15,80
109958942,14,3,2,1,20
109972859,70,38,10,5,123
109974007,82,3,2,5,92
109980571,14,8,2,1,25
109982099,24,12,2,3,41
110003655,11,45,2,5,63
110007109,19,61,2,1,83
110035021,31,3,2,1,37
110035675,52,75,2,3,132
110055620,24,11,6,1,42
110069159,38,26,14,1,79
110073071,164,28,4,5,201
110081558,53,11,28,2,94
110086236,80,16,9,4,109
110093901,187,6,2,2,197
110120348,145,17,207,2,371
110124045,10,6,2,1,19
110126467,116,22,22,1,161
110127975,13,14,2,1,30
110131943,10,5,3,1,19
110142089,258,3,2,2,265
110153295,68,3,2,1,74
110156477,74,12,11,2,99
110158051,106,19,84,7,216
110161352,190,3,2,26,221
110161400,107,66,59,4,236
110177080,19,3,2,1,25
110179748,132,30,31,43,236
110190797,47,18,27,1,93
110191805,25,40,2,1,68
110212604,22,30,5,2,59
110215770,71,16,2,1,90
110217487,96,11,71,1,179
110225990,123,3,2,1,129
110226725,69,54,35,1,159
110236539,154,51,24,2,231
110245426,19,18,2,1,40
110247604,12,8,2,1,23
110248535,28,12,2,3,45
110249208,140,28,3,3,174
110259403,11,3,2,1,17
110271539,22,57,8,1,88
110276117,35,32,20,1,88
110288186,46,3,2,1,52
110303355,62,3,2,2,69
110305418,24,29,2,11,66
110319249,35,13,2,1,51
110326609,110,14,2,8,134
110337563,69,26,25,38,158
110348734,37,6,2,1,46
110351868,132,8,135,11,286
110352971,48,19,11,7,85
110357728,118,5,25,1,149
110372903,56,3,2,1,62
110393837,13,37,31,3,84
110410667,35,6,14,1,56
110410775,13,3,2,1,19
110416699,64,15,66,3,148
110430273,55,49,63,2,169
110438642,164,3,2,3,172
110453337,63,8,2,4,77
110468692,105,23,3,3,134
110474469,171,6,2,35,214
110478531,60,22,2,2,86
110486767,71,5,11,1,88
110504947,42,3,2,1,48
110518532,30,3,2,1,36
110523594,131,3,2,2,138
110533729,57,18,29,1,105
110557135,10,3,2,10,25
110588637,24,3,2,1,30
110592024,51,59,12,6,128
110596966,23,29,4,2,58
110601868,10,8,2,5,25
110615542,164,5,2,2,173
110627209,16,9,2,1,28
110636993,11,3,2,1,17
110641581,13,3,2,1,19
110701953,44,3,2,4,53
110709251,36,18,2,1,57
110710912,80,35,2,1,118
110711849,198,9,2,1,210
110721360,109,24,2,2,137
110729038,180,43,2,1,226
110759508,13,11,4,1,29
110781174,117,3,2,1,123
110812046,34,26,13,1,74
110817506,57,22,21,1,101
110833166,31,3,2,1,37
110838222,56,43,2,1,102
110842488,10,3,2,29,44
110851293,78,32,11,3,124
110872496,12,3,2,1,18
110877566,28,3,2,1,34
110881079,44,47,69,1,161
110882951,25,3,2,2,32
110888470,25,3,2,6,36
110893054,28,3,2,1,34
110918234,143,3,2,2,150
110921573,14,3,2,3,22
110942426,21,8,2,10,41
110953583,94,21,73,2,190
110957595,63,24,47,10,144
110958287,36,57,8,36,137
110966155,61,20,2,3,86
110999356,72,32,37,26,167
111046896,58,35,20,28,141
111057619,101,19,2,1,123
111057993,14,3,2,2,21
111066155,57,16,11,1,85
111074825,53,107,35,8,203
111081719,21,53,3,3,80
111109040,121,3,2,1,127
111110275,60,16,12,4,92
111114211,13,3,2,1,19
111122655,37,9,11,1,58
111126993,39,3,2,1,45
111128081,57,10,2,2,71
111128173,155,3,2,1,161
111132436,18,10,6,1,35
111135128,208,30,33,7,278
111137809,119,31,3,25,178
111151562,11,11,2,1,25
111152954,56,3,2,1,62
111153379,20,3,2,7,32
111159342,88,40,2,1,131
111162555,92,3,2,1,98
111171349,24,55,22,1,102
111186146,36,34,22,5,97
111196245,21,42,13,8,84
111200253,13,3,2,2,20
111200504,35,3,2,4,44
111204428,138,3,2,5,148
111211865,22,3,2,2,29
111222060,134,27,7,5,173
111236981,191,21,2,10,224
111243127,43,15,4,8,70
111247325,133,31,40,2,206
111249168,183,7,3,16,209
111252416,14,3,2,1,20
111263163,55,6,7,3,71
111265136,17,17,2,1,37
111338495,70,3,2,41,116
111343088,50,22,20,1,93
111349144,76,21,10,8,115
111350958,134,38,6,3,181
111377036,78,14,2,2,96
111389805,17,5,2,1,25
111398573,45,37,11,26,119
111401494,27,3,2,5,37
111415818,78,11,6,1,96
111430666,40,32,5,3,80
111435562,38,20,20,11,89
111437685,21,4,10,1,36
111447157,126,26,5,2,159
111462567,12,3,2,1,18
111471255,79,56,2,4,141
111477614,13,3,2,1,19
111484696,99,18,2,23,142
111499978,49,57,21,14,141
111505580,11,3,2,1,17
111506333,97,6,2,14,119
111506453,10,17,2,1,30
111516475,39,11,2,1,53
111521698,11,3,2,1,17
111545647,50,27,50,8,135
111548619,63,3,2,1,69
111557503,112,24,12,9,157
111558286,31,40,54,11,136
111563253,139,12,80,3,234
111570097,130,52,30,8,220
111582913,165,3,2,7,177
111591654,11,3,2,4,20
111609663,91,37,60,6,194
111619035,36,8,42,1,87
111627090,25,25,2,1,53
111630014,10,5,2,1,18
111633832,58,16,20,1,95
111637541,63,35,40,4,142
111642031,10,11,2,3,26
111645383,39,4,2,3,48
111651719,17,5,2,1,25
111656621,87,33,3,17,140
111658629,44,3,2,1,50
111662980,72,7,2,10,91
111665309,261,30,15,15,321
111666492,64,43,43,4,154
111672406,10,5,2,1,18
111672808,105,48,17,8,178
111673990,101,66,2,1,170
111700742,220,40,27,7,294
111727395,28,35,2,4,69
111770683,45,28,3,1,77
111801498,11,3,2,1,17
111803228,80,8,2,37,127
111833855,86,3,2,16,107
111838362,32,12,2,1,47
111840704,638,3,2,13,656
111841420,15,14,2,2,33
111842267,20,26,3,1,50
111868735,17,3,2,2,24
111869751,125,98,13,7,243
111873366,77,34,2,1,114
111883340,101,21,6,29,157
111898275,22,21,19,1,63
111906610,17,59,2,1,79
111909027,926,3,2,103,1034
111911324,33,12,2,1,48
111927587,44,19,10,9,82
111933161,15,13,2,1,31
111938112,39,12,7,1,59
111938597,94,52,69,1,216
111939668,82,3,2,1,88
111947775,10,10,2,1,23
111968020,141,32,3,1,177
111971897,35,32,19,9,95
111996212,150,30,85,35,300
111996425,100,27,10,4,141
112002662,160,24,41,7,232
112005933,59,32,2,1,94
112017178,50,10,8,5,73
112023832,75,15,2,1,93
112039392,21,3,2,1,27
112046673,45,42,3,3,93
112048854,110,3,2,6,121
112050837,28,25,2,25,80
112055646,36,14,3,11,64
112075131,34,23,2,1,60
112081337,93,43,20,1,157
112088943,31,16,2,5,54
112115572,153,16,16,4,189
112121941,68,3,2,1,74
112135107,89,3,2,1,95
112142631,34,37,2,3,76
112142706,21,3,2,1,27
112148445,40,64,10,9,123
112166810,43,6,8,1,58
112184373,85,3,2,3,93
112189137,60,3,2,1,66
112191774,14,3,2,1,20
112192282,92,21,2,1,116
112205195,63,10,2,2,77
112218069,197,116,37,13,363
112238155,92,6,11,4,113
112239501,12,4,2,4,22
112256513,19,41,2,1,63
112271952,35,19,5,2,61
112281940,185,32,23,1,241
112320364,30,18,2,1,51
112334481,42,21,41,6,110
112337622,48,14,12,12,86
112343797,12,3,2,1,18
112352203,38,3,2,1,44
112354733,18,3,2,1,24
112369462,32,21,5,1,59
112378191,11,23,9,12,55
112379607,131,19,2,2,154
112407001,17,4,2,1,24
112436261,284,4,2,24,314
112437863,83,26,51,1,161
112441183,81,19,9,9,118
112457641,37,3,3,1,44
112472590,49,18,60,1,128
112476510,42,23,11,5,81
112488798,76,52,2,15,145
112491948,11,3,2,1,17
112508041,45,17,5,1,68
112521724,10,11,2,1,24
112531695,74,3,4,1,82
112533785,30,17,2,5,54
112541741,22,35,2,4,63
112548160,68,20,46,1,135
112551878,193,15,5,7,220
112567070,38,3,2,5,48
112589157,25,3,2,2,32
112625833,128,3,2,1,134
112631861,41,34,21,1,97
112636422,92,33,2,15,142
112640124,41,12,2,1,56
112645406,19,3,2,1,25
112649347,20,4,2,1,27
112654876,40,50,22,15,127
112667013,11,31,4,1,47
112703512,57,23,23,10,113
112713675,102,3,2,1,108
112716090,71,20,4,5,100
112723601,56,27,2,26,111
112744737,13,10,2,1,26
112751188,37,70,29,37,173
112762936,223,19,2,30,274
112765960,91,49,26,1,167
112770647,84,23,2,7,116
112770675,63,25,28,1,117
112772090,10,4,2,1,17
112777567,33,22,20,1,76
112781017,107,139,54,1,301
112782308,12,3,2,1,18
112786608,19,25,2,1,47
112795523,84,44,30,6,164
112799935,21,37,4,1,63
112827555,37,46,24,7,114
112828424,11,3,2,1,17
112830314,18,17,2,5,42
112841580,13,3,2,1,19
112859149,13,25,2,1,41
112880799,30,27,5,14,76
112890272,63,6,2,13,84
112897012,130,21,26,38,215
112905687,110,3,2,38,153
112906899,112,12,34,21,179
112910104,58,40,5,2,105
112913296,130,6,3,2,141
112920181,148,16,35,7,206
112920585,14,3,2,2,21
112922355,19,35,12,14,80
112932780,38,36,21,5,100
112943303,59,8,16,1,84
112943362,67,27,8,16,118
112959817,33,49,16,9,107
112962912,65,3,88,2,158
112969610,108,25,2,1,136
112977460,63,108,2,8,181
112982390,10,9,2,7,28
112983236,83,14,6,11,114
112984011,86,22,2,1,111
113008600,46,58,13,5,122
113013921,43,29,2,12,86
113015259,43,36,20,1,100
113021242,66,59,29,14,168
113026271,89,37,42,14,182
113036254,20,4,2,1,27
113042941,183,35,51,2,271
113043293,263,45,2,4,314
113044427,55,21,7,29,112
113048633,25,66,2,1,94
113054988,29,34,31,5,99
113064780,57,10,14,1,82
113067933,11,3,2,1,17
113069212,11,3,2,1,17
113092339,53,3,2,1,59
113097061,16,16,2,4,38
113104182,147,20,26,16,209
113104210,107,25,38,24,194
113112117,16,28,2,1,47
113117431,13,3,2,1,19
113157067,41,32,2,1,76
113159182,64,70,18,8,160
113160213,153,3,2,3,161
113160755,92,3,2,11,108
113186751,32,33,14,1,80
113219033,114,20,17,11,162
113223199,32,41,4,5,82
113231035,68,31,2,21,122
113232779,34,3,2,1,40
113236294,95,3,2,3,103
113240482,137,5,9,1,152
113260537,73,15,12,4,104
113261774,26,3,2,1,32
113262583,82,24,31,5,142
113296994,17,6,2,1,26
113297405,31,3,2,1,37
113299074,11,3,2,2,18
113304699,48,43,2,1,94
113316390,38,7,2,2,49
113321646,11,6,2,1,20
113346691,81,5,2,1,89
113346991,124,3,2,4,133
113364244,106,33,29,1,169
113400733,45,41,44,3,133
113401573,34,35,8,2,79
113425369,19,4,2,1,26
113431150,10,14,2,1,27
113439217,13,41,2,1,57
113449122,134,86,49,10,279
113450657,41,31,12,16,100
113454017,94,48,27,29,198
113457609,110,89,56,1,256
113474970,36,98,36,1,171
113480662,50,39,3,4,96
113495260,129,3,2,1,135
113512220,33,3,2,1,39
113515721,19,3,2,1,25
113527995,21,14,2,1,38
113545279,46,60,22,6,134
113545715,97,27,3,21,148
113547044,46,9,18,17,90
113549955,128,3,2,1,134
113556221,83,3,2,40,128
113569954,51,3,2,1,57
113570135,61,54,3,9,127
113577733,12,3,2,1,18
113578576,105,12,2,3,122
113579497,38,59,12,3,112
113595831,18,61,3,1,83
113610808,26,3,2,1,32
113617678,21,6,2,2,31
113622981,139,3,2,6,150
113639592,136,3,2,7,148
113641677,86,3,2,1,92
113658683,81,37,18,11,147
113662737,87,28,2,3,120
113667552,14,25,2,1,42
113668229,75,30,87,1,193
113684050,20,3,2,16,41
113688790,14,3,2,1,20
113690640,33,37,26,60,156
113691466,103,3,2,3,111
113696898,12,3,2,1,18
113716279,65,34,3,2,104
113733714,33,4,2,3,42
113737381,48,9,5,1,63
113756595,106,103,34,1,244
113770780,200,19,3,2,224
113771285,65,3,2,1,71
113774203,18,9,3,5,35
113792359,12,3,2,1,18
113808602,150,34,3,1,188
113809395,25,26,14,3,68
113815079,23,3,2,3,31
113816096,16,6,3,1,26
113823237,21,14,2,8,45
113833910,182,7,2,9,200
113851017,11,3,2,2,18
113862268,13,3,2,1,19
113886395,42,25,2,1,70
113888023,144,20,9,10,183
113905132,72,41,39,3,155
113926690,126,18,2,1,147
113944875,14,18,2,1,35
113947792,72,34,71,27,204
113947965,47,72,52,2,173
113952768,16,23,2,3,44
113964093,16,3,2,2,23
113975195,74,3,2,1,80
113998971,78,6,3,3,90
114017387,28,3,2,13,46
114017880,83,46,2,9,140
114017937,75,20,2,4,101
114023473,87,4,3,2,96
114028131,50,3,2,1,56
114034083,22,3,2,1,28
114037936,33,31,2,1,67
114039687,114,3,2,1,120
114085482,95,19,26,30,170
114086168,47,3,2,3,55
114096920,66,52,43,5,166
114098336,32,17,2,1,52
114112922,43,5,2,7,57
114118254,13,14,13,1,41
114129965,85,33,6,4,128
114130053,44,31,16,1,92
114144466,24,3,2,1,30
114147344,60,41,44,14,159
114157145,51,18,2,8,79
114168484,178,3,2,1,184
114177882,57,25,145,18,245
114192926,49,27,17,6,99
114193765,143,3,2,1,149
114198446,41,25,27,3,96
114199244,74,3,2,2,81
114219614,22,3,2,3,30
114220250,114,49,2,1,166
114223337,124,13,2,1,140
114227157,19,3,2,4,28
114227489,128,12,11,7,158
114233299,74,6,2,2,84
114235546,112,73,2,11,198
114247305,45,29,2,1,77
114248262,91,135,58,13,297
114257283,10,4,2,1,17
114280669,29,32,65,1,127
114286807,163,36,2,26,227
114299966,114,9,2,1,126
114305928,16,3,2,2,23
114324614,102,3,2,4,111
114340449,79,62,14,17,172
114340974,44,17,2,3,66
114354786,34,5,2,6,47
114365158,19,3,12,1,35
114367007,37,36,6,20,99
114385148,36,5,14,1,56
114396389,28,3,2,1,34
114401083,31,36,6,2,75
114407708,101,39,13,1,154
114441551,55,69,31,1,156
114448567,33,14,15,3,65
114478116,27,3,2,1,33
114480191,100,3,2,1,106
114484795,214,22,52,6,294
114496061,17,3,2,1,23
114506938,74,3,2,1,80
114512386,87,50,6,6,149
114533377,38,43,2,13,96
114541114,30,3,2,1,36
114587479,117,45,25,10,197
114588216,19,3,2,1,25
114607311,20,3,2,1,26
114612501,13,9,2,1,25
114623072,68,3,2,1,74
114640650,56,23,2,3,84
114654074,86,3,2,4,95
114675176,483,3,2,10,498
114683336,13,11,2,1,27
114684990,129,66,4,17,216
114692523,13,4,2,1,20
114694388,200,17,20,2,239
114702215,81,41,62,51,235
114716868,11,13,2,1,27
114722203,135,12,13,3,163
114728755,182,3,33,67,285
114734856,31,3,2,1,37
114739579,43,7,2,1,53
114744183,60,3,2,9,74
114757246,105,12,23,1,141
114761494,22,4,2,5,33
114770989,106,34,12,2,154
114776321,44,5,2,1,52
114780033,27,16,6,1,50
114788737,88,40,3,9,140
114792823,52,68,18,1,139
114796155,124,32,11,1,168
114799720,21,23,2,4,50
114799892,13,49,19,1,82
114808073,39,3,2,1,45
114824647,102,3,2,1,108
114855718,13,3,2,1,19
114864635,59,3,2,1,65
114864722,185,26,19,3,233
114868566,75,38,7,1,121
114872945,95,69,113,43,320
114874950,100,5,2,1,108
114878047,10,6,2,1,19
114879485,26,15,3,21,65
114907066,43,9,16,18,86
114920126,34,64,20,16,134
114932590,11,3,2,1,17
114953355,106,3,2,1,112
114959423,21,11,3,6,41
114975022,19,3,2,1,25
114979220,63,27,3,4,97
114982525,95,28,15,14,152
114983174,138,14,3,1,156
114983337,48,26,4,12,90
114999472,101,51,144,15,311
115002319,21,3,2,1,27
115027072,150,33,75,12,270
115041054,36,19,2,3,60
115042098,111,40,76,16,243
115045717,10,5,2,1,18
115055734,12,6,2,1,21
115055894,13,3,2,1,19
115068529,17,7,8,5,37
115072129,128,14,2,1,145
115080098,90,35,7,13,145
115083925,99,46,53,2,200
115092171,199,10,43,5,257
115092501,154,26,3,1,184
115103248,71,3,2,2,78
115104093,12,3,2,1,18
115104593,129,3,2,6,140
115107209,62,14,2,13,91
115115591,134,26,2,1,163
115142102,21,54,36,32,143
115154988,124,3,2,1,130
115158520,10,8,2,1,21
115163250,116,8,2,1,127
115173976,16,51,2,1,70
115177631,11,3,2,1,17
115188509,34,28,2,4,68
115190546,112,16,10,1,139
115203266,34,3,2,3,42
115206253,66,70,14,7,157
115208445,85,9,2,2,98
115218454,40,29,2,1,72
115247040,171,12,2,3,188
115254922,75,21,2,1,99
115257162,59,19,2,1,81
115260008,28,4,2,1,35
115262727,115,8,46,1,170
115264461,182,22,34,42,280
115281822,28,11,8,13,60
115284387,89,30,2,1,122
115294950,95,3,2,7,107
115313325,27,45,10,1,83
115315070,180,29,2,5,216
115317762,93,24,29,2,148
115326535,11,3,2,1,17
115330736,23,3,2,1,29
115345301,56,9,7,15,87
115351684,133,36,20,4,193
115353177,12,3,2,1,18
115357311,175,3,2,1,181
115376589,48,39,20,1,108
115388420,35,3,2,6,46
115389054,51,129,12,6,198
115435812,58,3,2,2,65
115444010,93,15,2,17,127
115449739,207,50,19,2,278
115455848,103,3,2,1,109
115463370,28,4,2,2,36
115471246,47,31,23,10,111
115474642,305,3,2,19,329
115479945,71,27,48,29,175
115488906,41,12,2,2,57
115490339,154,3,2,1,160
115511108,12,3,2,1,18
115522214,182,27,51,20,280
115522596,118,63,52,10,243
115525999,53,6,11,6,76
115528576,11,3,2,1,17
115529565,59,3,2,1,65
115534752,36,41,26,34,137
115543174,67,17,19,1,104
115555394,114,35,27,12,188
115558882,17,50,25,5,97
115563965,56,62,5,3,126
115569042,43,10,2,13,68
115573121,148,10,60,16,234
115577301,12,3,2,1,18
115577774,25,23,4,1,53
115583880,93,26,2,2,123
115599691,94,59,26,2,181
115600011,10,10,2,1,23
115636829,46,11,2,1,60
115672083,212,7,2,1,222
115681067,88,17,6,3,114
115688339,38,3,2,1,44
115690301,51,13,3,1,68
115691007,12,3,2,1,18
115694554,34,15,17,13,79
115699937,21,3,15,1,40
115704350,47,33,2,1,83
115749389,89,19,64,18,190
115751490,10,4,2,1,17
115789624,26,3,2,1,32
115816946,33,3,2,4,42
115828109,60,51,34,1,146
115834448,52,42,35,1,130
115864431,232,19,140,1,392
115865521,112,3,2,1,118
115865642,44,39,56,17,156
115867706,13,3,2,1,19
115870986,11,3,2,1,17
115931132,45,13,10,4,72
115943325,49,35,2,1,87
115945115,35,56,15,9,115
115946198,27,12,9,12,60
115953684,57,3,2,1,63
115971779,14,3,2,1,20
115982896,14,27,4,2,47
115990358,91,23,21,6,141
115995780,17,3,2,1,23
116002936,28,32,2,1,63
116015949,58,32,17,16,123
116017997,107,15,95,56,273
116024873,12,3,2,3,20
116028693,67,11,34,13,125
116045545,94,23,12,9,138
116056866,10,27,2,1,40
116083675,60,30,18,27,135
116092425,99,3,2,1,105
116099653,50,3,2,13,68
116101407,105,12,25,3,145
116113352,42,22,13,2,79
116116673,10,3,2,3,18
116131145,15,27,2,1,45
116149995,90,3,2,1,96
116174572,194,46,5,37,282
116182236,44,21,2,6,73
116186532,114,37,2,1,154
116196770,196,21,2,1,220
116203527,98,27,2,3,130
116207515,290,3,2,9,304
116217723,40,3,28,1,72
116218315,44,3,2,3,52
116224011,16,3,2,1,22
116231289,139,96,19,1,255
116239394,10,21,2,1,34
116242881,69,19,2,9,99
116243927,38,3,2,1,44
116247664,69,53,67,4,193
116260413,23,6,2,4,35
116265073,36,38,14,3,91
116267239,28,3,2,7,40
116291692,56,52,4,3,115
116293134,43,19,41,1,104
116296845,90,3,2,2,97
116300141,39,29,42,83,193
116304833,11,3,2,2,18
116316469,612,3,2,1,618
116318001,169,50,39,18,276
116319396,12,3,2,1,18
116326746,57,3,2,11,73
116330159,41,19,24,10,94
116333447,56,22,2,9,89
116337172,21,3,2,1,27
116349960,191,95,7,5,298
116354738,65,40,11,4,120
116366752,10,21,2,4,37
116368273,140,3,2,2,147
116371891,153,8,2,5,168
116382863,15,17,2,1,35
116406455,108,26,2,2,138
116424917,59,11,2,11,83
116426916,23,3,2,2,30
116453070,14,3,2,1,20
116454491,184,3,2,2,191
116463129,22,24,8,1,55
116468465,301,11,53,7,372
116469607,11,3,2,3,19
116483112,20,10,2,1,33
116492802,66,25,3,1,95
116504154,126,43,6,1,176
116518321,18,3,2,1,24
116523471,15,3,2,1,21
116527255,61,9,31,3,104
116544830,129,9,11,4,153
116559496,46,32,15,1,94
116569765,16,37,3,1,57
116583702,93,24,35,1,153
116638842,16,8,19,2,45
116639149,108,36,3,3,150
116641818,11,4,2,1,18
116658996,16,11,2,10,39
116693789,170,47,4,26,247
116707956,87,34,3,6,130
116709663,62,58,15,15,150
116722129,28,11,7,8,54
116727348,44,10,2,3,59
116727791,106,3,2,4,115
116731626,52,3,2,2,59
116731733,17,3,2,1,23
116738842,21,4,2,1,28
116744537,65,23,57,7,152
116748259,16,3,2,1,22
116753479,113,40,44,17,214
116754696,66,3,2,1,72
116778400,37,24,54,8,123
116779081,613,3,2,5,623
116784861,71,21,16,3,111
116800652,27,9,10,4,50
116801075,25,6,2,1,34
116802412,68,3,2,1,74
116806870,58,30,38,26,152
116819661,107,6,23,1,137
116837538,174,22,2,52,250
116860630,30,12,2,1,45
116868496,38,3,2,1,44
116868854,106,3,2,29,140
116875256,20,3,2,1,26
116884818,145,3,5,1,154
116885922,112,3,13,3,131
116896295,45,40,26,4,115
116897821,109,21,2,3,135
116900640,91,21,2,1,115
116912336,12,3,2,1,18
116919767,63,44,36,59,202
116925602,11,3,2,2,18
116938361,13,3,2,1,19
116945228,75,28,2,6,111
116954365,97,3,2,6,108
116956554,54,8,4,5,71
116959240,84,15,28,2,129
116994169,110,3,2,4,119
116995745,172,3,2,8,185
116996113,87,30,6,1,124
117002308,17,6,2,1,26
117018794,17,32,11,2,62
117034588,35,18,8,2,63
117065609,46,14,2,3,65
117068563,61,3,2,6,72
117074307,11,3,2,2,18
117087562,103,8,2,19,132
117091030,109,11,6,6,132
117104655,46,42,33,30,151
117119358,88,27,2,1,118
117129290,427,3,2,2,434
117152192,26,16,2,6,50
117160684,61,34,60,2,157
117163545,56,45,15,1,117
117175492,221,41,72,3,337
117185405,20,3,2,1,26
117187079,12,3,2,1,18
117189564,37,26,11,7,81
117192901,55,11,22,23,111
117193652,68,17,2,5,92
117208216,30,7,98,2,137
117209012,20,24,21,1,66
117211284,72,28,2,14,116
117214918,120,61,11,16,208
117215734,41,3,2,1,47
117219506,11,18,2,1,32
117246831,13,51,2,1,67
117261564,48,9,3,1,61
117262678,11,3,2,1,17
117265556,55,3,2,1,61
117272326,52,10,2,9,73
117276677,44,9,2,1,56
117283814,45,25,6,1,77
117287710,60,43,15,7,125
117291788,80,19,2,1,102
117294710,22,7,2,3,34
117314303,13,17,2,1,33
117329078,24,11,54,1,90
117334526,98,3,2,1,104
117359024,11,3,2,1,17
117359877,10,3,2,2,17
117362299,46,36,82,1,165
117367693,17,10,52,1,80
117402160,82,28,33,12,155
117402555,201,24,2,3,230
117405912,41,3,2,1,47
117406376,84,3,2,1,90
117410115,171,39,6,1,217
117418468,65,64,3,5,137
117433583,25,3,2,1,31
117435024,113,17,3,1,134
117443651,55,40,33,1,129
117453271,10,8,2,1,21
117471001,17,10,2,1,30
117478476,62,8,5,2,77
117492914,24,43,54,72,193
117507502,93,3,15,7,118
117519831,114,3,2,33,152
117535429,102,3,2,9,116
117540673,20,17,7,3,47
117559956,80,52,13,14,159
117568033,50,44,20,1,115
117582365,50,3,2,13,68
117606257,88,38,2,1,129
117624349,99,6,2,1,108
117628045,12,3,2,1,18
117633708,46,7,11,1,65
117645910,32,54,79,1,166
117647880,104,3,2,11,120
117658082,16,3,2,1,22
117660090,174,12,2,12,200
117678046,261,3,2,5,271
117697845,56,68,52,17,193
117700231,63,25,48,26,162
117703769,91,11,21,1,124
117704537,36,3,2,1,42
117712103,21,9,2,2,34
117725268,15,5,2,1,23
117731395,91,31,8,1,131
117750269,15,15,3,1,34
117757239,73,44,7,4,128
117760484,143,38,3,2,186
117772265,43,12,3,22,80
117779373,27,13,3,1,44
117780657,102,3,2,12,119
117781539,710,3,30,86,829
117782917,45,51,3,1,100
117785266,13,3,2,1,19
117786664,56,30,109,11,206
117804774,92,40,25,19,176
117808415,119,24,12,22,177
117834709,67,8,15,11,101
117843171,134,42,24,1,201
117850187,71,45,54,8,178
117856245,16,3,2,1,22
117858590,10,7,2,2,21
117871516,15,14,10,6,45
117882031,73,55,2,8,138
117894244,123,3,2,1,129
117903318,54,36,41,1,132
117919445,10,4,2,1,17
117931565,78,3,2,3,86
117932054,174,3,2,11,190
117933784,71,3,2,1,77
117945207,31,3,2,1,37
117952399,36,35,45,1,117
117973206,32,4,26,7,69
117998988,19,6,4,1,30
118000961,132,3,2,1,138
118007058,27,23,3,9,62
118013246,47,6,2,1,56
118017161,98,3,2,1,104
118017200,27,40,2,1,70
118017220,26,3,2,1,32
118021782,60,64,2,59,185
118023597,89,10,3,1,103
118033394,32,3,2,4,41
118034661,29,28,10,1,68
118038567,20,3,2,6,31
118062760,60,18,12,12,102
118069071,67,14,2,1,84
118096607,13,5,2,1,21
118135023,70,23,2,1,96
118136224,92,25,40,10,167
118144954,22,4,2,1,29
118146561,19,22,2,1,44
118162956,41,3,2,1,47
118163733,22,16,4,3,45
118164048,43,68,20,4,135
118168893,37,10,2,9,58
118173897,77,36,12,28,153
118193700,10,20,2,1,33
118201726,67,28,2,5,102
118224386,57,35,4,2,98
118237406,23,3,2,3,31
118243289,19,3,2,1,25
118243408,83,32,2,3,120
118248679,32,20,12,31,95
118251609,87,8,2,1,98
118260420,95,36,29,2,162
118261411,64,3,2,6,75
118321127,101,47,31,13,192
118333759,119,22,9,36,186
118339921,10,11,2,1,24
118346672,123,3,2,1,129
118349446,30,7,2,4,43
118350719,59,3,2,1,65
118350732,39,30,52,10,131
118351193,88,3,2,1,94
118353470,54,59,10,16,139
118368986,30,3,2,4,39
118370205,167,24,2,11,204
118372742,75,8,3,2,88
118378671,109,18,86,1,214
118394846,44,3,2,5,54
118396174,62,38,3,1,104
118398968,56,52,2,12,122
118406020,114,35,56,6,211
118406666,53,9,26,22,110
118410313,40,15,3,1,59
118413890,156,34,69,6,265
118434550,45,37,19,1,102
118435065,57,12,2,5,76
118451139,206,3,2,17,228
118459340,102,36,10,11,159
118471012,25,31,4,3,63
118472326,145,28,16,28,217
118483397,47,3,2,1,53
118491161,94,35,54,3,186
118494752,146,20,2,2,170
118496483,82,44,42,3,171
118498927,11,3,2,1,17
118520909,50,3,2,1,56
118523273,23,16,4,7,50
118524937,23,10,3,3,39
118529674,71,32,47,66,216
118542807,12,23,2,2,39
118545537,60,3,2,4,69
118549393,136,36,63,1,236
118563063,109,28,26,1,164
118569021,43,3,41,6,93
118572682,13,9,2,1,25
118577424,105,21,2,5,133
118577437,27,3,2,1,33
118602523,33,22,2,2,59
118602933,33,10,3,5,51
118607867,10,4,2,1,17
118609561,90,26,30,10,156
118623967,157,29,2,5,193
118628379,19,9,10,1,39
118654856,18,20,21,30,89
118663574,168,57,100,12,337
118680731,20,55,65,5,145
118685031,149,3,2,2,156
118690914,127,28,51,27,233
118691964,14,3,2,4,23
118696421,11,25,2,2,40
118713599,83,23,2,6,114
118770500,73,3,2,1,79
118771400,49,3,2,1,55
118773066,119,52,32,15,218
118781127,46,3,2,6,57
118783770,74,14,16,1,105
118808265,10,3,2,2,17
118812109,104,19,6,4,133
118815264,52,3,2,1,58
118832623,17,20,2,2,41
118849751,93,3,2,1,99
118854966,28,7,9,1,45
118866607,63,49,28,1,141
118873514,31,7,2,9,49
118890235,49,4,3,1,57
118891018,35,8,5,14,62
118893836,62,3,2,10,77
118896704,120,5,18,3,146
118897762,178,29,12,17,236
118904051,74,19,11,3,107
118906677,23,3,5,1,32
118911304,87,6,3,5,101
118912510,119,32,38,9,198
118913419,137,20,2,27,186
118929743,123,3,2,1,129
118962758,45,20,11,5,81
119016143,10,21,2,1,34
119030889,123,9,79,51,262
119033346,50,3,2,2,57
119042683,50,26,78,4,158
119043769,155,3,2,1,161
119062869,20,3,2,1,26
119071594,48,3,2,1,54
119075178,138,39,6,1,184
119077616,89,14,2,9,114
119079486,14,3,2,1,20
119090606,139,3,2,1,145
119105060,47,12,2,1,62
119110145,12,10,2,4,28
119137833,64,16,2,2,84
119140737,48,14,42,2,106
119149402,76,10,2,1,89
119150257,44,23,3,12,82
119155438,22,14,2,1,39
119156575,12,15,2,2,31
119160279,15,16,11,1,43
119173736,13,6,2,1,22
119188568,87,32,40,4,163
119191984,40,3,2,1,46
119192119,11,3,2,1,17
119194048,26,38,59,33,156
119197127,16,13,2,1,32
119203163,11,31,2,2,46
119208777,152,3,2,14,171
119216069,49,20,2,1,72
119222137,53,14,3,1,71
119238908,36,3,2,1,42
119255026,87,3,2,2,94
119304847,62,10,3,3,78
119308064,62,3,2,1,68
119313487,10,7,2,1,20
119332622,12,3,2,1,18
119349546,49,3,2,6,60
119370447,149,8,35,1,193
119373452,12,3,2,1,18
119380185,53,27,2,5,87
119383436,15,3,2,1,21
119418262,60,3,2,1,66
119438564,86,47,24,2,159
119450639,26,8,14,6,54
119451289,70,8,2,7,87
119457169,119,3,2,1,125
119457832,109,10,2,10,131
119461773,20,66,3,6,95
119470222,127,7,17,2,153
119475808,48,45,36,10,139
119477810,120,4,2,2,128
119483184,22,3,2,1,28
119485721,89,9,50,1,149
119511851,134,3,2,4,143
119513067,57,11,2,2,72
119520208,46,3,2,1,52
119520852,49,35,28,9,121
119541264,73,34,2,1,110
119546156,24,3,2,6,35
119553122,88,32,5,11,136
119580090,42,78,10,6,136
119588880,40,30,2,1,73
119589385,94,48,3,7,152
119592222,44,45,46,19,154
119593021,48,22,46,3,119
119597006,79,3,2,1,85
119609559,134,9,3,12,158
119621554,175,4,2,27,208
119635823,71,41,24,10,146
119640361,79,4,12,2,97
119643904,36,133,16,2,187
119645425,10,3,2,6,21
119648503,49,70,7,4,130
119671010,64,3,2,7,76
119672355,93,69,15,90,267
119690706,143,58,17,49,267
119691172,37,3,2,1,43
119707148,67,143,14,1,225
119724510,59,11,2,1,73
119726759,225,3,2,26,256
119733526,37,75,99,1,212
119735647,15,3,2,1,21
119762653,28,3,2,1,34
119764513,95,23,2,23,143
119786460,78,18,14,2,112
119789949,36,22,73,39,170
119795516,48,15,4,1,68
119797770,13,3,2,6,24
119801265,73,16,33,27,149
119814920,76,3,2,5,86
119815790,41,20,2,7,70
119815813,17,3,2,1,23
119823162,35,19,3,11,68
119824122,13,3,2,2,20
119828664,12,10,2,5,29
119829161,47,72,27,43,189
119831095,37,13,7,7,64
119839604,117,3,4,1,125
119842663,13,3,2,1,19
119845288,10,3,2,3,18
119856128,277,11,2,2,292
119863057,36,37,4,9,86
119863670,130,48,57,14,249
119877539,11,3,2,1,17
119894405,170,70,2,7,249
119898522,13,12,2,1,28
119916649,40,34,8,2,84
119958398,79,9,2,14,104
119972466,96,7,16,1,120
119990675,142,8,4,6,160
119997360,69,9,25,4,107
120005093,95,64,12,7,178
120012824,14,40,2,1,57
120015207,18,3,2,7,30
120024629,53,3,3,4,63
120025039,83,61,10,2,156
120025223,46,4,2,1,53
120026046,15,3,2,1,21
120026677,30,3,2,1,36
120031696,35,95,2,2,134
120040022,70,15,23,8,116
120046626,136,3,2,3,144
120057244,41,6,5,6,58
120085015,213,3,2,2,220
120086024,13,6,2,1,22
120090379,25,62,25,1,113
120092369,35,3,2,2,42
120105983,146,24,93,11,274
120111226,51,31,27,7,116
120111860,14,22,2,1,39
120112388,72,3,2,1,78
120117736,47,16,58,1,122
120129156,48,26,10,9,93
120130962,210,16,59,44,329
120140995,100,16,2,11,129
120142651,162,82,6,35,285
120147218,29,8,2,2,41
120149868,13,8,2,1,24
120150295,90,16,3,1,110
120169393,88,34,23,18,163
120183508,52,33,14,12,111
120218014,16,13,3,3,35
120225919,77,33,38,2,150
120227912,113,30,30,1,174
120229242,43,32,2,5,82
120229766,75,70,51,2,198
120242056,37,17,112,1,167
120250990,45,27,2,1,75
120261862,62,8,2,10,82
120265304,314,6,2,1,323
120273328,62,16,49,1,128
120278488,87,19,3,2,111
120281578,76,3,2,1,82
120284189,195,34,74,3,306
120286190,47,3,2,1,53
120312807,18,51,7,1,77
120319237,26,11,3,12,52
120321894,32,6,2,10,50
120335671,62,28,13,3,106
120344382,102,3,2,1,108
120350532,92,80,28,29,229
120351223,23,34,20,1,78
120351532,48,34,22,8,112
120353752,72,23,60,1,156
120366946,82,38,79,2,201
120368519,56,25,2,18,101
120389307,86,12,53,8,159
120403214,23,24,9,1,57
120406831,210,24,6,7,247
120424281,174,27,23,1,225
120428005,16,22,3,4,45
120431908,86,66,2,1,155
120448224,114,3,2,56,175
120465338,70,52,35,1,158
120470391,82,23,8,10,123
120477473,24,4,2,6,36
120482469,30,3,2,5,40
120486694,165,16,38,1,220
120493268,137,3,2,15,157
120498715,39,29,35,4,107
120499810,14,3,2,3,22
120502787,23,58,15,1,97
120506824,42,20,12,2,76
120509971,10,13,16,1,40
120513876,15,6,2,1,24
120516602,24,44,40,1,109
120520111,87,27,13,22,149
120522883,28,14,2,4,48
120526671,72,3,2,2,79
120528959,98,19,55,4,176
120536259,84,12,2,1,99
120559663,51,7,2,4,64
120568807,21,3,2,1,27
120580733,21,28,2,4,55
120585992,194,44,54,1,293
120592713,11,70,7,1,89
120593951,21,49,2,1,73
120595900,68,3,2,1,74
120614230,113,24,16,11,164
120614577,102,43,20,12,177
120627813,67,3,2,10,82
120639478,13,3,2,1,19
120658136,59,10,2,12,83
120659208,210,27,7,7,251
120668046,20,58,47,2,127
120669936,98,53,22,1,174
120674198,77,3,2,1,83
120675432,74,13,21,3,111
120680745,29,3,2,5,39
120690628,13,3,2,1,19
120695039,101,27,6,4,138
120696703,64,50,11,20,145
120704486,46,34,3,1,84
120707854,18,15,2,1,36
120727526,36,69,3,4,112
120730416,66,18,7,8,99
120734881,39,3,2,1,45
120735830,11,3,2,1,17
120758619,74,26,4,6,110
120760100,24,5,13,13,55
120765185,44,9,19,7,79
120781577,86,29,35,4,154
120789809,67,3,2,1,73
120795011,15,7,2,1,25
120799753,106,3,2,6,117
120800480,17,3,2,1,23
120811926,11,9,2,1,23
120811953,27,4,2,1,34
120827602,77,26,5,11,119
120829837,74,12,6,20,112
120830433,15,3,2,1,21
120836806,16,3,2,1,22
120845762,82,6,10,10,108
120856292,91,3,2,1,97
120857589,167,3,7,10,187
120864042,79,25,23,8,135
120869178,10,3,2,2,17
120877041,23,25,2,5,55
120884849,82,5,2,16,105
120890163,61,64,30,4,159
120898159,28,3,2,1,34
120902829,37,8,2,1,48
120906641,79,38,27,83,227
120921388,69,10,11,5,95
120922978,11,3,2,1,17
120930359,16,17,2,1,36
120936498,15,8,3,3,29
120936567,123,3,2,8,136
120938274,15,6,2,9,32
120938941,100,7,4,6,117
120941667,99,16,76,49,240
120952388,11,3,2,1,17
120955484,49,21,4,1,75
120956880,158,8,4,14,184
120970782,12,3,2,1,18
120984861,77,11,4,1,93
120986902,124,48,110,7,289
120989164,71,20,2,1,94
121004552,35,3,2,1,41
121012861,58,19,40,14,131
121018764,100,32,44,3,179
121021133,45,22,2,1,70
121031663,112,24,37,3,176
121051075,20,3,2,1,26
121063544,86,3,5,1,95
121067908,66,3,2,1,72
121092940,97,3,2,3,105
121103370,158,19,103,5,285
121107644,27,25,10,37,99
121109933,52,3,2,1,58
121123908,111,40,63,22,236
121131606,17,3,2,4,26
121131887,84,29,9,8,130
121135939,30,3,2,2,37
121145840,13,8,2,1,24
121147957,93,11,2,7,113
121152177,150,48,2,25,225
121165275,105,3,2,1,111
121177057,40,43,5,2,90
121177570,65,3,19,1,88
121177938,28,4,2,2,36
121198732,159,5,2,5,171
121199665,29,3,2,7,41
121230411,109,3,2,1,115
121248765,46,15,5,6,72
121262134,17,12,4,4,37
121264324,27,5,4,3,39
121272764,150,15,2,26,193
121274236,57,5,18,1,81
121274261,70,23,2,2,97
121287318,27,6,18,10,61
121287527,121,14,10,18,163
121288549,112,7,8,6,133
121292146,10,3,4,1,18
121295789,72,39,22,2,135
121319516,119,3,2,9,133
121322714,23,31,15,1,70
121329274,38,29,44,10,121
121331326,51,35,72,5,163
121336617,19,3,2,1,25
121340593,82,56,2,15,155
121343152,126,35,2,2,165
121343739,92,6,2,8,108
121376027,188,3,2,3,196
121379036,89,45,10,6,150
121401654,91,28,23,21,163
121402284,113,3,2,1,119
121418963,61,26,2,3,92
121420554,87,6,2,6,101
121431011,13,3,2,1,19
121454025,90,3,85,1,179
121460041,15,3,2,1,21
121483568,39,26,45,3,113
121486862,138,3,9,1,151
121492091,12,8,2,1,23
121497044,86,26,5,7,124
121505204,75,38,2,2,117
121513728,77,3,2,1,83
121517821,47,3,2,1,53
121517861,118,3,2,1,124
121518058,80,3,2,1,86
121531749,18,3,2,1,24
121533935,58,24,34,7,123
121542380,26,3,2,1,32
121545166,71,35,23,16,145
121563136,13,3,23,1,40
121565179,134,23,8,28,193
121579235,50,6,2,4,62
121584835,10,5,2,2,19
121595372,122,3,2,3,130
121597510,63,3,42,1,109
121612157,168,36,19,3,226
121619055,83,4,31,7,125
121623676,70,13,26,28,137
121639929,71,3,2,8,84
121643370,36,21,2,12,71
121646177,297,3,2,8,310
121659520,96,6,2,37,141
121675604,11,3,2,5,21
121701891,82,3,2,9,96
121702103,68,19,55,3,145
121702827,311,4,23,3,341
121703073,35,58,2,2,97
121719124,70,18,7,2,97
121724301,62,3,2,1,68
121728924,19,43,2,17,81
121729902,112,9,2,2,125
121733232,32,6,29,4,71
121751025,203,8,2,4,217
121752074,15,3,2,1,21
121773752,48,14,60,6,128
121790140,85,21,2,3,111
121798688,17,3,2,2,24
121807604,58,22,2,1,83
121811070,87,42,13,2,144
121823108,81,38,17,8,144
121830251,21,3,2,1,27
121853099,45,29,34,2,110
121873314,25,43,3,5,76
121885125,11,7,2,1,21
121889351,40,13,2,3,58
121893053,131,3,2,30,166
121898449,23,29,2,9,63
121929903,44,57,9,3,113
121936244,34,3,2,1,40
121945300,85,3,2,1,91
121945601,98,18,3,1,120
121955748,26,20,2,10,58
121963594,41,3,2,1,47
121967316,38,26,2,2,68
121969667,18,3,2,1,24
121972765,176,20,2,1,199
121976756,15,8,2,1,26
121986851,131,3,2,1,137
121990330,100,71,80,25,276
122004170,88,10,2,18,118
122019871,15,3,2,1,21
122021073,24,31,3,2,60
122021126,10,4,2,1,17
122031254,141,27,56,18,242
122040565,81,3,2,5,91
122042785,140,21,103,1,265
122048462,109,3,2,1,115
122052800,137,46,25,1,209
122078945,168,3,2,19,192
122094102,110,22,2,12,146
122103221,27,31,2,1,61
122107226,59,40,4,4,107
122107887,55,17,68,1,141
122119107,85,17,9,1,112
122120997,14,4,2,1,21
122132357,95,18,2,1,116
122149144,70,38,5,1,114
122150559,206,33,49,14,302
122181727,13,3,2,4,22
122190099,12,5,2,1,20
122190361,117,59,38,1,215
122200467,50,11,2,3,66
122202827,11,3,2,1,17
122204754,94,3,2,1,100
122217151,101,20,2,2,125
122219437,13,8,4,1,26
122220063,223,24,49,3,299
122222003,68,71,16,1,156
122222131,88,3,2,1,94
122247728,18,7,2,2,29
122259655,56,65,38,5,164
122300946,36,22,10,15,83
122301344,16,3,2,1,22
122303541,14,3,2,1,20
122308608,36,36,2,3,77
122322021,138,3,2,8,151
122369375,60,12,2,2,76
122374156,30,3,2,1,36
122381592,27,67,12,10,116
122390476,28,3,2,1,34
122411544,50,27,18,8,103
122411949,25,3,2,2,32
122414343,10,33,2,1,46
122415653,12,29,2,2,45
122426482,80,90,74,25,269
122450301,91,112,42,7,252
122450745,17,10,2,1,30
122456793,17,3,2,1,23
122463437,12,112,23,3,150
122465264,41,10,2,7,60
122470623,38,3,2,4,47
122478601,74,62,4,6,146
122484543,67,3,2,4,76
122485604,82,26,38,12,158
122491759,236,3,2,2,243
122491947,58,56,4,1,119
122494656,41,14,40,2,97
122502269,147,3,2,1,153
122503812,10,6,2,1,19
122504733,92,45,40,14,191
122527267,30,18,5,1,54
122528140,34,9,13,6,62
122533022,37,146,4,12,199
122536562,13,22,14,1,50
122566447,37,41,19,1,98
122578017,111,18,2,1,132
122581505,56,21,2,1,80
122582702,115,3,2,12,132
122609078,84,3,2,1,90
122610911,34,17,2,3,56
122611376,22,13,2,10,47
122624950,13,3,2,1,19
122630686,75,3,2,3,83
122635795,12,25,2,1,40
122639000,86,3,2,19,110
122644551,66,3,2,4,75
122653579,17,3,2,3,25
122672412,33,23,3,1,60
122694005,34,28,2,1,65
122694755,125,3,2,1,131
122696746,10,5,2,1,18
122700646,72,67,24,13,176
122708891,81,13,54,2,150
122721703,68,71,6,6,151
122725087,190,16,14,1,221
122743985,17,8,2,1,28
122753343,58,40,2,5,105
122761695,73,17,2,4,96
122763572,67,37,43,46,193
122765711,129,16,2,10,157
122768970,75,8,50,2,135
122776793,56,11,4,1,72
122777838,32,21,5,2,60
122781220,34,3,2,8,47
122788789,76,5,4,26,111
122811538,137,55,25,42,259
122823842,63,3,2,1,69
122833024,94,38,41,39,212
122837668,34,34,2,4,74
122842510,35,3,2,3,43
122854369,13,4,2,1,20
122857360,10,18,2,1,31
122863813,13,3,2,1,19
122866804,181,36,2,21,240
122871550,75,8,2,5,90
122888192,103,21,46,2,172
122893719,11,6,2,1,20
122895235,25,3,2,10,40
122905457,144,3,2,7,156
122911513,38,36,8,1,83
122940640,19,16,2,4,41
122956854,45,3,2,1,51
122967447,73,42,32,26,173
122969461,63,11,2,1,77
122971749,10,10,2,1,23
122976299,81,81,49,16,227
123015135,142,3,2,5,152
123017405,74,3,2,12,91
123019100,77,5,14,14,110
123021593,16,3,2,2,23
123021670,43,6,2,3,54
123028719,101,3,2,1,107
123032862,98,14,2,1,115
123039068,117,15,2,7,141
123049818,54,16,2,1,73
123050471,10,13,2,1,26
123054029,41,13,9,7,70
123074150,53,7,22,17,99
123088284,247,10,3,45,305
123092970,25,3,2,1,31
123099143,26,39,83,6,154
123129378,76,3,2,2,83
123147270,94,3,5,15,117
123156197,13,3,2,1,19
123177035,68,41,27,2,138
123195672,77,26,22,3,128
123202060,20,3,2,1,26
123208871,57,55,19,10,141
123242713,160,3,2,7,172
123245070,38,21,2,11,72
123252475,86,10,22,7,125
123260652,39,27,22,13,101
123263677,34,41,9,1,85
123270465,38,4,2,5,49
123270747,79,3,2,11,95
123271708,18,64,2,1,85
123276701,84,3,82,20,189
123288372,204,9,5,3,221
123299229,28,49,2,1,80
123306674,17,3,2,1,23
123339893,21,14,2,1,38
123340975,11,3,2,1,17
123348250,84,14,41,15,154
123348907,51,118,2,1,172
123348976,56,15,108,1,180
123349162,76,34,2,1,113
123350870,70,24,72,5,171
123354391,81,28,2,3,114
123354917,69,123,2,3,197
123381166,28,23,32,8,91
123386265,128,64,6,10,208
123397368,123,54,7,4,188
123406127,65,14,2,10,91
123410706,41,3,2,1,47
123427277,18,5,2,1,26
123427356,12,13,2,1,28
123429101,94,4,2,2,102
123436669,15,6,28,1,50
123438518,16,3,2,1,22
123449397,41,3,2,1,47
123451904,135,3,2,2,142
123453584,105,22,42,8,177
123457693,176,14,3,5,198
123466290,17,41,2,4,64
123504011,36,25,2,1,64
123515422,100,13,23,3,139
123521705,60,45,30,5,140
123522718,18,8,2,1,29
123523877,72,28,2,3,105
123531580,94,40,146,8,288
123543382,81,4,23,19,127
123545734,26,56,13,2,97
123552449,78,17,20,4,119
123553166,66,7,69,4,146
123557373,17,3,2,3,25
123559334,14,3,2,1,20
123567911,62,3,2,1,68
123586427,241,17,31,3,292
123588840,21,3,2,3,29
123611195,58,3,2,1,64
123624565,109,34,14,10,167
123639990,29,14,5,4,52
123641476,33,86,2,8,129
123645891,40,3,2,1,46
123654986,45,3,2,2,52
123674102,199,16,14,4,233
123674631,101,65,2,29,197
123675113,23,3,2,5,33
123695761,26,6,2,1,35
123714328,26,18,20,1,65
123720081,76,16,2,1,95
123725499,10,3,2,16,31
123727974,88,26,2,2,118
123734301,12,3,2,4,21
123737380,20,3,3,1,27
123754017,72,3,2,1,78
123766051,14,3,2,1,20
123795583,14,7,2,1,24
123811747,57,3,2,1,63
123822460,136,57,15,6,214
123825278,149,23,12,2,186
123827319,11,3,2,1,17
123829279,12,3,2,1,18
123835933,282,116,5,14,417
123842218,13,3,2,1,19
123859279,154,31,3,47,235
123868465,78,8,63,4,153
123876850,39,89,6,4,138
123889290,188,20,45,3,256
123903081,24,35,15,4,78
123906800,69,26,7,1,103
123918910,64,44,32,4,144
123920261,159,3,2,24,188
123923948,38,81,48,14,181
123930327,34,10,2,1,47
123932159,20,22,3,1,46
123936270,174,25,25,11,235
123940312,17,3,2,2,24
123940715,168,3,2,3,176
123955641,11,3,2,1,17
123957252,146,3,2,4,155
123995835,50,13,25,2,90
123996198,12,3,2,3,20
123997864,11,4,3,1,19
123998895,20,3,2,7,32
124001438,93,57,3,6,159
124005804,139,10,3,2,154
124007405,12,3,2,1,18
124010382,10,4,2,3,19
124012104,69,3,2,1,75
124017013,46,12,5,1,64
124024953,14,3,2,1,20
124028040,56,31,10,4,101
124032378,12,19,28,1,60
124047775,145,40,45,1,231
124069887,130,9,3,23,165
124076930,72,3,2,1,78
124077323,137,52,4,5,198
124089778,27,3,2,3,35
124104681,38,48,2,10,98
124105745,10,5,2,1,18
124131762,23,3,2,1,29
124132517,126,3,2,1,132
124194978,209,60,25,13,307
124210531,25,12,53,9,99
124217114,22,3,2,1,28
124239883,28,36,3,3,70
124241767,111,52,22,19,204
124247276,15,3,2,1,21
124267547,105,52,5,35,197
124289274,66,14,20,33,133
124308102,97,18,2,1,118
124313892,23,3,2,5,33
124314094,153,51,26,2,232
124318286,61,3,2,1,67
124319897,16,27,19,1,63
124326964,11,5,2,1,19
124329560,115,29,3,42,189
124330897,21,14,8,2,45
124335597,147,42,2,2,193
124341887,31,28,2,27,88
124350995,58,5,3,1,67
124355836,93,3,2,1,99
124356971,111,3,3,2,119
124358306,36,30,2,1,69
124369640,22,3,2,1,28
124373898,10,8,2,1,21
124374338,23,8,2,1,34
124385675,51,12,2,2,67
124392263,35,52,5,1,93
124395226,19,29,2,3,53
124403697,52,39,2,49,142
124414456,70,34,39,27,170
124441473,131,3,2,3,139
124446775,11,3,2,1,17
124447583,133,29,2,4,168
124454410,47,23,18,13,101
124460132,11,3,2,1,17
124465182,11,3,2,1,17
124466981,22,112,2,10,146
124470152,64,3,2,5,74
124471253,44,12,10,2,68
124499378,116,34,28,2,180
124508297,16,3,2,1,22
124511974,33,26,4,1,64
124513126,79,5,4,13,101
124514109,27,3,2,12,44
124516553,59,55,14,4,132
124520370,80,11,2,2,95
124525753,10,10,2,1,23
124548768,51,29,31,11,122
124551322,16,49,2,26,93
124554910,43,33,51,3,130
124566543,21,3,2,2,28
124574149,36,33,30,18,117
124578753,20,32,3,1,56
124578939,13,3,2,1,19
124579486,32,3,2,1,38
124596363,151,25,20,26,222
124604481,32,3,2,1,38
124618114,33,107,39,8,187
124619485,52,3,2,2,59
124631492,88,42,49,2,181
124652016,23,14,31,13,81
124655014,63,13,4,7,87
124663765,130,4,10,7,151
124688746,76,3,2,1,82
124735179,90,23,2,2,117
124736371,20,12,2,5,39
124737546,22,15,2,3,42
124738789,37,3,2,1,43
124744855,91,19,9,1,120
124755940,93,3,2,1,99
124763177,27,34,6,2,69
124763931,44,8,2,1,55
124764832,134,32,36,10,212
124795974,31,3,2,1,37
124796383,86,121,9,13,229
124816736,36,29,4,4,73
124834237,50,88,10,2,150
124849506,71,8,2,1,82
124856345,201,57,21,87,366
124867524,44,20,2,1,67
124888612,12,10,2,1,25
124890203,10,4,2,1,17
124896026,111,7,2,1,121
124901753,51,25,7,29,112
124916486,59,54,7,10,130
124918466,27,3,2,1,33
124923098,18,11,2,1,32
124943428,13,5,2,2,22
124951951,73,12,45,3,133
124953706,82,3,2,3,90
124969551,112,12,2,7,133
124971943,171,33,55,3,262
124973225,136,16,6,2,160
124983873,25,82,2,3,112
124985597,39,44,2,51,136
124990714,62,12,2,1,77
124996183,99,17,2,2,120
125022308,11,3,2,1,17
125025556,10,26,2,1,39
125038096,11,3,2,1,17
125046424,33,6,8,30,77
125047543,12,3,2,1,18
125062656,80,3,2,1,86
125065031,69,40,4,10,123
125071053,20,57,2,1,80
125082887,57,48,45,28,178
125106995,161,83,8,36,288
125113740,56,51,63,2,172
125114535,24,3,2,1,30
125117712,15,3,2,2,22
125127555,165,24,10,7,206
125132857,46,41,6,3,96
125147581,13,18,3,1,35
125150378,70,18,15,13,116
125192237,64,11,9,19,103
125207305,52,80,4,11,147
125213480,87,22,45,2,156
125217200,38,7,4,14,63
125223817,85,32,3,12,132
125251710,13,3,2,1,19
125261941,72,20,4,17,113
125269425,25,9,2,1,37
125273829,62,18,2,1,83
125279923,61,27,53,40,181
125291832,87,26,2,5,120
125292912,33,3,2,2,40
125293191,43,16,9,1,69
125299050,15,40,2,3,60
125311220,94,13,16,1,124
125319917,120,20,2,17,159
125321287,16,6,2,2,26
125325411,47,10,2,1,60
125325694,149,66,12,14,241
125340762,110,28,25,1,164
125340860,131,21,24,17,193
125344460,266,3,2,32,303
125344785,18,43,2,3,66
125347276,106,3,2,1,112
125348315,176,12,2,9,199
125378233,33,8,2,1,44
125394572,133,3,2,2,140
125401300,28,18,2,3,51
125419152,10,7,2,1,20
125432473,29,3,2,1,35
125437921,10,5,2,1,18
125445472,81,3,2,24,110
125451510,34,3,2,1,40
125458140,100,31,7,2,140
125469367,125,3,2,1,131
125472948,160,16,2,1,179
125486999,23,5,2,2,32
125503827,82,75,6,14,177
125505526,17,17,2,2,38
125508234,42,8,2,6,58
125509269,93,17,2,4,116
125510459,39,21,15,43,118
125515627,12,13,2,1,28
125516581,97,29,105,50,281
125535247,10,16,7,1,34
125549525,94,30,18,1,143
125555664,38,34,14,1,87
125600018,28,22,19,1,70
125611238,79,64,93,5,241
125611727,15,3,2,2,22
125620516,22,3,2,2,29
125635790,27,8,2,1,38
125638087,14,3,2,1,20
125641470,148,5,27,8,188
125642407,12,3,2,1,18
125649714,64,13,31,3,111
125665458,80,3,2,1,86
125684693,81,13,2,1,97
125715280,10,6,2,4,22
125720517,26,82,21,9,138
125720920,62,11,8,4,85
125725025,227,29,23,7,286
125725359,58,26,37,26,147
125735002,28,10,2,7,47
125738571,35,5,5,5,50
125747171,30,19,4,1,54
125750635,37,6,2,2,47
125753975,119,3,2,2,126
125759842,18,27,2,1,48
125772019,24,5,2,4,35
125784924,664,3,2,20,689
125788687,46,6,2,10,64
125790605,10,6,2,1,19
125825855,131,34,34,11,210
125828811,32,60,5,10,107
125838737,16,56,12,7,91
125839083,20,5,2,1,28
125851539,127,15,21,40,203
125867818,45,3,2,1,51
125868238,139,29,4,53,225
125873042,67,30,49,37,183
125901813,85,29,9,1,124
125917090,117,26,2,17,162
125929142,18,3,2,1,24
125932029,11,3,2,1,17
125935357,32,3,2,1,38
125947242,76,18,30,17,141
125948083,140,62,75,3,280
125949570,85,3,2,2,92
125953708,21,3,2,1,27
125962962,32,25,70,1,128
125976424,58,14,11,22,105
125982481,41,18,2,1,62
125983568,90,26,53,1,170
125990796,319,3,2,60,384
125992858,96,60,24,21,201
125993022,151,3,2,40,196
126003509,36,31,19,2,88
126020919,117,6,30,17,170
126023127,36,5,2,3,46
126029215,10,31,2,1,44
126065951,13,22,2,1,38
126066676,21,66,36,1,124
126077241,60,17,2,6,85
126088510,100,36,13,13,162
126097431,47,28,99,1,175
126097951,16,3,2,1,22
126129665,15,3,2,1,21
126142384,13,3,2,1,19
126145377,77,3,2,1,83
126151187,82,3,2,1,88
126152344,51,30,2,12,95
126154592,15,3,2,1,21
126213550,63,24,2,1,90
126224783,78,7,21,1,107
126231582,15,37,15,1,68
126261378,114,67,20,12,213
126275702,10,4,2,1,17
126277578,117,59,8,4,188
126288563,75,3,2,6,86
126302482,30,6,10,7,53
126303047,10,3,2,2,17
126303818,158,8,16,6,188
126307231,77,17,41,8,143
126321480,13,3,2,1,19
126321714,62,20,2,8,92
126329464,88,24,2,2,116
126333839,103,3,2,19,127
126335170,97,27,84,17,225
126337600,118,18,7,12,155
126342672,44,3,16,1,64
126361309,77,3,2,3,85
126366197,13,37,2,1,53
126368290,225,3,2,23,253
126368922,111,12,2,1,126
126371126,15,5,2,7,29
126378373,66,3,2,1,72
126385985,79,3,15,1,98
126407180,54,24,2,1,81
126408148,13,14,2,1,30
126411130,69,13,2,3,87
126414962,98,3,2,11,114
126421549,35,10,6,1,52
126424946,36,43,49,4,132
126441849,104,28,32,25,189
126441871,22,3,2,1,28
126442899,33,54,14,3,104
126444601,77,12,2,1,92
126451548,11,12,8,2,33
126451716,14,3,2,6,25
126462427,101,11,2,1,115
126467885,70,10,18,2,100
126473038,71,7,2,1,81
126479416,17,22,2,1,42
126490749,52,3,2,4,61
126499855,21,3,2,1,27
126499974,69,3,2,13,87
126510797,132,4,2,20,158
126515775,15,3,2,1,21
126521982,62,27,4,14,107
126534489,88,9,34,6,137
126545033,27,12,6,7,52
126546892,18,3,2,1,24
126556617,73,13,3,1,90
126559611,12,3,2,1,18
126570136,35,18,2,1,56
126573175,159,33,21,8,221
126578062,11,5,2,1,19
126584938,107,15,2,1,125
126618481,25,6,2,1,34
126622230,19,54,18,3,94
126630394,17,3,2,1,23
126632764,58,32,4,4,98
126648396,14,6,10,1,31
126686507,171,31,2,11,215
126694913,30,3,2,3,38
126700413,11,3,2,1,17
126701371,17,3,2,3,25
126702059,14,34,3,1,52
126706403,111,11,23,55,200
126715959,483,3,2,17,505
126723310,14,6,2,1,23
126745239,23,3,2,4,32
126748976,11,4,2,1,18
126754889,62,74,58,17,211
126767294,118,46,70,7,241
126768249,87,43,21,5,156
126774447,100,3,2,7,112
126778799,31,26,2,1,60
126795828,23,71,2,1,97
126805157,82,3,2,1,88
126819191,101,123,30,10,264
126823872,138,3,2,6,149
126831858,49,37,4,1,91
126837836,23,4,2,1,30
126843118,16,41,4,8,69
126847100,78,17,2,10,107
126849236,26,3,2,1,32
126855473,79,19,2,50,150
126865178,53,81,27,23,184
126867654,104,3,2,1,110
126879871,129,3,2,1,135
126882025,13,6,2,8,29
126882033,88,21,2,4,115
126882894,59,19,3,5,86
126896455,107,14,2,18,141
126897516,41,48,3,1,93
126900017,10,54,9,1,74
126908369,86,10,2,1,99
126930129,137,3,2,64,206
126952366,82,19,9,4,114
126980830,159,14,3,20,196
127005252,49,18,4,7,78
127015910,86,3,2,3,94
127047966,268,17,30,2,317
127054050,92,15,55,8,170
127056888,172,24,4,4,204
127057999,25,16,55,1,97
127060922,33,19,13,2,67
127062621,21,3,2,1,27
127064185,45,20,2,16,83
127075947,70,3,2,7,82
127090140,136,3,2,13,154
127101955,766,3,2,1,772
127121999,98,3,2,1,104
127122409,10,3,2,2,17
127122892,38,21,2,4,65
127129698,60,32,5,11,108
127148802,79,34,23,13,149
127183237,72,30,56,1,159
127183669,112,54,15,48,229
127186457,45,26,15,7,93
127186824,44,3,2,22,71
127226918,39,7,29,4,79
127233318,45,55,17,19,136
127235527,196,8,2,1,207
127243492,14,43,5,1,63
127251292,59,44,18,1,122
127261296,53,3,2,1,59
127268149,35,3,2,1,41
127278867,32,3,2,1,38
127287192,31,3,2,15,51
127293717,16,4,2,1,23
127301259,63,12,2,1,78
127315203,269,3,2,24,298
127315709,14,3,2,1,20
127319994,105,34,33,4,176
127331780,63,8,2,27,100
127336929,25,3,2,4,34
127337519,102,3,2,1,108
127338816,111,3,4,14,132
127346008,156,31,37,20,244
127346593,120,3,2,8,133
127355746,33,8,2,1,44
127356461,49,4,13,1,67
127357543,37,21,3,2,63
127365793,13,5,2,4,24
127382252,44,3,2,1,50
127382938,46,28,11,43,128
127386909,188,57,45,44,334
127394193,30,6,13,2,51
127401471,120,23,37,2,182
127408660,104,3,2,1,110
127412311,68,13,3,2,86
127429569,78,38,3,3,122
127449490,23,8,2,1,34
127459520,75,23,2,3,103
127467657,52,25,2,3,82
127478388,120,27,2,1,150
127487673,36,96,4,1,137
127494795,16,34,9,1,60
127501174,53,15,2,32,102
127508237,18,24,2,1,45
127514477,63,6,2,12,83
127519454,51,32,38,49,170
127521584,27,61,10,2,100
127526980,94,13,2,4,113
127527274,32,47,15,1,95
127532372,149,3,2,9,163
127534933,17,3,2,3,25
127535214,74,13,4,7,98
127535487,13,44,2,2,61
127536251,28,33,2,2,65
127537609,66,28,40,5,139
127545314,11,7,2,4,24
127548804,69,10,92,30,201
127555749,64,3,2,2,71
127594286,39,3,2,2,46
127597213,56,24,2,15,97
127646663,162,39,57,2,260
127651748,22,77,24,36,159
127661175,15,3,2,1,21
127669455,48,72,21,3,144
127674240,53,12,3,10,78
127684246,18,31,2,1,52
127725627,104,16,7,2,129
127736767,92,46,20,2,160
127736779,71,3,2,8,84
127738662,72,53,3,7,135
127783375,144,60,75,1,280
127787768,61,30,38,19,148
127792267,12,3,2,1,18
127813599,48,12,3,1,64
127831110,83,50,17,21,171
127852522,62,3,2,1,68
127860011,104,29,24,3,160
127865610,21,26,2,1,50
127867177,155,17,10,2,184
127868025,33,24,46,2,105
127873770,28,7,13,1,49
127875080,74,16,28,3,121
127878985,78,3,2,2,85
127882348,136,49,16,32,233
127903530,118,40,35,3,196
127917959,38,16,23,3,80
127926915,87,15,28,12,142
127931363,67,21,18,7,113
127939035,99,12,40,45,196
127944689,28,3,2,1,34
127955881,25,3,2,1,31
127965271,40,10,2,33,85
127968666,76,3,2,1,82
127977133,17,3,2,3,25
127987488,67,44,5,23,139
127989398,19,30,2,3,54
127989827,58,16,2,9,85
128002349,17,19,14,3,53
128002600,111,18,2,3,134
128006642,34,68,5,16,123
128044440,289,15,12,13,329
128056341,13,37,4,4,58
128064807,77,3,2,1,83
128066748,13,23,6,1,43
128077203,37,20,3,6,66
128087415,70,11,2,1,84
128089150,744,3,2,24,773
128091302,11,3,2,1,17
128093229,68,37,5,2,112
128098136,24,23,15,3,65
128102654,53,21,49,20,143
128112098,34,15,19,2,70
128122035,101,3,2,1,107
128130989,16,3,2,1,22
128136233,54,31,10,16,111
128141999,96,42,6,15,159
128147998,109,38,20,42,209
128159307,93,63,57,21,234
128165703,12,5,2,1,20
128166155,80,3,2,1,86
128170435,19,5,2,1,27
128170937,36,43,3,5,87
128179869,24,44,3,1,72
128198026,42,40,3,8,93
128198344,25,3,2,1,31
128211321,11,8,3,1,23
128226013,40,22,18,10,90
128230683,23,4,2,1,30
128231093,172,23,34,2,231
128243263,75,9,2,1,87
128246690,87,14,19,9,129
128254222,14,3,2,1,20
128256104,11,3,2,1,17
128256744,14,3,2,4,23
128264318,38,8,2,1,49
128264741,136,13,16,5,170
128278274,54,3,2,1,60
128284627,12,9,2,1,24
128305688,11,9,2,1,23
128315212,180,18,45,18,261
128326127,10,7,2,1,20
128329025,10,6,2,1,19
128339746,82,35,8,25,150
128340848,131,48,3,1,183
128343431,169,3,2,15,189
128349484,25,14,6,1,46
128351343,145,23,46,11,225
128351417,16,3,2,1,22
128352638,208,42,10,2,262
128362288,115,31,25,9,180
128409757,26,3,2,1,32
128423693,24,3,2,2,31
128425557,12,12,2,1,27
128449331,117,54,25,3,199
128453704,52,3,2,2,59
128468920,72,42,5,9,128
128496988,37,8,2,6,53
128505293,13,16,3,1,33
128505638,31,11,5,7,54
128507929,28,3,2,1,34
128509690,175,3,2,13,193
128511889,13,3,2,1,19
128512401,16,3,2,2,23
128518457,67,39,2,1,109
128523570,15,3,2,1,21
128540066,81,3,2,2,88
128555697,38,16,2,12,68
128559191,10,3,2,2,17
128568809,30,86,17,3,136
128578066,109,36,44,32,221
128583396,112,3,2,1,118
128588730,60,20,12,12,104
128608521,56,19,14,26,115
128608626,61,3,2,4,70
128614186,22,31,7,3,63
128615777,230,36,230,26,522
128624305,21,8,2,1,32
128633638,207,3,2,24,236
128642321,57,3,2,1,63
128657618,36,44,15,7,102
128676499,18,15,2,5,40
128677156,10,3,2,2,17
128691168,44,3,2,1,50
128691207,27,3,2,1,33
128691578,28,3,2,1,34
128693675,99,56,2,11,168
128695856,66,24,7,2,99
128717487,96,19,2,2,119
128738209,40,36,10,2,88
128741730,137,49,13,3,202
128741850,12,4,2,2,20
128755104,25,72,2,13,112
128764700,45,39,2,2,88
128771738,100,7,8,6,121
128777301,112,3,2,14,131
128781692,46,58,16,6,126
128786787,53,19,6,8,86
128787340,26,7,2,2,37
128792301,90,8,2,3,103
128810172,80,30,27,13,150
128823751,45,3,2,2,52
128832328,37,21,2,1,61
128844767,37,31,2,10,80
128848559,254,48,4,2,308
128848944,37,27,2,7,73
128860304,31,49,2,3,85
128864055,10,3,2,2,17
128869656,74,9,2,10,95
128881083,145,81,27,14,267
128897915,56,37,2,4,99
128917493,76,6,5,3,90
128922223,11,6,2,1,20
128922631,22,12,2,2,38
128927157,44,20,66,12,142
128932702,54,18,2,1,75
128937381,54,54,7,11,126
128946000,97,25,18,61,201
128946032,11,8,2,1,22
128952757,209,44,4,5,262
128955357,10,3,2,2,17
128972451,101,3,2,1,107
128991395,18,8,2,3,31
128995223,11,3,2,1,17
128995423,80,44,6,30,160
128998038,53,3,2,1,59
129009286,44,58,58,13,173
129022287,33,3,2,1,39
129026943,41,7,2,2,52
129029711,50,15,2,1,68
129060546,42,13,27,1,83
129069020,103,45,18,1,167
129070308,101,3,2,2,108
129073715,117,6,2,1,126
129094228,10,3,2,2,17
129094577,105,51,2,1,159
129095697,10,38,2,1,51
129122286,104,10,2,16,132
129124702,146,21,2,3,172
129125910,118,3,2,1,124
129130338,15,9,4,3,31
129130966,30,54,54,23,161
129134720,44,3,2,1,50
129135360,101,23,2,2,128
129135523,71,10,10,6,97
129176318,131,3,2,2,138
129185604,37,3,18,14,72
129189246,24,3,2,1,30
129193503,55,41,4,1,101
129204188,82,29,2,1,114
129207009,57,28,13,7,105
129210426,46,9,2,1,58
129235027,42,20,2,1,65
129245644,85,3,2,1,91
129259065,14,3,2,4,23
129273184,21,3,2,1,27
129282803,43,41,21,7,112
129284446,25,3,2,1,31
129285182,10,3,2,2,17
129309036,43,14,4,1,62
129309857,17,3,2,1,23
129330405,101,26,44,1,172
129332562,76,26,2,7,111
129345709,53,3,2,1,59
129358422,18,3,2,1,24
129363405,81,3,2,1,87
129365765,68,43,110,10,231
129373553,25,27,2,1,55
129375503,162,7,4,8,181
129387152,63,3,2,1,69
129389426,74,31,3,2,110
129391572,23,3,2,1,29
129397430,65,11,24,18,118
129408343,51,29,6,9,95
129409687,154,3,3,42,202
129411832,47,20,2,1,70
129428329,11,3,2,1,17
129431034,46,16,2,2,66
129432553,21,3,2,3,29
129465961,20,22,13,3,58
129474026,12,3,2,1,18
129481546,34,22,2,9,67
129483226,18,10,4,1,33
129505111,12,3,2,1,18
129518492,36,47,2,5,90
129527055,103,20,30,25,178
129540803,67,6,2,1,76
129544921,102,7,18,26,153
129560676,91,32,16,3,142
129571578,23,3,2,6,34
129574354,38,7,2,10,57
129587304,13,25,13,1,52
129607050,58,3,2,2,65
129608390,26,3,2,1,32
129611661,111,3,2,1,117
129616012,14,70,124,1,209
129621177,59,21,20,4,104
129628052,31,5,5,2,43
129631240,181,56,4,1,242
129636190,13,3,2,1,19
129637640,51,38,15,2,106
129657527,171,3,2,1,177
129664088,14,8,2,2,26
129665225,22,72,58,2,154
129669085,85,3,2,4,94
129678812,55,3,2,1,61
129683737,13,5,2,1,21
129690941,136,32,28,32,228
129692439,58,10,2,7,77
129716333,74,14,2,3,93
129719159,25,43,3,3,74
129719274,92,3,2,4,101
129724586,121,45,63,14,243
129724735,11,3,2,1,17
129725923,64,3,2,1,70
129735091,104,44,32,1,181
129739880,42,10,2,1,55
129748913,155,18,4,21,198
129759554,17,3,2,1,23
129775719,52,3,2,1,58
129775789,27,14,2,3,46
129786830,13,37,2,1,53
129802769,157,33,4,27,221
129808422,261,3,2,1,267
129826596,13,3,2,1,19
129832022,48,7,24,1,80
129844220,132,3,2,1,138
129846525,96,13,25,1,135
129856535,29,10,12,1,52
129858742,32,16,22,3,73
129860825,74,59,50,10,193
129871232,85,55,5,29,174
129879054,224,28,5,3,260
129890172,20,19,12,2,53
129894889,102,4,3,7,116
129895017,91,11,2,2,106
129900839,13,13,29,8,63
129910160,251,3,2,5,261
129922107,345,3,2,11,361
129927895,66,28,76,23,193
129930990,73,3,2,1,79
129939764,32,4,5,8,49
129940510,19,5,3,1,28
129957031,44,7,2,1,54
129972003,25,15,21,34,95
130000487,141,3,2,4,150
130002590,76,10,3,10,99
130008037,211,134,17,10,372
130016122,38,50,3,4,95
130016866,81,4,2,1,88
130018896,72,3,3,20,98
130024796,45,10,2,8,65
130031169,11,3,2,1,17
130032764,98,13,2,7,120
130041263,39,35,9,6,89
130041488,45,40,6,7,98
130044277,16,32,2,1,51
130047668,147,49,47,17,260
130048877,11,3,2,1,17
130055921,18,3,3,1,25
130078026,93,3,11,3,110
130089131,55,24,52,6,137
130096002,42,25,3,4,74
130113205,349,3,2,2,356
130113717,24,3,2,1,30
130122827,146,14,3,1,164
130129044,143,3,2,1,149
130132951,15,58,14,2,89
130136923,86,90,65,6,247
130145993,56,3,2,1,62
130155356,99,44,51,10,204
130155543,80,9,2,1,92
130156061,90,3,2,21,116
130168155,55,41,7,15,118
130170228,17,58,2,9,86
130173994,38,3,2,12,55
130175432,125,3,2,10,140
130176048,37,27,2,4,70
130177300,17,23,38,1,79
130177800,133,3,45,8,189
130187335,92,11,13,6,122
130187371,94,11,22,1,128
130199256,92,8,2,1,103
130217479,37,59,5,15,116
130232435,188,3,2,4,197
130245029,60,39,38,1,138
130263479,55,7,2,1,65
130276159,12,3,2,1,18
130280003,60,7,2,2,71
130281572,76,18,50,1,145
130284724,90,13,46,23,172
130287279,71,3,2,25,101
130299350,103,26,33,30,192
130304376,85,3,2,2,92
130310501,98,15,52,2,167
130310634,126,33,32,28,219
130312872,64,13,2,1,80
130315018,122,54,4,33,213
130317550,102,5,3,13,123
130318744,22,3,2,1,28
130328591,22,3,2,1,28
130353395,24,3,2,1,30
130358685,52,59,2,1,114
130377856,87,51,19,11,168
130386732,10,4,2,1,17
130399665,13,3,2,1,19
130399949,64,24,2,1,91
130407199,76,43,2,2,123
130438027,74,32,5,14,125
130450725,64,36,12,43,155
130452442,16,3,2,2,23
130455102,42,23,3,1,69
130457933,82,25,2,5,114
130463481,47,8,29,1,85
130472228,34,31,2,2,69
130473197,90,3,2,1,96
130473408,11,3,2,2,18
130477682,65,3,2,1,71
130486719,68,21,5,18,112
130495567,99,11,17,1,128
130502420,62,3,2,2,69
130511917,11,3,2,1,17
130512639,37,3,2,1,43
130515068,165,3,2,2,172
130519332,62,23,36,16,137
130524595,35,55,22,17,129
130525917,170,30,2,64,266
130526481,17,3,2,1,23
130527528,10,12,2,1,25
130529091,10,25,2,1,38
130546931,37,3,2,1,43
130552158,16,26,12,8,62
130590740,44,41,75,24,184
130594612,13,3,2,1,19
130602077,48,16,121,3,188
130608158,69,39,26,1,135
130612461,27,13,2,11,53
130623461,413,34,2,9,458
130629095,20,3,2,1,26
130635591,62,3,2,1,68
130659002,20,13,8,10,51
130661484,40,16,2,57,115
130670373,51,10,2,1,64
130676488,75,13,4,2,94
130682922,107,3,2,6,118
130695391,30,21,2,1,54
130704227,88,48,2,2,140
130723611,92,34,63,25,214
130729274,59,56,17,2,134
130743169,16,7,2,1,26
130751946,43,8,34,9,94
130754100,38,21,22,12,93
130767832,46,10,2,3,61
130769055,54,3,2,9,68
130770305,31,3,2,1,37
130774672,81,13,30,10,134
130776896,54,21,16,26,117
130783469,49,3,2,1,55
130783841,1267,7,2,8,1284
130785029,45,3,18,1,67
130809035,45,3,2,2,52
130833782,15,3,3,1,22
130846414,32,69,27,11,139
130849687,15,11,2,1,29
130851804,42,28,18,21,109
130869096,73,3,2,1,79
130890008,32,28,3,7,70
130898090,56,5,2,6,69
130911058,36,3,2,5,46
130936018,158,48,3,1,210
130938536,70,21,30,10,131
130940713,11,6,2,1,20
130941073,11,3,2,1,17
130950679,15,5,2,3,25
130953919,11,5,2,1,19
130954239,19,3,2,1,25
130959001,27,26,39,5,97
130984635,11,3,2,1,17
130984677,91,39,2,1,133
131003598,10,4,2,1,17
131011418,18,3,2,3,26
131011930,87,3,2,2,94
131015935,90,3,2,1,96
131018024,24,52,16,1,93
131045748,38,3,2,1,44
131064271,41,7,2,1,51
131064416,84,3,2,1,90
131068600,118,30,13,10,171
131070246,30,6,2,1,39
131094744,81,73,8,7,169
131114540,111,17,23,9,160
131120745,57,3,2,1,63
131125395,109,3,2,1,115
131132504,152,83,50,8,293
131137657,55,9,2,1,67
131144250,35,27,2,1,65
131163010,35,26,8,4,73
131164058,122,43,107,45,317
131172088,77,3,2,2,84
131190447,207,3,2,26,238
131224737,23,3,2,1,29
131252625,17,3,2,1,23
131254365,20,6,2,1,29
131268316,59,33,59,11,162
131278337,160,25,23,2,210
131278806,40,24,3,1,68
131289160,11,3,2,1,17
131299804,70,12,2,4,88
131301770,42,42,22,7,113
131311399,428,17,2,3,450
131312486,37,3,2,1,43
131313272,13,25,9,3,50
131320135,50,3,2,1,56
131323700,45,5,2,9,61
131327317,20,27,2,1,50
131334547,261,64,59,106,490
131347103,84,3,2,1,90
131362366,50,39,14,31,134
131364545,92,20,9,5,126
131394746,77,54,79,2,212
131395505,11,3,2,1,17
131398144,93,9,2,8,112
131399687,154,3,2,3,162
131402560,44,54,30,4,132
131414843,18,27,32,3,80
131418613,29,3,2,1,35
131420462,50,33,16,28,127
131433227,40,46,10,22,118
131438972,80,63,34,5,182
131446851,21,9,2,1,33
131457396,31,42,8,18,99
131459880,11,3,2,1,17
131478310,15,4,2,1,22
131483212,16,3,2,1,22
131500410,58,81,18,10,167
131542750,45,10,2,4,61
131544490,121,3,2,24,150
131562815,180,50,19,1,250
131568802,55,3,2,2,62
131616371,108,25,20,3,156
131639424,10,5,2,1,18
131644153,94,11,2,7,114
131652033,70,67,8,76,221
131653566,148,63,2,12,225
131657824,41,19,2,4,66
131660277,45,3,2,2,52
131677019,278,19,4,2,303
131679666,20,3,2,1,26
131683100,20,17,2,1,40
131686318,103,3,2,3,111
131708299,34,21,15,1,71
131711563,110,7,17,1,135
131715177,38,10,2,1,51
131727940,65,3,2,1,71
131739906,14,10,4,1,29
131751854,31,22,2,2,57
131765211,60,4,53,18,135
131767349,11,6,2,1,20
131768198,25,5,2,2,34
131771870,14,23,4,9,50
131773559,17,6,5,1,29
131774153,39,3,2,1,45
131774665,16,11,2,6,35
131777938,11,3,2,1,17
131779343,112,3,2,5,122
131781972,38,25,3,2,68
131782331,53,18,85,1,157
131791346,71,3,2,4,80
131792378,17,3,2,1,23
131813158,129,52,29,23,233
131826934,90,77,43,5,215
131827232,73,3,2,9,87
131852742,104,57,22,18,201
131863281,24,22,10,1,57
131866001,12,4,2,1,19
131870388,46,34,77,3,160
131873627,15,3,2,8,28
131873897,184,3,2,11,200
131878923,395,3,2,55,455
131879503,58,85,8,10,161
131917742,25,3,2,1,31
131934212,24,11,2,3,40
131970083,61,49,5,7,122
131970086,29,28,2,5,64
132002196,19,19,2,1,41
132005356,50,3,2,3,58
132024281,16,3,2,1,22
132043326,30,20,2,3,55
132052966,37,101,21,1,160
132063670,77,27,3,1,108
132087644,37,17,2,1,57
132098208,45,3,2,16,66
132103094,10,4,2,1,17
132106334,31,9,14,1,55
132109837,148,11,19,1,179
132119533,44,13,2,2,61
132120688,31,39,4,4,78
132139519,31,3,2,1,37
132145403,246,8,3,46,303
132155150,39,72,24,3,138
132172004,53,8,2,1,64
132180131,124,28,2,1,155
132221129,48,32,9,5,94
132238029,11,5,2,1,19
132239064,74,26,4,1,105
132293101,11,3,2,1,17
132318626,14,3,2,1,20
132322650,133,57,103,24,317
132328750,31,51,2,3,87
132332715,148,32,7,4,191
132354655,136,3,2,1,142
132361269,60,48,2,1,111
132365496,26,12,30,3,71
132372116,142,92,58,13,305
132372278,39,3,2,1,45
132390256,90,3,14,8,115
132420613,89,3,2,1,95
132426319,111,38,230,5,384
132427012,14,5,3,2,24
132441430,56,3,7,12,78
132443444,76,5,8,7,96
132455820,28,8,2,1,39
132456080,14,3,2,1,20
132458462,63,11,2,16,92
132462807,14,5,2,1,22
132466467,52,35,62,1,150
132473843,61,20,2,1,84
132490722,140,3,2,1,146
132494951,81,19,34,1,135
132508383,75,17,18,6,116
132514836,56,23,2,3,84
132527943,10,4,2,1,17
132529249,177,33,2,1,213
132536632,42,19,3,11,75
132549268,30,56,13,9,108
132549934,11,6,2,1,20
132555135,62,19,12,5,98
132596811,20,3,2,1,26
132611640,119,3,2,1,125
132614421,89,28,13,2,132
132615911,37,32,5,1,75
132636848,15,3,2,2,22
132638398,102,3,2,3,110
132638877,78,94,24,17,213
132670387,44,3,2,4,53
132677040,11,19,2,1,33
132685505,13,43,2,2,60
132688513,13,9,2,4,28
132707952,138,3,2,2,145
132728896,36,25,4,1,66
132730444,86,6,12,14,118
132730884,19,19,24,1,63
132772899,44,25,28,5,102
132778476,133,27,2,21,183
132785504,18,3,2,1,24
132789289,36,6,9,1,52
132794163,218,20,37,6,281
132799632,24,49,69,1,143
132800504,124,52,58,30,264
132824535,74,3,31,2,110
132835086,113,32,2,6,153
132845109,54,16,5,5,80
132891276,78,3,2,1,84
132909803,11,3,2,1,17
132917032,118,35,45,9,207
132922734,94,35,87,13,229
132931408,154,14,3,4,175
132940643,54,3,2,1,60
132941722,51,21,2,5,79
132950458,242,36,77,5,360
132959141,82,39,69,6,196
132959385,14,3,2,1,20
132983957,22,3,2,1,28
132992236,17,3,2,2,24
132995166,58,57,164,2,281
132996685,55,3,2,1,61
133012830,24,3,2,4,33
133016310,43,25,27,4,99
133025103,94,6,2,7,109
133029354,10,4,2,1,17
133034894,49,19,32,1,101
133068701,59,3,2,1,65
133069685,156,56,44,32,288
133071909,50,13,2,1,66
133095513,45,27,70,60,202
133111693,11,42,4,2,59
133115980,121,100,42,13,276
133121810,100,3,2,1,106
133124311,97,20,19,2,138
133125624,62,35,42,17,156
133132105,99,12,29,47,187
133134506,65,9,3,1,78
133139863,357,14,2,8,381
133148660,24,3,3,1,31
133153200,69,24,55,1,149
133156377,19,3,2,11,35
133164859,29,3,2,5,39
133170112,61,42,7,7,117
133223051,81,9,2,5,97
133236534,102,4,2,1,109
133238422,113,35,8,10,166
133244417,110,7,3,6,126
133248886,78,65,79,1,223
133250324,40,3,6,1,50
133261645,62,13,2,1,78
133311915,52,3,3,1,59
133313134,29,3,2,1,35
133314010,12,7,2,1,22
133320390,60,10,29,3,102
133329607,48,3,2,2,55
133333231,20,38,2,1,61
133334322,11,3,2,1,17
133345306,69,3,25,2,99
133354910,35,3,2,1,41
133357169,126,3,2,1,132
133359518,97,3,2,4,106
133360114,39,45,2,3,89
133362079,28,6,3,1,38
133365462,108,17,48,10,183
133372060,17,15,2,1,35
133387848,57,50,14,5,126
133395315,11,21,2,1,35
133413136,118,27,2,1,148
133416539,205,3,2,10,220
133416764,20,19,18,9,66
133419498,35,11,18,4,68
133428630,13,3,2,3,21
133457750,130,12,25,2,169
133466259,44,40,21,2,107
133475938,11,3,2,1,17
133496299,53,21,14,3,91
133500141,47,67,4,21,139
133514061,72,6,43,1,122
133519152,55,3,2,1,61
133524077,76,3,2,1,82
133538919,50,36,20,3,109
133557144,11,3,2,1,17
133562122,64,11,2,2,79
133574824,71,14,70,3,158
133579915,47,20,67,4,138
133601125,49,13,2,4,68
133612255,66,5,2,1,74
133634201,68,7,2,1,78
133640219,32,36,3,1,72
133642152,25,10,2,1,38
133652154,15,13,23,17,68
133663596,50,10,2,1,63
133671219,104,4,2,16,126
133693598,64,33,2,11,110
133699850,53,3,2,6,64
133712778,18,4,2,1,25
133713632,24,6,3,3,36
133733308,14,8,2,1,25
133734898,13,3,2,1,19
133770797,63,3,2,2,70
133771913,10,4,2,2,18
133782841,34,25,9,25,93
133784709,31,13,2,1,47
133790114,69,3,2,1,75
133790182,42,21,2,2,67
133793487,121,62,14,2,199
133794937,29,56,11,2,98
133804837,78,31,2,1,112
133805635,99,3,4,1,107
133811777,132,3,2,1,138
133817515,157,24,20,1,202
133842409,15,3,2,1,21
133852188,28,11,45,2,86
133854690,44,22,4,1,71
133863090,12,3,2,1,18
133867642,39,3,2,1,45
133874721,46,26,18,3,93
133885364,59,6,45,20,130
133892634,108,18,117,3,246
133896350,214,51,18,17,300
133903780,111,16,2,1,130
133930839,346,3,2,1,352
133945402,464,3,2,2,471
133959326,15,3,2,1,21
133963716,28,4,4,5,41
133965169,491,5,2,5,503
133971059,17,3,2,1,23
133979078,143,3,2,1,149
133979343,23,3,2,3,31
133995975,29,3,2,7,41
133997459,50,3,2,1,56
134003760,11,34,2,2,49
134005526,75,12,13,8,108
134024834,10,15,3,2,30
134028195,130,15,2,5,152
134028225,43,5,2,1,51
134037328,40,6,15,2,63
134038353,63,8,2,9,82
134044118,11,3,2,1,17
134048090,29,35,2,24,90
134064556,66,38,54,67,225
134079502,122,5,64,3,194
134090493,129,13,2,5,149
134102648,39,12,2,1,54
134110365,143,29,23,1,196
134111274,26,35,5,8,74
134134551,41,11,2,14,68
134147895,34,10,6,1,51
134158022,50,34,2,5,91
134173418,746,3,2,9,760
134186133,122,18,2,8,150
134199863,56,64,2,2,124
134207211,66,3,2,5,76
134213546,28,16,2,1,47
134213680,110,7,2,9,128
134214076,122,35,24,3,184
134221877,121,3,2,1,127
134222237,105,26,5,16,152
134227330,53,3,2,3,61
134228023,69,22,2,4,97
134235530,31,47,25,12,115
134241512,26,7,2,1,36
134270870,34,18,2,3,57
134279950,53,3,2,6,64
134294074,45,26,5,7,83
134294340,133,11,8,4,156
134298513,45,22,5,7,79
134303505,10,3,2,2,17
134309705,11,3,2,1,17
134314446,113,3,2,11,129
134318763,25,22,6,1,54
134326115,16,3,2,2,23
134329867,42,21,2,6,71
134343613,48,3,2,3,56
134354170,98,27,117,21,263
134373444,53,16,13,2,84
134382136,12,3,2,1,18
134392040,45,24,6,6,81
134400068,15,3,2,1,21
134405157,44,3,62,1,110
134418297,14,3,2,1,20
134424186,78,7,11,1,97
134431139,53,28,21,30,132
134469661,46,28,6,2,82
134474037,11,3,2,1,17
134478071,52,12,23,14,101
134482415,13,12,2,1,28
134483547,63,57,2,11,133
134487110,39,69,37,20,165
134500834,214,6,2,10,232
134501188,39,32,2,4,77
134505186,11,5,3,6,25
134517795,14,10,2,1,27
134520026,66,13,2,1,82
134538264,43,36,2,1,82
134539603,14,3,2,1,20
134558123,22,21,4,1,48
134607445,29,31,2,1,63
134609694,36,47,33,4,120
134611940,10,3,2,20,35
134618563,116,72,44,3,235
134629979,101,3,2,1,107
134650389,36,7,2,1,46
134655791,66,43,3,10,122
134659323,354,3,2,8,367
134662280,291,36,9,3,339
134663080,35,41,4,1,81
134663442,11,5,2,1,19
134675597,40,18,19,15,92
134693410,52,35,3,35,125
134696931,10,5,3,1,19
134732355,50,13,2,7,72
134734034,10,3,2,4,19
134734165,69,22,20,20,131
134740058,23,15,30,7,75
134741109,25,46,2,3,76
134743771,72,3,2,21,98
134747262,12,3,2,1,18
134748517,98,13,2,1,114
134758022,12,3,2,1,18
134758078,134,10,2,2,148
134764039,13,3,2,2,20
134772360,78,26,2,2,108
134785308,18,3,2,2,25
134785980,84,40,25,49,198
134802790,54,3,8,1,66
134810911,82,11,44,14,151
134814027,110,41,2,9,162
134816317,23,6,2,4,35
134819259,29,3,2,10,44
134823004,35,26,3,3,67
134827084,128,41,22,5,196
134843546,127,45,6,5,183
134861176,92,47,18,1,158
134865981,36,3,2,1,42
134881474,10,20,2,2,34
134884503,72,5,2,1,80
134892013,58,5,2,10,75
134894617,11,3,2,2,18
134908299,67,13,2,3,85
134928064,50,33,26,1,110
134936806,11,4,2,1,18
134937823,17,66,2,1,86
134939681,159,27,6,18,210
134946219,16,10,2,1,29
134953547,25,35,2,1,63
134968865,41,3,2,4,50
134970370,187,21,5,26,239
134985332,28,43,5,20,96
135000817,111,17,2,24,154
135004751,113,30,25,21,189
135004926,42,15,8,7,72
135009702,133,3,2,4,142
135022342,116,3,2,1,122
135057059,201,17,5,1,224
135059644,39,15,55,7,116
135082083,10,3,2,4,19
135086510,22,6,2,1,31
135093615,87,27,2,1,117
135100887,51,11,2,1,65
135103385,12,6,2,4,24
135122852,49,34,44,51,178
135143904,48,50,12,1,111
135157011,125,33,5,4,167
135176844,63,7,2,18,90
135187275,53,81,24,1,159
135196358,70,33,2,5,110
135238225,82,22,31,2,137
135243640,30,15,21,1,67
135268811,40,9,69,3,121
135282580,145,19,67,16,247
135287631,34,15,7,5,61
135294758,19,3,2,1,25
135315545,60,46,25,9,140
135323921,36,53,21,5,115
135329112,102,3,2,1,108
135348531,102,3,2,1,108
135353514,23,9,3,5,40
135366632,178,36,16,2,232
135377191,78,25,5,1,109
135387939,109,16,3,2,130
135392719,36,18,2,2,58
135401682,47,3,2,1,53
135411777,25,3,2,3,33
135412466,99,11,2,1,113
135423904,110,33,2,18,163
135424892,75,20,2,11,108
135426616,103,16,8,6,133
135426859,67,16,3,9,95
135435029,89,3,2,1,95
135448261,43,32,25,2,102
135463949,112,5,2,1,120
135467201,39,3,2,1,45
135471484,88,75,29,22,214
135479687,66,9,3,1,79
135479720,23,23,2,1,49
135482540,48,18,8,4,78
135508888,62,12,2,2,78
135518448,96,55,50,2,203
135523170,12,8,2,1,23
135532251,25,22,14,6,67
135541340,146,3,2,7,158
135543483,130,6,5,3,144
135546303,163,38,38,11,250
135549683,150,36,9,1,196
135568489,77,10,2,1,90
135571394,28,3,2,1,34
135571534,100,3,2,2,107
135573432,135,55,132,28,350
135577126,20,3,2,2,27
135588261,45,3,2,1,51
135591905,98,6,2,4,110
135606650,100,18,23,4,145
135609631,12,8,3,1,24
135617401,37,49,17,4,107
135624181,23,46,4,2,75
135630052,11,3,2,2,18
135634173,10,10,6,1,27
135644898,30,3,2,3,38
135674604,84,18,2,1,105
135677120,32,13,25,9,79
135680843,210,73,5,23,311
135688048,20,3,2,1,26
135692696,184,32,3,1,220
135700336,77,24,34,93,228
135705770,55,5,3,6,69
135712651,35,3,2,1,41
135715111,15,14,2,2,33
135717026,55,20,9,11,95
135725999,47,3,2,1,53
135740761,113,3,2,14,132
135758894,70,30,5,10,115
135764306,25,3,2,1,31
135775030,127,47,11,10,195
135800120,45,48,29,46,168
135804139,63,27,47,1,138
135830623,11,3,2,1,17
135833203,30,81,4,5,120
135839469,12,6,2,1,21
135841777,23,22,2,3,50
135856789,32,35,27,1,95
135861538,106,3,2,1,112
135871287,130,24,2,6,162
135876659,52,19,2,1,74
135879799,61,10,25,3,99
135902461,77,12,32,5,126
135902997,145,7,32,11,195
135907192,21,15,22,8,66
135931097,84,3,2,1,90
135947969,81,11,2,3,97
135957666,13,3,5,1,22
135964837,227,21,13,3,264
135966281,27,23,2,4,56
135978088,120,39,2,25,186
135979469,36,3,2,1,42
135987768,27,3,2,1,33
135993476,91,72,78,15,256
135994055,61,3,3,1,68
135995597,69,21,9,14,113
136005831,480,7,4,59,550
136037153,21,9,2,1,33
136042436,11,3,2,2,18
136045458,15,11,2,1,29
136048122,53,61,11,11,136
136062481,18,10,10,1,39
136073375,65,18,2,18,103
136074368,58,3,2,1,64
136082865,99,10,10,1,120
136091295,91,3,2,19,115
136118200,20,3,2,2,27
136127894,93,71,2,3,169
136135322,16,30,2,1,49
136136321,40,3,2,1,46
136152069,51,50,8,2,111
136153192,129,32,9,2,172
136160295,52,13,6,26,97
136162981,30,3,2,1,36
136165971,88,13,10,28,139
136175205,110,3,2,26,141
136178461,13,10,16,6,45
136191225,172,3,2,7,184
136202299,15,14,2,1,32
136216507,64,3,2,3,72
136222079,44,3,2,1,50
136228880,96,15,6,5,122
136238058,122,43,36,31,232
136245687,10,3,2,4,19
136246098,66,7,2,1,76
136246734,27,5,2,1,35
136269499,14,3,2,6,25
136274207,10,13,2,1,26
136277605,69,12,23,11,115
136280567,75,33,3,3,114
136282933,47,81,36,15,179
136292616,123,16,4,2,145
136303179,100,3,2,7,112
136322860,194,24,2,40,260
136327294,84,3,2,1,90
136330403,118,77,63,10,268
136330413,40,4,20,1,65
136331829,11,3,2,1,17
136332407,34,25,21,1,81
136335559,69,14,41,7,131
136342961,33,21,32,2,88
136373166,40,30,26,1,97
136393427,49,29,2,3,83
136397828,152,24,2,1,179
136398878,19,23,2,11,55
136402736,157,16,56,2,231
136407240,93,45,37,19,194
136412603,17,55,2,1,75
136413538,102,39,55,9,205
136439255,36,19,50,1,106
136446840,10,4,2,1,17
136454292,13,3,2,1,19
136463158,152,18,28,7,205
136463914,10,6,2,1,19
136464100,141,3,2,23,169
136464882,10,5,2,1,18
136469929,37,30,26,1,94
136478144,48,95,3,3,149
136479451,64,72,7,1,144
136484009,200,3,31,2,236
136495240,29,12,2,1,44
136519424,77,33,5,4,119
136531952,80,3,2,1,86
136539436,99,11,110,24,244
136540593,55,41,48,2,146
136550938,37,62,2,5,106
136553337,41,42,2,3,88
136559219,104,32,32,18,186
136576685,42,3,2,2,49
136577779,56,3,2,1,62
136587861,65,30,31,3,129
136588254,12,3,2,1,18
136602125,116,60,78,1,255
136602517,37,25,13,4,79
136605863,34,20,36,2,92
136606085,54,3,4,4,65
136632225,88,3,2,1,94
136637365,35,18,2,2,57
136639462,189,10,46,70,315
136653456,10,3,2,2,17
136661847,42,6,2,1,51
136664630,96,54,33,2,185
136670813,76,3,2,3,84
136686717,50,154,38,14,256
136687601,29,21,2,1,53
136692890,75,28,102,3,208
136698498,64,3,2,3,72
136700651,32,20,2,29,83
136702158,164,3,2,4,173
136712103,31,3,2,1,37
136733710,54,17,67,1,139
136736932,45,32,3,2,82
136744192,12,18,2,1,33
136767617,71,27,4,5,107
136811204,69,16,2,2,89
136823167,11,3,2,1,17
136827915,51,17,2,3,73
136840107,89,3,2,1,95
136862263,135,43,22,3,203
136864930,40,75,18,1,134
136867337,73,66,39,1,179
136870673,55,13,2,7,77
136876422,139,4,2,1,146
136878472,36,7,2,1,46
136887067,68,3,2,1,74
136888339,21,7,2,4,34
136891102,41,21,30,39,131
136899648,64,12,19,1,96
136900708,15,14,2,1,32
136903528,48,13,2,9,72
136915045,27,15,2,1,45
136935214,125,3,2,1,131
136942219,105,3,2,1,111
136942355,67,3,2,2,74
136950873,10,9,21,1,41
136961863,16,3,2,2,23
136970667,33,3,2,5,43
136989085,13,3,2,1,19
137012457,106,5,2,3,116
137018079,50,3,2,1,56
137042222,315,3,2,4,324
137044970,10,5,2,1,18
137058719,42,3,2,1,48
137060027,23,3,2,1,29
137065967,25,72,2,1,100
137066661,110,19,6,5,140
137072063,109,4,2,5,120
137073328,62,27,21,1,111
137090157,28,17,7,1,53
137103397,70,3,2,1,76
137108067,117,3,2,2,124
137110444,65,9,2,4,80
137133904,123,15,2,4,144
137140270,52,34,25,4,115
137146459,113,27,11,49,200
137156271,13,3,2,1,19
137160103,10,3,2,2,17
137168030,47,10,39,4,100
137174198,68,27,6,13,114
137186787,71,38,18,106,233
137187448,35,30,22,5,92
137190294,42,106,57,1,206
137198964,20,3,2,1,26
137207789,102,3,2,1,108
137212704,29,8,2,1,40
137243577,49,14,2,1,66
137244023,79,29,57,1,166
137244313,86,21,3,23,133
137244599,32,33,47,7,119
137245298,64,64,32,11,171
137252317,18,3,2,1,24
137254971,118,3,2,1,124
137274650,43,9,28,32,112
137276186,35,3,2,7,47
137277477,12,3,2,1,18
137279574,67,11,25,1,104
137300188,66,48,25,1,140
137304701,22,3,2,1,28
137309344,23,3,2,1,29
137320849,38,3,2,1,44
137320882,78,24,2,13,117
137336448,48,3,2,1,54
137338264,16,22,2,2,42
137343180,77,20,2,4,103
137347771,12,16,2,1,31
137351303,178,7,2,10,197
137371174,17,3,2,1,23
137374026,84,3,2,2,91
137383184,101,3,2,6,112
137392170,260,46,2,3,311
137394650,78,14,5,25,122
137400860,18,39,5,1,63
137411029,31,12,2,1,46
137412705,24,3,2,2,31
137431089,26,45,2,6,79
137432593,11,6,2,1,20
137433769,10,4,2,1,17
137440800,119,15,74,3,211
137446511,1344,3,2,5,1354
137452503,16,3,2,1,22
137458845,13,3,2,1,19
137460389,73,26,4,1,104
137465141,112,3,2,4,121
137485298,94,10,2,6,112
137491867,45,32,68,7,152
137511188,15,3,2,1,21
137512853,44,3,2,1,50
137518512,13,3,2,1,19
137530004,39,74,2,1,116
137540693,122,18,2,14,156
137568982,11,6,2,1,20
137576508,49,33,2,1,85
137577851,78,6,49,4,137
137579653,84,72,2,20,178
137592913,78,7,2,17,104
137596790,93,17,65,1,176
137606387,11,3,2,1,17
137618019,88,16,32,9,145
137621319,101,41,8,2,152
137633641,190,14,2,2,208
137648656,180,67,47,14,308
137650915,35,3,2,6,46
137673757,85,4,2,2,93
137682548,51,71,2,13,137
137718189,86,9,6,1,102
137724807,70,3,2,1,76
137729953,29,6,5,1,41
137733737,47,22,3,1,73
137746289,24,15,2,1,42
137752433,21,5,2,2,30
137754895,33,3,2,2,40
137769197,29,39,2,1,71
137770556,21,15,14,1,51
137783338,94,26,2,1,123
137790434,31,5,2,4,42
137800923,112,23,5,4,144
137823083,19,24,30,1,74
137829579,56,61,12,3,132
137830804,20,18,6,1,45
137832081,124,3,2,2,131
137847656,25,7,9,7,48
137848445,46,3,2,1,52
137871743,113,38,3,89,243
137876170,14,3,2,3,22
137901187,121,28,2,3,154
137904842,25,9,17,6,57
137908244,10,27,2,1,40
137911193,98,19,2,5,124
137927897,15,71,5,6,97
137929834,18,60,2,2,82
137944323,244,3,2,24,273
137952093,107,15,46,3,171
137962905,103,17,2,6,128
137973659,24,9,13,1,47
137974280,44,10,2,2,58
137975813,160,6,2,1,169
137985572,94,41,4,4,143
137993664,18,7,2,1,28
137998241,47,14,59,1,121
138019314,98,39,3,4,144
138023554,143,35,2,2,182
138023946,66,32,44,3,145
138025455,23,11,26,13,73
138032677,343,3,2,6,354
138035824,108,17,2,4,131
138037539,59,3,2,8,72
138045863,24,30,2,1,57
138048831,18,41,2,4,65
138061902,12,3,2,1,18
138090016,172,33,17,6,228
138098701,56,9,17,1,83
138099068,86,46,2,18,152
138099198,98,3,2,1,104
138101154,146,24,2,2,174
138112900,30,5,2,1,38
138113805,65,3,2,1,71
138121118,16,14,13,13,56
138122857,114,69,30,37,250
138124175,52,65,11,46,174
138129049,76,14,2,7,99
138131616,114,30,2,6,152
138144398,50,24,2,4,80
138155981,58,3,2,1,64
138161240,14,6,2,1,23
138164358,63,3,2,3,71
138182921,10,25,2,1,38
138184749,146,26,7,8,187
138235689,10,3,2,2,17
138236383,11,3,2,1,17
138248984,107,3,2,1,113
138254692,45,11,2,1,59
138268537,14,3,2,1,20
138276563,169,3,2,2,176
138278432,32,40,25,21,118
138283293,99,68,35,9,211
138285358,11,4,2,1,18
138302463,105,24,12,1,142
138305365,87,9,4,13,113
138306010,21,3,2,1,27
138308655,102,20,10,31,163
138310908,10,12,2,1,25
138312188,59,12,29,9,109
138317604,47,77,58,26,208
138333388,138,24,23,2,187
138336890,85,45,24,2,156
138341329,85,12,63,10,170
138353247,60,4,9,14,87
138364567,101,3,2,1,107
138370091,113,16,2,13,144
138386252,139,32,18,3,192
138387256,81,3,2,1,87
138411863,10,3,3,1,17
138420496,62,55,19,65,201
138437233,25,3,2,1,31
138439634,70,9,2,1,82
138443027,32,7,2,1,42
138450273,19,3,2,1,25
138451866,57,28,19,21,125
138455528,114,7,10,3,134
138459285,68,14,46,10,138
138462767,43,106,27,1,177
138464455,13,3,2,1,19
138479669,111,3,2,3,119
138481303,16,27,2,1,46
138489166,31,3,2,5,41
138503163,58,24,35,8,125
138509691,88,21,45,34,188
138515194,37,25,23,10,95
138517616,10,3,2,2,17
138526019,21,20,2,5,48
138533860,21,3,2,1,27
138533934,96,25,72,20,213
138539922,32,3,2,1,38
138543088,40,3,2,3,48
138562115,59,23,28,1,111
138573828,56,57,2,1,116
138575863,20,3,2,1,26
138580426,96,11,2,2,111
138582556,66,17,2,1,86
138586572,260,29,3,4,296
138602945,53,32,3,6,94
138603462,44,27,3,14,88
138607407,14,65,5,6,90
138632997,11,3,2,1,17
138635660,19,3,2,1,25
138638138,44,14,2,3,63
138643997,67,29,42,1,139
138644598,119,3,2,1,125
138644614,54,3,2,1,60
138656305,17,9,2,1,29
138667932,52,37,2,1,92
138671253,36,4,2,8,50
138671667,10,6,2,1,19
138677582,19,3,2,1,25
138678875,87,14,8,1,110
138688554,25,3,2,1,31
138695764,129,3,2,1,135
138699604,90,19,2,3,114
138701590,138,3,7,32,180
138726607,64,20,2,31,117
138730564,123,33,14,10,180
138739347,17,3,2,1,23
138744153,66,3,2,1,72
138747847,60,3,2,17,82
138755554,41,8,2,1,52
138768297,145,34,40,3,222
138782697,22,8,2,1,33
138796209,64,3,2,1,70
138803583,14,3,2,4,23
138813121,11,3,2,1,17
138826751,80,30,5,11,126
138831680,16,35,2,1,54
138838093,35,13,2,1,51
138848432,49,41,2,10,102
138851044,19,3,2,1,25
138855497,47,10,71,1,129
138858046,50,7,5,2,64
138858115,110,47,20,5,182
138880768,37,22,5,1,65
138887020,19,8,24,1,52
138923238,47,3,2,10,62
138928372,139,3,2,16,160
138931124,113,3,2,4,122
138937894,10,5,2,1,18
138940756,26,8,2,1,37
138941544,13,33,2,1,49
138946110,35,10,2,2,49
138960329,128,4,2,1,135
138960740,70,3,2,1,76
138984070,75,46,16,13,150
138992642,62,15,36,24,137
138998770,49,3,2,21,75
139001171,51,8,2,1,62
139004626,46,6,3,4,59
139008380,64,26,37,3,130
139014610,52,69,3,2,126
139023084,16,20,2,1,39
139030232,19,3,2,1,25
139031358,83,3,2,1,89
139047429,14,3,2,3,22
139050708,33,22,4,1,60
139066861,45,27,22,66,160
139067731,22,33,2,1,58
139069057,15,6,2,1,24
139072998,70,15,13,18,116
139081118,22,3,2,1,28
139083141,33,22,2,1,58
139123727,53,61,2,1,117
139133640,66,13,32,2,113
139140378,108,24,3,1,136
139144040,10,6,2,1,19
139159574,64,7,3,14,88
139161802,28,3,2,1,34
139162986,65,31,51,3,150
139174575,20,12,14,1,47
139185012,56,3,2,1,62
139187376,28,14,5,1,48
139187534,12,3,2,1,18
139208111,11,3,2,1,17
139208901,11,3,2,1,17
139212519,10,6,2,1,19
139219413,156,13,130,26,325
139237216,22,7,2,3,34
139246623,67,31,2,11,111
139252891,29,12,2,3,46
139254093,32,3,2,1,38
139267000,13,3,24,1,41
139267263,11,3,2,1,17
139285210,53,13,6,2,74
139286187,161,10,2,10,183
139289013,69,16,2,9,96
139302416,13,3,2,4,22
139314073,152,39,57,13,261
139321896,95,6,2,2,105
139326597,25,13,2,17,57
139329782,20,45,2,2,69
139332226,166,9,2,1,178
139346728,20,3,2,2,27
139359279,32,7,2,1,42
139391018,58,4,15,13,90
139392837,221,15,3,1,240
139398457,68,49,2,24,143
139403223,22,56,8,4,90
139406044,93,24,35,2,154
139417993,10,4,2,1,17
139431221,95,34,2,1,132
139437982,14,3,2,1,20
139438752,17,3,2,2,24
139443738,86,25,2,8,121
139478125,311,15,11,7,344
139480005,104,3,2,1,110
139488847,66,44,4,8,122
139489918,157,26,39,15,237
139526554,29,35,2,1,67
139553743,78,15,41,17,151
139571637,144,24,3,1,172
139581523,105,47,27,4,183
139589858,111,14,2,1,128
139590991,44,37,2,16,99
139597416,18,28,2,13,61
139600908,29,42,6,1,78
139606266,212,25,4,3,244
139625352,22,5,2,7,36
139626341,117,4,38,5,164
139629543,173,3,2,33,211
139646248,85,49,28,27,189
139648453,15,3,2,3,23
139657348,233,26,2,47,308
139666568,136,42,16,25,219
139679158,33,42,2,1,78
139680570,34,4,18,1,57
139700803,155,25,6,3,189
139704006,410,3,2,2,417
139707485,168,19,61,1,249
139711059,41,3,2,1,47
139713257,23,5,2,2,32
139717756,31,34,2,1,68
139721077,97,3,2,1,103
139727637,63,19,28,4,114
139728642,120,17,66,1,204
139732528,41,38,25,14,118
139738638,13,3,2,1,19
139748186,23,56,50,1,130
139756203,11,3,2,1,17
139759176,125,37,68,8,238
139767510,12,3,2,1,18
139773944,13,3,2,1,19
139795971,45,3,2,1,51
139800969,19,3,2,2,26
139808765,38,40,4,1,83
139822715,14,3,2,2,21
139855718,14,5,2,2,23
139857045,16,3,2,1,22
139858282,64,3,2,1,70
139862121,10,22,2,1,35
139879182,104,24,8,1,137
139885659,168,26,70,1,265
139891180,18,22,2,1,43
139921463,12,3,2,1,18
139922868,76,39,5,26,146
139955614,111,41,32,2,186
139961283,73,16,24,4,117
139966636,27,3,2,1,33
139972076,32,58,4,5,99
139973679,78,3,2,1,84
140001143,65,14,12,7,98
140010190,36,107,2,1,146
140017624,71,17,31,2,121
140032618,11,3,2,1,17
140033983,150,3,2,6,161
140034075,36,3,15,3,57
140047292,46,45,53,14,158
140059725,14,12,2,1,29
140094837,125,25,2,6,158
140095638,91,3,2,1,97
140105177,21,58,26,1,106
140126444,72,39,38,4,153
140126581,142,3,2,4,151
140133209,188,24,3,1,216
140135965,59,30,2,9,100
140138429,13,5,2,1,21
140142707,14,3,2,1,20
140150921,108,3,2,3,116
140157684,18,6,2,7,33
140181753,22,3,2,1,28
140182388,10,3,2,2,17
140201835,35,3,2,5,45
140209847,46,17,51,82,196
140213097,107,3,2,13,125
140215466,80,3,2,1,86
140217283,39,3,2,1,45
140218854,85,4,2,2,93
140228165,60,15,23,7,105
140231277,43,43,9,1,96
140233136,98,22,2,8,130
140236056,14,3,2,1,20
140239781,42,3,2,4,51
140256464,12,3,2,1,18
140271012,13,3,2,4,22
140276921,11,3,2,1,17
140285472,84,3,33,1,121
140286004,26,37,3,12,78
140295686,80,70,5,3,158
140295899,83,34,91,2,210
140313366,11,5,4,1,21
140324827,39,40,4,4,87
140335151,522,27,2,13,564
140343526,10,4,2,2,18
140356866,84,19,2,3,108
140358646,124,13,27,6,170
140366327,12,14,2,1,29
140367678,10,4,2,1,17
140370096,48,6,74,1,129
140372753,290,3,2,1,296
140378567,54,6,12,1,73
140380689,73,3,2,1,79
140383780,132,11,7,15,165
140385122,30,23,2,2,57
140395288,37,3,2,1,43
140405055,16,9,2,1,28
140405828,53,16,19,7,95
140418164,17,14,2,1,34
140429704,11,3,2,1,17
140432746,15,14,5,5,39
140455227,285,3,2,1,291
140458494,11,3,2,1,17
140462264,66,36,41,3,146
140463210,25,8,2,1,36
140465035,95,62,50,9,216
140466524,161,23,21,9,214
140466659,18,30,2,6,56
140490671,39,7,3,3,52
140507362,36,27,5,1,69
140508621,62,49,27,34,172
140508660,142,25,2,2,171
140512863,83,19,4,1,107
140514058,96,3,2,6,107
140528328,60,28,2,9,99
140540371,74,39,75,1,189
140543435,58,11,2,9,80
140563872,13,3,2,1,19
140584424,53,14,2,3,72
140584949,44,31,67,21,163
140597122,42,12,2,1,57
140614756,84,28,10,29,151
140622963,32,3,2,12,49
140638764,45,3,2,2,52
140643486,26,52,31,30,139
140670905,13,3,2,1,19
140675960,190,3,2,10,205
140713564,152,19,2,1,174
140724980,46,20,66,1,133
140737608,34,59,7,1,101
140767183,115,22,2,7,146
140780264,38,3,2,49,92
140791730,77,56,49,5,187
140792224,54,23,11,11,99
140803944,49,3,2,3,57
140807549,45,15,2,4,66
140812506,95,3,2,6,106
140816064,10,5,2,1,18
140825647,18,3,2,4,27
140831647,61,33,13,2,109
140837502,85,3,2,3,93
140848827,20,3,2,1,26
140872612,15,50,2,2,69
140894874,55,36,3,3,97
140896011,128,48,35,1,212
140915602,36,46,6,3,91
140926982,117,3,2,1,123
140927326,50,41,47,1,139
140949617,57,42,68,44,211
140956124,93,3,4,3,103
140974931,82,19,2,6,109
140995266,54,25,9,61,149
140999022,80,21,4,1,106
141004403,146,3,2,1,152
141006703,139,3,2,3,147
141020177,14,3,2,1,20
141023309,14,3,2,1,20
141023501,43,19,158,5,225
141025001,10,6,2,1,19
141065382,65,16,2,1,84
141089389,194,12,4,30,240
141132419,16,3,2,1,22
141163275,93,3,2,4,102
141170262,36,10,2,1,49
141171245,58,18,10,1,87
141175945,112,3,2,2,119
141183248,39,21,7,22,89
141194220,73,3,6,1,83
141208716,141,3,2,1,147
141214583,122,64,41,5,232
141226266,13,3,2,1,19
141230045,40,34,3,6,83
141235442,108,11,20,1,140
141239089,30,3,2,1,36
141258585,82,13,47,24,166
141262394,71,6,2,3,82
141263033,79,3,2,1,85
141264924,16,29,7,1,53
141276325,81,4,2,4,91
141281309,56,3,6,5,70
141289217,131,16,7,6,160
141290478,58,14,2,1,75
141293122,222,5,37,3,267
141303881,22,66,2,3,93
141306540,54,5,2,8,69
141315857,40,72,19,4,135
141323666,97,27,15,1,140
141343136,80,90,5,28,203
141346785,88,33,76,10,207
141349729,84,36,41,16,177
141357685,35,25,2,1,63
141359034,93,3,2,1,99
141376420,41,87,7,14,149
141390759,48,20,2,1,71
141399394,37,10,4,7,58
141403978,32,7,2,1,42
141415750,24,24,25,6,79
141427225,140,6,2,8,156
141446173,13,10,2,1,26
141446548,15,3,2,2,22
141466359,11,5,2,7,25
141488777,194,24,6,1,225
141503641,11,3,2,2,18
141527654,65,3,2,4,74
141528580,151,3,2,3,159
141538977,34,12,2,2,50
141555134,114,3,2,6,125
141586926,78,17,7,74,176
141587751,154,3,2,9,168
141618878,60,17,46,20,143
141634279,46,6,2,3,57
141638197,58,9,4,2,73
141646128,22,3,2,1,28
141659685,74,3,2,1,80
141665160,24,27,6,5,62
141669238,12,3,2,3,20
141671083,16,3,2,1,22
141673405,29,10,22,10,71
141673805,10,3,2,2,17
141674628,69,12,2,2,85
141695480,75,26,6,3,110
141707107,76,10,60,9,155
141712550,346,5,2,9,362
141714040,13,12,2,1,28
141716825,88,4,3,1,96
141717561,97,78,27,11,213
141726022,38,10,5,8,61
141745140,75,3,2,3,83
141748754,52,14,7,1,74
141749446,169,12,4,1,186
141752006,93,47,56,5,201
141752837,223,6,5,1,235
141760908,58,25,19,7,109
141775628,46,19,47,28,140
141775883,39,58,6,39,142
141778190,55,12,4,3,74
141793382,33,3,2,2,40
141832803,21,49,2,2,74
141834694,43,20,8,2,73
141880426,14,3,2,1,20
141888510,35,10,2,1,48
141890055,62,41,5,14,122
141893165,13,3,2,1,19
141912403,10,19,2,1,32
141928322,46,23,8,2,79
141945376,89,3,2,1,95
141960502,44,3,2,5,54
141966042,42,3,2,1,48
141987270,53,41,45,18,157
141992692,39,3,2,9,53
142002191,15,6,2,1,24
142040916,15,3,2,1,21
142047216,10,48,14,6,78
142059391,44,3,2,1,50
142066358,114,3,2,3,122
142070937,42,28,6,3,79
142070952,46,63,123,1,233
142085661,25,12,6,1,44
142086070,64,8,8,5,85
142087113,13,33,2,1,49
142095126,108,68,17,31,224
142136629,81,23,77,24,205
142161191,53,3,7,4,67
142173077,17,37,2,1,57
142178738,43,39,2,3,87
142190957,20,25,7,1,53
142201544,34,42,30,1,107
142217512,113,3,2,3,121
142228980,75,17,2,1,95
142238979,69,29,2,39,139
142244258,11,3,2,1,17
142271720,31,25,5,4,65
142290677,31,32,2,14,79
142298103,12,3,2,2,19
142301249,76,3,2,2,83
142320803,80,41,7,6,134
142329674,56,3,2,1,62
142352887,23,3,2,1,29
142355374,31,3,2,1,37
142357134,96,3,2,4,105
142357992,18,19,2,2,41
142362713,61,28,21,28,138
142366781,16,18,2,1,37
142378551,87,3,86,1,177
142380429,65,19,5,1,90
142389864,31,3,2,2,38
142398212,33,44,5,2,84
142401718,30,22,42,14,108
142402522,13,8,2,1,24
142402836,12,23,2,1,38
142411925,36,13,2,7,58
142413691,45,37,23,1,106
142416155,34,54,29,6,123
142421153,50,10,2,1,63
142428507,44,60,11,8,123
142437323,42,32,24,5,103
142437601,86,110,9,21,226
142444790,47,3,4,17,71
142481706,72,22,15,4,113
142498414,447,3,2,27,479
142508944,53,16,2,1,72
142509149,132,26,2,5,165
142516997,62,83,45,2,192
142517081,13,19,8,3,43
142524324,40,57,2,2,101
142524650,62,79,19,19,179
142524897,79,3,2,6,90
142542296,65,53,3,3,124
142554721,34,72,2,2,110
142557271,17,3,2,1,23
142560688,83,24,26,1,134
142567069,136,46,4,9,195
142571291,39,3,2,1,45
142572810,59,21,30,1,111
142587511,83,16,2,1,102
142588249,27,6,2,1,36
142598336,121,11,43,10,185
142601148,20,3,2,1,26
142606056,68,19,7,2,96
142607629,109,3,2,14,128
142610453,183,3,2,2,190
142623242,51,11,2,1,65
142629735,46,11,2,4,63
142636313,10,5,2,1,18
142640564,62,3,2,4,71
142657504,30,3,2,1,36
142658524,25,3,2,1,31
142666807,86,120,2,16,224
142676178,155,3,2,1,161
142681869,11,3,2,3,19
142682594,98,82,32,2,214
142688421,145,15,9,6,175
142688829,201,25,42,14,282
142693823,61,11,2,1,75
142696708,132,151,23,44,350
142696824,126,46,11,25,208
142731757,90,3,2,7,102
142735764,44,23,14,2,83
142741310,17,27,38,1,83
142747244,38,8,21,1,68
142759477,24,6,2,5,37
142760495,57,37,73,1,168
142764462,12,3,2,1,18
142771675,20,9,2,1,32
142783368,31,21,2,1,55
142799747,11,3,2,3,19
142813304,24,44,42,2,112
142815812,107,19,19,56,201
142827733,28,53,14,2,97
142855063,160,3,2,41,206
142856874,15,67,2,1,85
142860729,79,3,2,6,90
142862439,82,31,2,1,116
142867004,24,21,2,1,48
142888764,35,23,21,18,97
142896796,10,3,2,8,23
142899978,21,22,6,2,51
142904472,63,21,17,21,122
142907956,115,35,164,5,319
142908041,71,9,19,6,105
142924759,112,48,2,1,163
142936209,11,3,2,1,17
142958317,16,3,2,1,22
142961804,10,21,2,1,34
142986632,48,5,3,8,64
142990021,29,3,2,1,35
142991752,69,56,38,26,189
143003433,28,3,2,11,44
143011725,115,3,2,5,125
143028399,10,3,2,5,20
143050281,16,26,2,1,45
143060668,75,15,5,2,97
143068965,50,13,36,6,105
143074226,52,15,2,1,70
143077628,122,4,2,6,134
143078259,26,14,2,4,46
143083806,58,38,2,10,108
143091792,50,48,43,2,143
143093445,126,3,2,3,134
143104462,34,42,10,3,89
143119172,100,65,8,25,198
143119912,46,12,2,4,64
143120566,44,3,11,7,65
143127701,25,5,2,3,35
143138890,136,4,2,3,145
143142989,89,36,2,9,136
143161471,107,41,2,6,156
143173079,66,10,69,6,151
143175514,30,7,52,5,94
143182715,29,4,2,3,38
143192353,51,28,12,1,92
143207130,22,4,2,5,33
143225577,14,5,2,2,23
143242994,33,20,2,2,57
143249692,48,3,2,3,56
143251735,108,29,123,74,334
143267845,155,3,2,1,161
143270936,116,33,2,6,157
143285302,50,3,2,2,57
143287331,74,9,2,1,86
143311075,100,21,27,14,162
143317284,58,53,60,121,292
143328283,134,17,25,3,179
143339211,73,3,2,1,79
143339379,53,45,28,4,130
143349240,55,18,21,27,121
143353920,19,5,2,3,29
143362446,25,11,2,3,41
143371603,42,3,2,1,48
143375858,10,5,2,7,24
143377959,83,3,2,1,89
143383352,21,3,2,4,30
143405310,57,47,32,8,144
143408586,17,4,2,8,31
143408638,24,8,6,5,43
143420261,38,40,16,10,104
143424160,36,45,3,1,85
143424480,138,19,61,17,235
143442530,157,13,21,6,197
143449168,10,9,2,1,22
143450146,15,11,2,1,29
143462336,21,3,2,3,29
143462392,88,34,5,1,128
143464468,92,3,2,1,98
143473383,77,3,2,2,84
143476262,80,15,2,1,98
143480161,158,26,28,12,224
143488568,26,3,9,9,47
143488857,95,3,2,2,102
143529425,70,3,2,1,76
143529922,61,31,7,5,104
143602661,11,3,2,1,17
143606599,51,8,12,9,80
143615532,30,45,2,4,81
143629492,45,61,20,36,162
143638156,44,40,21,4,109
143656383,134,13,4,1,152
143668320,63,36,2,1,102
143680927,46,34,3,1,84
143695066,113,34,5,42,194
143708013,66,32,16,1,115
143711381,142,53,6,12,213
143727783,53,26,2,3,84
143728339,16,15,3,6,40
143740396,46,3,2,1,52
143740475,273,37,10,1,321
143779220,111,3,2,7,123
143800604,88,64,35,19,206
143819407,26,3,2,6,37
143827641,122,69,48,39,278
143834915,94,37,2,16,149
143838311,27,3,2,1,33
143839045,12,13,7,1,33
143847440,100,38,82,14,234
143847481,41,78,31,32,182
143853368,154,20,2,2,178
143866390,146,42,44,76,308
143897377,16,3,2,1,22
143902285,136,3,2,11,152
143906079,44,8,4,7,63
143906418,29,31,20,1,81
143906667,40,3,2,1,46
143910864,41,21,12,1,75
143919234,150,16,49,27,242
143920827,48,20,10,4,82
143922159,47,15,8,1,71
143939783,87,14,3,24,128
143940618,46,27,34,6,113
143959899,50,42,14,6,112
143979327,30,3,2,2,37
143983440,16,3,2,1,22
143985978,28,77,78,1,184
143986964,98,3,2,1,104
143997501,27,3,2,1,33
143999608,52,25,13,1,91
144017024,91,20,44,10,165
144032383,62,13,26,5,106
144049156,170,7,20,6,203
144059715,16,3,2,1,22
144096578,136,32,26,4,198
144097180,59,3,2,32,96
144100402,12,3,2,1,18
144106187,57,24,12,24,117
144123897,139,17,26,1,183
144126386,67,3,2,7,79
144128223,20,3,2,1,26
144132142,143,25,6,6,180
144142012,14,7,2,6,29
144148028,38,20,2,1,61
144159833,34,19,6,1,60
144161975,10,8,2,1,21
144163915,142,38,2,1,183
144171312,93,6,20,103,222
144186501,42,25,15,4,86
144187884,104,15,36,1,156
144189327,15,28,2,1,46
144196101,16,3,2,1,22
144199753,58,39,100,2,199
144217779,103,21,4,1,129
144224280,107,26,51,27,211
144239305,57,3,14,1,75
144240418,42,3,2,1,48
144241828,52,5,26,1,84
144253408,101,3,2,3,109
144264191,118,15,35,5,173
144279732,68,6,5,1,80
144280010,107,11,5,13,136
144281386,30,3,2,1,36
144281758,163,3,2,3,171
144297510,169,3,2,2,176
144318209,57,45,53,7,162
144328782,55,3,2,2,62
144329853,11,3,2,1,17
144379651,25,3,2,1,31
144385163,96,25,19,7,147
144391724,105,21,49,5,180
144399641,11,7,2,1,21
144427744,35,7,21,1,64
144429481,11,3,2,1,17
144432176,56,66,37,50,209
144433694,15,22,19,8,64
144446314,41,12,29,8,90
144463169,37,69,18,14,138
144463526,13,3,2,2,20
144506359,88,3,2,1,94
144519920,52,52,41,11,156
144530156,70,90,11,30,201
144530607,131,30,78,2,241
144532322,50,22,4,11,87
144537592,88,33,106,8,235
144564128,59,12,2,1,74
144571551,30,29,8,5,72
144576689,12,3,2,1,18
144585264,31,9,8,6,54
144595711,14,17,2,1,34
144611894,25,3,2,6,36
144612566,128,6,5,5,144
144615684,98,78,103,6,285
144634541,26,52,2,6,86
144643629,96,13,3,17,129
144664600,80,25,2,3,110
144665579,12,5,2,1,20
144670025,67,3,2,1,73
144690532,13,3,2,1,19
144699989,12,16,2,1,31
144748211,147,46,41,29,263
144757638,31,38,48,22,139
144778279,179,3,2,2,186
144792700,77,3,2,1,83
144796042,73,3,2,2,80
144796282,53,19,28,5,105
144803378,22,3,2,1,28
144811514,72,8,2,10,92
144816988,51,14,2,9,76
144838125,56,3,2,4,65
144860426,24,3,2,1,30
144862355,35,12,2,1,50
144862409,38,3,2,1,44
144876599,37,36,79,1,153
144884097,86,39,46,1,172
144889698,23,8,2,1,34
144890156,37,30,3,3,73
144893026,16,14,7,26,63
144894157,87,17,7,13,124
144894714,173,43,54,83,353
144903205,32,26,16,5,79
144906579,44,38,61,4,147
144910047,12,3,2,1,18
144921758,45,35,2,1,83
144928557,35,11,17,1,64
144929799,53,29,51,3,136
144954499,30,24,2,3,59
144960337,115,75,55,30,275
144993884,48,3,2,6,59
144997770,56,29,33,10,128
145017619,19,25,2,2,48
145021049,15,3,2,1,21
145048448,151,36,2,1,190
145066083,111,27,8,1,147
145084317,66,24,107,1,198
145085338,11,3,2,1,17
145086384,180,3,2,34,219
145090417,12,3,2,3,20
145095967,66,14,2,16,98
145114582,148,55,16,8,227
145117750,17,21,2,1,41
145130044,14,24,20,1,59
145132022,87,33,65,27,212
145146565,50,34,5,7,96
145164278,76,10,17,1,104
145169184,27,35,2,1,65
145185148,48,21,2,2,73
145193850,29,50,20,1,100
145220900,12,3,2,1,18
145231344,34,3,2,1,40
145238894,73,8,64,14,159
145250348,18,3,2,1,24
145258319,180,18,5,21,224
145258441,61,3,2,1,67
145259510,120,3,2,20,145
145272162,43,37,2,3,85
145277748,78,47,94,3,222
145278233,13,8,2,1,24
145278629,188,118,89,54,449
145284174,97,3,2,1,103
145299834,194,41,34,1,270
145313866,119,31,3,9,162
145316164,160,30,2,1,193
145317053,11,3,2,1,17
145319598,50,3,2,1,56
145335517,124,46,2,4,176
145340159,15,25,2,9,51
145385365,88,12,52,1,153
145396297,138,3,2,1,144
145435717,103,10,2,1,116
145455982,112,15,4,7,138
145458091,25,33,23,1,82
145460066,31,56,15,21,123
145479602,34,3,2,8,47
145487023,47,37,59,2,145
145487072,16,13,2,2,33
145490603,68,3,2,1,74
145496199,76,14,23,1,114
145501537,108,3,2,1,114
145504180,29,6,2,1,38
145508738,77,34,16,6,133
145521777,29,47,5,3,84
145523521,100,18,10,33,161
145539966,33,3,2,9,47
145549601,67,3,2,2,74
145572817,165,3,2,4,174
145578357,125,7,98,1,231
145596878,18,7,2,1,28
145599969,50,55,2,11,118
145604889,15,12,2,1,30
145607752,80,3,2,1,86
145613133,253,3,2,1,259
145646160,78,21,3,1,103
145651217,42,13,2,13,70
145654229,44,68,16,1,129
145665187,88,19,47,7,161
145670946,75,40,18,6,139
145710131,53,16,33,5,107
145715819,21,3,2,4,30
145721213,64,7,54,30,155
145724726,42,30,3,1,76
145725925,71,3,2,1,77
145730647,10,3,2,2,17
145732755,13,10,2,1,26
145741964,85,38,29,13,165
145758110,35,41,19,1,96
145758458,10,3,2,7,22
145770820,24,24,2,1,51
145775460,46,3,2,2,53
145790658,37,14,7,1,59
145797591,22,3,2,1,28
145798513,72,3,2,5,82
145804161,94,9,30,1,134
145804612,17,9,2,1,29
145815342,20,3,2,1,26
145846502,61,28,118,49,256
145853621,12,3,2,1,18
145862083,78,25,5,12,120
145864124,35,5,2,1,43
145887863,17,3,2,6,28
145887934,71,51,3,19,144
145898978,26,3,2,1,32
145905981,50,17,2,1,70
145923397,46,7,2,1,56
145925963,27,3,2,5,37
145940979,19,3,2,1,25
145961069,101,47,26,7,181
146000470,79,6,15,3,103
146004198,44,32,53,74,203
146016738,43,23,4,4,74
146043087,66,33,52,2,153
146052207,10,20,2,1,33
146060245,96,3,2,5,106
146064761,18,3,2,1,24
146075103,14,17,2,1,34
146075490,105,56,10,14,185
146078467,48,3,2,1,54
146083850,21,19,3,7,50
146092582,66,23,17,5,111
146094020,71,54,50,13,188
146110066,20,17,2,1,40
146149372,47,33,4,1,85
146166928,14,5,2,1,22
146178012,17,3,2,1,23
146181243,175,14,5,3,197
146182469,90,18,2,4,114
146182885,111,3,2,1,117
146186884,122,3,2,8,135
146188606,20,24,2,1,47
146194104,11,25,2,1,39
146204168,67,26,90,2,185
146204490,51,17,73,3,144
146212428,115,7,15,26,163
146214368,27,3,2,12,44
146223677,99,3,2,1,105
146242217,89,42,2,8,141
146248285,11,3,2,2,18
146249230,54,3,2,1,60
146262007,90,5,2,11,108
146274171,75,33,6,6,120
146280258,11,4,2,1,18
146287217,64,15,10,1,90
146291312,66,25,26,5,122
146318211,27,3,2,1,33
146318270,37,3,2,2,44
146319916,11,4,2,2,19
146330755,10,22,3,2,37
146331755,105,47,10,9,171
146348483,69,16,11,8,104
146350170,53,3,2,1,59
146361090,35,3,2,2,42
146374107,25,9,2,1,37
146377328,138,75,20,18,251
146378712,33,6,2,1,42
146384522,99,10,14,52,175
146385307,79,35,28,6,148
146387268,78,17,2,1,98
146391543,67,30,2,1,100
146437193,48,24,72,1,145
146449714,89,94,29,4,216
146469392,34,10,19,3,66
146470923,32,24,7,4,67
146473142,22,7,2,1,32
146484047,105,21,4,21,151
146498934,64,20,58,2,144
146504008,42,3,2,2,49
146507952,45,38,2,1,86
146515029,12,3,2,1,18
146515092,17,12,2,10,41
146528155,13,3,2,1,19
146533703,83,21,2,2,108
146546995,11,3,2,1,17
146578690,116,28,2,3,149
146594732,53,43,4,2,102
146609079,26,9,2,1,38
146620866,79,56,18,5,158
146621066,77,26,8,2,113
146622736,11,19,2,1,33
146644550,77,3,2,3,85
146660931,56,38,37,1,132
146671723,80,27,2,1,110
146691305,31,49,2,1,83
146705713,108,3,2,1,114
146715964,64,27,9,6,106
146720921,31,15,5,4,55
146733536,120,80,28,2,230
146734955,95,3,2,11,111
146746767,55,40,2,12,109
146747023,37,3,2,8,50
146751464,36,17,3,3,59
146752361,129,35,38,3,205
146757212,68,28,2,5,103
146764025,93,12,2,31,138
146786025,99,3,20,11,133
146808685,24,138,2,3,167
146817259,72,3,2,1,78
146817333,37,5,3,3,48
146821915,70,25,29,17,141
146829509,30,15,8,17,70
146873974,109,9,2,2,122
146874554,66,3,2,1,72
146877667,137,33,48,3,221
146909276,15,14,2,1,32
146910188,118,3,2,1,124
146911112,14,3,2,1,20
146926409,63,5,2,1,71
146934363,51,26,7,8,92
146939017,10,6,2,1,19
146954174,214,52,34,5,305
146955771,12,3,2,1,18
146958691,42,15,3,2,62
146990114,13,7,2,3,25
147006504,54,27,41,3,125
147026131,31,23,39,3,96
147036260,64,15,29,3,111
147044933,24,72,2,1,99
147050042,51,3,2,2,58
147057873,23,7,2,1,33
147066392,43,41,15,2,101
147078133,11,3,2,2,18
147080130,52,23,24,13,112
147083802,78,17,6,7,108
147085890,12,4,2,1,19
147092595,67,13,2,2,84
147122703,17,15,2,7,41
147126031,63,37,50,7,157
147130673,230,12,3,5,250
147139747,10,47,2,1,60
147164197,102,17,56,28,203
147165957,34,3,2,2,41
147166934,224,34,3,2,263
147180024,363,3,2,5,373
147180547,43,11,3,4,61
147180619,40,3,2,2,47
147189003,10,11,2,1,24
147191527,54,36,3,14,107
147218875,110,3,2,3,118
147221477,18,7,2,1,28
147227323,114,15,4,1,134
147227755,64,3,2,3,72
147259712,45,3,2,1,51
147260961,13,10,2,1,26
147268996,32,75,3,1,111
147270496,11,3,2,1,17
147283771,122,13,2,3,140
147284747,100,3,2,1,106
147304452,79,37,17,10,143
147311031,96,3,2,11,112
147342679,34,21,7,15,77
147343951,57,3,2,2,64
147346493,25,81,2,1,109
147351833,51,6,2,1,60
147365409,82,14,6,1,103
147387797,80,50,37,3,170
147393731,37,3,2,1,43
147396335,17,3,2,1,23
147412070,29,27,5,2,63
147416357,13,7,2,1,23
147418877,38,28,2,1,69
147427186,26,9,2,3,40
147430296,10,4,2,1,17
147437801,109,95,10,76,290
147437867,15,29,27,2,73
147442862,86,32,36,14,168
147450868,32,8,5,14,59
147451128,54,3,2,1,60
147453333,161,43,28,1,233
147462925,47,100,23,48,218
147472410,44,3,2,1,50
147472668,39,45,24,9,117
147521962,20,56,20,6,102
147523959,109,42,56,29,236
147552805,261,55,48,33,397
147559628,71,3,5,14,93
147572965,33,56,46,8,143
147592674,11,3,2,1,17
147595338,346,3,2,10,361
147606394,10,15,2,1,28
147618972,39,3,2,2,46
147619754,61,13,3,2,79
147622026,77,105,15,18,215
147623403,44,18,2,6,70
147625337,116,22,24,2,164
147631251,100,3,2,2,107
147632557,82,36,74,18,210
147641048,148,34,31,20,233
147647955,20,3,2,1,26
147648581,98,42,6,10,156
147655216,14,8,2,1,25
147660785,11,3,2,1,17
147668126,157,3,2,7,169
147668386,23,24,22,1,70
147669800,39,28,17,1,85
147670726,11,3,2,1,17
147687724,24,23,9,1,57
147696891,19,3,2,6,30
147702088,52,19,2,1,74
147710883,32,32,34,43,141
147730828,51,6,3,1,61
147732638,46,12,2,3,63
147749723,17,3,2,2,24
147755567,62,45,2,1,110
147788277,100,3,2,1,106
147811118,141,80,79,1,301
147813247,72,17,23,4,116
147849566,23,18,2,1,44
147853870,10,3,2,2,17
147877096,74,20,59,3,156
147877788,28,28,2,6,64
147893844,18,18,2,1,39
147897235,65,3,2,2,72
147905725,62,47,5,1,115
147912592,73,13,16,2,104
147917097,37,6,2,1,46
147929812,42,3,2,1,48
147944220,57,16,134,1,208
147944541,20,3,2,4,29
147963667,92,49,4,14,159
147966351,33,21,6,7,67
147967644,21,69,5,6,101
147972432,35,8,2,1,46
148014086,59,46,17,5,127
148025080,13,3,2,3,21
148036910,26,8,2,1,37
148075765,46,38,24,27,135
148087878,97,72,38,16,223
148091930,51,35,3,1,90
148103335,46,54,2,13,115
148111056,57,13,17,40,127
148114362,43,3,2,1,49
148134005,436,25,2,11,474
148160246,58,50,2,3,113
148161260,47,42,26,2,117
148170496,59,3,2,17,81
148188096,31,9,2,2,44
148196814,73,6,2,2,83
148197942,36,44,2,1,83
148221197,39,35,116,3,193
148244536,28,18,3,18,67
148249461,17,3,2,1,23
148264842,10,5,2,1,18
148272214,196,3,2,4,205
148277803,62,3,2,1,68
148300363,35,36,5,2,78
148303754,39,8,9,16,72
148312690,98,10,7,18,133
148313821,10,5,2,1,18
148315694,58,38,26,1,123
148326899,51,25,10,3,89
148350770,16,8,2,1,27
148350860,81,3,2,15,101
148351037,93,30,19,1,143
148360975,88,16,9,17,130
148366797,116,20,3,4,143
148373161,81,37,7,4,129
148374218,11,3,2,1,17
148389386,27,3,2,4,36
148394054,26,29,15,2,72
148397097,20,59,3,2,84
148401824,35,5,10,19,69
148402724,52,167,37,4,260
148410036,372,3,2,1,378
148419070,121,5,2,3,131
148422149,68,3,2,8,81
148429291,46,33,5,5,89
148429338,41,20,21,1,83
148438196,34,3,2,1,40
148439357,176,3,2,1,182
148442355,145,16,2,2,165
148443053,216,46,38,65,365
148454569,116,9,71,27,223
148460145,95,3,2,2,102
148468495,14,3,2,1,20
148483497,22,57,17,2,98
148484459,103,47,77,43,270
148492153,79,49,24,22,174
148498915,31,18,2,1,52
148503353,26,23,15,1,65
148503767,147,11,18,5,181
148520071,40,21,17,1,79
148537641,61,32,31,3,127
148539286,30,3,2,3,38
148548381,13,18,2,1,34
148554854,13,3,2,1,19
148561758,19,37,4,5,65
148579213,100,3,2,7,112
148603766,10,4,2,1,17
148631210,24,46,3,3,76
148643357,79,78,76,1,234
148644849,37,3,2,1,43
148662944,13,3,2,1,19
148685903,26,11,3,1,41
148686945,53,24,2,1,80
148696989,73,36,17,25,151
148706860,132,16,2,3,153
148721298,65,27,3,37,132
148728388,11,13,2,1,27
148731834,17,8,2,1,28
148735725,22,3,2,1,28
148746029,30,25,25,3,83
148760493,11,3,2,3,19
148770831,13,3,2,1,19
148771275,37,12,5,3,57
148782574,26,51,3,5,85
148783390,123,3,2,3,131
148784572,66,30,2,2,100
148791328,130,24,41,39,234
148826131,95,19,27,35,176
148831782,81,9,2,2,94
148838074,85,3,2,5,95
148842312,14,3,2,1,20
148852245,81,23,50,4,158
148855061,49,14,19,1,83
148874668,39,3,2,1,45
148878115,10,50,2,1,63
148883823,49,16,45,39,149
148904053,67,3,2,1,73
148914644,39,9,35,7,90
148919649,17,21,2,13,53
148921072,69,14,28,1,112
148928431,95,29,28,21,173
148930389,11,11,2,1,25
148960288,10,50,2,1,63
148963925,95,29,2,2,128
148977040,32,68,7,7,114
148981558,35,18,6,1,60
148986349,53,46,32,30,161
148988861,247,3,2,6,258
148994641,235,3,2,11,251
148996111,72,3,2,1,78
149008300,162,3,2,3,170
149011116,123,14,32,1,170
149021609,102,23,9,7,141
149029485,57,3,2,5,67
149030704,73,3,2,3,81
149031764,188,3,2,6,199
149036950,46,17,3,12,78
149053583,30,25,3,29,87
149065898,12,3,2,1,18
149070223,100,31,2,5,138
149072473,21,3,2,1,27
149082763,85,48,122,1,256
149102457,42,3,2,5,52
149111459,13,17,3,2,35
149111660,33,3,2,2,40
149155755,56,26,11,2,95
149196116,67,20,15,14,116
149196520,40,14,4,2,60
149214244,20,23,2,10,55
149230570,77,15,12,4,108
149231993,51,22,2,2,77
149244953,37,29,20,1,87
149263668,59,3,2,1,65
149274329,54,67,16,1,138
149274811,70,55,107,1,233
149276492,21,3,2,1,27
149287648,45,36,2,1,84
149290850,30,47,2,3,82
149296015,18,3,2,2,25
149302434,191,45,3,2,241
149306902,51,42,2,2,97
149320876,30,13,2,4,49
149324857,91,18,95,1,205
149328106,110,27,18,2,157
149334485,135,3,2,7,147
149337215,98,3,2,2,105
149338587,23,12,11,5,51
149367191,70,3,2,1,76
149382629,13,3,2,1,19
149385950,11,6,2,1,20
149386460,51,19,21,20,111
149387458,10,6,2,1,19
149410406,121,9,42,8,180
149411385,37,10,42,1,90
149424757,60,12,3,1,76
149430811,138,3,2,33,176
149441393,232,3,2,6,243
149455143,14,17,13,15,59
149455261,20,13,2,1,36
149467226,69,48,3,1,121
149468654,86,20,81,17,204
149475117,16,15,2,1,34
149486724,52,24,17,2,95
149489190,108,3,2,5,118
149495077,56,3,2,1,62
149506477,100,3,2,2,107
149508403,27,3,2,1,33
149511473,20,3,2,1,26
149531592,151,3,2,2,158
149544901,36,5,2,1,44
149554514,71,3,2,5,81
149561329,29,6,20,3,58
149564096,162,113,2,13,290
149574916,11,3,2,1,17
149579846,15,46,2,3,66
149584243,97,7,43,6,153
149608550,18,3,2,1,24
149610178,13,3,2,1,19
149610758,10,31,2,1,44
149612111,37,26,5,3,71
149613557,10,3,2,2,17
149614973,79,23,63,10,175
149625720,24,12,2,1,39
149625875,101,30,2,3,136
149628306,86,33,2,14,135
149639861,16,20,8,16,60
149644537,26,20,2,1,49
149648313,13,8,2,1,24
149654650,114,17,2,1,134
149665503,27,32,103,10,172
149683122,14,12,2,1,29
149696468,47,14,6,4,71
149730334,88,9,2,3,102
149734650,39,21,21,24,105
149739019,118,3,2,1,124
149742854,132,117,6,21,276
149749982,44,39,27,18,128
149751935,159,3,2,5,169
149753872,32,73,5,2,112
149773030,157,3,2,1,163
149774639,28,83,11,2,124
149774939,44,60,16,4,124
149778880,16,11,2,1,30
149779557,82,5,2,1,90
149800743,88,35,3,4,130
149803991,16,38,3,5,62
149804555,40,14,6,1,61
149808191,23,6,2,1,32
149841765,10,13,2,1,26
149842695,13,6,2,1,22
149849242,23,3,2,1,29
149854099,32,98,20,16,166
149866148,12,3,2,1,18
149867574,233,27,29,27,316
149882229,40,21,2,2,65
149890925,63,3,2,2,70
149905933,43,7,26,43,119
149910196,48,5,2,12,67
149915488,50,41,3,3,97
149942169,174,3,2,4,183
149943261,22,3,2,1,28
149946963,16,20,2,1,39
149953819,18,44,15,11,88
149961666,33,3,2,1,39
149976180,77,8,46,1,132
149985382,11,3,2,1,17
149990379,150,3,2,3,158
149993226,85,38,89,1,213
149994275,16,3,2,1,22
149995010,26,3,2,1,32
149995816,19,12,15,1,47
150001248,25,3,2,4,34
150005434,152,129,26,78,385
150008077,10,11,4,1,26
150011586,23,27,19,1,70
150017961,48,13,2,1,64
150020267,65,23,3,1,92
150027640,63,56,19,29,167
150028990,116,27,112,2,257
150031096,15,4,3,3,25
150035080,86,21,26,11,144
150055302,39,22,2,7,70
150062865,10,14,3,1,28
150064345,175,27,71,38,311
150071126,123,3,2,6,134
150077454,66,48,2,10,126
150082767,72,3,2,5,82
150091109,92,20,55,2,169
150105805,40,6,22,1,69
150117965,104,46,62,27,239
150123551,63,17,3,40,123
150124437,66,10,13,19,108
150130513,56,3,2,1,62
150141216,16,8,2,1,27
150149730,49,3,2,2,56
150151575,69,42,5,11,127
150154050,26,32,8,10,76
150161408,141,29,18,41,229
150168984,31,89,2,3,125
150192916,168,8,2,1,179
150198242,45,19,54,5,123
150216442,114,3,2,5,124
150227457,20,3,2,1,26
150233131,128,41,39,5,213
150241866,46,3,2,30,81
150255646,18,51,2,1,72
150264258,157,18,57,9,241
150266157,80,32,2,31,145
150275880,59,13,2,1,75
150290968,12,3,2,1,18
150294063,102,8,2,10,122
150305437,26,3,2,1,32
150309512,10,16,2,1,29
150329612,43,26,39,1,109
150332550,102,19,8,15,144
150335737,177,75,19,1,272
150341248,66,5,38,1,110
150345775,16,3,2,1,22
150347222,18,4,2,5,29
150368411,66,31,24,1,122
150379062,151,63,14,9,237
150385162,11,3,2,1,17
150392782,249,35,67,39,390
150398602,91,14,102,7,214
150407514,11,10,2,1,24
150407939,61,3,2,12,78
150413173,105,3,2,5,115
150419614,213,3,3,1,220
150431105,59,47,2,1,109
150438721,86,9,2,2,99
150442295,35,27,2,3,67
150447276,166,3,2,1,172
150465228,60,3,2,4,69
150466270,135,21,2,1,159
150471680,107,3,2,2,114
150488999,24,14,2,4,44
150501535,95,3,2,1,101
150512253,199,15,4,36,254
150516926,11,3,2,1,17
150519856,139,3,2,1,145
150522597,51,77,38,3,169
150540452,12,30,2,1,45
150554604,22,16,2,1,41
150558294,41,114,12,1,168
150562159,28,56,17,6,107
150565337,54,23,2,1,80
150565377,43,17,2,2,64
150581020,50,3,45,18,116
150602179,96,30,2,11,139
150606033,19,21,2,1,43
150614857,129,3,2,10,144
150640296,73,27,2,20,122
150641101,20,9,2,7,38
150655894,57,3,2,1,63
150668640,71,21,29,3,124
150670534,71,3,4,5,83
150674981,129,20,36,2,187
150680087,96,14,2,1,113
150689752,52,23,88,3,166
150694927,13,4,2,2,21
150695717,12,3,2,1,18
150697709,264,65,40,7,376
150714628,73,11,22,2,108
150716764,153,20,5,39,217
150721026,104,9,5,3,121
150732610,200,3,2,4,209
150735156,69,4,6,24,103
150744700,21,36,11,7,75
150746256,183,3,2,3,191
150749697,120,6,2,1,129
150757601,64,54,11,2,131
150764531,87,62,3,7,159
150769950,90,14,13,1,118
150771199,61,20,7,11,99
150777889,45,36,17,23,121
150787078,12,3,2,1,18
150791455,35,3,2,1,41
150795696,13,3,2,1,19
150806943,90,37,19,6,152
150824707,44,58,9,23,134
150826813,70,53,115,11,249
150832255,63,3,2,2,70
150833675,60,11,2,9,82
150838782,50,52,31,2,135
150847478,109,40,2,1,152
150849157,61,3,2,1,67
150852692,16,3,2,4,25
150858350,101,16,2,1,120
150864353,180,3,2,1,186
150871707,97,17,2,2,118
150871911,147,53,47,19,266
150877258,19,3,2,1,25
150882911,10,3,2,2,17
150886949,55,20,49,10,134
150907654,24,26,13,17,80
150908925,61,16,29,6,112
150919116,48,16,2,19,85
150947025,54,53,32,8,147
150948630,72,12,30,10,124
150954069,34,19,15,11,79
150965015,13,8,2,1,24
150978864,57,27,60,5,149
150987837,10,3,2,3,18
150993185,12,3,2,1,18
151003681,50,24,22,18,114
151005903,101,41,18,2,162
151010498,161,3,2,1,167
151037995,35,26,53,29,143
151041583,65,3,2,2,72
151044173,57,3,2,1,63
151052666,154,7,57,1,219
151054533,13,3,2,1,19
151058728,47,10,54,39,150
151081531,78,17,89,11,195
151090234,117,111,9,3,240
151096020,16,18,2,1,37
151104976,10,3,2,2,17
151161859,136,42,77,1,256
151165539,127,38,3,51,219
151168689,102,28,4,19,153
151174470,17,7,2,3,29
151180001,28,72,40,25,165
151181578,21,27,3,1,52
151185165,81,15,2,9,107
151201225,11,3,2,1,17
151203069,93,3,2,1,99
151203465,24,3,2,1,30
151208188,106,3,81,1,191
151213567,32,14,6,3,55
151218697,12,28,2,1,43
151220449,14,14,4,1,33
151223017,36,4,2,1,43
151249702,13,3,2,2,20
151260776,65,3,2,2,72
151261012,27,4,2,7,40
151263409,173,31,2,1,207
151264171,17,33,2,4,56
151283963,82,13,12,10,117
151285780,116,4,2,1,123
151294265,13,3,2,1,19
151295332,77,29,2,16,124
151299078,14,5,2,1,22
151316337,34,37,4,11,86
151327705,25,95,2,4,126
151346017,10,7,2,1,20
151353457,38,50,2,4,94
151394195,44,38,18,27,127
151401306,45,25,5,11,86
151416082,13,3,2,2,20
151421187,22,3,2,1,28
151421874,16,13,2,7,38
151423050,52,38,3,2,95
151424223,26,13,7,7,53
151454327,39,25,12,8,84
151465936,83,3,2,4,92
151472011,16,3,2,4,25
151493843,24,3,2,2,31
151493847,29,3,4,12,48
151501898,23,124,64,2,213
151505047,129,43,8,33,213
151509147,131,10,25,6,172
151556121,13,9,2,1,25
151572509,10,3,3,1,17
151574159,61,3,2,1,67
151587438,13,3,2,1,19
151603489,71,3,2,2,78
151627659,74,33,14,1,122
151637198,58,36,58,8,160
151642446,18,37,2,1,58
151646645,16,3,2,1,22
151653967,37,15,5,11,68
151664333,41,24,7,11,83
151703967,13,3,2,1,19
151712177,46,4,2,1,53
151718615,50,22,2,2,76
151721217,57,29,2,5,93
151723927,31,46,25,13,115
151735162,108,15,71,7,201
151735311,86,7,2,1,96
151739646,42,3,2,1,48
151740445,13,6,2,1,22
151740680,46,11,9,4,70
151765221,34,29,2,1,66
151769868,90,11,85,23,209
151780948,13,3,2,1,19
151805564,20,3,2,1,26
151811456,13,3,2,1,19
151818691,32,48,6,12,98
151819397,34,5,2,7,48
151843299,70,20,87,1,178
151850768,119,16,61,23,219
151855660,125,86,3,8,222
151876354,17,7,2,1,27
151882457,76,3,2,1,82
151887630,120,3,62,7,192
151895038,24,6,2,2,34
151899068,45,3,2,1,51
151919630,110,40,33,44,227
151920608,75,16,5,26,122
151931807,93,20,91,18,222
151939957,92,3,2,4,101
151943791,152,8,3,1,164
151951591,74,24,3,3,104
151979595,15,3,2,1,21
151991760,104,49,114,6,273
151995385,87,51,7,5,150
152004429,16,3,2,3,24
152007506,80,16,22,19,137
152011456,108,22,32,2,164
152018751,30,7,2,1,40
152022194,15,11,2,1,29
152025701,27,5,2,13,47
152062821,129,99,41,1,270
152066108,10,19,2,1,32
152068954,173,22,2,4,201
152077645,10,4,2,1,17
152118237,10,4,2,1,17
152156103,222,18,62,6,308
152168002,90,12,43,4,149
152176645,90,30,9,1,130
152181972,67,22,16,7,112
152186882,68,14,9,2,93
152191649,13,9,2,6,30
152199422,20,3,2,1,26
152211022,25,4,2,1,32
152218180,89,27,25,5,146
152231285,56,31,44,30,161
152239037,134,25,2,1,162
152240161,59,75,5,4,143
152243672,55,16,2,1,74
152251171,36,54,12,10,112
152251259,100,19,27,5,151
152265596,105,3,2,1,111
152273640,11,4,2,1,18
152299301,84,51,87,5,227
152302752,132,16,7,1,156
152305648,19,3,2,1,25
152309015,18,10,49,7,84
152327462,53,17,9,18,97
152330762,63,37,13,19,132
152335322,50,15,2,10,77
152345164,134,27,80,16,257
152350420,87,30,34,9,160
152354856,21,13,2,1,37
152381286,44,4,2,7,57
152395900,117,88,53,99,357
152396713,25,3,2,1,31
152399122,91,48,108,94,341
152405014,154,44,38,32,268
152408286,13,3,2,2,20
152408550,77,45,6,1,129
152429201,88,31,24,7,150
152443287,19,3,2,1,25
152455552,45,7,4,5,61
152466892,12,6,2,1,21
152481160,14,3,2,2,21
152494131,139,3,2,2,146
152500385,32,33,27,2,94
152510746,40,28,2,10,80
152511939,88,80,2,2,172
152517999,21,3,2,3,29
152535462,48,3,2,3,56
152546739,162,15,68,13,258
152550764,77,13,2,6,98
152564473,33,4,3,1,41
152571212,78,3,2,3,86
152574848,52,35,8,4,99
152590547,11,4,2,1,18
152594679,62,8,5,1,76
152597705,104,26,70,27,227
152603126,170,8,2,5,185
152617673,72,3,2,1,78
152640712,130,5,2,1,138
152648336,56,64,24,47,191
152659014,33,11,2,1,47
152678208,110,20,2,1,133
152679965,71,3,2,3,79
152679967,175,3,2,124,304
152682596,98,14,2,1,115
152695836,64,23,102,3,192
152702646,130,3,2,41,176
152705964,71,3,2,10,86
152727484,179,54,44,80,357
152735685,65,92,15,12,184
152737473,60,3,2,1,66
152742750,13,3,2,1,19
152744209,32,13,2,3,50
152744758,56,23,2,1,82
152764292,89,17,2,5,113
152764612,130,7,2,3,142
152764729,36,3,2,1,42
152766929,32,5,2,6,45
152805667,19,3,2,1,25
152811816,80,32,13,1,126
152819317,104,27,2,1,134
152858514,85,3,2,51,141
152861203,12,3,2,1,18
152868525,17,3,2,2,24
152880020,11,3,2,1,17
152880485,52,8,3,2,65
152887917,117,14,16,16,163
152906480,17,3,2,1,23
152907769,22,37,2,3,64
152935581,78,4,42,1,125
152945613,36,3,2,1,42
152946128,14,9,2,1,26
152952898,83,12,2,1,98
152964822,23,22,2,1,48
152970546,192,5,2,1,200
152974951,20,3,2,1,26
152975784,41,25,2,6,74
152977657,70,54,5,2,131
152978286,25,3,2,2,32
152979460,95,8,15,12,130
152980630,187,93,2,33,315
152982093,57,5,2,1,65
152983813,53,7,31,9,100
152989499,34,38,6,1,79
152998166,192,64,3,22,281
153002457,39,34,5,1,79
153012573,55,52,36,1,144
153018790,27,53,15,1,96
153025565,11,3,2,1,17
153046307,222,3,2,9,236
153046902,51,42,10,19,122
153073138,34,43,2,1,80
153077320,47,5,34,2,88
153078366,81,15,5,4,105
153080607,10,4,2,1,17
153080924,15,53,2,3,73
153085041,87,3,2,1,93
153091057,157,39,91,1,288
153097936,86,20,2,3,111
153104049,47,6,3,1,57
153115313,83,8,2,3,96
153123572,29,38,33,1,101
153134625,48,70,13,4,135
153142797,37,11,80,16,144
153159094,147,78,2,4,231
153171743,11,3,2,3,19
153179892,91,17,66,27,201
153186570,192,8,2,11,213
153190390,57,3,2,1,63
153194374,53,22,2,4,81
153197445,83,46,38,11,178
153206007,19,4,2,6,31
153207172,194,32,38,11,275
153227327,50,27,2,1,80
153227529,63,45,15,50,173
153260881,16,8,2,1,27
153261909,10,32,2,1,45
153261944,146,3,2,3,154
153313427,30,31,13,6,80
153325654,66,80,100,10,256
153350605,74,35,11,4,124
153354800,62,59,2,2,125
153364006,29,58,2,1,90
153375111,32,3,2,2,39
153383228,58,15,8,17,98
153384680,10,4,2,1,17
153391799,120,8,6,5,139
153397060,68,5,12,12,97
153404275,189,40,25,3,257
153405049,100,16,3,26,145
153412125,59,104,20,8,191
153428657,112,3,58,2,175
153430596,148,27,20,1,196
153450757,23,3,2,1,29
153452933,18,3,2,4,27
153466712,107,3,2,2,114
153471532,14,3,2,1,20
153481652,22,5,2,1,30
153484023,56,27,2,1,86
153489483,84,5,34,1,124
153507111,14,18,2,1,35
153508246,12,3,2,1,18
153516168,48,27,6,2,83
153524421,38,12,2,1,53
153527701,32,16,3,10,61
153528927,14,3,2,2,21
153535924,56,24,3,9,92
153543886,106,39,77,3,225
153559692,68,7,2,4,81
153562104,55,41,10,17,123
153564854,168,27,2,1,198
153583988,37,4,2,9,52
153584811,10,4,3,4,21
153584907,203,3,2,20,228
153618957,14,14,2,27,57
153619129,17,3,2,5,27
153623652,122,3,2,3,130
153656994,69,3,2,1,75
153667212,64,3,2,25,94
153667532,58,80,26,2,166
153706292,47,3,2,1,53
153714469,163,19,2,9,193
153726950,19,3,2,1,25
153729025,165,58,2,5,230
153734447,36,31,15,3,85
153735410,47,3,2,5,57
153741335,83,3,23,1,110
153749965,54,39,34,1,128
153773327,82,15,26,20,143
153780983,11,8,2,1,22
153790724,139,8,2,4,153
153823782,15,5,2,1,23
153826096,65,3,2,3,73
153836296,105,36,4,8,153
153842946,67,50,2,1,120
153860196,70,7,2,1,80
153864525,109,12,2,1,124
153877962,45,13,18,5,81
153879434,47,3,2,1,53
153899749,51,3,2,1,57
153902267,14,3,2,1,20
153908294,57,4,2,1,64
153916279,119,13,24,14,170
153923693,58,50,21,8,137
153928415,198,3,2,2,205
153930755,15,4,2,10,31
153945271,19,10,2,1,32
153960840,21,23,2,1,47
153968796,14,7,2,1,24
153971145,45,11,2,2,60
153985501,122,9,2,1,134
153986944,274,20,5,2,301
153994996,28,14,5,5,52
154003761,54,28,20,1,103
154027585,14,3,2,1,20
154033387,80,3,2,10,95
154045429,117,118,27,5,267
154051764,91,27,30,30,178
154062154,252,77,3,10,342
154068383,29,3,2,1,35
154073534,18,3,2,1,24
154098806,53,3,2,5,63
154108799,10,4,2,1,17
154114928,58,23,2,2,85
154122873,78,22,138,1,239
154136396,31,26,2,4,63
154175309,27,3,2,1,33
154179423,167,17,14,21,219
154185784,28,3,2,12,45
154204865,20,15,2,1,38
154222000,17,5,2,1,25
154228828,20,3,2,2,27
154255794,15,3,2,1,21
154261537,90,3,2,2,97
154285685,16,32,2,1,51
154301230,46,3,2,8,59
154301542,159,30,69,26,284
154308968,23,3,2,1,29
154317922,63,3,2,1,69
154326851,36,27,4,10,77
154340171,29,26,2,9,66
154342613,93,3,2,1,99
154348955,28,3,2,13,46
154357628,60,30,35,1,126
154359223,197,19,2,3,221
154369183,10,5,2,1,18
154393067,30,42,2,2,76
154408151,38,15,8,2,63
154445836,20,3,2,1,26
154448198,48,9,2,4,63
154455294,64,11,4,15,94
154466210,27,3,2,1,33
154466969,14,4,7,1,26
154468517,91,35,2,11,139
154474885,10,4,2,1,17
154483048,104,24,2,6,136
154492684,18,10,2,1,31
154501820,287,24,2,22,335
154512907,32,3,2,1,38
154526777,45,76,3,1,125
154530302,89,20,2,2,113
154530677,43,23,17,8,91
154533303,45,71,3,1,120
154533976,94,5,2,2,103
154536194,107,42,7,12,168
154568828,29,18,55,108,210
154573727,42,12,2,10,66
154605505,39,3,2,3,47
154606453,17,3,2,1,23
154624723,173,3,2,1,179
154634546,61,33,24,35,153
154649756,12,33,2,1,48
154653573,56,59,30,1,146
154659145,167,21,2,8,198
154664094,93,3,2,1,99
154670438,53,4,2,20,79
154702039,93,22,26,1,142
154712212,21,3,2,1,27
154725208,151,23,3,5,182
154734189,75,3,24,6,108
154740890,11,3,2,1,17
154769904,47,26,24,10,107
154775375,86,30,12,1,129
154785942,117,21,5,30,173
154808582,28,3,2,1,34
154809082,12,3,2,1,18
154816408,33,13,2,1,49
154830462,127,3,2,1,133
154837258,62,3,2,22,89
154837907,167,44,4,17,232
154879980,63,23,12,1,99
154882582,40,19,22,13,94
154884971,232,9,2,1,244
154900098,11,3,2,6,22
154909799,139,11,8,5,163
154931730,10,7,2,1,20
154946440,45,12,19,13,89
154948719,135,3,2,1,141
154960071,15,3,2,1,21
154969566,210,3,2,2,217
154977222,10,5,2,1,18
154991882,17,13,9,3,42
154992194,36,20,19,8,83
155013160,74,31,23,23,151
155020469,573,3,2,51,629
155023004,22,33,32,1,88
155025487,135,18,3,4,160
155027192,51,3,2,1,57
155041793,19,3,2,3,27
155051495,74,28,39,20,161
155058627,29,30,13,1,73
155063136,46,9,2,5,62
155070980,31,29,8,1,69
155075077,12,5,2,1,20
155076867,45,17,2,15,79
155081492,87,24,3,20,134
155095945,66,4,27,10,107
155106266,111,3,2,9,125
155111681,16,3,2,2,23
155116691,36,16,2,4,58
155118799,42,78,7,17,144
155134789,59,3,2,1,65
155175365,209,22,58,17,306
155192859,21,34,2,1,58
155193369,162,22,54,26,264
155194386,25,3,2,2,32
155197936,78,3,2,4,87
155219412,50,133,6,3,192
155220756,33,54,2,36,125
155225302,35,3,2,1,41
155245673,82,63,5,103,253
155258603,42,3,3,1,49
155262750,25,16,2,2,45
155267306,72,26,9,2,109
155267485,16,34,2,2,54
155293420,99,27,5,4,135
155296133,39,41,12,1,93
155311716,152,39,92,9,292
155346009,36,3,2,1,42
155348250,216,3,2,4,225
155356360,12,30,2,1,45
155357211,41,3,2,1,47
155359713,80,3,2,6,91
155360959,38,3,2,36,79
155364316,87,3,2,3,95
155364334,120,58,37,2,217
155373063,24,26,2,6,58
155394647,57,8,2,1,68
155409107,47,3,2,8,60
155409160,23,7,2,5,37
155421312,10,6,2,3,21
155423208,146,3,2,9,160
155425927,98,28,83,21,230
155442332,11,3,2,1,17
155444134,179,3,2,1,185
155459199,181,3,5,5,194
155461421,133,3,2,2,140
155476649,76,71,29,42,218
155485477,38,3,3,14,58
155491640,105,3,2,1,111
155509293,15,4,2,1,22
155510164,14,25,2,1,42
155510740,22,41,6,2,71
155516532,19,3,2,1,25
155518518,142,24,95,1,262
155524793,12,4,2,1,19
155538196,110,26,2,3,141
155548214,53,7,26,1,87
155558420,33,32,63,2,130
155581630,88,8,2,7,105
155592480,14,14,2,12,42
155594823,10,3,2,2,17
155608516,14,4,2,1,21
155618045,27,12,3,12,54
155621118,11,3,2,1,17
155632294,199,34,50,57,340
155633378,50,17,2,1,70
155645822,31,3,2,1,37
155660366,78,7,2,1,88
155721742,37,30,19,16,102
155734235,133,3,2,1,139
155747188,20,25,5,4,54
155748403,26,27,8,3,64
155769932,10,9,2,1,22
155773894,13,21,2,1,37
155783272,90,43,92,4,229
155792711,11,3,2,1,17
155799918,110,4,21,1,136
155801024,11,3,2,1,17
155803315,170,9,5,1,185
155805144,14,5,2,1,22
155816651,56,3,5,2,66
155823544,66,17,2,10,95
155826743,45,3,2,28,78
155832633,10,9,2,1,22
155833427,25,39,2,1,67
155840386,28,3,2,1,34
155855170,14,3,2,1,20
155866928,18,3,2,1,24
155872406,27,63,33,8,131
155872803,25,24,24,1,74
155917667,11,3,2,1,17
155937784,11,3,2,1,17
155943578,10,4,2,1,17
155957203,154,36,33,1,224
155963882,15,17,4,1,37
155971587,45,19,15,19,98
155972137,13,25,2,1,41
155973828,19,16,26,4,65
155983075,24,17,14,6,61
155997866,181,41,11,17,250
156001198,17,3,2,2,24
156018090,13,3,2,1,19
156021080,72,12,2,3,89
156027259,16,21,2,1,40
156036634,142,3,2,2,149
156040100,29,77,14,6,126
156050150,38,12,10,1,61
156053791,76,25,76,1,178
156069378,21,3,2,1,27
156086274,92,5,16,8,121
156099001,32,6,2,2,42
156112002,122,44,9,13,188
156116812,234,3,2,1,240
156123129,72,6,33,4,115
156124967,50,22,30,5,107
156131931,193,9,22,16,240
156132002,157,10,2,7,176
156134372,104,49,76,1,230
156137299,196,23,6,14,239
156144860,39,13,2,1,55
156166725,57,11,2,1,71
156170435,16,3,2,1,22
156191500,24,3,2,10,39
156197874,85,47,19,7,158
156208529,191,30,104,50,375
156214227,82,20,2,9,113
156228920,14,3,2,2,21
156242052,112,3,2,2,119
156251642,98,3,2,1,104
156253356,107,16,2,9,134
156273104,31,19,36,1,87
156279815,33,8,2,6,49
156280274,63,3,2,1,69
156280810,12,3,2,1,18
156297736,82,67,61,7,217
156298866,92,8,21,9,130
156335250,151,3,2,1,157
156357642,68,22,3,1,94
156377554,10,3,3,1,17
156381606,87,3,2,1,93
156386538,11,3,2,4,20
156402230,31,29,9,1,70
156411118,136,31,15,26,208
156418949,45,35,2,1,83
156439736,36,91,20,5,152
156441610,152,53,16,1,222
156441893,24,19,2,4,49
156465605,67,13,16,1,97
156470177,102,61,68,16,247
156478148,164,41,66,5,276
156480561,29,19,5,10,63
156490221,229,28,116,19,392
156501274,138,15,88,4,245
156513135,36,5,2,2,45
156523428,162,36,64,50,312
156541947,95,3,2,1,101
156543217,28,20,3,6,57
156545240,49,5,7,3,64
156550692,58,51,26,3,138
156555180,166,3,2,3,174
156558199,139,31,12,2,184
156565019,18,5,2,4,29
156565524,50,7,2,1,60
156577327,16,3,2,1,22
156589812,77,74,62,1,214
156594426,30,30,3,16,79
156595662,98,3,2,46,149
156600543,81,42,51,1,175
156608305,27,3,2,1,33
156626645,84,3,2,5,94
156627756,67,33,52,27,179
156630773,66,37,17,2,122
156630817,18,3,2,1,24
156643023,93,9,2,5,109
156650944,45,12,3,9,69
156651743,110,71,8,9,198
156660127,23,19,2,8,52
156663254,34,33,2,25,94
156664367,172,55,6,9,242
156675480,30,3,2,1,36
156685164,35,41,2,16,94
156691123,98,11,2,1,112
156693647,80,32,7,5,124
156697407,10,5,2,1,18
156708940,69,25,2,31,127
156709765,133,14,2,10,159
156717558,35,11,2,1,49
156720441,147,6,3,21,177
156720530,38,16,2,16,72
156743569,87,52,2,9,150
156746351,104,3,2,4,113
156759647,138,3,2,1,144
156763776,29,4,2,51,86
156771294,48,68,19,15,150
156782233,16,3,2,1,22
156783856,51,17,29,4,101
156784096,152,25,58,21,256
156784476,112,30,25,1,168
156797479,211,5,2,3,221
156799967,72,34,25,1,132
156811831,54,10,2,1,67
156817434,152,19,2,7,180
156840262,62,4,2,3,71
156856242,25,36,22,6,89
156856899,92,36,2,18,148
156864781,151,39,31,77,298
156866221,66,23,2,1,92
156868289,76,7,55,10,148
156870087,109,13,17,1,140
156871195,24,3,2,2,31
156882634,12,4,4,6,26
156886046,33,35,9,3,80
156905808,11,7,7,1,26
156911035,60,13,32,4,109
156912010,45,34,3,1,83
156956751,51,29,2,4,86
156960587,96,19,3,4,122
156966558,40,43,41,3,127
156967034,84,20,24,13,141
156967226,47,44,3,8,102
156968951,155,16,100,3,274
156993641,46,29,2,10,87
157041598,98,10,7,4,119
157055981,123,30,2,3,158
157075777,147,68,97,8,320
157076767,65,3,2,4,74
157091355,203,15,2,5,225
157102472,110,27,61,23,221
157102939,99,25,12,5,141
157106615,112,9,2,1,124
157115487,13,3,2,1,19
157130878,11,77,2,1,91
157140651,127,69,27,5,228
157140784,31,9,2,5,47
157141768,131,24,4,20,179
157143596,19,30,2,1,52
157150678,37,39,3,9,88
157163657,11,3,2,3,19
157171899,40,25,17,9,91
157193873,79,50,2,2,133
157196663,163,55,70,6,294
157198161,14,4,2,1,21
157202945,88,9,3,3,103
157205575,213,3,2,1,219
157211237,11,3,2,1,17
157214035,11,5,2,1,19
157219598,65,3,2,3,73
157225028,137,136,33,1,307
157227797,100,8,2,4,114
157251436,114,29,2,5,150
157261047,65,3,2,1,71
157261209,182,19,2,2,205
157278345,17,13,2,2,34
157280846,21,3,2,1,27
157284334,34,4,73,1,112
157287768,96,3,2,1,102
157295916,103,3,2,2,110
157307284,104,19,2,6,131
157312756,41,24,2,1,68
157312858,101,27,5,2,135
157320612,87,3,2,4,96
157329412,115,27,2,1,145
157342596,81,3,2,1,87
157344797,13,3,2,1,19
157369562,24,22,4,1,51
157378550,114,29,4,4,151
157385539,52,3,2,1,58
157393721,78,26,36,10,150
157398207,30,52,6,3,91
157398432,20,36,57,1,114
157409092,76,16,50,37,179
157417371,16,43,16,21,96
157430130,81,141,6,6,234
157434093,69,3,2,4,78
157444958,10,3,2,2,17
157445566,29,3,2,1,35
157462716,48,3,2,1,54
157462809,43,41,2,11,97
157470391,51,27,8,2,88
157477773,19,9,9,1,38
157480922,11,3,4,1,19
157481227,11,11,2,1,25
157484309,148,3,2,27,180
157489008,50,68,15,6,139
157505415,75,3,2,3,83
157512299,152,26,2,49,229
157514640,59,4,2,1,66
157515352,47,3,2,1,53
157529672,70,19,23,1,113
157533639,81,3,6,1,91
157546304,37,40,47,1,125
157554539,10,16,2,2,30
157560431,54,3,2,16,75
157563377,44,69,16,9,138
157564285,22,13,2,1,38
157567828,192,3,2,1,198
157571709,48,20,2,1,71
157578705,26,4,2,1,33
157579260,53,28,26,36,143
157584248,16,30,3,4,53
157586881,10,5,2,1,18
157587598,66,35,60,13,174
157587699,107,70,38,10,225
157600221,31,18,2,1,52
157604156,89,35,2,1,127
157621281,50,8,2,1,61
157635721,14,18,2,2,36
157637831,121,3,2,8,134
157639317,87,36,7,16,146
157664304,76,56,34,8,174
157666188,108,47,41,11,207
157670827,201,3,2,6,212
157673913,31,108,10,1,150
157693509,34,35,2,5,76
157697138,10,12,2,2,26
157698231,52,3,2,2,59
157705890,15,11,4,1,31
157709941,171,16,11,1,199
157746252,51,3,2,1,57
157754433,17,3,2,1,23
157765055,133,16,129,5,283
157771575,157,35,34,50,276
157775478,10,5,2,1,18
157777904,81,12,2,1,96
157788121,189,3,2,1,195
157800158,10,3,2,2,17
157800655,47,11,2,3,63
157804354,168,26,22,2,218
157810655,15,21,2,1,39
157822860,76,11,55,1,143
157822887,11,3,2,4,20
157833281,16,8,2,1,27
157837770,60,52,70,7,189
157843694,20,31,2,2,55
157844400,76,19,3,1,99
157856068,13,3,2,1,19
157856955,12,3,2,1,18
157857716,93,36,20,6,155
157865603,28,78,4,1,111
157875664,112,21,40,18,191
157901428,30,6,2,6,44
157921412,10,6,2,1,19
157922256,110,3,3,1,117
157938466,38,24,2,1,65
157949475,152,17,2,2,173
157951225,28,47,2,6,83
157957109,64,3,2,7,76
157967839,101,13,2,8,124
157972686,11,3,2,2,18
157976016,16,8,2,1,27
157979924,39,3,2,7,51
157990744,47,28,35,4,114
157995926,110,47,2,2,161
158008750,18,3,2,1,24
158015540,104,3,2,1,110
158020976,91,3,2,1,97
158026604,12,3,2,1,18
158029837,18,59,4,10,91
158041616,159,23,9,5,196
158050695,53,3,2,1,59
158055252,177,23,4,4,208
158062573,73,3,2,5,83
158081017,32,7,8,3,50
158083149,96,6,5,4,111
158093283,76,43,4,5,128
158094261,140,4,2,1,147
158095167,87,37,24,5,153
158106443,48,15,29,15,107
158111723,60,3,2,2,67
158144798,14,6,2,1,23
158155332,114,36,21,1,172
158162119,134,7,2,1,144
158170125,131,12,8,11,162
158170237,13,3,2,1,19
158182705,64,3,2,2,71
158184211,164,7,30,13,214
158199093,10,5,2,2,19
158204123,89,15,12,9,125
158208355,12,3,2,2,19
158210797,56,11,9,1,77
158216180,66,29,34,9,138
158231831,24,31,30,14,99
158232634,20,5,2,1,28
158236917,23,54,2,30,109
158238160,61,14,39,10,124
158253127,29,14,2,4,49
158256889,51,3,2,1,57
158274244,80,25,19,8,132
158282277,12,9,2,1,24
158286392,11,6,2,1,20
158313636,46,3,2,1,52
158340110,53,3,2,4,62
158352932,10,6,2,1,19
158356933,25,5,2,1,33
158360671,71,19,11,2,103
158364754,11,3,2,1,17
158381139,43,32,22,69,166
158386715,29,3,2,1,35
158387787,155,5,13,35,208
158389044,47,16,5,28,96
158396606,60,40,2,1,103
158420899,31,5,2,4,42
158424017,53,10,2,10,75
158430995,13,4,2,1,20
158431942,56,49,2,7,114
158432705,169,50,26,35,280
158439713,76,61,2,1,140
158442940,88,28,16,14,146
158463638,66,77,30,16,189
158474857,503,49,2,9,563
158478849,152,42,47,24,265
158480675,10,5,2,1,18
158503613,25,27,28,1,81
158545795,85,11,26,10,132
158546466,332,40,5,16,393
158551974,48,5,2,1,56
158552260,18,14,11,4,47
158575393,126,3,5,3,137
158577405,12,3,2,1,18
158582738,199,3,2,1,205
158590405,56,24,3,1,84
158611799,12,3,2,1,18
158615281,38,24,3,1,66
158623464,74,30,2,14,120
158640570,150,15,7,3,175
158652584,65,15,41,1,122
158668696,49,3,2,1,55
158689238,94,17,30,14,155
158701312,18,5,2,1,26
158710714,142,14,22,4,182
158714940,33,19,2,1,55
158723460,27,3,2,1,33
158728675,68,19,9,19,115
158737115,18,30,3,1,52
158739491,13,7,2,2,24
158751587,74,3,2,11,90
158752279,145,42,34,4,225
158769290,12,3,2,1,18
158777361,103,3,2,13,121
158784559,182,3,2,33,220
158785362,52,3,2,3,60
158799067,50,3,3,2,58
158799409,87,14,47,10,158
158803791,72,3,2,4,81
158809058,17,3,2,1,23
158812868,101,63,13,2,179
158817245,141,3,2,1,147
158825903,82,3,2,1,88
158837467,54,56,2,3,115
158862050,107,15,7,10,139
158867899,37,31,12,2,82
158884357,51,24,6,5,86
158894986,58,10,3,1,72
158894995,97,3,2,1,103
158896971,157,46,13,1,217
158901279,11,3,2,1,17
158904709,44,91,34,1,170
158912656,82,3,2,1,88
158915727,166,16,15,13,210
158915828,32,56,10,16,114
158917062,14,3,2,1,20
158926694,29,20,10,10,69
158943193,52,22,2,19,95
158944330,33,3,2,1,39
158949317,14,3,2,1,20
158964024,12,3,2,1,18
158972802,24,50,2,3,79
158979564,127,64,38,22,251
158994629,87,3,2,3,95
158995434,51,18,2,2,73
158996317,89,6,6,1,102
158997040,48,41,30,8,127
159002959,54,11,8,43,116
159004408,13,11,2,3,29
159016508,139,74,57,18,288
159028631,86,101,2,1,190
159030366,17,4,2,1,24
159036055,83,34,7,5,129
159036089,43,5,2,1,51
159038516,15,12,6,8,41
159039083,260,3,2,1,266
159054709,43,5,2,1,51
159065339,86,33,5,12,136
159069605,34,19,8,1,62
159070351,16,30,15,1,62
159071059,69,12,2,1,84
159077676,29,42,6,13,90
159084378,19,4,3,2,28
159099758,163,134,7,35,339
159110774,21,3,6,1,31
159128868,34,39,15,3,91
159132730,131,6,38,15,190
159135574,127,17,35,2,181
159138959,143,77,37,1,258
159139961,14,6,3,1,24
159145231,104,19,3,8,134
159158405,47,23,19,10,99
159161436,148,14,2,1,165
159166056,282,29,2,9,322
159173359,69,3,2,2,76
159195406,12,3,2,1,18
159201074,67,7,2,1,77
159213479,75,24,17,1,117
159220974,65,15,16,2,98
159236905,42,24,28,12,106
159264093,25,19,5,16,65
159269725,80,3,2,1,86
159310141,107,45,5,17,174
159324742,64,3,2,2,71
159337548,111,3,2,1,117
159349632,16,22,6,2,46
159376558,55,6,2,4,67
159387082,16,3,2,1,22
159387237,149,46,126,20,341
159397620,35,49,28,24,136
159400556,21,12,7,6,46
159405886,23,3,2,1,29
159406765,49,3,2,1,55
159407154,33,12,16,1,62
159432951,107,28,11,1,147
159433109,36,42,11,1,90
159439941,197,3,2,2,204
159447097,36,6,2,1,45
159447200,28,15,20,4,67
159452933,118,29,22,5,174
159459128,17,13,2,4,36
159459632,32,21,13,2,68
159477067,145,36,28,6,215
159479180,166,3,2,1,172
159497308,122,46,2,8,178
159518796,81,3,2,1,87
159528684,61,16,25,2,104
159531798,48,13,2,2,65
159539607,10,49,2,1,62
159550252,11,3,2,1,17
159554715,68,21,23,8,120
159565276,28,3,2,5,38
159572956,12,3,2,1,18
159592565,17,3,2,1,23
159593738,112,39,13,15,179
159601446,20,10,2,1,33
159604603,22,14,35,13,84
159607313,163,20,39,1,223
159621148,58,19,19,8,104
159639106,114,14,4,7,139
159647586,96,6,3,1,106
159652509,140,8,44,24,216
159667172,136,3,2,19,160
159667181,113,34,31,9,187
159668305,26,13,2,1,42
159668812,256,3,2,3,264
159677397,12,9,2,1,24
159682679,29,8,2,1,40
159685088,43,10,21,2,76
159694387,114,14,2,17,147
159701611,236,13,4,2,255
159707049,19,3,2,1,25
159710724,41,3,2,7,53
159720120,13,14,2,1,30
159743611,13,9,2,1,25
159750708,65,37,3,3,108
159753578,34,11,2,7,54
159754800,49,44,2,6,101
159777693,85,29,51,11,176
159785874,60,6,2,9,77
159795160,11,3,2,1,17
159796722,23,14,12,26,75
159797201,13,12,2,1,28
159808114,99,3,2,1,105
159812366,37,3,2,2,44
159825551,119,15,2,2,138
159828767,15,5,2,1,23
159837016,11,3,2,1,17
159847380,131,3,2,5,141
159875902,25,59,157,14,255
159905722,102,24,66,1,193
159916723,48,25,2,16,91
159917179,13,35,2,1,51
159925898,95,6,2,1,104
159928357,38,18,34,2,92
159931320,58,3,2,3,66
159938092,47,3,2,2,54
159957448,22,3,2,1,28
159968535,29,15,2,6,52
159980129,50,92,2,7,151
159986048,12,3,2,2,19
159989189,92,3,2,1,98
160021500,42,21,2,1,66
160023938,16,17,3,9,45
160045112,44,35,19,7,105
160046009,104,3,2,1,110
160068296,43,42,16,9,110
160072657,18,17,2,7,44
160073688,28,52,82,3,165
160075168,15,3,2,3,23
160077545,82,3,2,1,88
160090401,11,3,2,1,17
160101150,127,31,4,17,179
160101506,141,3,2,1,147
160103705,122,3,2,2,129
160108334,84,19,20,6,129
160109669,176,27,2,24,229
160123606,71,20,2,1,94
160123615,44,12,2,1,59
160139324,10,4,2,1,17
160142125,35,3,2,2,42
160148189,49,66,26,11,152
160150710,97,3,2,1,103
160151370,28,3,2,1,34
160178769,65,22,39,8,134
160185256,52,3,2,1,58
160185820,69,25,2,1,97
160189358,74,24,34,10,142
160193526,32,4,39,3,78
160201256,24,3,2,1,30
160202134,92,17,2,1,112
160202250,11,3,2,1,17
160206430,18,43,9,6,76
160231034,120,27,131,7,285
160231676,11,3,2,1,17
160260786,22,67,3,9,101
160264516,17,3,14,1,35
160281709,63,78,31,16,188
160297613,87,70,3,1,161
160303144,126,26,2,14,168
160307227,94,3,2,1,100
160359033,65,41,14,28,148
160367891,20,22,8,3,53
160374430,40,3,2,2,47
160385981,31,7,3,1,42
160398093,61,48,28,27,164
160399803,95,22,195,1,313
160401029,17,3,2,3,25
160404918,12,13,2,6,33
160410848,13,3,2,1,19
160419683,123,34,23,1,181
160422443,168,58,133,7,366
160427520,160,3,2,23,188
160432529,11,6,2,1,20
160437185,57,3,2,1,63
160440958,154,3,2,2,161
160442836,31,3,2,1,37
160452505,25,3,2,8,38
160467863,18,3,2,1,24
160470120,44,3,2,1,50
160472198,469,3,2,2,476
160474932,139,28,69,54,290
160492492,20,14,2,1,37
160507626,10,46,2,1,59
160509534,22,8,2,1,33
160531686,22,34,7,1,64
160532327,146,37,6,19,208
160537801,30,60,4,1,95
160540948,70,3,2,2,77
160541017,22,3,2,1,28
160547518,102,7,2,1,112
160551812,59,7,29,2,97
160557452,27,54,34,7,122
160562375,11,4,3,1,19
160567561,55,19,16,1,91
160571938,109,5,2,2,118
160583665,11,18,2,1,32
160588059,29,19,12,2,62
160590666,62,14,2,3,81
160610800,123,5,2,2,132
160613759,12,3,2,2,19
160619858,32,69,10,1,112
160622564,139,3,2,12,156
160666692,86,11,4,9,110
160675754,11,3,2,1,17
160679350,11,3,2,1,17
160680532,92,3,2,2,99
160684119,42,3,2,1,48
160701969,128,53,50,42,273
160708291,85,25,2,3,115
160718043,59,22,2,10,93
160718388,41,28,2,1,72
160735134,70,3,2,7,82
160737684,58,31,5,27,121
160739546,23,49,24,2,98
160764069,10,3,2,2,17
160764688,49,51,34,1,135
160766595,37,23,2,1,63
160784445,81,116,8,11,216
160801820,36,42,2,4,84
160821981,94,104,58,10,266
160824467,177,42,14,8,241
160831945,14,3,2,5,24
160836903,13,3,2,1,19
160838691,159,56,2,15,232
160856602,115,15,2,3,135
160872315,41,3,2,1,47
160878800,100,25,11,13,149
160882070,77,3,3,7,90
160889361,14,10,2,14,40
160903320,37,3,16,1,57
160909539,29,3,2,1,35
160938766,76,3,2,1,82
160953068,62,34,4,1,101
160961769,13,3,2,2,20
160971892,48,32,14,1,95
160977253,86,73,71,8,238
160988626,15,3,2,1,21
161024449,75,3,2,4,84
161029634,182,49,28,37,296
161032412,12,4,2,1,19
161034256,23,36,5,3,67
161049422,92,3,2,9,106
161063703,67,3,2,1,73
161071347,16,49,9,2,76
161071498,139,3,2,12,156
161071938,14,22,2,1,39
161082398,300,3,2,5,310
161083465,10,5,2,2,19
161086158,51,55,3,8,117
161086957,60,3,2,1,66
161091588,59,27,2,3,91
161098692,95,67,19,1,182
161099634,19,3,2,1,25
161101111,26,8,2,4,40
161103888,10,34,2,1,47
161114549,115,12,68,1,196
161117819,46,11,6,28,91
161145808,11,3,2,1,17
161173884,47,60,16,1,124
161182708,60,24,2,5,91
161192245,18,56,9,5,88
161194480,18,7,2,1,28
161199767,72,63,2,19,156
161224208,79,38,18,5,140
161225692,62,63,39,1,165
161261685,15,3,2,1,21
161270367,38,44,6,22,110
161281657,111,64,14,1,190
161286240,82,24,12,3,121
161287722,13,3,2,1,19
161289093,38,5,2,1,46
161291002,47,77,84,2,210
161291865,207,3,2,5,217
161297188,14,7,2,1,24
161304847,79,5,2,4,90
161312942,74,16,2,7,99
161322872,19,3,2,1,25
161328386,31,59,26,8,124
161338281,182,34,4,1,221
161361141,35,41,2,4,82
161368808,36,39,7,7,89
161374228,55,3,12,1,71
161376089,109,14,25,1,149
161384815,132,9,2,1,144
161422241,46,30,90,2,168
161432500,52,8,2,4,66
161433375,34,20,2,1,57
161434541,43,52,40,3,138
161442897,191,15,5,2,213
161447773,142,32,2,7,183
161450989,28,33,24,16,101
161452156,13,3,2,3,21
161457840,82,12,2,19,115
161472660,177,36,6,14,233
161475349,12,3,2,1,18
161476636,47,16,2,7,72
161478747,50,35,21,2,108
161480978,107,40,4,6,157
161481157,35,59,52,4,150
161483242,83,3,2,1,89
161485304,319,3,2,22,346
161490107,38,5,6,1,50
161498674,117,4,2,1,124
161504823,105,84,3,2,194
161513627,86,31,25,2,144
161554572,17,3,2,4,26
161555464,117,4,2,1,124
161555734,17,3,2,1,23
161556755,11,3,2,1,17
161564813,46,32,2,1,81
161568813,52,11,76,25,164
161570063,31,4,2,1,38
161575546,64,36,5,5,110
161599613,92,105,23,8,228
161628121,11,3,2,3,19
161641297,27,24,2,1,54
161644706,81,17,3,7,108
161645248,51,33,2,8,94
161650586,38,6,2,2,48
161679559,26,16,2,10,54
161680862,23,11,15,53,102
161690046,26,23,11,1,61
161691034,31,20,2,1,54
161712228,161,3,2,7,173
161713854,28,3,2,1,34
161716372,83,45,33,12,173
161717803,15,19,11,1,46
161721329,19,3,2,1,25
161745831,30,11,2,1,44
161747315,47,26,17,23,113
161748606,31,5,2,6,44
161761317,14,3,2,3,22
161765736,221,74,8,22,325
161778977,153,17,44,20,234
161788196,42,3,2,4,51
161791879,120,31,2,1,154
161804878,48,17,37,12,114
161812900,27,3,2,1,33
161826040,136,27,2,17,182
161826352,95,26,50,34,205
161828494,12,4,2,3,21
161835879,14,5,2,1,22
161853712,26,32,16,10,84
161858874,41,3,2,1,47
161867682,116,3,2,1,122
161884867,81,7,40,13,141
161891292,12,3,2,1,18
161896140,124,4,3,9,140
161900737,85,3,2,1,91
161903017,11,5,2,1,19
161908154,64,4,2,8,78
161924736,47,8,2,1,58
161942204,10,9,2,1,22
161945724,136,46,35,1,218
161952311,142,32,4,5,183
161974600,52,3,2,1,58
161988730,81,31,2,9,123
161988878,54,18,3,2,77
162003109,29,40,2,1,72
162003348,201,86,2,3,292
162015540,12,3,2,1,18
162018075,98,12,2,1,113
162028226,65,26,2,1,94
162035686,198,106,6,17,327
162036547,60,3,7,2,72
162036738,222,3,2,3,230
162038054,178,50,24,13,265
162040528,37,28,31,2,98
162045797,31,14,2,7,54
162060458,126,33,2,1,162
162060574,103,12,84,1,200
162068333,114,3,2,5,124
162069778,16,10,2,3,31
162094039,55,3,2,5,65
162097718,50,8,11,1,70
162122179,63,3,2,1,69
162132123,17,13,2,1,33
162133342,66,12,2,1,81
162154306,318,8,2,29,357
162156769,83,24,22,2,131
162159677,40,6,2,1,49
162203477,45,49,23,6,123
162205835,22,3,21,1,47
162210981,46,42,2,17,107
162222977,116,20,2,1,139
162232238,171,42,3,2,218
162236453,56,33,33,9,131
162237334,54,3,2,1,60
162243427,38,3,2,1,44
162255684,65,3,2,1,71
162262708,143,33,37,4,217
162271042,55,3,2,7,67
162275175,51,3,2,1,57
162278784,73,3,2,1,79
162279157,29,27,5,15,76
162279826,50,20,2,1,73
162287852,63,4,2,1,70
162291242,68,7,11,2,88
162300964,36,71,11,3,121
162301095,51,8,2,1,62
162308656,27,26,5,3,61
162311867,98,3,2,1,104
162316828,36,3,2,1,42
162327531,117,34,2,39,192
162332414,16,12,2,1,31
162334151,190,44,25,1,260
162346214,91,24,8,15,138
162349885,218,12,2,23,255
162365886,76,3,2,2,83
162381833,162,11,11,23,207
162388305,24,34,2,1,61
162393092,129,11,6,1,147
162398153,146,20,2,19,187
162409668,32,20,4,8,64
162409833,43,35,2,1,81
162409996,167,3,3,7,180
162413681,10,13,2,1,26
162414096,58,67,2,7,134
162428988,11,7,2,1,21
162429673,35,10,13,2,60
162430211,70,5,72,5,152
162433887,268,3,2,18,291
162451434,71,3,2,49,125
162465697,38,3,2,1,44
162466539,38,30,21,1,90
162470060,106,61,3,23,193
162482838,11,65,2,1,79
162496192,99,3,2,1,105
162500520,160,49,25,72,306
162501808,91,15,2,1,109
162522423,57,30,52,10,149
162529264,10,3,2,2,17
162543569,98,3,2,2,105
162573496,28,73,2,1,104
162574552,12,3,2,1,18
162583359,54,45,2,5,106
162585133,11,3,2,1,17
162593383,17,3,2,1,23
162599121,37,44,2,1,84
162599315,84,56,3,6,149
162610212,46,23,3,1,73
162639046,23,8,2,2,35
162645333,52,28,2,1,83
162653397,20,3,2,2,27
162653948,65,47,2,10,124
162656491,78,10,2,8,98
162671963,17,9,2,1,29
162679784,28,24,7,18,77
162697388,27,29,6,12,74
162703518,45,40,42,2,129
162705359,31,36,2,1,70
162705720,10,3,2,3,18
162736139,12,3,2,2,19
162740136,37,3,2,3,45
162741543,167,75,3,20,265
162747467,105,3,2,1,111
162748967,29,19,10,12,70
162752379,90,6,2,2,100
162759753,12,5,2,3,22
162763746,22,17,12,2,53
162770568,25,30,7,3,65
162788004,83,35,7,2,127
162810201,53,11,2,3,69
162810736,59,4,2,1,66
162827080,17,12,2,5,36
162829388,16,14,2,2,34
162851886,35,34,20,1,90
162853169,28,3,3,1,35
162861111,103,53,2,1,159
162875883,35,53,9,2,99
162877272,57,3,3,1,64
162883758,26,4,2,2,34
162886701,60,17,2,2,81
162941382,108,141,17,13,279
162941710,50,60,9,4,123
162944444,180,3,2,3,188
162947727,48,3,2,2,55
162951291,131,16,17,1,165
162973226,92,16,2,1,111
162984788,11,8,2,2,23
162985519,36,14,10,6,66
163002464,95,157,81,13,346
163015021,11,3,2,1,17
163018636,83,30,16,9,138
163019353,181,55,66,5,307
163024685,94,47,23,3,167
163025627,207,37,2,22,268
163028225,25,25,5,18,73
163030392,71,113,78,33,295
163032271,70,3,2,1,76
163042493,25,10,3,1,39
163043353,11,24,2,1,38
163097682,56,21,2,4,83
163109569,39,44,2,4,89
163114486,102,24,2,10,138
163123511,33,3,2,1,39
163123947,36,3,2,2,43
163125618,12,11,5,1,29
163125661,32,3,14,1,50
163137421,13,3,2,5,23
163142753,112,8,4,7,131
163147341,71,10,33,1,115
163147502,40,3,2,1,46
163149634,30,8,4,6,48
163155296,10,10,2,1,23
163164040,77,36,3,23,139
163167590,79,51,8,4,142
163168354,13,8,2,3,26
163171503,29,16,2,2,49
163177416,12,3,2,1,18
163189849,13,8,2,3,26
163207413,30,53,2,2,87
163211170,11,13,2,1,27
163220713,14,3,2,1,20
163222676,26,3,2,4,35
163227676,98,3,2,1,104
163249442,68,16,18,12,114
163255056,14,3,2,1,20
163260264,94,7,2,5,108
163274103,12,3,2,3,20
163285042,105,4,2,3,114
163292657,76,3,2,2,83
163294838,16,3,2,1,22
163298225,24,4,2,6,36
163332291,14,3,2,1,20
163336781,104,19,2,1,126
163341341,31,3,2,7,43
163341936,27,6,2,1,36
163362749,94,67,3,8,172
163368774,100,6,12,3,121
163376101,10,4,2,2,18
163388459,12,3,2,1,18
163412285,44,3,35,1,83
163415490,108,4,6,50,168
163428542,68,24,11,12,115
163435659,10,3,2,3,18
163451029,96,38,2,2,138
163455209,38,3,2,1,44
163462758,23,15,2,10,50
163464979,49,3,37,1,90
163468417,16,3,2,1,22
163472664,15,3,2,4,24
163481303,39,84,25,1,149
163490551,87,3,2,28,120
163503027,10,3,2,2,17
163509247,209,15,2,60,286
163528449,85,28,32,14,159
163529785,93,18,3,6,120
163559193,90,3,15,1,109
163567224,61,14,4,1,80
163571908,14,3,2,15,34
163574655,13,3,2,1,19
163580095,69,51,87,6,213
163596695,11,3,2,1,17
163615857,69,52,107,8,236
163637100,96,28,69,6,199
163637203,113,9,23,33,178
163648819,23,3,2,1,29
163651505,13,20,8,37,78
163652273,89,18,2,4,113
163652938,48,21,2,1,72
163659189,104,3,2,1,110
163664182,38,14,2,1,55
163669749,94,84,3,17,198
163678702,87,3,2,3,95
163697149,76,3,2,1,82
163704034,43,4,3,1,51
163716148,15,3,2,1,21
163722209,44,24,9,8,85
163741455,33,7,2,5,47
163743534,10,3,2,2,17
163756376,84,93,2,80,259
163756444,78,62,3,7,150
163762949,56,3,2,1,62
163772755,60,13,2,6,81
163775783,26,4,2,4,36
163788233,211,3,2,7,223
163800906,13,67,11,2,93
163829343,10,16,2,1,29
163835786,98,3,2,1,104
163841986,18,3,2,1,24
163844110,241,3,2,4,250
163844906,49,3,2,2,56
163875604,32,9,2,1,44
163877908,98,3,2,8,111
163887221,50,3,2,7,62
163890887,81,3,59,5,148
163903585,54,5,27,1,87
163918802,87,7,2,1,97
163931993,23,66,9,1,99
163934582,10,9,2,1,22
163939164,94,4,2,2,102
163951320,75,21,2,45,143
163954846,35,26,2,4,67
163956009,35,3,2,2,42
163977061,80,35,2,8,125
163979611,26,31,5,18,80
163981455,50,15,19,6,90
164001101,50,37,4,2,93
164016191,57,3,2,1,63
164021833,441,3,2,12,458
164027557,37,50,37,47,171
164038591,52,3,2,13,70
164044986,100,38,2,15,155
164058484,11,14,5,2,32
164064568,120,24,2,3,149
164076331,68,15,22,92,197
164098655,73,37,60,99,269
164107790,109,18,2,3,132
164115859,53,66,5,1,125
164128651,56,3,2,37,98
164130903,28,20,6,6,60
164136612,153,23,2,6,184
164140529,42,89,4,1,136
164142048,36,3,2,1,42
164142442,26,14,13,46,99
164144049,64,17,2,1,84
164158025,26,31,2,1,60
164158799,82,10,2,2,96
164188965,68,18,81,20,187
164205177,82,3,2,1,88
164206843,11,3,2,1,17
164213522,121,3,2,1,127
164232247,14,16,2,1,33
164233307,131,14,2,2,149
164243507,68,3,2,16,89
164256108,77,27,5,1,110
164267695,47,8,2,1,58
164280524,50,16,7,1,74
164280588,20,9,9,1,39
164286900,87,41,11,13,152
164292607,93,66,2,18,179
164301712,51,48,8,2,109
164307108,124,15,2,1,142
164312830,144,3,2,6,155
164316108,59,3,2,1,65
164344245,134,58,30,33,255
164349942,239,3,2,1,245
164355097,109,33,51,2,195
164357449,67,19,5,23,114
164365224,16,19,2,1,38
164368390,168,12,16,6,202
164368800,18,3,2,2,25
164370725,34,3,2,1,40
164371221,60,45,2,25,132
164431181,40,78,2,1,121
164449842,68,20,80,18,186
164478651,50,3,2,21,76
164493690,193,4,2,1,200
164496773,25,10,2,16,53
164514976,80,12,2,4,98
164516498,46,44,2,2,94
164521054,36,20,12,1,69
164522145,19,5,2,1,27
164522988,61,3,2,9,75
164527560,10,3,2,2,17
164542592,59,3,2,1,65
164543036,55,7,2,2,66
164553896,78,20,6,2,106
164563273,75,3,2,2,82
164578348,111,37,137,9,294
164599944,26,10,2,1,39
164601426,49,102,13,9,173
164603001,11,3,2,1,17
164629378,24,15,4,1,44
164629726,42,16,39,39,136
164631621,10,3,2,4,19
164632475,62,4,13,1,80
164640710,12,30,2,1,45
164645502,12,3,2,1,18
164650146,25,27,2,1,55
164650336,52,9,70,1,132
164668870,24,17,2,1,44
164670772,77,33,3,13,126
164682392,106,17,47,3,173
164684902,96,32,3,1,132
164703383,110,43,16,13,182
164707302,27,3,2,1,33
164714771,116,29,3,5,153
164717158,48,26,15,51,140
164726871,79,30,2,8,119
164738975,53,9,11,6,79
164749380,55,9,73,1,138
164756357,10,3,2,3,18
164763253,89,3,2,3,97
164766040,88,3,2,14,107
164769515,283,31,45,21,380
164770632,73,20,87,1,181
164770808,42,28,2,1,73
164786992,23,6,2,3,34
164811215,179,18,24,19,240
164816535,11,3,2,5,21
164820153,76,68,3,16,163
164828868,82,36,11,7,136
164829357,90,13,90,17,210
164833567,464,3,2,13,482
164842213,65,27,9,1,102
164868760,279,3,2,5,289
164876941,45,12,2,5,64
164884541,58,33,25,1,117
164888922,40,14,22,12,88
164897665,102,49,7,4,162
164898906,119,3,2,1,125
164901106,12,14,2,1,29
164913222,64,8,2,5,79
164929892,75,23,10,4,112
164936906,109,3,2,14,128
164937916,231,3,2,1,237
164945156,70,42,39,11,162
164950839,81,74,2,23,180
164953989,29,77,2,3,111
164977108,48,26,57,2,133
164989025,19,3,2,1,25
164993059,59,16,2,25,102
165007336,15,3,2,1,21
165009600,38,20,4,9,71
165009602,19,3,2,1,25
165011781,36,3,2,1,42
165039301,71,3,2,3,79
165040314,21,46,2,1,70
165066343,24,69,5,3,101
165069439,29,3,2,1,35
165072291,27,3,2,1,33
165073042,45,3,2,1,51
165081526,12,3,2,1,18
165110600,87,61,2,16,166
165117802,23,18,5,1,47
165123582,11,3,2,2,18
165129202,12,3,2,2,19
165130655,169,9,28,6,212
165136991,67,30,2,2,101
165163045,18,22,10,8,58
165179863,62,8,2,8,80
165188159,25,12,13,29,79
165197809,58,36,2,4,100
165200210,69,3,2,6,80
165207745,87,25,2,1,115
165210437,118,21,2,2,143
165210840,19,6,10,1,36
165229078,71,22,2,8,103
165238448,40,26,27,2,95
165245662,178,12,11,7,208
165246775,26,21,21,7,75
165247426,98,34,83,2,217
165247837,11,3,2,1,17
165249718,10,9,2,1,22
165263956,106,23,2,1,132
165274232,45,3,2,3,53
165285304,11,3,2,1,17
165291897,110,32,24,1,167
165297671,10,8,2,2,22
165309437,78,21,5,4,108
165313814,12,11,2,1,26
165318403,149,15,10,32,206
165319298,29,3,2,1,35
165324350,22,27,11,1,61
165342503,67,36,20,4,127
165345411,14,7,2,1,24
165346093,172,22,2,1,197
165349476,64,38,48,1,151
165350180,20,3,2,1,26
165357476,76,36,23,8,143
165362979,92,16,2,1,111
165372147,18,3,2,1,24
165373279,94,3,2,2,101
165395513,17,3,2,1,23
165407787,54,51,12,20,137
165421113,33,3,2,1,39
165423085,81,37,34,8,160
165426269,50,3,2,4,59
165436006,151,3,2,1,157
165451936,43,21,4,11,79
165461944,11,14,2,1,28
165467444,36,48,2,1,87
165471477,83,17,2,1,103
165475387,73,3,2,1,79
165488511,55,28,44,32,159
165493862,46,6,2,3,57
165496692,90,26,38,3,157
165497400,37,17,2,1,57
165498193,13,23,2,7,45
165503331,13,3,2,1,19
165503660,73,3,2,3,81
165520427,48,3,2,5,58
165525962,59,6,30,9,104
165527229,113,18,2,11,144
165529352,108,44,72,8,232
165530943,107,74,44,5,230
165531490,21,40,3,2,66
165536172,43,3,2,15,63
165536657,51,34,14,4,103
165547066,184,13,2,3,202
165552046,83,3,2,11,99
165568070,11,3,2,1,17
165569019,185,32,6,28,251
165570165,109,36,32,25,202
165578924,19,9,2,1,31
165580909,45,49,3,4,101
165586141,15,3,2,1,21
165587952,45,25,15,46,131
165590966,332,3,2,4,341
165617470,51,37,57,19,164
165655189,104,25,9,2,140
165658380,53,33,7,18,111
165660121,124,54,30,23,231
165667166,82,15,2,1,100
165674079,20,7,2,1,30
165676429,15,85,2,1,103
165688302,64,3,2,1,70
165713989,15,18,2,2,37
165734255,44,6,23,14,87
165735983,58,3,2,2,65
165740292,25,3,2,1,31
165740486,208,3,2,1,214
165752829,81,14,13,7,115
165757875,73,16,5,9,103
165789204,10,14,2,17,43
165790925,104,26,49,16,195
165795283,47,9,2,1,59
165804830,10,4,2,1,17
165808896,15,3,2,2,22
165818474,165,3,2,12,182
165818588,57,9,3,10,79
165826901,106,58,38,63,265
165851826,128,25,8,32,193
165861096,59,11,13,1,84
165861843,69,24,2,4,99
165862496,25,24,5,2,56
165863230,87,3,2,2,94
165869383,147,47,73,59,326
165870582,38,3,2,1,44
165872717,22,23,4,1,50
165881272,25,12,4,5,46
165882622,148,23,26,29,226
165886859,35,3,2,2,42
165905960,70,3,2,2,77
165913493,139,12,2,13,166
165922660,39,4,2,11,56
165923063,11,9,3,10,33
165923461,11,3,2,1,17
165924175,15,53,2,1,71
165933547,154,38,5,4,201
165939646,67,3,2,2,74
165966425,76,9,35,9,129
165973828,17,3,2,1,23
165988102,96,23,10,5,134
165996853,27,3,2,1,33
166006511,15,3,2,1,21
166016725,30,44,9,53,136
166018781,43,48,22,29,142
166022634,236,87,30,2,355
166028645,11,6,2,1,20
166029560,79,15,6,4,104
166030305,150,10,2,7,169
166032044,14,3,2,1,20
166035989,33,21,22,1,77
166042523,94,44,11,2,151
166046172,494,11,2,6,513
166050400,57,17,6,1,81
166054679,10,29,2,1,42
166059495,135,3,2,2,142
166063782,18,32,2,2,54
166070923,35,3,2,1,41
166072528,77,69,2,2,150
166073866,11,92,2,1,106
166078894,86,32,59,11,188
166094483,120,15,50,3,188
166096123,13,3,2,3,21
166108543,10,22,2,1,35
166109500,17,5,2,1,25
166116757,65,14,11,5,95
166118369,55,42,9,50,156
166119563,42,3,2,1,48
166123231,32,35,2,2,71
166135928,85,3,2,1,91
166140319,14,40,21,2,77
166146586,10,3,2,2,17
166150519,18,18,2,5,43
166150786,118,9,2,8,137
166161745,55,6,41,6,108
166165071,17,3,3,3,26
166180159,69,15,21,4,109
166182047,47,3,2,1,53
166202626,107,3,2,1,113
166210654,118,30,44,12,204
166231573,66,3,2,2,73
166232571,74,15,7,1,97
166246413,136,3,2,1,142
166251279,10,5,2,1,18
166262920,87,20,104,3,214
166266440,10,9,2,3,24
166268877,102,16,2,14,134
166280878,22,38,2,1,63
166283830,12,63,2,1,78
166290577,14,3,7,2,26
166297463,39,3,2,1,45
166303695,14,19,2,1,36
166308598,99,60,16,3,178
166310752,50,47,44,2,143
166312937,10,22,2,1,35
166333660,183,83,43,55,364
166337438,13,6,2,1,22
166338469,38,20,52,51,161
166346919,92,3,2,3,100
166347717,10,13,2,4,29
166368709,71,18,8,16,113
166370825,25,3,2,1,31
166371274,146,44,37,4,231
166375354,110,9,2,2,123
166387772,208,17,71,2,298
166434219,59,9,71,1,140
166438508,60,3,2,1,66
166442398,60,19,10,8,97
166444669,10,13,2,1,26
166446675,85,3,2,1,91
166458017,150,39,11,26,226
166458340,119,24,2,1,146
166460970,163,51,2,9,225
166481440,100,74,110,3,287
166494112,19,29,2,1,51
166509705,14,17,3,7,41
166515813,69,33,29,11,142
166526103,42,69,19,3,133
166535370,21,3,2,1,27
166548843,78,19,3,8,108
166551677,21,10,2,2,35
166553285,64,26,2,14,106
166568487,12,3,2,3,20
166583510,74,66,37,1,178
166611409,195,3,2,9,209
166614491,101,36,14,1,152
166615994,1201,3,2,9,1215
166629186,80,3,2,1,86
166633203,15,34,12,14,75
166649649,48,37,2,2,89
166657729,66,29,33,8,136
166659094,13,3,2,1,19
166666430,95,6,2,2,105
166673942,92,7,2,8,109
166680646,69,34,18,99,220
166698772,13,4,2,1,20
166710207,99,8,5,10,122
166710938,28,26,2,2,58
166716203,13,3,2,1,19
166723005,45,51,2,2,100
166731688,57,45,3,1,106
166735304,48,17,2,1,68
166746995,119,41,23,4,187
166758512,109,12,25,3,149
166771843,89,3,2,1,95
166775693,15,42,16,2,75
166789880,37,11,56,1,105
166791394,17,5,2,1,25
166796309,69,50,31,40,190
166799320,62,3,2,1,68
166809046,79,18,22,6,125
166811513,122,26,28,1,177
166811667,88,34,2,1,125
166813231,67,33,23,32,155
166819492,29,58,42,2,131
166820583,90,17,2,3,112
166827139,21,34,2,3,60
166829183,69,3,2,2,76
166846225,35,16,2,2,55
166847349,30,34,9,10,83
166850242,47,7,2,2,58
166853182,10,3,2,2,17
166867931,98,39,2,4,143
166876851,14,3,2,1,20
166881189,69,3,2,2,76
166882373,133,59,29,2,223
166893655,109,50,103,1,263
166895521,68,16,2,9,95
166902461,80,3,2,7,92
166906723,13,3,2,1,19
166920812,77,19,2,9,107
166928078,43,3,2,5,53
166928954,42,34,12,2,90
166934049,88,25,17,1,131
166946621,33,18,2,5,58
166951703,88,3,2,1,94
166964515,182,17,65,1,265
166964519,50,108,3,2,163
166969417,39,77,2,3,121
166981918,69,28,10,5,112
166992437,124,19,14,1,158
166998053,37,4,2,5,48
167019804,18,39,12,9,78
167024306,10,6,2,1,19
167026125,45,35,90,64,234
167037400,148,43,40,39,270
167066946,48,28,41,2,119
167069801,48,43,2,36,129
167073864,44,7,15,14,80
167075883,11,3,2,1,17
167102577,12,4,2,3,21
167110472,11,3,2,1,17
167116251,47,8,2,4,61
167117726,10,5,2,1,18
167118420,85,53,2,5,145
167129564,96,53,40,8,197
167130093,71,3,2,1,77
167141619,10,12,2,1,25
167175033,58,3,2,5,68
167182248,85,16,11,1,113
167187779,62,38,55,1,156
167193841,45,4,2,3,54
167197120,18,21,2,1,42
167223797,58,13,3,17,91
167236233,61,32,42,2,137
167239850,46,19,40,1,106
167245189,17,3,3,1,24
167245487,167,43,70,23,303
167266534,100,14,16,1,131
167266931,14,3,2,1,20
167281760,41,3,2,1,47
167290392,18,3,2,1,24
167299998,103,24,2,5,134
167318340,39,48,5,13,105
167333807,124,54,2,1,181
167339136,27,3,2,1,33
167341265,37,46,2,8,93
167368340,54,3,2,1,60
167373313,47,61,26,1,135
167375953,98,3,2,2,105
167387588,44,43,42,4,133
167388008,182,28,46,45,301
167404735,41,3,2,14,60
167425391,127,3,2,11,143
167428259,140,17,99,21,277
167429830,77,13,10,1,101
167430273,20,14,2,1,37
167431162,85,28,4,29,146
167432233,11,3,2,5,21
167439894,106,9,2,2,119
167444328,76,26,3,2,107
167475442,13,32,5,3,53
167480399,87,3,2,7,99
167486374,71,41,61,1,174
167488805,40,28,2,2,72
167490680,40,31,4,5,80
167492824,78,7,37,5,127
167494564,52,27,2,11,92
167495276,71,29,37,13,150
167498018,32,3,2,1,38
167505914,231,45,2,1,279
167529516,111,21,2,5,139
167529705,4969,3,2,76,5050
167537449,12,3,2,1,18
167550089,48,19,2,3,72
167563419,85,27,6,1,119
167564471,11,3,2,1,17
167580837,94,20,3,3,120
167583587,30,3,2,1,36
167620660,95,3,2,1,101
167635500,19,5,2,1,27
167636539,36,23,5,9,73
167650609,12,3,2,2,19
167653005,40,39,3,1,83
167666554,21,43,118,1,183
167666676,40,40,29,15,124
167682859,168,3,2,1,174
167702061,57,18,2,8,85
167705465,79,3,2,6,90
167714050,71,6,4,2,83
167714781,102,45,7,2,156
167719447,95,8,2,9,114
167747175,13,3,2,3,21
167772769,38,18,2,1,59
167781558,61,40,25,54,180
167803138,37,10,4,12,63
167818061,49,17,2,1,69
167818720,38,56,5,17,116
167828334,58,3,2,3,66
167828762,82,6,2,3,93
167829589,18,3,2,1,24
167839584,46,3,2,1,52
167855799,55,113,25,2,195
167858706,151,3,2,1,157
167863296,88,14,46,1,149
167868098,49,60,9,1,119
167875839,17,3,2,1,23
167892927,11,5,2,1,19
167894412,97,33,28,52,210
167894849,68,3,10,18,99
167902527,33,27,2,1,63
167903341,21,16,3,1,41
167910992,95,55,2,1,153
167913267,115,31,16,7,169
167920542,87,42,15,1,145
167931233,13,6,2,1,22
167939008,28,32,2,2,64
167947596,79,80,8,1,168
167948850,49,29,3,14,95
167952908,19,3,2,1,25
167954073,118,48,12,18,196
167955407,216,22,2,6,246
167958333,35,57,37,2,131
167986847,11,3,2,1,17
167994122,36,3,2,2,43
167994600,47,50,2,7,106
168015077,76,22,3,9,110
168034612,12,3,2,1,18
168042598,49,6,2,6,63
168046392,57,68,117,40,282
168052476,10,4,2,1,17
168083301,31,3,2,1,37
168088351,34,13,17,3,67
168093434,229,3,2,1,235
168114400,174,3,2,5,184
168114803,92,23,4,4,123
168120579,12,3,2,1,18
168145381,80,17,2,1,100
168146002,132,7,2,3,144
168147667,23,35,2,1,61
168149037,11,3,2,2,18
168160869,27,3,2,1,33
168167432,48,20,4,2,74
168175838,69,50,39,1,159
168187235,87,3,2,8,100
168196497,205,3,2,7,217
168197532,45,28,63,9,145
168205736,229,11,64,18,322
168219373,31,10,11,14,66
168230600,62,3,2,1,68
168250420,38,44,35,47,164
168261011,67,17,14,5,103
168263311,21,5,2,1,29
168263378,46,9,2,1,58
168276683,60,3,2,1,66
168279752,66,3,2,1,72
168291619,18,63,2,5,88
168306395,84,16,4,1,105
168323157,11,3,2,1,17
168327991,55,94,2,7,158
168338796,58,3,2,1,64
168344551,83,27,84,10,204
168350454,50,5,5,1,61
168360261,13,3,8,6,30
168363599,300,3,2,4,309
168381266,18,35,7,2,62
168386598,44,12,2,18,76
168388408,32,23,3,2,60
168401385,16,16,2,1,35
168401906,71,15,35,11,132
168427031,42,8,32,3,85
168441938,14,3,2,1,20
168442327,28,6,2,1,37
168448608,135,40,26,2,203
168455437,27,13,6,7,53
168464272,13,3,2,1,19
168465119,80,31,23,5,139
168475083,13,3,2,1,19
168490578,253,33,10,14,310
168503803,12,3,2,1,18
168506326,71,3,2,1,77
168511896,99,16,2,9,126
168534041,26,36,3,3,68
168559127,67,40,53,1,161
168571112,53,6,2,1,62
168578756,23,6,2,2,33
168582649,12,34,11,1,58
168595662,69,3,2,14,88
168605182,14,4,2,1,21
168618428,16,21,2,1,40
168631548,11,3,2,1,17
168665277,10,17,2,1,30
168667205,12,7,2,1,22
168671143,30,43,13,10,96
168681204,38,42,22,19,121
168691543,96,22,28,2,148
168695068,14,3,2,1,20
168712028,91,9,25,1,126
168723677,69,3,2,1,75
168729529,54,93,16,1,164
168751264,13,4,2,1,20
168752313,49,4,2,1,56
168753851,81,21,2,45,149
168754193,22,6,2,1,31
168764830,66,41,50,1,158
168766175,24,13,2,16,55
168774583,18,22,86,1,127
168775361,180,37,2,1,220
168780577,21,3,2,1,27
168787917,67,25,9,1,102
168808986,11,3,2,1,17
168827517,21,3,2,3,29
168829721,17,3,2,1,23
168838279,75,44,33,27,179
168840229,149,27,72,5,253
168841968,13,3,2,1,19
168859131,83,46,2,3,134
168862005,26,48,46,2,122
168863193,196,40,4,1,241
168864477,136,33,67,18,254
168867373,87,24,19,4,134
168890128,22,30,2,11,65
168904011,165,6,7,12,190
168905748,118,3,2,20,143
168906502,49,9,3,8,69
168906983,55,3,2,1,61
168912203,27,3,2,1,33
168920010,87,3,2,1,93
168928250,98,21,12,15,146
168960838,38,56,31,3,128
168973338,68,37,3,14,122
168975127,85,37,2,32,156
169007144,252,3,2,1,258
169007152,10,5,2,1,18
169018895,45,31,38,2,116
169022091,130,16,21,12,179
169023800,29,43,2,1,75
169053873,10,8,2,1,21
169054641,16,14,36,1,67
169078661,50,6,2,2,60
169081417,56,22,15,3,96
169084671,120,3,2,7,132
169096765,111,3,2,12,128
169097122,107,31,34,3,175
169112452,18,4,2,1,25
169114807,66,3,5,6,80
169118493,128,3,2,8,141
169124052,137,20,5,1,163
169129978,49,51,5,26,131
169136823,42,29,6,8,85
169138691,11,3,2,1,17
169139586,104,49,3,5,161
169140078,11,4,2,1,18
169146367,37,3,2,1,43
169155293,56,13,2,6,77
169162759,173,64,9,117,363
169189964,133,20,13,1,167
169206139,114,3,2,1,120
169208896,128,57,37,2,224
169219582,52,9,5,1,67
169230726,27,3,2,5,37
169232126,111,23,38,1,173
169233901,127,10,2,1,140
169234407,32,50,10,1,93
169242071,37,40,14,3,94
169246370,87,29,104,30,250
169253356,97,7,2,6,112
169257439,37,12,2,7,58
169261868,60,3,2,1,66
169266520,29,9,2,2,42
169271749,77,10,5,1,93
169275381,59,25,2,1,87
169284260,51,3,2,1,57
169285348,15,3,2,4,24
169291899,143,3,2,1,149
169303797,23,17,4,4,48
169304963,45,33,2,2,82
169313312,90,19,3,2,114
169315859,85,6,2,4,97
169320471,21,3,2,6,32
169329931,68,6,30,1,105
169340591,34,3,5,1,43
169344620,87,43,52,9,191
169345280,174,14,37,2,227
169383114,13,3,2,5,23
169390989,36,13,2,5,56
169396324,25,9,2,3,39
169397330,105,35,44,16,200
169406519,81,40,25,3,149
169412882,20,13,7,2,42
169429934,19,3,2,1,25
169435830,14,11,2,1,28
169474904,11,3,2,1,17
169485753,194,29,48,1,272
169486675,62,9,3,8,82
169491941,14,7,5,1,27
169495516,13,6,2,2,23
169528386,16,3,2,7,28
169571068,82,27,35,23,167
169577146,57,3,17,1,78
169589801,180,17,2,2,201
169591871,63,41,14,1,119
169622256,43,5,2,1,51
169631264,31,4,3,1,39
169639801,237,3,2,63,305
169648107,14,3,2,4,23
169656560,10,5,2,1,18
169682278,89,3,2,1,95
169683729,12,3,2,1,18
169685640,15,3,2,1,21
169686548,66,9,12,1,88
169691767,35,30,24,1,90
169692478,13,3,2,1,19
169715466,46,3,8,14,71
169716561,98,9,2,21,130
169724787,15,24,2,1,42
169725482,63,3,2,7,75
169737135,114,10,7,1,132
169744097,42,47,9,10,108
169748021,34,33,54,3,124
169750187,26,36,5,5,72
169762973,11,6,2,1,20
169766048,40,21,15,4,80
169767106,17,11,3,1,32
169770954,34,3,2,6,45
169780037,13,73,2,3,91
169785404,25,20,3,1,49
169790183,83,13,3,12,111
169791752,198,8,59,8,273
169828109,47,40,60,1,148
169842312,39,33,2,3,77
169886881,33,34,89,1,157
169893948,13,3,2,1,19
169899751,12,3,2,1,18
169905556,137,23,7,2,169
169934386,30,28,8,2,68
169938342,127,9,2,1,139
169956116,64,35,15,6,120
169965458,66,38,2,1,107
169966648,36,3,2,6,47
169989866,45,22,4,4,75
169995510,58,5,2,1,66
170003837,55,20,40,2,117
170005559,90,50,26,8,174
170006940,43,31,22,31,127
170012947,56,3,2,1,62
170025811,21,20,3,2,46
170052212,13,38,2,1,54
170057600,72,23,2,9,106
170074278,14,3,2,1,20
170081516,186,3,2,23,214
170082932,11,3,2,1,17
170089944,31,20,6,2,59
170090637,93,39,2,10,144
170099152,50,3,2,1,56
170107342,54,6,2,1,63
170125188,80,64,54,74,272
170126538,21,19,25,1,66
170126716,194,45,3,21,263
170146870,23,54,5,2,84
170149115,40,37,8,1,86
170150642,18,38,2,4,62
170162974,165,3,2,3,173
170163529,26,21,2,6,55
170176698,10,15,2,3,30
170177946,93,9,2,1,105
170180664,51,40,59,8,158
170196140,112,26,2,1,141
170201169,316,3,2,4,325
170222418,11,3,2,1,17
170226976,91,3,2,4,100
170247558,29,3,2,2,36
170248502,173,49,10,27,259
170272279,10,3,2,2,17
170273140,61,3,21,3,88
170281283,32,7,2,1,42
170288660,10,9,2,1,22
170310332,59,3,2,1,65
170341275,79,18,12,1,110
170345241,87,21,22,18,148
170347232,141,9,14,5,169
170366302,24,3,2,1,30
170368630,23,12,13,10,58
170392153,148,52,2,20,222
170392914,12,3,2,1,18
170427260,40,11,6,1,58
170427790,49,3,2,1,55
170433968,18,12,21,14,65
170437840,107,3,2,1,113
170442827,15,19,2,1,37
170455321,16,9,2,1,28
170519102,34,16,2,1,53
170522174,115,5,2,4,126
170530734,182,15,10,2,209
170537536,148,14,2,14,178
170542000,43,3,2,2,50
170552043,132,3,2,18,155
170553279,96,10,43,1,150
170558130,22,3,2,1,28
170588697,136,12,45,10,203
170600368,25,79,13,1,118
170604332,32,8,2,2,44
170604817,59,29,30,1,119
170623133,139,19,96,21,275
170624215,13,50,6,6,75
170644349,85,26,52,64,227
170655316,10,5,2,1,18
170664819,110,19,64,13,206
170671183,240,3,2,3,248
170673717,67,20,18,14,119
170673812,18,31,9,10,68
170674532,18,3,2,1,24
170688472,43,3,2,1,49
170689046,59,44,2,12,117
170693230,52,34,50,9,145
170694377,25,3,2,2,32
170705000,58,62,38,3,161
170707366,117,13,2,6,138
170728562,17,12,2,4,35
170730381,27,3,2,1,33
170734579,169,41,19,55,284
170755778,18,3,2,1,24
170770581,10,3,2,3,18
170772667,46,7,2,3,58
170777662,25,3,2,1,31
170781354,101,39,30,4,174
170795680,123,10,8,8,149
170796884,164,43,18,8,233
170809413,49,3,2,4,58
170827069,52,3,2,4,61
170828323,11,3,2,1,17
170843410,13,3,2,1,19
170848396,36,5,23,20,84
170867475,30,11,2,1,44
170871624,31,18,35,2,86
170875226,81,12,2,4,99
170883684,73,3,2,3,81
170884254,27,3,2,1,33
170894478,20,3,2,1,26
170895742,109,3,2,1,115
170897422,588,76,2,16,682
170919008,17,3,2,3,25
170923754,185,6,51,33,275
170932365,19,20,2,1,42
170947644,207,34,98,26,365
170985723,55,16,35,53,159
170987767,11,3,2,1,17
170993515,59,40,104,35,238
171000225,20,4,2,1,27
171002807,48,3,2,1,54
171006405,71,78,5,26,180
171018024,39,3,7,1,50
171020479,11,3,2,1,17
171023063,15,15,2,3,35
171026020,23,21,2,1,47
171029130,97,26,4,6,133
171032769,12,16,2,3,33
171032945,13,3,2,4,22
171034286,158,51,6,1,216
171047008,79,40,4,20,143
171051561,17,3,2,1,23
171054978,71,3,2,2,78
171061291,64,3,2,1,70
171078882,44,31,2,1,78
171084984,106,7,2,11,126
171103429,66,16,2,8,92
171120138,89,77,92,10,268
171132363,37,7,2,1,47
171134878,427,4,29,13,473
171136793,22,3,2,1,28
171143659,85,65,43,6,199
171155938,19,13,14,6,52
171157963,167,26,9,8,210
171180870,43,34,11,5,93
171187867,19,3,2,1,25
171197769,12,3,2,1,18
171201635,65,7,2,2,76
171226570,11,3,2,1,17
171227191,57,6,2,1,66
171232289,94,32,42,15,183
171233353,54,30,14,16,114
171233978,10,3,2,2,17
171249745,105,34,100,3,242
171275861,122,3,2,1,128
171278976,18,3,2,1,24
171279802,32,22,5,3,62
171287764,26,6,2,1,35
171289734,86,81,63,42,272
171292991,102,11,9,34,156
171297690,13,7,2,5,27
171313148,97,13,2,2,114
171325404,28,8,27,2,65
171328095,12,3,2,1,18
171331199,109,43,57,38,247
171337234,16,35,45,8,104
171345052,75,54,16,15,160
171347628,41,29,36,2,108
171352604,100,3,21,1,125
171364820,66,3,2,1,72
171372593,135,32,2,1,170
171380527,53,19,18,5,95
171392604,56,39,57,2,154
171403557,325,39,4,2,370
171409769,45,3,2,1,51
171421024,93,3,2,1,99
171430089,64,35,2,1,102
171433209,205,3,2,1,211
171433663,80,49,70,3,202
171434742,30,6,9,1,46
171441756,64,58,18,2,142
171446656,64,11,2,1,78
171451378,144,3,2,3,152
171457527,16,12,3,1,32
171482263,40,6,2,1,49
171516122,118,32,15,17,182
171518263,81,3,2,8,94
171521426,25,27,2,2,56
171526132,106,47,28,8,189
171529044,57,3,2,4,66
171537626,113,3,2,3,121
171561113,49,3,8,8,68
171561735,25,19,2,1,47
171563369,24,3,2,1,30
171582537,38,16,28,5,87
171594346,150,3,2,1,156
171603311,64,28,2,1,95
171611812,95,23,26,14,158
171630318,186,3,2,2,193
171635825,18,3,2,1,24
171641409,56,42,10,7,115
171647744,84,26,75,6,191
171649685,53,3,2,2,60
171672904,97,57,3,6,163
171675196,36,21,2,3,62
171675627,43,24,36,4,107
171676356,15,3,2,1,21
171678691,11,44,3,1,59
171682796,158,3,2,5,168
171689859,11,5,2,1,19
171692419,204,3,2,11,220
171694582,15,3,2,1,21
171697554,39,16,2,1,58
171703697,22,20,4,1,47
171706662,38,36,4,1,79
171707624,63,32,47,3,145
171708202,59,48,35,35,177
171712914,38,58,2,3,101
171732835,132,3,2,5,142
171753874,43,3,38,2,86
171779363,141,3,2,7,153
171789142,52,3,2,1,58
171789408,50,7,2,1,60
171791398,64,32,59,2,157
171800094,33,36,4,1,74
171805699,10,6,2,1,19
171808553,14,28,2,1,45
171825617,303,4,11,2,320
171828486,55,11,2,1,69
171829064,127,21,2,7,157
171829606,112,38,13,14,177
171838233,11,3,2,4,20
171846485,13,3,2,1,19
171854798,27,17,3,3,50
171861917,75,3,2,1,81
171870053,125,18,28,7,178
171870767,39,16,9,3,67
171871483,22,3,2,1,28
171894986,17,28,14,16,75
171900922,48,3,2,6,59
171901320,21,6,2,1,30
171902917,50,17,3,3,73
171927833,18,3,2,1,24
171928199,19,46,65,4,134
171945897,59,3,2,1,65
171955218,72,33,10,14,129
171956855,13,10,14,1,38
171974435,20,3,2,1,26
171974673,139,79,12,13,243
171979242,63,3,2,2,70
171982141,30,48,2,47,127
171982231,82,3,2,1,88
171985492,24,37,2,1,64
171988515,84,15,21,1,121
172007951,152,22,24,8,206
172014769,86,3,2,19,110
172023064,148,47,10,5,210
172023285,97,26,23,22,168
172026164,30,3,2,1,36
172033295,15,3,2,1,21
172033853,48,31,58,15,152
172034210,96,20,27,9,152
172043197,27,10,2,1,40
172050293,126,3,2,1,132
172077532,67,31,11,5,114
172100545,35,3,2,10,50
172101453,57,25,46,17,145
172112376,209,36,2,5,252
172116978,50,18,16,9,93
172128762,22,23,3,3,51
172136272,75,13,2,1,91
172143735,11,3,2,1,17
172165102,11,3,2,2,18
172170246,70,12,2,21,105
172172662,24,3,2,4,33
172175633,138,16,18,5,177
172186525,117,3,2,3,125
172196074,29,3,2,8,42
172208956,81,68,2,10,161
172216833,119,3,2,1,125
172217694,17,19,6,10,52
172231455,97,26,2,1,126
172249615,14,7,2,1,24
172252141,222,41,2,16,281
172254521,70,3,2,10,85
172261445,34,51,42,6,133
172270155,77,18,5,8,108
172279216,56,14,5,4,79
172321372,109,25,55,6,195
172336084,93,3,2,13,111
172336645,23,20,5,2,50
172342020,122,28,113,31,294
172350654,11,3,2,2,18
172357574,54,15,2,3,74
172365137,30,3,2,1,36
172369334,74,21,2,1,98
172375644,14,3,2,5,24
172389336,79,26,9,5,119
172392295,11,3,2,1,17
172394515,147,3,2,23,175
172396934,109,39,19,36,203
172408841,44,44,2,1,91
172409320,23,3,12,1,39
172411140,62,25,5,3,95
172412349,11,3,2,1,17
172442647,33,38,34,2,107
172449974,20,23,2,10,55
172453791,81,25,39,4,149
172455454,13,6,2,1,22
172461702,63,19,2,6,90
172465514,91,50,21,13,175
172468124,66,11,73,21,171
172474219,30,42,3,4,79
172491433,50,17,10,2,79
172498551,174,8,19,12,213
172507693,51,26,15,17,109
172511021,47,14,2,9,72
172514301,49,3,2,1,55
172521515,141,3,2,1,147
172523607,25,50,33,2,110
172534365,35,29,2,1,67
172554751,13,17,2,1,33
172583303,36,14,18,2,70
172586113,95,12,2,1,110
172597449,11,3,2,1,17
172614577,72,3,2,1,78
172619785,20,12,4,1,37
172619902,105,3,2,1,111
172625701,40,46,5,1,92
172638381,44,3,2,22,71
172642493,100,43,108,1,252
172661228,99,28,2,1,130
172679185,28,12,2,2,44
172687165,160,3,2,3,168
172692886,49,39,70,31,189
172704126,48,28,53,8,137
172706331,148,14,63,7,232
172712470,84,4,10,2,100
172720305,25,3,2,1,31
172726365,17,10,2,1,30
172734706,45,23,14,3,85
172742141,71,5,2,1,79
172750208,21,22,53,12,108
172759482,97,60,115,6,278
172774332,63,3,2,2,70
172791410,61,52,13,5,131
172794590,15,44,2,1,62
172806508,80,3,2,1,86
172808751,26,4,7,12,49
172816595,81,28,2,6,117
172831291,24,9,26,11,70
172839570,122,12,2,1,137
172842270,11,3,2,1,17
172847014,79,15,55,1,150
172860738,12,3,2,1,18
172884809,16,15,2,3,36
172891127,179,13,2,1,195
172909784,117,61,6,5,189
172919347,67,29,36,2,134
172924347,23,16,2,8,49
172933328,13,14,2,5,34
172950291,27,6,2,1,36
172959330,81,3,2,1,87
172962860,61,3,2,1,67
172978419,76,14,10,2,102
172991460,40,22,57,18,137
172992067,247,3,2,18,270
173002088,94,34,61,73,262
173002138,150,14,5,4,173
173002582,38,3,2,1,44
173004651,37,31,44,20,132
173010753,25,29,2,4,60
173018141,69,18,2,4,93
173019270,25,3,2,1,31
173019471,11,14,2,1,28
173022676,37,132,2,3,174
173028229,33,25,8,8,74
173028432,33,36,13,23,105
173036220,18,49,2,1,70
173047169,28,52,34,31,145
173056744,42,74,21,6,143
173060360,106,3,2,1,112
173063332,62,10,5,1,78
173065478,18,3,2,1,24
173072707,87,29,23,21,160
173127707,16,3,2,2,23
173138148,11,4,2,1,18
173149740,23,26,7,7,63
173176325,13,3,2,1,19
173182489,184,15,23,17,239
173187586,91,9,7,1,108
173205892,10,26,2,1,39
173212018,37,53,40,4,134
173232994,21,32,8,2,63
173234115,10,8,2,1,21
173239210,27,18,31,3,79
173242402,47,17,15,21,100
173249878,38,60,69,24,191
173255182,97,40,2,12,151
173255226,29,6,2,1,38
173259649,15,3,2,1,21
173262606,62,3,2,1,68
173266349,12,3,2,1,18
173266939,67,31,42,23,163
173277317,65,35,6,10,116
173280027,65,34,27,19,145
173281437,12,3,2,1,18
173297082,29,18,7,1,55
173302714,152,3,2,9,166
173323168,21,31,3,1,56
173326074,57,67,4,1,129
173327618,138,3,2,3,146
173334554,11,3,2,1,17
173338108,14,3,2,1,20
173340185,23,6,2,5,36
173341404,45,82,69,37,233
173346400,45,19,2,12,78
173347948,103,44,17,1,165
173361303,132,13,11,4,160
173363214,54,48,13,1,116
173377659,71,19,4,7,101
173378892,21,19,8,28,76
173389612,88,15,2,3,108
173393962,26,29,11,9,75
173412981,49,13,16,15,93
173414664,65,18,60,15,158
173417937,118,18,17,7,160
173428691,85,3,2,4,94
173433003,30,31,2,2,65
173448998,10,4,2,4,20
173462331,25,48,2,1,76
173476705,11,26,4,2,43
173479992,104,30,33,3,170
173492072,123,17,3,3,146
173504730,74,17,9,29,129
173511396,74,7,2,1,84
173520505,36,27,2,2,67
173533348,64,10,7,1,82
173535784,77,3,2,4,86
173559459,44,24,7,27,102
173563880,49,62,4,24,139
173564473,126,4,2,5,137
173576087,18,26,2,1,47
173576164,16,62,15,1,94
173582696,125,3,2,11,141
173588380,44,16,42,5,107
173592535,38,17,2,5,62
173598910,93,29,11,1,134
173601989,50,3,2,1,56
173613122,29,8,8,3,48
173625452,15,10,2,1,28
173652971,11,3,2,1,17
173669936,252,4,48,1,305
173677478,134,28,42,25,229
173682492,160,22,5,9,196
173697669,35,34,50,1,120
173713926,40,9,2,2,53
173714347,93,16,2,7,118
173714985,59,50,6,2,117
173716509,97,6,13,2,118
173732141,110,17,2,4,133
173747559,168,39,53,9,269
173751752,37,47,9,29,122
173755319,25,8,9,6,48
173761571,117,13,14,10,154
173763126,177,56,71,21,325
173764351,38,55,41,20,154
173774510,87,30,12,12,141
173778772,22,3,2,1,28
173790471,232,40,16,26,314
173811424,48,7,2,15,72
173824232,43,40,5,4,92
173824492,45,13,2,1,61
173826808,81,3,2,6,92
173834494,28,6,2,1,37
173837976,15,3,2,1,21
173839286,47,39,15,5,106
173844214,111,74,114,1,300
173867574,13,27,3,1,44
173876898,12,3,2,1,18
173881846,107,28,2,1,138
173918921,16,9,4,3,32
173945731,280,35,116,19,450
173952222,178,3,2,17,200
173967366,90,6,2,2,100
173970280,98,13,24,25,160
173975950,32,42,4,4,82
173990394,132,12,62,12,218
173995558,53,33,13,22,121
174001101,83,3,2,8,96
174010604,62,10,15,1,88
174026077,23,3,2,1,29
174041228,35,11,3,27,76
174047238,31,4,4,2,41
174055062,36,20,5,1,62
174099640,29,58,7,1,95
174107918,61,30,17,23,131
174121784,56,3,2,1,62
174125249,83,3,2,12,100
174126697,86,11,51,1,149
174131407,82,6,39,1,128
174133427,75,7,9,1,92
174135808,40,11,48,33,132
174137131,97,3,2,7,109
174149131,131,53,38,1,223
174183136,98,3,2,7,110
174204501,163,3,55,2,223
174208128,129,18,2,1,150
174209429,147,15,2,12,176
174215710,10,3,2,3,18
174225228,32,35,14,29,110
174235377,85,25,3,4,117
174239575,105,55,8,17,185
174278061,33,30,20,6,89
174310018,50,14,37,21,122
174312906,34,10,2,1,47
174318306,10,4,2,1,17
174319153,92,23,2,1,118
174323139,14,13,5,2,34
174324153,39,3,2,3,47
174339104,79,25,37,2,143
174339712,95,41,44,2,182
174342754,17,3,2,1,23
174354211,27,21,25,1,74
174370782,52,12,2,7,73
174373882,31,55,12,19,117
174398213,66,3,85,7,161
174432187,89,3,2,1,95
174433619,59,56,2,3,120
174434759,265,3,2,2,272
174439899,39,3,2,3,47
174460501,22,19,2,1,44
174464312,70,16,2,4,92
174478515,181,93,34,28,336
174495687,159,12,19,1,191
174507617,54,3,2,1,60
174508796,10,9,2,1,22
174544992,30,10,2,1,43
174548061,82,30,20,20,152
174564365,19,23,5,1,48
174572515,147,12,2,7,168
174574917,111,16,137,3,267
174580208,148,35,2,11,196
174594244,61,11,13,2,87
174621365,76,30,31,11,148
174631438,57,3,9,1,70
174642382,114,10,29,1,154
174646972,28,29,2,35,94
174653140,71,12,17,3,103
174658496,10,4,2,1,17
174690310,71,3,2,5,81
174693065,13,3,2,1,19
174700108,39,68,2,5,114
174701480,11,14,2,1,28
174707756,528,3,2,8,541
174709981,10,3,2,2,17
174710777,24,15,17,15,71
174722474,33,3,2,1,39
174731280,58,22,3,7,90
174734105,13,3,2,1,19
174768147,15,3,2,1,21
174771184,54,3,2,2,61
174785356,65,31,5,6,107
174790899,39,20,2,6,67
174796182,24,18,96,8,146
174802885,34,10,12,1,57
174827216,8306,3,2,53,8364
174829229,13,3,2,1,19
174831308,23,17,20,13,73
174836764,73,9,17,1,100
174838746,91,3,4,12,110
174873602,70,3,2,14,89
174884048,13,8,2,1,24
174911694,53,78,35,41,207
174924448,110,4,4,1,119
174932771,29,11,8,53,101
174933864,91,3,2,1,97
174938904,26,6,2,1,35
174946938,77,29,57,11,174
174949091,166,3,2,1,172
174966025,246,3,2,5,256
174969237,22,3,2,1,28
174983744,29,35,36,37,137
175008305,21,19,5,2,47
175010538,34,3,2,1,40
175037291,76,15,3,4,98
175042973,28,3,2,14,47
175047274,216,39,25,1,281
175068357,52,29,2,13,96
175073028,28,3,2,1,34
175074623,50,3,2,1,56
175077824,49,23,29,1,102
175082946,10,5,2,1,18
175093080,14,3,2,1,20
175093298,63,3,2,1,69
175103150,11,3,2,1,17
175136163,19,3,2,3,27
175159562,29,11,14,4,58
175172050,64,35,5,41,145
175176090,16,5,2,1,24
175202524,94,43,67,14,218
175209164,17,4,2,1,24
175228800,19,16,2,1,38
175261377,93,75,2,3,173
175262698,43,38,19,6,106
175275688,50,30,2,1,83
175296475,117,40,3,10,170
175299742,86,13,2,4,105
175302334,58,4,2,25,89
175316843,21,3,2,1,27
175323337,18,16,4,6,44
175323369,38,13,7,1,59
175327035,34,76,3,2,115
175342581,93,45,50,4,192
175352756,91,22,2,10,125
175367629,13,40,2,2,57
175386308,12,13,2,1,28
175386536,119,35,3,15,172
175400002,14,3,2,1,20
175407039,100,22,2,1,125
175407270,24,20,2,5,51
175407642,10,5,2,3,20
175427242,42,4,5,8,59
175432270,64,41,44,19,168
175433737,89,14,7,1,111
175434616,68,9,2,1,80
175462186,11,74,5,1,91
175470648,26,6,2,4,38
175475314,101,3,2,13,119
175480364,54,9,2,5,70
175485183,39,3,2,1,45
175494718,219,35,2,26,282
175496226,107,30,2,9,148
175498171,52,39,3,1,95
175505865,10,5,2,1,18
175507577,46,3,2,2,53
175514554,14,3,2,1,20
175520014,65,3,2,51,121
175541358,32,15,2,2,51
175553370,24,35,2,10,71
175555990,137,3,2,2,144
175556896,58,24,3,5,90
175570096,46,41,2,17,106
175586626,27,3,2,3,35
175589217,143,34,40,1,218
175591135,37,29,18,1,85
175591377,81,3,2,19,105
175591743,15,109,22,2,148
175596356,24,9,2,1,36
175599426,20,19,2,1,42
175615878,18,15,2,1,36
175620947,161,57,55,3,276
175652608,26,57,43,15,141
175664926,55,67,12,15,149
175669033,88,49,6,17,160
175670588,42,8,2,2,54
175682515,141,17,36,3,197
175690311,100,3,2,1,106
175691026,75,53,9,1,138
175701626,60,5,29,8,102
175715861,65,5,2,1,73
175718014,97,30,4,9,140
175720777,37,55,5,1,98
175730286,83,3,2,9,97
175739310,66,14,2,1,83
175772563,20,5,2,1,28
175804063,90,14,6,29,139
175805161,60,3,2,4,69
175805681,33,3,2,6,44
175809162,40,3,2,4,49
175815740,251,3,2,1,257
175832849,20,5,3,2,30
175839089,18,32,2,1,53
175843697,35,102,17,3,157
175846014,168,3,3,1,175
175849983,41,3,2,5,51
175880004,54,3,2,1,60
175890196,51,20,2,1,74
175915597,10,12,2,1,25
175918652,225,52,3,1,281
175919310,45,19,14,2,80
175927345,14,3,2,1,20
175941371,91,46,4,20,161
175964058,13,12,2,1,28
175965751,49,27,2,14,92
176005362,86,11,2,23,122
176010873,12,3,2,1,18
176014131,498,3,2,9,512
176027311,24,7,2,11,44
176028241,87,13,45,4,149
176057174,62,41,13,12,128
176058748,104,18,2,3,127
176066347,109,40,65,1,215
176095358,10,3,2,6,21
176097551,38,10,2,1,51
176098208,33,3,2,1,39
176105780,20,3,2,1,26
176111660,67,60,2,5,134
176116312,11,10,2,1,24
176125088,130,36,2,1,169
176128453,27,48,4,28,107
176138305,21,3,2,1,27
176141733,97,31,2,1,131
176152070,17,73,2,1,93
176162513,147,27,36,1,211
176171503,13,3,2,1,19
176185289,75,33,2,7,117
176194523,89,9,3,2,103
176200886,111,5,2,21,139
176212040,65,41,37,1,144
176213567,55,11,4,1,71
176217667,31,55,3,1,90
176226195,98,46,121,11,276
176238333,74,8,2,9,93
176239924,36,6,3,20,65
176243777,164,31,56,4,255
176259544,10,8,2,1,21
176264661,168,7,4,35,214
176267002,10,3,2,2,17
176284654,159,17,2,3,181
176286925,88,20,16,4,128
176311780,92,28,19,9,148
176329111,102,16,31,9,158
176329314,45,3,2,2,52
176334671,115,3,2,1,121
176346262,77,3,2,4,86
176376649,64,127,131,4,326
176377751,29,42,10,5,86
176379713,12,3,2,1,18
176388563,61,49,2,19,131
176391675,213,15,11,4,243
176392493,110,29,18,64,221
176397664,14,4,2,1,21
176399745,44,33,2,2,81
176399930,59,7,3,4,73
176419518,99,43,2,24,168
176448122,63,8,2,7,80
176465837,42,23,4,4,73
176471062,175,3,2,33,213
176482777,107,18,2,1,128
176483285,84,18,44,18,164
176496423,67,6,2,2,77
176502974,95,21,2,3,121
176505744,155,3,2,2,162
176508951,58,7,20,2,87
176524492,91,33,15,1,140
176534792,61,15,78,2,156
176535283,320,9,3,18,350
176536308,52,17,15,5,89
176536325,133,49,91,11,284
176541616,87,31,2,1,121
176543382,36,3,2,2,43
176546915,10,4,2,1,17
176563001,44,64,8,1,117
176577490,93,3,2,8,106
176580405,69,22,3,1,95
176587727,16,8,6,1,31
176624660,171,3,2,1,177
176631474,12,10,2,3,27
176636901,75,3,2,6,86
176667397,17,3,2,6,28
176700680,177,36,29,3,245
176701285,19,3,2,1,25
176707883,88,20,56,2,166
176720921,59,12,39,11,121
176726200,160,4,2,2,168
176737170,38,3,2,5,48
176753337,76,35,6,1,118
176755702,51,16,11,59,137
176758697,41,3,2,1,47
176762011,17,31,2,31,81
176763789,32,20,26,4,82
176792707,177,3,2,1,183
176800114,206,10,25,1,242
176801270,107,15,10,3,135
176805903,17,20,2,1,40
176811358,11,11,10,2,34
176812946,30,15,8,3,56
176824858,12,3,2,1,18
176830644,30,7,2,1,40
176830805,21,3,2,1,27
176831301,70,46,2,10,128
176838006,21,3,2,1,27
176840894,40,43,14,13,110
176841077,118,57,35,22,232
176852435,89,69,113,82,353
176853968,10,11,2,5,28
176857526,17,3,2,5,27
176862093,50,30,11,1,92
176864407,34,18,10,14,76
176874709,42,8,3,1,54
176875582,20,6,2,4,32
176886952,110,28,91,13,242
176893213,31,26,2,1,60
176894135,16,3,2,1,22
176899854,83,11,2,1,97
176910771,55,35,2,105,197
176912179,156,3,11,2,172
176940424,38,15,18,1,72
176943294,85,10,3,1,99
176947100,16,17,6,1,40
176950230,11,3,2,2,18
176954502,71,3,2,5,81
176964481,17,8,15,1,41
176988868,117,3,2,3,125
177003776,76,17,2,2,97
177007230,134,69,54,37,294
177011087,11,3,2,1,17
177032885,14,11,10,2,37
177037894,94,47,33,34,208
177040621,107,5,2,6,120
177042619,10,6,2,1,19
177068527,49,109,61,11,230
177072358,87,23,30,2,142
177078906,55,14,56,1,126
177092648,29,14,15,29,87
177093015,68,26,2,1,97
177099476,109,3,7,1,120
177103605,10,9,2,1,22
177104713,18,3,2,3,26
177114788,77,6,11,2,96
177129638,11,14,4,1,30
177132987,226,3,2,4,235
177135189,313,3,2,77,395
177144004,108,24,3,5,140
177148450,17,11,2,1,31
177166202,65,21,10,1,97
177172774,61,11,22,1,95
177173897,130,18,42,5,195
177174427,54,3,2,1,60
177187995,86,44,31,1,162
177193791,111,11,7,8,137
177197726,12,3,2,2,19
177198216,50,3,2,4,59
177204015,40,9,2,1,52
177215102,31,27,34,11,103
177218007,54,3,2,1,60
177220858,18,6,2,1,27
177225468,66,19,14,2,101
177227117,79,3,2,3,87
177229614,72,55,7,18,152
177233963,32,3,7,3,45
177235468,68,39,2,1,110
177236648,78,20,8,13,119
177239145,36,21,12,18,87
177242966,102,7,2,7,118
177247694,97,18,22,35,172
177249099,47,48,23,2,120
177251498,119,35,6,7,167
177256425,27,105,3,6,141
177257840,56,49,5,17,127
177268583,13,19,2,3,37
177292266,142,3,2,1,148
177299193,14,3,2,1,20
177301851,15,3,2,6,26
177313190,45,13,2,1,61
177317442,76,12,2,3,93
177329160,68,8,2,2,80
177357006,26,15,2,1,44
177357291,48,3,13,1,65
177363641,48,3,2,1,54
177396169,56,21,2,3,82
177398562,22,18,23,1,64
177401345,60,3,2,1,66
177433601,13,21,2,3,39
177449925,10,5,2,1,18
177455529,77,41,4,1,123
177474118,39,72,7,2,120
177474265,130,3,2,1,136
177490572,51,70,18,84,223
177494474,21,3,2,10,36
177506494,38,23,18,15,94
177506578,12,3,2,1,18
177510124,38,6,2,1,47
177519653,91,3,2,5,101
177524381,112,17,2,1,132
177541842,32,36,5,35,108
177551206,35,3,2,19,59
177558271,77,27,33,56,193
177578831,54,3,7,1,65
177589553,32,3,2,5,42
177592608,12,9,2,3,26
177594144,12,10,2,14,38
177595018,164,4,9,1,178
177647050,55,22,2,1,80
177649526,75,64,2,8,149
177650278,60,147,3,1,211
177665493,90,12,49,10,161
177667564,55,3,2,1,61
177683052,44,11,3,3,61
177687069,33,24,37,34,128
177710649,118,11,3,2,134
177717481,34,44,2,1,81
177734476,57,47,21,22,147
177740791,76,30,2,1,109
177767202,84,3,2,1,90
177811018,35,17,26,23,101
177812844,14,3,2,1,20
177813914,159,3,2,1,165
177835956,62,3,67,1,133
177845931,110,49,27,5,191
177853038,118,20,42,8,188
177853113,39,49,56,64,208
177864407,99,16,31,7,153
177869620,153,3,2,1,159
177880054,20,17,4,2,43
177901802,130,102,62,11,305
177909252,11,20,2,1,34
177921987,51,21,8,1,81
177930156,71,3,2,1,77
177938907,13,3,2,1,19
177942969,32,38,2,2,74
177962298,19,45,7,1,72
177962940,112,19,2,4,137
177965830,51,12,5,21,89
177967067,67,18,3,7,95
177968345,73,3,2,1,79
177973026,37,9,3,1,50
177977861,14,19,2,1,36
177983246,30,38,2,3,73
177985960,54,24,2,1,81
178008696,44,17,3,3,67
178031647,70,18,64,7,159
178043295,28,23,7,1,59
178046655,25,3,2,1,31
178055708,11,6,2,6,25
178068563,14,3,2,1,20
178079079,16,7,5,8,36
178084994,94,15,4,1,114
178097707,23,3,2,1,29
178098757,28,44,5,7,84
178105222,23,8,2,1,34
178122645,101,23,2,1,127
178141647,46,77,2,1,126
178146846,67,3,2,1,73
178158636,16,6,2,1,25
178169062,104,23,23,3,153
178178763,51,14,23,1,89
178179339,34,50,3,24,111
178197351,13,3,2,1,19
178200489,54,60,39,7,160
178208315,56,19,2,10,87
178208443,142,44,2,1,189
178210909,43,3,2,1,49
178213361,65,26,38,18,147
178250333,37,3,2,1,43
178250793,60,4,2,2,68
178259912,114,3,2,2,121
178266894,175,111,12,71,369
178278029,155,25,2,2,184
178280225,48,4,2,1,55
178302241,179,7,3,2,191
178303452,81,53,100,3,237
178304634,14,3,2,1,20
178329530,19,27,2,1,49
178347488,46,13,34,7,100
178348237,50,3,2,8,63
178359779,34,29,15,6,84
178365325,20,5,2,1,28
178371187,18,6,2,1,27
178375221,115,9,3,4,131
178379038,152,27,2,5,186
178383319,11,5,2,1,19
178384716,27,43,3,3,76
178403114,58,3,2,2,65
178405862,77,3,2,1,83
178408823,29,3,5,1,38
178410122,63,16,2,3,84
178416457,65,23,18,6,112
178418504,17,43,18,1,79
178424177,33,53,17,28,131
178428792,28,117,2,5,152
178432151,46,28,18,7,99
178444205,48,3,79,9,139
178466501,161,3,2,5,171
178468702,11,3,2,2,18
178471268,144,3,2,1,150
178485436,60,4,9,3,76
178516256,169,3,2,64,238
178517171,11,3,2,1,17
178520303,103,3,2,10,118
178522898,18,3,2,1,24
178531343,11,5,2,1,19
178538697,15,4,2,1,22
178551302,48,3,2,1,54
178560923,64,40,27,26,157
178573006,13,5,2,10,30
178613130,59,3,2,2,66
178647006,151,112,32,19,314
178648643,19,3,2,3,27
178658100,77,19,2,4,102
178664923,78,3,2,2,85
178690159,68,36,17,24,145
178695565,49,3,2,4,58
178712178,224,27,72,12,335
178718798,108,3,2,1,114
178723815,26,3,2,6,37
178724237,40,24,2,1,67
178730096,124,3,2,1,130
178752428,64,38,68,2,172
178754989,32,4,2,4,42
178755871,11,3,2,5,21
178767715,64,5,2,1,72
178770660,67,3,2,1,73
178776821,48,6,12,1,67
178812532,34,71,13,3,121
178816215,49,79,16,12,156
178822992,52,39,2,13,106
178828543,29,5,2,6,42
178831015,52,5,36,14,107
178875976,34,20,11,2,67
178883971,67,3,2,8,80
178890130,90,3,2,2,97
178890656,47,3,2,1,53
178897116,11,12,2,1,26
178897492,24,32,3,2,61
178898491,14,12,2,1,29
178902275,109,3,2,2,116
178912043,291,25,30,5,351
178915532,13,3,2,1,19
178921153,75,11,2,1,89
178923209,114,26,61,23,224
178925195,28,14,2,8,52
178949041,52,3,2,1,58
178951578,14,15,2,3,34
178951760,141,16,30,1,188
178968585,13,3,2,1,19
178975046,109,3,5,5,122
178988590,44,30,2,1,77
179015116,71,16,13,1,101
179030903,66,40,38,2,146
179042198,10,3,2,3,18
179055505,67,13,73,29,182
179057646,59,28,52,6,145
179058229,110,3,2,1,116
179062439,51,10,2,1,64
179067034,88,32,22,4,146
179071487,65,3,2,2,72
179076355,35,3,2,3,43
179089881,13,6,2,1,22
179096914,59,3,2,6,70
179106814,10,3,2,2,17
179125007,10,5,2,1,18
179137282,84,18,2,7,111
179137765,10,25,2,3,40
179141734,49,7,2,1,59
179143062,34,15,55,19,123
179160330,74,17,2,3,96
179178331,17,3,2,2,24
179186919,119,3,2,9,133
179192884,35,18,2,1,56
179209055,246,41,2,17,306
179215201,184,3,2,18,207
179216850,11,3,2,1,17
179222804,66,7,15,1,89
179227388,97,30,2,15,144
179227874,32,7,2,7,48
179248694,81,3,2,1,87
179280268,145,9,2,2,158
179287932,72,71,41,27,211
179292775,21,14,2,1,38
179294349,16,3,2,1,22
179296244,18,3,2,1,24
179299314,34,30,2,4,70
179299794,132,33,3,1,169
179303315,43,3,27,8,81
179303835,13,13,2,1,29
179305391,144,10,2,2,158
179309791,10,9,2,1,22
179322688,31,20,6,1,58
179325203,56,77,4,1,138
179328503,35,35,3,4,77
179328573,13,16,2,1,32
179332678,14,3,2,1,20
179335691,22,33,11,1,67
179340624,35,3,2,5,45
179353874,12,19,3,1,35
179360531,91,71,110,16,288
179374633,66,11,2,1,80
179393481,57,22,2,3,84
179417349,57,3,2,2,64
179430196,86,24,30,28,168
179435164,124,13,2,6,145
179443087,138,12,2,2,154
179454373,34,24,28,1,87
179456808,88,18,2,5,113
179457569,39,34,5,1,79
179463134,31,8,2,1,42
179466413,45,29,14,5,93
179469571,93,40,14,21,168
179471266,28,117,37,2,184
179483556,69,3,2,12,86
179487432,18,3,2,1,24
179501798,25,49,24,4,102
179537987,82,13,13,5,113
179545717,77,62,5,8,152
179547376,11,3,2,1,17
179551744,73,3,2,1,79
179551910,11,3,2,1,17
179554698,11,3,2,1,17
179555695,46,11,4,1,62
179556544,49,46,26,9,130
179558193,35,3,2,3,43
179565743,91,10,104,1,206
179567918,119,28,2,5,154
179600811,14,3,2,1,20
179608554,66,9,19,37,131
179615019,41,29,2,6,78
179624004,35,17,27,5,84
179642861,10,3,2,2,17
179658483,76,3,2,1,82
179670693,13,3,2,1,19
179671822,11,17,2,1,31
179672150,14,6,2,1,23
179673033,81,3,2,2,88
179684074,10,6,2,1,19
179688321,13,3,2,1,19
179698552,23,33,2,1,59
179716280,10,3,2,3,18
179725508,115,26,52,3,196
179735522,30,47,2,27,106
179740386,30,3,2,1,36
179742140,51,44,62,17,174
179756388,79,37,2,2,120
179757682,14,4,5,5,28
179760246,119,3,2,5,129
179761103,97,5,64,1,167
179764607,51,20,7,6,84
179766738,41,32,9,36,118
179769414,64,3,2,1,70
179775235,64,43,29,1,137
179777689,20,7,2,1,30
179789732,26,17,2,2,47
179800176,97,16,30,3,146
179808043,15,22,2,7,46
179819242,75,61,6,11,153
179820148,43,7,2,1,53
179828569,59,30,14,2,105
179862637,143,3,2,15,163
179870629,12,3,2,1,18
179898699,10,17,2,1,30
179905181,35,18,9,24,86
179922191,23,29,4,1,57
179931610,10,4,2,1,17
179951472,59,3,2,1,65
179953351,53,28,10,11,102
179962116,90,3,2,1,96
179963255,32,5,2,1,40
179964968,22,14,22,4,62
179972700,13,3,4,1,21
179981517,162,77,26,8,273
179991675,128,6,9,3,146
179996229,11,3,2,1,17
180003183,52,7,2,1,62
180005743,137,27,43,9,216
180008161,49,20,22,4,95
180025316,141,38,2,1,182
180059081,28,8,2,9,47
180109288,110,19,63,3,195
180118433,113,59,71,16,259
180165961,44,33,19,12,108
180167959,46,3,2,2,53
180168595,31,19,6,2,58
180173814,12,3,2,1,18
180180739,31,5,2,1,39
180181684,32,35,2,1,70
180182249,18,34,3,4,59
180184459,15,3,2,1,21
180187251,32,77,22,1,132
180210393,28,33,25,1,87
180240290,29,21,6,43,99
180245424,103,27,3,15,148
180246680,97,27,81,3,208
180247810,18,62,2,1,83
180251381,82,44,26,13,165
180252533,113,21,2,1,137
180270535,10,4,2,2,18
180270693,139,23,17,18,197
180351010,26,3,2,2,33
180357325,136,22,2,13,173
180358640,50,25,39,5,119
180363838,50,38,2,2,92
180369709,15,3,2,1,21
180387640,75,32,2,2,111
180387908,114,12,7,3,136
180392889,16,3,2,1,22
180400948,109,24,2,37,172
180401391,37,39,9,12,97
180407242,11,3,2,1,17
180409298,69,19,4,2,94
180414368,14,3,2,1,20
180415296,46,18,2,1,67
180428602,81,11,80,21,193
180433754,29,3,2,7,41
180436421,58,16,2,1,77
180439515,155,3,2,1,161
180452882,25,3,2,1,31
180462224,19,3,2,1,25
180465412,17,3,2,3,25
180479194,91,3,2,1,97
180540100,16,3,2,1,22
180541232,13,3,2,2,20
180549777,41,3,2,11,57
180551075,101,8,68,1,178
180551985,139,56,14,9,218
180552441,51,3,2,1,57
180553048,39,3,2,1,45
180562309,84,34,4,2,124
180565038,78,3,2,1,84
180566353,32,4,2,2,40
180570261,100,29,2,1,132
180576269,93,21,11,23,148
180588655,23,11,2,1,37
180602270,74,4,2,3,83
180606835,28,29,22,1,80
180611373,23,26,17,1,67
180622620,74,3,2,3,82
180631328,53,4,4,3,64
180642166,24,10,2,4,40
180651608,113,31,6,8,158
180657942,36,109,2,4,151
180665822,45,3,2,1,51
180677231,114,76,9,2,201
180684765,213,3,2,15,233
180687240,91,15,88,30,224
180708351,383,3,2,10,398
180734137,68,23,2,19,112
180736861,11,8,2,1,22
180759932,85,8,40,4,137
180760581,11,43,2,1,57
180762940,62,3,2,1,68
180773915,296,22,17,8,343
180774356,29,3,2,1,35
180786111,58,49,7,1,115
180795645,129,37,58,29,253
180812540,69,12,40,1,122
180843285,16,8,2,1,27
180863432,65,7,11,1,84
180863462,53,3,2,1,59
180870886,51,10,3,2,66
180875519,112,64,2,1,179
180880745,133,28,8,25,194
180881046,49,3,2,1,55
180882760,69,12,6,1,88
180895737,32,30,28,2,92
180900613,37,12,13,1,63
180902400,75,3,2,1,81
180908339,55,22,4,16,97
180914074,119,76,64,1,260
180919885,15,3,2,1,21
180928204,32,15,11,12,70
180956265,44,22,41,2,109
180959154,40,16,16,12,84
180967409,43,39,11,2,95
180968350,23,39,17,5,84
180972255,10,7,2,1,20
180977502,26,14,3,5,48
180984830,44,14,5,3,66
180991925,91,11,3,24,129
181017928,83,4,2,9,98
181018204,23,31,5,4,63
181022449,132,28,6,6,172
181024388,53,9,2,1,65
181032787,94,3,2,1,100
181035804,75,3,2,52,132
181051663,27,17,3,1,48
181052952,78,13,12,8,111
181074547,10,4,2,1,17
181087472,28,3,2,1,34
181095145,29,3,2,3,37
181110578,184,28,29,1,242
181125218,14,3,2,2,21
181126168,151,16,12,1,180
181128804,28,3,2,1,34
181147734,81,58,11,16,166
181164091,49,18,3,1,71
181174640,41,16,24,31,112
181186051,72,30,7,28,137
181191251,15,17,5,11,48
181204577,104,55,2,1,162
181212050,115,37,45,2,199
181224743,103,3,2,1,109
181243787,79,3,2,2,86
181248101,26,3,2,45,76
181255132,82,3,2,2,89
181266674,77,3,2,1,83
181273265,184,3,2,8,197
181275398,21,34,4,3,62
181287321,104,25,164,5,298
181289755,11,3,2,2,18
181293264,12,12,2,2,28
181298835,57,64,4,5,130
181299724,160,34,32,4,230
181305321,13,18,14,15,60
181315083,36,21,30,2,89
181322961,68,25,79,4,176
181348275,64,19,65,15,163
181348839,63,3,2,4,72
181349420,26,46,11,4,87
181393454,42,17,11,4,74
181399412,25,4,2,2,33
181407251,89,8,2,1,100
181416919,17,23,2,14,56
181420362,38,3,2,1,44
181435996,44,26,2,1,73
181443082,26,3,2,2,33
181452332,68,24,36,3,131
181462205,11,26,2,2,41
181464435,263,3,2,3,271
181467696,11,3,2,1,17
181472213,11,3,2,1,17
181477533,95,13,7,8,123
181488981,146,60,3,22,231
181500381,97,25,23,10,155
181507509,14,3,2,2,21
181520967,46,8,11,4,69
181522481,46,7,27,1,81
181534399,38,52,7,12,109
181538269,52,11,2,1,66
181541524,17,6,2,1,26
181567070,109,3,2,1,115
181575744,11,47,2,1,61
181583799,34,20,2,4,60
181589121,16,3,4,2,25
181592839,193,8,2,23,226
181596116,95,45,43,5,188
181609486,31,9,11,14,65
181613820,12,4,2,1,19
181620750,73,3,2,1,79
181622233,55,15,77,3,150
181625943,11,3,2,1,17
181662310,25,65,3,5,98
181666191,24,3,2,2,31
181671410,79,39,26,18,162
181676115,11,3,2,1,17
181678062,17,5,2,1,25
181682776,11,3,2,4,20
181709359,34,10,2,5,51
181717962,16,6,2,5,29
181733465,99,59,31,1,190
181734141,66,32,41,20,159
181751553,180,37,12,1,230
181756485,35,25,6,1,67
181763031,129,3,2,1,135
181776699,22,3,2,1,28
181779914,48,3,2,5,58
181787801,26,7,52,6,91
181791107,99,3,2,1,105
181814890,103,41,2,1,147
181816801,66,23,15,1,105
181825826,18,3,2,1,24
181826407,47,3,2,1,53
181828057,77,3,2,1,83
181836708,59,24,2,1,86
181838412,111,3,2,27,143
181863312,12,5,2,2,21
181869380,53,27,38,2,120
181870918,37,24,43,8,112
181873223,57,3,2,6,68
181889116,45,23,3,1,72
181891159,44,3,2,2,51
181892571,47,12,2,9,70
181910849,14,3,2,2,21
181913794,45,3,2,7,57
181917687,30,61,12,2,105
181920934,38,6,2,1,47
181921579,87,48,2,1,138
181922868,34,24,25,13,96
181938896,111,26,3,1,141
181942964,29,41,6,11,87
181944622,22,3,2,1,28
181947175,35,23,3,1,62
181949865,30,5,2,1,38
181952871,72,14,15,1,102
181966273,65,17,77,1,160
181969195,14,3,2,1,20
181976690,94,29,12,5,140
181982122,66,21,24,5,116
181985391,15,14,2,14,45
181990251,10,3,2,2,17
181991590,89,8,2,4,103
181992450,82,86,48,8,224
181996239,25,27,4,1,57
182028852,50,21,2,1,74
182041152,59,5,2,3,69
182051257,24,3,2,2,31
182060402,58,27,2,10,97
182065428,44,3,2,1,50
182071179,10,4,2,1,17
182071396,194,7,38,1,240
182073438,137,3,2,5,147
182084187,73,45,14,14,146
182086071,13,68,2,1,84
182104790,14,4,2,1,21
182106713,13,3,2,1,19
182128372,17,15,30,1,63
182129599,18,9,8,8,43
182135189,39,3,2,1,45
182141494,16,3,2,1,22
182142856,19,10,2,2,33
182155792,20,3,2,1,26
182159222,88,7,8,2,105
182160185,39,3,2,5,49
182172800,80,10,2,3,95
182189779,18,3,2,1,24
182212871,210,3,2,18,233
182217925,71,101,3,29,204
182226032,48,19,33,1,101
182226212,52,52,5,6,115
182232828,21,5,2,2,30
182232968,63,13,2,1,79
182238234,12,3,2,1,18
182247683,30,25,2,1,58
182252448,13,34,2,2,51
182293482,106,13,3,1,123
182300939,85,33,36,46,200
182316322,29,19,2,1,51
182328032,59,21,21,1,102
182353747,40,5,2,4,51
182354241,80,21,3,1,105
182359386,160,25,2,8,195
182359970,26,3,2,1,32
182360661,34,7,19,13,73
182368058,18,6,2,1,27
182372268,39,51,30,1,121
182375120,76,32,6,13,127
182376074,61,3,2,2,68
182380985,13,5,2,1,21
182381912,38,3,2,2,45
182384793,50,29,19,5,103
182401435,73,4,2,2,81
182410408,17,3,2,1,23
182429309,20,3,2,2,27
182450834,69,33,2,1,105
182451730,35,11,24,3,73
182454178,77,3,2,2,84
182454441,16,8,6,1,31
182457350,62,27,25,20,134
182459116,31,11,35,5,82
182459399,136,45,2,1,184
182472644,94,3,2,1,100
182478663,89,43,8,3,143
182493989,18,24,22,2,66
182497565,122,7,2,1,132
182507991,62,32,11,18,123
182519459,37,16,2,3,58
182525606,38,3,2,1,44
182525659,63,3,2,2,70
182525916,55,5,13,9,82
182533024,22,3,2,1,28
182548623,86,3,2,4,95
182549386,42,32,5,6,85
182561781,227,129,6,2,364
182581926,11,3,2,4,20
182607724,37,8,10,1,56
182614019,14,32,6,1,53
182616239,64,31,3,3,101
182626021,14,5,2,1,22
182630914,44,7,2,7,60
182640673,178,65,71,8,322
182649690,92,3,2,7,104
182650815,68,72,5,4,149
182653368,206,48,2,22,278
182660978,18,4,2,1,25
182674304,16,3,2,1,22
182675695,117,12,4,1,134
182678771,17,3,2,3,25
182697150,56,65,2,25,148
182697583,58,26,2,1,87
182704398,16,6,2,1,25
182707478,10,4,2,2,18
182707520,43,29,4,12,88
182727128,67,5,7,1,80
182755350,49,15,2,21,87
182771770,10,13,2,1,26
182791130,17,3,2,1,23
182805878,15,3,2,1,21
182813147,31,39,2,1,73
182827263,21,6,2,3,32
182828297,71,66,2,9,148
182848688,12,14,2,1,29
182850328,45,32,18,2,97
182850975,37,24,2,1,64
182853039,63,3,2,1,69
182853760,43,41,16,31,131
182856921,34,8,2,2,46
182858980,63,28,2,2,95
182871271,43,71,20,1,135
182874505,141,3,2,1,147
182877713,42,38,3,2,85
182900648,24,4,3,2,33
182923324,84,17,3,1,105
182932965,112,10,157,1,280
182946941,170,47,2,3,222
182949130,19,3,2,1,25
182951907,22,3,2,1,28
182954226,23,3,2,1,29
182957206,52,8,2,2,64
182957447,15,24,2,1,42
182959277,19,11,2,3,35
182961731,419,3,2,67,491
182963418,38,19,40,13,110
182970866,73,3,2,1,79
182975988,64,34,27,1,126
182978088,19,11,2,1,33
182980673,95,38,2,3,138
182986653,10,5,2,1,18
182987044,111,34,95,2,242
182993238,47,102,7,1,157
182995664,47,30,93,1,171
183006879,13,3,2,1,19
183007183,218,20,2,1,241
183019723,40,19,2,1,62
183031191,61,18,20,3,102
183057135,21,3,2,4,30
183057935,10,6,2,1,19
183088117,109,25,70,2,206
183116334,18,3,2,11,34
183117103,93,3,2,1,99
183120836,21,19,2,1,43
183128159,66,16,2,1,85
183129772,150,91,15,5,261
183131501,12,3,2,1,18
183146451,136,8,2,18,164
183186931,47,36,5,8,96
183190493,10,3,2,2,17
183196890,59,11,12,5,87
183221975,94,25,4,7,130
183226807,139,3,2,1,145
183241643,98,3,2,19,122
183277337,42,31,5,1,79
183280074,14,14,2,1,31
183291196,85,13,2,9,109
183295969,74,21,9,2,106
183297102,182,7,10,5,204
183297697,106,15,38,17,176
183301209,88,6,2,1,97
183315185,153,3,2,2,160
183332413,63,3,2,1,69
183344368,14,6,5,2,27
183360678,20,45,12,1,78
183365123,79,3,2,12,96
183368498,15,6,2,1,24
183372040,125,3,2,22,152
183377989,82,3,2,2,89
183381753,49,17,2,1,69
183382275,141,3,2,2,148
183395705,171,36,2,3,212
183400986,72,45,66,5,188
183415467,257,23,14,3,297
183426991,35,17,18,16,86
183429159,53,3,2,21,79
183435093,15,24,2,1,42
183444128,64,3,2,3,72
183444518,32,33,12,8,85
183448381,13,4,2,1,20
183451051,105,29,42,24,200
183458303,45,3,2,1,51
183467212,77,43,16,9,145
183469636,23,3,2,1,29
183494097,23,22,4,5,54
183495189,223,4,4,6,237
183495249,223,22,10,4,259
183500914,12,3,2,1,18
183510922,93,42,6,19,160
183516653,11,3,2,1,17
183521867,106,36,28,10,180
183523271,11,3,2,1,17
183524890,93,26,2,1,122
183530493,91,24,32,13,160
183557576,25,88,2,1,116
183572943,13,3,2,1,19
183583012,24,9,2,3,38
183587032,57,12,3,1,73
183592837,10,3,2,4,19
183593884,18,3,2,8,31
183604865,11,4,2,1,18
183622282,71,9,3,1,84
183623850,37,3,2,4,46
183625118,118,12,21,5,156
183639556,64,57,10,22,153
183683327,68,37,27,4,136
183692789,102,35,48,4,189
183695851,10,24,2,1,37
183708289,66,24,2,1,93
183708302,10,15,2,1,28
183709857,40,107,45,5,197
183712691,17,3,2,1,23
183716307,25,11,7,8,51
183722779,73,10,59,1,143
183728465,31,10,5,4,50
183731909,11,24,2,2,39
183736698,160,3,2,13,178
183738167,45,10,60,7,122
183740694,20,3,2,1,26
183755747,129,59,2,11,201
183761752,137,3,2,14,156
183763682,151,18,2,10,181
183785630,36,10,29,7,82
183790126,148,8,22,3,181
183796058,53,16,2,1,72
183798260,441,3,2,69,515
183816795,43,10,2,2,57
183820267,11,3,2,1,17
183821761,113,29,82,1,225
183824380,142,6,13,2,163
183832051,27,3,2,6,38
183856153,38,17,2,1,58
183864360,69,27,2,7,105
183877045,45,27,26,21,119
183885183,18,36,2,5,61
183885257,67,111,36,25,239
183892817,104,40,37,4,185
183893180,117,3,36,1,157
183897161,17,3,2,1,23
183906097,143,3,17,3,166
183916100,13,3,2,1,19
183917890,78,3,2,2,85
183919237,69,99,5,4,177
183921150,10,8,2,1,21
183921613,79,22,9,1,111
183924024,79,21,47,36,183
183959004,50,55,29,30,164
183962470,43,44,8,23,118
183974854,127,27,14,2,170
183975317,37,33,4,8,82
183978732,65,19,5,10,99
183988837,97,3,2,1,103
183990407,125,28,167,25,345
184017094,11,17,2,2,32
184019988,170,3,2,2,177
184022677,89,17,2,7,115
184029137,73,17,82,1,173
184034516,257,3,2,4,266
184039038,14,12,2,1,29
184040733,97,33,2,3,135
184044671,13,12,3,1,29
184045579,76,3,2,2,83
184057894,103,28,20,11,162
184059184,31,3,2,2,38
184067248,61,15,2,1,79
184070088,74,39,8,26,147
184082809,207,36,32,83,358
184085233,19,3,2,3,27
184085885,21,4,5,1,31
184090067,159,3,2,3,167
184108420,79,32,2,4,117
184110611,11,3,2,1,17
184128000,48,26,2,7,83
184130248,96,3,2,2,103
184153850,75,3,2,2,82
184159914,56,51,7,14,128
184168994,121,14,19,1,155
184179013,49,45,16,12,122
184186380,118,3,2,7,130
184204603,19,11,8,7,45
184205468,44,3,2,4,53
184210979,56,3,2,1,62
184212429,116,41,65,32,254
184220604,11,3,2,1,17
184235027,43,25,2,1,71
184240125,82,3,2,1,88
184245541,10,5,2,1,18
184249017,139,37,123,31,330
184268089,75,28,39,2,144
184271979,63,28,5,5,101
184284651,25,21,2,1,49
184288310,66,38,2,1,107
184310282,32,45,42,12,131
184321546,71,3,2,1,77
184322712,40,3,2,1,46
184331856,116,8,2,25,151
184350385,11,3,2,1,17
184377601,61,75,15,36,187
184379286,70,6,2,1,79
184384067,37,3,2,1,43
184394708,15,3,2,2,22
184409049,31,9,2,1,43
184414081,80,3,2,2,87
184419201,94,16,31,2,143
184424010,11,3,2,2,18
184426414,64,11,11,1,87
184432065,58,17,2,1,78
184438839,96,3,11,2,112
184440738,14,6,2,1,23
184441403,17,12,2,1,32
184473319,44,16,3,2,65
184474276,466,31,2,12,511
184474424,89,27,7,30,153
184484272,35,3,2,1,41
184489499,13,3,2,1,19
184505410,10,21,4,1,36
184524522,98,3,2,1,104
184525593,12,3,2,2,19
184526208,11,3,2,1,17
184527553,63,11,2,1,77
184549866,54,76,53,3,186
184550211,42,45,7,4,98
184551885,107,36,40,39,222
184568187,143,53,4,7,207
184579449,108,3,2,6,119
184584144,54,33,15,1,103
184627654,108,3,2,1,114
184628337,12,12,2,1,27
184630447,170,22,2,1,195
184647573,29,3,2,1,35
184661276,84,10,2,3,99
184670517,50,23,2,1,76
184672465,46,12,58,1,117
184683046,106,3,2,1,112
184686175,98,11,15,2,126
184690397,10,3,2,9,24
184698786,12,10,2,6,30
184713716,10,72,2,6,90
184722372,121,12,76,2,211
184744520,42,49,2,1,94
184749300,79,18,35,12,144
184754931,51,4,2,1,58
184760194,45,27,21,4,97
184777742,66,25,2,42,135
184847909,12,5,2,1,20
184861604,11,3,2,1,17
184866653,33,13,2,1,49
184885315,49,24,25,1,99
184886571,66,6,2,1,75
184896302,27,53,2,1,83
184955332,53,6,2,1,62
184960327,29,4,18,7,58
184962570,48,3,2,3,56
184963871,86,60,46,17,209
184967899,52,6,2,3,63
184976663,20,3,2,6,31
184978983,58,3,48,1,110
184984025,46,3,2,4,55
185006746,57,7,3,11,78
185011475,10,6,2,1,19
185015406,13,3,2,1,19
185028348,18,56,4,11,89
185037108,47,24,25,1,97
185047321,13,27,3,8,51
185074387,186,67,48,2,303
185075486,80,7,5,1,93
185098813,22,3,2,1,28
185100200,11,3,2,1,17
185101097,35,3,2,1,41
185118666,146,25,22,12,205
185133034,85,12,90,10,197
185141681,10,26,2,1,39
185150675,14,3,2,1,20
185172003,95,5,20,1,121
185172771,21,31,18,1,71
185180567,24,13,2,2,41
185182909,60,3,2,1,66
185226484,68,3,2,6,79
185228493,83,3,2,1,89
185236585,13,3,2,1,19
185249730,76,73,110,45,304
185262742,121,10,2,21,154
185263851,147,30,47,6,230
185282418,85,3,2,3,93
185289506,109,3,2,9,123
185293767,66,18,2,1,87
185295291,85,4,56,3,148
185300827,76,3,2,3,84
185306600,101,43,3,5,152
185310226,51,3,2,1,57
185321924,82,76,32,26,216
185324417,21,8,2,1,32
185328109,175,40,12,4,231
185331499,103,39,7,7,156
185333427,43,3,2,1,49
185334666,59,3,2,3,67
185335034,91,3,2,4,100
185344590,50,9,19,5,83
185348744,91,51,70,2,214
185350136,17,8,2,1,28
185359234,40,33,44,22,139
185367715,141,3,4,2,150
185370935,49,8,43,1,101
185379148,92,30,11,1,134
185406112,174,14,95,1,284
185407618,34,46,2,6,88
185425411,10,4,2,1,17
185430448,89,20,2,2,113
185456992,85,3,2,1,91
185459006,83,3,2,9,97
185462378,216,3,2,1,222
185475756,52,65,28,10,155
185484924,148,18,113,17,296
185490690,15,3,2,3,23
185493148,12,3,2,1,18
185499237,76,47,58,34,215
185506897,92,16,2,2,112
185509908,10,7,2,1,20
185515688,127,5,2,1,135
185518282,166,36,2,24,228
185518543,41,3,3,3,50
185531814,104,3,33,75,215
185542402,697,3,2,5,707
185550786,16,45,25,1,87
185557536,11,8,2,1,22
185575013,24,30,2,6,62
185576186,30,5,2,2,39
185579605,114,30,28,3,175
185605630,76,29,92,3,200
185614371,136,28,51,5,220
185630133,80,22,18,7,127
185633053,134,28,3,11,176
185640677,50,3,2,21,76
185642287,16,6,2,1,25
185651854,105,14,13,2,134
185660010,89,18,17,1,125
185684836,11,12,2,1,26
185690552,72,8,4,1,85
185693338,89,80,7,5,181
185713570,105,9,2,13,129
185720749,25,3,2,1,31
185730985,53,32,6,2,93
185732347,69,32,10,3,114
185739836,24,3,2,2,31
185758041,55,23,39,12,129
185758568,57,3,2,1,63
185767942,90,18,2,2,112
185771085,47,34,44,11,136
185777490,23,7,10,29,69
185787402,128,21,3,2,154
185800118,35,5,2,2,44
185809638,91,26,2,42,161
185813467,20,62,11,2,95
185815054,225,38,7,1,271
185816014,77,35,2,1,115
185817321,124,45,83,2,254
185818608,50,43,2,16,111
185826214,11,3,2,1,17
185832331,10,4,2,1,17
185832969,21,3,2,1,27
185834437,6223,3,2,121,6349
185850437,13,13,2,1,29
185857702,51,36,43,2,132
185860315,21,49,25,7,102
185865597,14,6,2,1,23
185866515,31,3,2,5,41
185881496,31,14,6,5,56
185888887,50,34,44,1,129
185900570,180,10,5,4,199
185912726,15,3,2,1,21
185916181,161,19,9,11,200
185918706,31,4,2,17,54
185929630,21,20,14,18,73
185934434,96,21,65,10,192
185938000,128,3,2,3,136
185949680,76,43,2,25,146
185952334,91,3,2,1,97
185962653,54,49,38,1,142
185963460,45,3,2,1,51
185964004,78,32,36,17,163
185985903,12,3,2,4,21
185990786,46,41,11,1,99
185993977,96,55,41,1,193
185994024,17,3,2,1,23
186003635,61,3,2,1,67
186003797,62,22,19,16,119
186012847,80,65,10,1,156
186029217,197,45,20,12,274
186035589,24,3,2,4,33
186079649,49,17,21,1,88
186093409,22,7,2,1,32
186100157,45,84,13,6,148
186104306,140,40,7,2,189
186108567,28,14,5,8,55
186131245,14,23,2,11,50
186147510,141,19,142,2,304
186151131,140,11,19,11,181
186157168,85,3,2,2,92
186157217,96,24,28,19,167
186161652,45,29,10,29,113
186162808,125,3,2,1,131
186173325,33,23,2,2,60
186182151,153,49,126,62,390
186186317,41,39,33,7,120
186192961,159,3,2,5,169
186201450,32,9,2,6,49
186210904,138,3,2,3,146
186214342,68,23,17,16,124
186222583,13,6,2,1,22
186230694,2341,80,2,64,2487
186251142,1110,3,2,14,1129
186253464,129,9,3,7,148
186260577,67,4,2,1,74
186267636,45,30,14,1,90
186272660,45,11,78,12,146
186276665,63,3,2,1,69
186291891,22,50,4,1,77
186292471,96,34,2,5,137
186304347,14,15,2,1,32
186304956,24,27,6,1,58
186308881,52,48,14,1,115
186320296,58,36,21,9,124
186325575,161,3,2,6,172
186335416,228,34,114,5,381
186336980,14,3,2,1,20
186341895,48,51,73,4,176
186400337,35,3,2,8,48
186400672,86,64,143,2,295
186401494,67,65,61,5,198
186410194,105,5,5,8,123
186453713,14,3,2,1,20
186456113,54,12,3,6,75
186476481,11,6,2,1,20
186478775,97,34,2,9,142
186529431,142,27,12,3,184
186535571,121,29,2,2,154
186537191,43,22,28,14,107
186539371,32,47,28,23,130
186541936,65,3,8,1,77
186545868,14,3,2,1,20
186565516,126,3,2,22,153
186574312,106,20,44,2,172
186578087,53,29,26,9,117
186586937,98,7,29,8,142
186587913,26,3,2,3,34
186589182,57,18,32,24,131
186595691,128,9,2,1,140
186603221,26,35,2,6,69
186621657,33,13,2,1,49
186624185,177,3,2,5,187
186624779,276,105,4,19,404
186633792,52,3,6,5,66
186638326,53,16,28,1,98
186645267,278,3,2,1,284
186652683,10,3,2,4,19
186653868,12,5,2,1,20
186661918,52,44,27,2,125
186679012,54,3,2,5,64
186692621,47,23,3,24,97
186731907,12,24,2,1,39
186736164,17,22,2,1,42
186747658,72,33,23,32,160
186756441,14,3,2,1,20
186759049,69,33,2,7,111
186764522,36,34,34,2,106
186770692,13,3,2,1,19
186776522,119,22,48,1,190
186776593,13,3,2,1,19
186778887,114,16,5,3,138
186778911,17,3,2,1,23
186780718,73,8,15,13,109
186785692,99,13,2,1,115
186803180,33,56,2,1,92
186806979,317,3,2,13,335
186808303,127,39,65,1,232
186815046,68,18,2,3,91
186828761,35,9,2,1,47
186832896,125,43,2,1,171
186835301,128,37,3,2,170
186843877,115,30,37,32,214
186847277,21,3,2,1,27
186858065,27,3,2,9,41
186858296,61,22,5,4,92
186863232,11,3,2,5,21
186864739,17,3,2,1,23
186865430,66,14,2,7,89
186865584,83,45,41,60,229
186868420,15,10,2,1,28
186869756,64,21,2,26,113
186883804,50,8,2,1,61
186894143,23,4,4,2,33
186912688,22,4,2,6,34
186928628,27,12,2,1,42
186981149,50,13,2,1,66
186982305,267,14,3,12,296
187010907,29,22,2,3,56
187013267,83,3,2,1,89
187025481,28,8,2,1,39
187028140,93,3,2,2,100
187035638,158,44,48,41,291
187045244,32,47,5,14,98
187056693,59,15,3,15,92
187079997,43,7,2,1,53
187088421,161,3,2,2,168
187092556,58,19,9,2,88
187096557,48,15,30,1,94
187104651,40,26,10,1,77
187108564,47,3,2,23,75
187110702,64,3,2,1,70
187125521,571,3,2,25,601
187147389,22,17,2,1,42
187162234,27,3,7,4,41
187166485,41,40,8,1,90
187180478,92,49,18,8,167
187190949,152,3,2,1,158
187206543,15,5,2,1,23
187227040,56,11,19,4,90
187236140,17,32,2,1,52
187240337,16,11,3,3,33
187266882,239,30,98,14,381
187269357,30,3,22,2,57
187271607,51,9,21,2,83
187273707,14,3,2,3,22
187283698,43,25,2,3,73
187290210,59,16,29,17,121
187312165,46,5,2,2,55
187320383,42,3,87,1,133
187320425,26,3,2,4,35
187326756,38,13,2,1,54
187341200,39,4,2,1,46
187350217,19,3,2,1,25
187356381,106,22,14,1,143
187364253,84,42,52,35,213
187370253,89,53,30,3,175
187377300,56,70,57,3,186
187393130,74,38,23,5,140
187393664,56,37,27,2,122
187405135,55,51,29,5,140
187413000,57,22,39,7,125
187437254,40,3,2,3,48
187438848,160,3,2,5,170
187441152,67,14,70,14,165
187441362,24,4,2,12,42
187444880,96,3,2,1,102
187444969,20,31,4,1,56
187460841,18,3,2,1,24
187505561,151,15,2,1,169
187518179,103,47,40,3,193
187531433,45,6,2,2,55
187538277,391,3,2,8,404
187551784,20,41,11,6,78
187554448,71,32,2,11,116
187563156,74,21,2,8,105
187569198,10,4,2,1,17
187572379,47,3,2,1,53
187600080,46,3,2,1,52
187608429,31,12,2,7,52
187612139,13,70,2,1,86
187613740,11,16,2,1,30
187617608,155,13,26,6,200
187618208,35,3,2,1,41
187620672,27,16,2,1,46
187639714,23,36,2,1,62
187641276,47,28,5,1,81
187645368,38,3,2,1,44
187646809,94,3,2,5,104
187665097,12,50,25,1,88
187668222,48,3,2,1,54
187670994,213,32,72,1,318
187676838,87,11,35,1,134
187678709,113,26,3,1,143
187681906,38,34,6,13,91
187685993,84,3,2,1,90
187688784,160,41,104,1,306
187701991,14,3,2,3,22
187714017,65,7,2,32,106
187734609,121,20,11,11,163
187746937,13,10,2,1,26
187751631,71,49,4,1,125
187761620,21,18,2,1,42
187770547,30,38,17,4,89
187770827,64,3,2,2,71
187771014,24,8,2,16,50
187772836,44,49,7,6,106
187776582,215,3,2,1,221
187785436,27,37,10,4,78
187788690,18,3,2,1,24
187820671,30,3,2,3,38
187831529,53,23,8,11,95
187832059,161,47,95,2,305
187853912,33,3,2,4,42
187855960,107,23,19,15,164
187856922,43,3,2,1,49
187870125,70,48,38,2,158
187885503,10,12,2,1,25
187890384,35,8,2,1,46
187892301,28,15,2,11,56
187902501,52,3,2,6,63
187907750,14,3,2,1,20
187910217,63,3,2,13,81
187932615,123,21,2,2,148
187933054,90,19,17,10,136
187935744,63,46,3,23,135
187938691,58,5,2,1,66
187943059,118,20,56,3,197
187943426,39,31,4,10,84
187947075,77,24,6,1,108
187958256,56,3,2,1,62
187971189,13,5,2,1,21
187978762,122,38,27,31,218
187983388,72,20,89,1,182
187985215,118,3,2,1,124
187990367,55,31,4,11,101
188007492,41,21,2,12,76
188036870,41,3,2,6,52
188037275,62,5,17,1,85
188051518,43,23,4,44,114
188064458,54,12,2,1,69
188087396,74,3,2,1,80
188098179,11,3,2,1,17
188110581,153,3,2,5,163
188117385,11,3,2,1,17
188139029,71,91,6,10,178
188156970,41,22,33,15,111
188171739,94,40,30,14,178
188187947,28,15,2,1,46
188223652,172,110,85,76,443
188253639,11,3,2,1,17
188260465,31,62,81,8,182
188275557,93,20,50,2,165
188277876,36,37,2,25,100
188281809,62,3,2,1,68
188288704,63,20,2,1,86
188288917,22,3,2,1,28
188293830,30,17,2,1,50
188294252,155,21,30,3,209
188311643,35,9,2,1,47
188318112,93,6,46,1,146
188327605,98,31,123,1,253
188332155,15,3,2,1,21
188345977,43,3,2,3,51
188350725,11,6,2,3,22
188351567,37,3,2,2,44
188354394,108,5,2,2,117
188381726,14,11,2,4,31
188382673,23,44,30,3,100
188386399,16,24,3,1,44
188389889,150,28,16,1,195
188401196,353,3,2,34,392
188401688,136,30,35,3,204
188404011,42,9,2,1,54
188408696,85,23,19,3,130
188431762,15,50,9,1,75
188438296,84,3,27,7,121
188452565,29,17,6,14,66
188453099,11,3,2,1,17
188454032,12,3,2,2,19
188469885,45,41,2,1,89
188474381,70,48,3,14,135
188482691,13,3,2,1,19
188483421,54,11,2,1,68
188489039,151,18,58,7,234
188491706,16,12,2,1,31
188507396,44,14,2,10,70
188510155,37,83,24,2,146
188517261,56,3,2,2,63
188527022,110,3,2,1,116
188530951,161,3,2,1,167
188537181,30,3,2,3,38
188547639,85,10,3,1,99
188549554,20,3,18,1,42
188557413,148,56,2,4,210
188560405,131,3,2,35,171
188562421,12,3,2,5,22
188565975,172,3,2,1,178
188567967,20,24,2,4,50
188574840,63,29,53,4,149
188582837,10,5,2,1,18
188583962,116,11,2,13,142
188590229,76,6,2,1,85
188605439,23,3,2,1,29
188609979,40,22,4,1,67
188628585,11,3,2,1,17
188637693,97,3,2,2,104
188654071,19,32,7,1,59
188665619,63,3,2,1,69
188666048,19,3,2,1,25
188677394,44,3,2,1,50
188680752,34,26,3,3,66
188681022,31,3,2,1,37
188684819,16,20,4,11,51
188697871,90,3,2,1,96
188698460,26,3,7,14,50
188710521,86,3,2,3,94
188713857,28,3,2,3,36
188731432,19,59,2,1,81
188734688,71,13,74,1,159
188736265,163,65,103,12,343
188749351,109,59,121,12,301
188751203,41,30,12,2,85
188762528,31,22,2,1,56
188768591,76,3,2,2,83
188770210,23,25,5,13,66
188775550,132,34,25,17,208
188801413,170,30,2,71,273
188827603,12,3,14,1,30
188846632,32,3,2,1,38
188863093,145,22,39,6,212
188865000,144,35,2,1,182
188865794,47,3,2,1,53
188897467,72,7,2,2,83
188921176,28,47,10,2,87
188935568,55,17,5,1,78
188940821,141,6,2,4,153
188941191,57,3,7,2,69
188971886,60,35,65,13,173
188982755,17,21,2,1,41
188991969,20,3,2,1,26
188992933,46,48,19,4,117
189007259,61,3,2,2,68
189007525,10,3,2,6,21
189016557,16,9,2,1,28
189023845,12,3,2,2,19
189026306,18,64,2,1,85
189029579,47,25,43,3,118
189029776,11,3,4,1,19
189034368,107,4,2,1,114
189041736,76,34,30,9,149
189041762,62,9,86,2,159
189043800,127,30,3,35,195
189052606,101,25,77,3,206
189054066,130,23,2,3,158
189068470,31,14,2,4,51
189070697,56,7,2,1,66
189074196,24,3,2,1,30
189086140,59,10,3,1,73
189088357,57,3,2,1,63
189097094,37,50,11,1,99
189120437,65,76,93,36,270
189121844,40,27,2,2,71
189142068,169,6,2,2,179
189143948,186,3,25,3,217
189149451,17,11,2,1,31
189153576,55,38,2,1,96
189160653,16,4,2,1,23
189162967,11,3,2,1,17
189169171,109,46,10,12,177
189177868,48,3,2,1,54
189221686,11,3,2,1,17
189225673,32,27,20,43,122
189225838,90,7,2,1,100
189237867,122,33,2,3,160
189267339,114,8,152,1,275
189269441,18,3,2,1,24
189300667,30,16,18,9,73
189301831,73,37,46,4,160
189329657,12,3,2,6,23
189334106,37,22,3,16,78
189367083,65,24,23,1,113
189371033,285,33,11,10,339
189378223,92,49,2,1,144
189381333,10,7,2,1,20
189395106,16,3,2,13,34
189417519,26,31,49,19,125
189422082,74,3,2,1,80
189452817,13,3,2,1,19
189467498,46,49,6,13,114
189476891,24,16,2,1,43
189483008,27,75,2,4,108
189486772,25,3,2,1,31
189497809,10,8,2,1,21
189504631,61,14,2,24,101
189520125,146,3,2,13,164
189527297,182,22,2,1,207
189538148,26,8,2,5,41
189555450,77,33,3,3,116
189567732,52,15,2,1,70
189576097,29,17,40,2,88
189588537,11,3,2,1,17
189590269,50,3,2,1,56
189621070,104,12,26,12,154
189622697,122,27,63,17,229
189628669,106,41,24,6,177
189631479,162,3,2,1,168
189650741,39,3,2,2,46
189664225,49,16,3,5,73
189674874,108,130,39,40,317
189676578,11,3,2,1,17
189681756,20,51,38,4,113
189702743,50,24,41,17,132
189716791,23,12,2,1,38
189719569,82,5,43,2,132
189721949,106,6,13,14,139
189745114,79,3,2,1,85
189753734,10,8,2,1,21
189758367,59,3,2,1,65
189763255,12,4,2,1,19
189778208,49,5,2,2,58
189781565,58,22,2,1,83
189785205,84,3,2,1,90
189786604,75,9,3,3,90
189792602,71,3,2,1,77
189794425,130,44,43,1,218
189829131,70,27,13,2,112
189831285,53,3,2,1,59
189846389,82,33,51,8,174
189849902,40,9,8,8,65
189882317,85,3,2,1,91
189897871,82,3,2,2,89
189926865,68,26,29,10,133
189934148,56,12,2,1,71
189935238,29,16,6,1,52
189939634,12,4,2,1,19
189951457,27,50,12,6,95
189952076,68,24,2,7,101
189965519,125,3,2,12,142
189967861,11,4,2,1,18
189970114,12,3,2,1,18
189970236,39,3,2,1,45
189971887,92,48,14,3,157
189980024,10,7,2,4,23
189980062,926,3,2,50,981
189980635,74,3,2,3,82
189988820,83,5,3,1,92
189989837,93,16,16,23,148
189990352,63,13,2,9,87
190000631,51,3,44,1,99
190011198,28,43,16,37,124
190013457,43,34,4,13,94
190016336,40,27,2,9,78
190020874,24,3,2,1,30
190023028,11,3,2,1,17
190024169,141,45,63,8,257
190024965,72,19,2,5,98
190031113,16,6,2,1,25
190032359,64,19,18,4,105
190033234,28,3,2,1,34
190033347,16,29,2,1,48
190040359,117,30,58,7,212
190055405,49,48,28,13,138
190058052,53,3,2,1,59
190064794,156,3,2,2,163
190071268,30,3,2,1,36
190102259,96,3,2,2,103
190103610,98,39,28,6,171
190110541,53,3,2,1,59
190126389,15,3,2,1,21
190127693,81,3,2,1,87
190139921,84,24,2,1,111
190150581,44,16,23,1,84
190155324,10,5,2,1,18
190155616,52,33,6,6,97
190172713,42,3,2,8,55
190182691,16,3,2,1,22
190190196,83,3,2,1,89
190198011,86,9,5,8,108
190218304,111,60,2,106,279
190225387,16,14,2,2,34
190227239,74,6,3,5,88
190248742,704,3,2,27,736
190254104,192,10,3,6,211
190257074,12,3,2,1,18
190264173,121,9,2,7,139
190264376,12,3,2,1,18
190266003,158,3,2,1,164
190281851,26,3,2,1,32
190283228,134,25,2,3,164
190304485,31,22,22,1,76
190313030,60,3,2,8,73
190316307,93,45,10,1,149
190317114,30,55,4,3,92
190334862,131,26,2,10,169
190337553,69,3,2,1,75
190343171,60,3,2,10,75
190346348,22,3,2,1,28
190351908,136,3,2,7,148
190352453,116,5,2,1,124
190355259,24,3,2,1,30
190361641,11,10,2,1,24
190365372,35,3,2,1,41
190377072,71,3,2,1,77
190383968,35,3,2,11,51
190385905,21,5,2,1,29
190389956,131,35,2,13,181
190434938,101,48,24,4,177
190456680,109,34,30,2,175
190462328,135,14,34,1,184
190489027,42,25,8,3,78
190492322,10,5,2,1,18
190494468,54,3,2,1,60
190501981,68,65,49,1,183
190504001,10,5,2,1,18
190505433,17,8,2,4,31
190522637,121,11,2,1,135
190535029,31,19,5,2,57
190543809,18,23,2,49,92
190555807,80,10,2,1,93
190560513,27,3,2,1,33
190571998,43,29,17,1,90
190583654,12,58,2,1,73
190589623,135,97,132,26,390
190591103,56,3,2,1,62
190592101,20,7,2,1,30
190607798,11,4,10,1,26
190629133,310,29,2,18,359
190636484,31,21,2,5,59
190659274,136,3,23,11,173
190659618,54,13,2,11,80
190659733,66,9,3,11,89
190668461,40,20,2,1,63
190670205,85,28,23,4,140
190697448,11,3,2,1,17
190698332,178,3,2,6,189
190708341,51,15,2,4,72
190714521,243,72,59,13,387
190737300,131,49,11,4,195
190747541,10,6,2,1,19
190747726,39,13,2,1,55
190755523,20,3,2,1,26
190759430,10,3,2,9,24
190780145,89,3,2,1,95
190783046,62,3,2,1,68
190796650,17,15,2,2,36
190800100,50,73,37,4,164
190807676,78,3,2,1,84
190813721,49,3,2,1,55
190819849,65,35,2,5,107
190824797,15,27,2,5,49
190827340,68,5,2,1,76
190829311,65,4,2,1,72
190839554,20,3,2,1,26
190839653,73,3,2,1,79
190844833,100,15,2,1,118
190847690,25,3,2,1,31
190858284,60,3,2,1,66
190858567,225,51,2,7,285
190860082,33,19,2,1,55
190871455,20,3,2,1,26
190872395,70,4,4,6,84
190876710,61,29,2,5,97
190905058,23,3,2,3,31
190915924,28,21,5,5,59
190921143,98,3,2,1,104
190924231,33,6,3,3,45
190947470,14,3,2,1,20
190949116,74,28,27,6,135
190959841,183,69,2,8,262
190962042,64,28,18,11,121
190975633,41,8,3,1,53
190984152,95,32,18,19,164
190995336,81,64,40,2,187
190995356,19,38,2,1,60
190996276,43,3,2,2,50
191004075,209,11,2,2,224
191022355,189,3,20,1,213
191023381,70,8,12,1,91
191039777,148,74,13,6,241
191041221,63,3,2,1,69
191054444,33,36,55,1,125
191079289,81,29,38,1,149
191079641,56,19,7,16,98
191101443,77,3,2,1,83
191112354,108,3,20,3,134
191127976,37,63,2,2,104
191129623,53,28,15,2,98
191133229,63,21,2,1,87
191134235,126,18,20,1,165
191149019,41,3,2,1,47
191157373,33,72,3,1,109
191158862,28,32,16,2,78
191161399,185,37,4,11,237
191183731,10,30,2,1,43
191185562,114,3,2,1,120
191193507,121,55,59,4,239
191197717,130,13,2,2,147
191210589,53,57,36,24,170
191214943,95,18,22,15,150
191225810,59,48,9,29,145
191241894,10,9,2,1,22
191244383,83,50,3,3,139
191249691,41,42,2,1,86
191251370,142,3,2,5,152
191258510,17,3,2,1,23
191261091,202,5,2,5,214
191269411,28,3,4,2,37
191276595,192,37,49,4,282
191297088,175,22,12,1,210
191301385,17,3,2,1,23
191327508,12,3,2,1,18
191329084,76,14,18,1,109
191340746,68,3,2,1,74
191345133,60,3,2,1,66
191349881,29,7,2,1,39
191364404,32,44,5,2,83
191364714,42,46,21,3,112
191371130,11,3,2,1,17
191376157,112,28,13,24,177
191382900,93,28,31,27,179
191388326,169,49,31,21,270
191389112,120,28,36,9,193
191401583,141,3,2,1,147
191402353,163,10,32,4,209
191404500,30,26,3,6,65
191405994,108,18,2,9,137
191416880,39,21,6,15,81
191416983,67,58,2,2,129
191428570,22,33,69,1,125
191435766,38,13,12,8,71
191452678,19,19,4,1,43
191464917,149,3,2,1,155
191477444,12,3,2,1,18
191523094,246,26,84,3,359
191527589,62,13,14,30,119
191530483,14,9,4,4,31
191533777,10,14,2,1,27
191539034,101,41,132,104,378
191556417,16,5,2,14,37
191575327,46,12,22,2,82
191589353,21,7,2,4,34
191593162,81,13,13,1,108
191596832,15,3,2,2,22
191617658,104,31,67,4,206
191619751,42,8,7,13,70
191631681,57,3,2,1,63
191643240,69,21,2,20,112
191663162,12,3,2,1,18
191675047,42,11,20,1,74
191680049,20,3,2,1,26
191693097,32,18,11,1,62
191739679,30,3,2,1,36
191740078,47,3,2,1,53
191745499,42,3,2,1,48
191757797,11,6,2,3,22
191785571,288,15,2,14,319
191795101,69,36,3,3,111
191799001,26,47,33,11,117
191817395,18,3,2,3,26
191858408,15,3,2,1,21
191868000,17,3,2,1,23
191876161,134,10,124,25,293
191891116,48,4,2,1,55
191899752,168,3,9,3,183
191908484,27,10,42,1,80
191958693,19,3,2,1,25
191972684,127,3,2,39,171
191983400,22,43,6,11,82
191997429,10,44,2,7,63
192000403,54,38,8,13,113
192001909,11,4,2,1,18
192027185,19,3,2,1,25
192030656,179,20,20,6,225
192030831,48,31,16,2,97
192050693,105,3,2,2,112
192071125,65,3,2,1,71
192078494,147,4,13,27,191
192142600,24,34,5,4,67
192147579,140,64,66,38,308
192148191,456,3,2,4,465
192149663,35,3,2,2,42
192156020,60,23,39,1,123
192156988,17,28,4,6,55
192161226,42,3,2,1,48
192170317,38,27,2,6,73
192192585,51,46,2,3,102
192226119,32,26,8,1,67
192231591,78,26,37,8,149
192234687,139,9,2,9,159
192244494,45,7,2,6,60
192271166,53,3,2,2,60
192273482,11,13,6,1,31
192281417,71,3,2,2,78
192283843,53,27,2,1,83
192296859,71,10,2,10,93
192315795,61,3,2,4,70
192334710,20,3,3,6,32
192358007,48,3,2,40,93
192361801,63,31,3,52,149
192368590,50,3,2,1,56
192370069,39,12,2,2,55
192379359,29,3,2,1,35
192380433,32,6,2,1,41
192386866,61,25,7,19,112
192388122,49,8,2,9,68
192388299,128,26,20,10,184
192389541,14,12,2,2,30
192397038,19,3,2,4,28
192397332,22,61,34,1,118
192413699,60,41,51,6,158
192424300,172,14,2,1,189
192433188,62,16,64,62,204
192438495,42,3,2,2,49
192438790,16,6,2,1,25
192447930,14,3,2,1,20
192458598,95,3,2,16,116
192477628,16,3,2,1,22
192478152,14,16,2,1,33
192485058,107,63,2,26,198
192487408,61,3,2,2,68
192492679,119,7,2,1,129
192511290,55,7,6,1,69
192517340,183,7,20,4,214
192519231,16,3,2,2,23
192527844,76,34,128,23,261
192533971,113,3,2,1,119
192538432,29,3,2,1,35
192560492,156,3,2,1,162
192577405,23,3,2,1,29
192588839,39,25,8,3,75
192603261,29,3,2,1,35
192608237,26,29,5,1,61
192612565,13,3,2,1,19
192627004,41,33,2,5,81
192635000,13,6,2,1,22
192639184,125,69,48,62,304
192646586,16,3,2,1,22
192651310,38,21,2,3,64
192685501,23,49,13,38,123
192687201,11,12,2,1,26
192688303,118,10,2,3,133
192696777,12,24,2,1,39
192696928,25,45,11,5,86
192704480,59,37,2,8,106
192705364,70,21,2,2,95
192727665,14,3,2,1,20
192740098,23,45,23,21,112
192746366,144,8,6,8,166
192756711,86,3,2,4,95
192757015,112,3,2,1,118
192777013,76,5,36,1,118
192784392,50,9,2,1,62
192796727,22,35,8,2,67
192801699,33,30,18,8,89
192803487,23,43,2,2,70
192813302,88,21,2,18,129
192834307,114,26,52,62,254
192838380,45,5,3,2,55
192843392,19,47,35,1,102
192853547,12,3,2,3,20
192855111,10,26,2,3,41
192861117,21,3,2,1,27
192871354,81,73,91,9,254
192876650,37,3,2,4,46
192883215,18,3,2,2,25
192912469,63,5,2,4,74
192920009,178,24,105,1,308
192920846,74,47,45,3,169
192924403,16,3,2,3,24
192926962,98,35,12,8,153
192930778,117,35,39,7,198
192939052,10,6,2,1,19
192942880,46,55,3,2,106
192959076,90,48,60,21,219
192960268,109,21,27,1,158
192965142,115,3,2,11,131
192979427,47,20,42,1,110
192981651,133,32,14,41,220
192984710,52,27,5,3,87
193003907,83,11,62,4,160
193015058,70,28,7,37,142
193021276,48,3,2,1,54
193028621,102,39,50,31,222
193039696,74,8,2,1,85
193042246,84,3,2,1,90
193051679,63,8,2,5,78
193051761,58,3,2,5,68
193053591,103,15,2,1,121
193066813,28,10,2,2,42
193081255,62,16,3,6,87
193085031,109,8,7,6,130
193114007,33,3,2,6,44
193125172,10,19,2,1,32
193157239,136,24,2,5,167
193158594,159,46,13,8,226
193171193,33,31,2,2,68
193172103,91,29,31,1,152
193172379,60,3,2,7,72
193180589,85,42,80,11,218
193194537,32,41,52,2,127
193196490,126,3,2,1,132
193197556,34,5,2,1,42
193198240,36,3,6,1,46
193201520,102,38,13,1,154
193211421,42,15,20,1,78
193211614,139,18,19,1,177
193212099,38,3,2,1,44
193218603,29,3,2,1,35
193222193,393,3,2,3,401
193236977,13,3,2,1,19
193245322,44,6,35,18,103
193254705,43,117,12,23,195
193272768,32,28,14,2,76
193282847,82,18,2,4,106
193287124,100,62,2,3,167
193311604,80,31,4,1,116
193319932,20,3,2,1,26
193327593,44,10,3,7,64
193327800,111,21,41,1,174
193335203,10,4,2,2,18
193348610,256,12,5,14,287
193364584,48,17,34,1,100
193365988,10,6,2,1,19
193368662,49,25,3,19,96
193376791,62,28,2,4,96
193401300,147,3,2,5,157
193419148,59,29,46,3,137
193428275,17,3,15,20,55
193431021,92,22,29,1,144
193434426,19,3,2,1,25
193450876,19,3,2,1,25
193452927,67,24,7,2,100
193452989,94,18,4,6,122
193466350,192,3,2,3,200
193471238,13,31,2,1,47
193474799,149,3,2,1,155
193475669,13,3,2,1,19
193479125,112,8,54,11,185
193482954,19,8,4,3,34
193489878,36,17,2,1,56
193500309,14,8,2,1,25
193511031,22,3,2,3,30
193521239,62,16,2,3,83
193545723,47,13,2,3,65
193548123,13,19,2,3,37
193549002,98,60,45,47,250
193554934,84,11,11,1,107
193560561,53,29,6,5,93
193586543,70,3,2,2,77
193596405,83,14,2,1,100
193597560,178,86,11,30,305
193597864,105,73,30,1,209
193612176,126,14,2,2,144
193616702,34,12,2,1,49
193617040,48,3,2,1,54
193624717,12,19,2,1,34
193669202,14,26,2,1,43
193703475,68,51,2,51,172
193718122,65,38,64,2,169
193721495,10,11,2,1,24
193726687,81,49,25,79,234
193740961,131,69,81,13,294
193751688,198,8,2,6,214
193752151,17,4,8,2,31
193755965,128,15,2,3,148
193772712,111,4,2,16,133
193779816,11,5,2,1,19
193782440,174,54,19,3,250
193785890,67,9,3,1,80
193787527,74,14,34,19,141
193789405,25,3,2,3,33
193796754,157,18,3,1,179
193801378,181,49,2,2,234
193823857,71,3,2,1,77
193826604,129,35,101,1,266
193828626,75,115,25,3,218
193846564,73,41,6,1,121
193869813,31,3,2,3,39
193875916,11,3,2,1,17
193897125,119,20,2,1,142
193912372,60,3,2,3,68
193917471,50,3,2,1,56
193920512,84,8,4,1,97
193921509,18,21,25,1,65
193928629,74,3,2,3,82
193940080,132,3,2,1,138
193943196,39,3,2,1,45
193943640,126,5,2,7,140
193947910,83,20,2,13,118
193952346,184,75,38,7,304
193969863,60,20,2,2,84
193980276,20,3,2,13,38
193981440,83,3,2,20,108
193988269,36,3,2,9,50
193989002,82,23,2,1,108
194000964,60,11,2,10,83
194005542,44,10,2,2,58
194017795,32,8,13,8,61
194050367,149,3,2,2,156
194066906,76,16,18,1,111
194078773,66,10,2,6,84
194097560,87,3,19,11,120
194116563,105,14,2,1,122
194127703,29,3,2,3,37
194144579,104,3,2,7,116
194160197,63,31,12,21,127
194176049,47,21,11,23,102
194177778,86,7,118,10,221
194195532,127,39,3,3,172
194223571,484,19,3,9,515
194227484,47,3,2,1,53
194228557,14,3,2,1,20
194254355,81,4,119,15,219
194259256,11,3,2,1,17
194282190,35,17,26,2,80
194283720,54,17,24,6,101
194293995,59,3,2,4,68
194301786,120,3,2,1,126
194302700,44,6,19,8,77
194310408,25,5,2,4,36
194314262,11,3,2,1,17
194332375,10,11,2,1,24
194337954,41,15,11,5,72
194361786,315,3,2,18,338
194363411,299,57,2,1,359
194388702,194,48,3,10,255
194410017,169,30,92,14,305
194434530,78,25,2,7,112
194435728,106,3,2,1,112
194486072,44,3,2,2,51
194492898,12,3,2,1,18
194495794,93,19,2,10,124
194504145,80,14,2,3,99
194532342,154,41,115,1,311
194534886,38,11,2,2,53
194539118,28,33,15,5,81
194541955,20,44,3,1,68
194562112,23,47,2,1,73
194583314,25,3,2,1,31
194588592,93,6,4,8,111
194591689,13,19,2,3,37
194600434,16,3,2,1,22
194604498,24,3,2,4,33
194608721,11,35,2,1,49
194623834,23,4,2,3,32
194631512,77,4,2,3,86
194640583,58,51,19,14,142
194640627,69,3,2,6,80
194653656,182,21,2,5,210
194661453,12,3,2,1,18
194666277,93,17,2,2,114
194673200,53,14,48,19,134
194678178,98,29,51,5,183
194680591,64,32,2,1,99
194687350,68,17,8,3,96
194692273,37,3,2,5,47
194698500,40,3,2,1,46
194703671,52,23,13,6,94
194731737,156,56,4,4,220
194737700,19,3,2,1,25
194746472,38,22,15,13,88
194751172,190,4,3,11,208
194763103,44,26,26,7,103
194763227,16,7,11,1,35
194764534,62,23,5,11,101
194767427,125,3,2,1,131
194771819,37,4,20,2,63
194780201,53,3,2,1,59
194783972,37,13,61,1,112
194798322,104,55,61,21,241
194799585,26,3,2,1,32
194799785,257,3,46,3,309
194803221,10,5,2,1,18
194808183,36,12,2,1,51
194813280,46,3,2,1,52
194814744,22,7,24,1,54
194821200,93,35,2,7,137
194835555,10,43,2,3,58
194840643,60,76,41,1,178
194859857,32,34,2,1,69
194860561,164,18,76,21,279
194863007,74,15,2,35,126
194889771,37,3,2,3,45
194893338,17,40,2,2,61
194911479,77,53,2,13,145
194935864,84,26,2,9,121
194939581,156,51,45,38,290
194939834,21,6,2,2,31
194942905,57,14,2,4,77
194947668,11,3,2,1,17
194956091,37,4,2,1,44
194959682,178,53,6,5,242
194968229,66,61,2,1,130
194970045,233,95,29,33,390
194991930,46,6,2,2,56
195009503,32,3,2,1,38
195023872,40,62,68,57,227
195028921,23,8,2,1,34
195039130,105,3,2,1,111
195055622,32,10,12,1,55
195071602,11,27,2,3,43
195081742,51,28,36,20,135
195083148,90,10,5,1,106
195087514,133,32,45,30,240
195089904,49,11,11,8,79
195092239,13,3,2,1,19
195092945,46,3,2,3,54
195113971,163,31,32,34,260
195114131,32,46,12,2,92
195140733,45,12,16,15,88
195171009,19,3,2,1,25
195174099,128,8,11,20,167
195176961,44,3,2,1,50
195195452,11,5,2,1,19
195202870,88,25,2,1,116
195210963,63,13,2,10,88
195214737,37,12,62,1,112
195221252,78,7,2,1,88
195234280,276,29,2,1,308
195239085,168,9,4,32,213
195248025,210,19,2,18,249
195257230,10,20,2,1,33
195280389,50,10,2,12,74
195286971,29,20,4,1,54
195290642,61,3,2,1,67
195291675,80,3,2,1,86
195344911,85,17,33,26,161
195345055,120,3,5,14,142
195347753,69,3,2,1,75
195347890,68,22,11,3,104
195350365,189,3,2,3,197
195367632,45,26,2,7,80
195378518,97,11,71,2,181
195402160,26,5,2,1,34
195404990,182,26,87,28,323
195409600,10,3,2,3,18
195410407,22,22,2,1,47
195412169,17,20,23,4,64
195421562,69,54,16,75,214
195428196,64,57,57,2,180
195432492,106,3,2,1,112
195445690,78,14,9,15,116
195449871,39,17,20,26,102
195453805,175,3,2,1,181
195456061,89,3,2,1,95
195458830,46,19,5,1,71
195488040,19,23,2,1,45
195488686,77,12,2,1,92
195531227,10,30,2,1,43
195535449,225,43,2,3,273
195537439,65,4,20,1,90
195546825,49,44,7,1,101
195564808,14,30,2,6,52
195571268,106,25,44,1,176
195579372,193,3,2,3,201
195597821,17,9,2,1,29
195609181,97,19,2,4,122
195623982,94,21,52,44,211
195633219,20,6,2,9,37
195633784,56,33,4,2,95
195633814,61,3,10,2,76
195636148,38,3,2,11,54
195657200,51,3,2,1,57
195662748,96,18,13,3,130
195666127,13,3,2,1,19
195668054,90,3,2,6,101
195675834,21,18,2,7,48
195684402,11,3,2,1,17
195689288,11,3,2,1,17
195696313,12,13,2,1,28
195696828,157,3,2,1,163
195715928,87,3,2,1,93
195719010,168,31,37,3,239
195719075,98,3,2,4,107
195724638,13,11,5,1,30
195726406,52,21,45,41,159
195743234,39,22,2,1,64
195745121,28,4,2,1,35
195769213,15,7,2,1,25
195770779,27,3,2,1,33
195770968,18,9,2,1,30
195784691,24,7,11,11,53
195800379,85,25,50,35,195
195815304,52,47,22,2,123
195830446,35,17,2,1,55
195847694,140,23,67,12,242
195851181,64,24,32,29,149
195861117,103,5,46,6,160
195877866,52,22,31,7,112
195922473,116,3,2,9,130
195933107,55,3,60,1,119
195940070,33,29,15,43,120
195948187,89,53,48,65,255
195957174,41,5,2,1,49
195971047,22,3,2,2,29
195980094,135,38,9,27,209
195982314,73,3,2,9,87
195987305,19,3,2,4,28
196000138,37,26,2,1,66
196005243,10,5,2,1,18
196007777,81,19,25,1,126
196033819,50,3,2,6,61
196039685,17,3,2,1,23
196044997,195,103,2,35,335
196071255,16,6,2,1,25
196078174,132,25,2,7,166
196105871,101,40,3,3,147
196108373,11,3,2,1,17
196131269,20,3,2,1,26
196148115,78,24,2,1,105
196176934,32,82,22,4,140
196185405,112,10,19,4,145
196188150,25,3,2,3,33
196204848,28,32,4,8,72
196231286,31,3,11,1,46
196234637,22,6,8,5,41
196235192,12,26,2,1,41
196261357,99,3,2,1,105
196262611,60,37,36,9,142
196299561,55,13,2,1,71
196317829,33,8,2,1,44
196327301,113,19,2,9,143
196327785,26,3,2,5,36
196338362,124,55,94,18,291
196344369,11,3,2,3,19
196350289,261,3,2,1,267
196354622,22,3,2,1,28
196375028,10,18,2,1,31
196386710,12,3,2,1,18
196410406,201,4,99,32,336
196412539,42,26,7,4,79
196422089,59,3,2,4,68
196428930,26,4,2,30,62
196429826,32,44,2,1,79
196435647,163,9,3,3,178
196439384,37,41,24,10,112
196450643,76,19,9,8,112
196457177,39,18,7,36,100
196457809,66,12,37,8,123
196461622,35,3,2,1,41
196464689,21,3,2,1,27
196470764,54,25,85,1,165
196474081,73,37,36,10,156
196488478,27,23,8,1,59
196490150,81,43,36,74,234
196496959,31,18,2,4,55
196501069,39,14,12,15,80
196523998,82,40,11,5,138
196524027,49,3,2,1,55
196527802,12,5,2,1,20
196528446,48,3,2,5,58
196534057,17,4,2,1,24
196555239,11,11,8,1,31
196572952,73,60,6,10,149
196575860,31,30,2,1,64
196581750,42,7,2,6,57
196585227,44,11,2,59,116
196596145,42,3,2,9,56
196609318,11,13,2,1,27
196611340,13,28,2,1,44
196611820,53,37,19,46,155
196613611,71,31,2,3,107
196619486,43,30,28,28,129
196630043,18,15,16,3,52
196633389,90,22,16,1,129
196635702,122,3,9,4,138
196637434,59,62,2,2,125
196656972,54,19,37,9,119
196657319,79,3,2,1,85
196679251,21,3,2,1,27
196691485,131,12,31,15,189
196692512,19,3,2,1,25
196700415,57,8,12,2,79
196702096,28,45,2,1,76
196713524,70,38,2,5,115
196715334,10,92,2,2,106
196719745,11,10,2,1,24
196725628,55,3,2,1,61
196778277,73,76,132,9,290
196799276,86,20,18,3,127
196805177,60,62,2,1,125
196815722,59,12,7,6,84
196822541,24,41,19,1,85
196831943,20,30,2,1,53
196832487,35,11,2,1,49
196848097,90,53,14,1,158
196857790,28,12,10,1,51
196870064,82,30,17,4,133
196883622,29,21,11,1,62
196898680,34,16,2,1,53
196908399,71,5,2,3,81
196908679,109,11,4,9,133
196914984,17,17,17,1,52
196918244,62,8,2,1,73
196926092,53,9,65,4,131
196937803,12,3,2,14,31
196948064,53,7,3,5,68
196955565,10,5,2,1,18
196961609,167,59,15,1,242
196964310,29,3,2,4,38
196968043,27,3,2,8,40
196978755,39,3,2,1,45
196989497,57,75,22,17,171
196994253,196,35,41,6,278
197003896,115,3,2,16,136
197040151,53,3,2,1,59
197046497,112,19,51,63,245
197048867,104,3,2,1,110
197052870,13,3,2,1,19
197064501,120,17,8,5,150
197078365,13,27,2,1,43
197081645,18,3,2,1,24
197109709,71,31,26,9,137
197119871,31,10,21,5,67
197122277,95,3,2,1,101
197155002,21,27,10,15,73
197156136,53,15,7,9,84
197158625,15,10,2,1,28
197164111,127,24,4,19,174
197167364,32,35,2,1,70
197175729,13,7,2,1,23
197176457,64,47,14,33,158
197178566,34,15,33,1,83
197191315,11,7,2,1,21
197191617,146,14,9,3,172
197194761,13,5,2,2,22
197207652,142,39,14,33,228
197225905,43,14,10,5,72
197248124,81,34,2,14,131
197266346,65,12,3,16,96
197275155,16,52,2,1,71
197278520,53,74,3,45,175
197283762,197,3,2,3,205
197284861,110,4,9,7,130
197287832,182,28,28,6,244
197304486,206,24,12,9,251
197318872,49,3,2,1,55
197338338,11,3,2,1,17
197343140,33,32,19,2,86
197361614,100,20,2,3,125
197363489,44,12,2,1,59
197371951,156,17,9,3,185
197384544,166,36,30,20,252
197388118,103,3,2,5,113
197392783,174,27,15,13,229
197415871,89,22,15,7,133
197426269,30,3,2,1,36
197434345,24,3,2,1,30
197455620,35,35,58,1,129
197462703,64,3,2,1,70
197474397,43,3,2,1,49
197495284,71,26,2,1,100
197502002,29,3,2,2,36
197506723,18,3,2,1,24
197512223,58,41,24,7,130
197512868,31,40,7,10,88
197548667,100,17,40,3,160
197552345,19,20,12,24,75
197555544,74,3,2,1,80
197583544,112,4,19,17,152
197587489,168,15,3,16,202
197593759,15,3,2,1,21
197595007,14,6,2,3,25
197597786,31,29,3,1,64
197599072,10,5,2,1,18
197600074,34,24,2,2,62
197617648,35,3,2,1,41
197624987,102,7,2,2,113
197636825,38,63,2,16,119
197645699,102,3,2,1,108
197663741,26,8,2,1,37
197671490,30,9,2,41,82
197674553,13,3,2,1,19
197689192,160,3,2,8,173
197705692,364,33,26,22,445
197722317,62,3,2,5,72
197734684,100,3,2,2,107
197734981,68,51,55,3,177
197745124,89,20,100,36,245
197754058,160,48,2,12,222
197765219,145,3,2,1,151
197784232,30,3,2,1,36
197799458,45,3,2,1,51
197818478,11,3,2,1,17
197828574,218,73,76,11,378
197862064,11,3,2,1,17
197864590,16,9,2,1,28
197870749,16,14,2,7,39
197871109,42,16,4,1,63
197876676,32,12,2,20,66
197883357,174,45,36,7,262
197889316,40,3,2,3,48
197903432,48,26,5,12,91
197921356,40,70,55,13,178
197924690,23,3,2,1,29
197931622,78,14,12,5,109
197962628,14,43,2,5,64
197967031,13,15,2,2,32
197976534,15,30,2,1,48
197978846,10,6,2,1,19
197981953,10,34,2,1,47
197982847,18,49,2,1,70
197996239,30,17,16,18,81
198003400,96,23,33,9,161
198011541,203,79,7,2,291
198011637,17,3,2,3,25
198014912,69,39,2,11,121
198057331,30,3,2,1,36
198071189,31,22,4,42,99
198071932,25,20,12,2,59
198077475,144,24,35,9,212
198083435,18,3,2,1,24
198098705,46,23,37,1,107
198128499,121,38,10,41,210
198131706,108,9,5,1,123
198133219,31,23,7,1,62
198135074,71,5,10,6,92
198139662,39,46,18,2,105
198157538,33,31,14,8,86
198175701,11,4,2,1,18
198177376,35,3,2,1,41
198179437,19,3,2,1,25
198196496,14,3,2,3,22
198219029,65,54,38,3,160
198224575,25,16,2,4,47
198226589,46,33,14,32,125
198241504,11,3,2,1,17
198247028,104,3,2,2,111
198254007,64,3,2,1,70
198257084,83,25,2,1,111
198262869,193,37,13,6,249
198265880,62,19,64,16,161
198268115,122,31,60,1,214
198274599,129,28,3,2,162
198275690,30,21,2,14,67
198283484,50,32,2,3,87
198288780,25,8,2,5,40
198319209,61,21,15,1,98
198324038,10,37,2,7,56
198328555,26,46,19,35,126
198345820,13,15,13,1,42
198380072,79,14,2,5,100
198382401,91,10,11,1,113
198389307,170,3,2,1,176
198391798,104,3,2,3,112
198394143,26,35,7,5,73
198405385,35,3,3,2,43
198407502,63,32,8,7,110
198408434,16,13,8,2,39
198423691,78,77,8,15,178
198425150,17,13,2,1,33
198426462,142,5,2,2,151
198432683,19,3,2,1,25
198437227,32,13,4,1,50
198448855,19,4,2,1,26
198452326,31,3,2,1,37
198453451,120,53,91,55,319
198458408,20,3,2,1,26
198465757,73,11,3,1,88
198470712,15,15,2,1,33
198477840,92,3,2,1,98
198488033,38,3,2,9,52
198497106,20,13,2,1,36
198497230,54,3,2,1,60
198515664,18,27,3,1,49
198522428,21,3,2,1,27
198539104,50,38,5,7,100
198556976,59,3,2,1,65
198567285,10,48,2,1,61
198572904,31,3,2,10,46
198573618,11,10,2,1,24
198581912,76,35,59,7,177
198592065,58,3,2,1,64
198602203,41,37,4,2,84
198622869,10,4,2,1,17
198630031,220,44,43,1,308
198641685,206,47,18,40,311
198645442,184,32,15,1,232
198659389,155,3,2,1,161
198665474,33,8,2,1,44
198665663,10,3,2,2,17
198678211,126,21,12,24,183
198682611,21,34,2,1,58
198685738,13,3,2,1,19
198689138,88,30,40,20,178
198693590,57,23,2,2,84
198693629,58,34,11,7,110
198712994,72,21,2,6,101
198727771,80,54,61,12,207
198737667,14,9,2,1,26
198742131,14,37,2,1,54
198744409,158,30,4,13,205
198763020,68,3,2,1,74
198766433,18,3,2,3,26
198767072,55,24,16,37,132
198775880,49,3,2,4,58
198776362,30,55,5,2,92
198813108,101,27,34,25,187
198825429,53,8,3,9,73
198832180,14,3,2,1,20
198833937,14,41,2,1,58
198878569,36,11,2,1,50
198880375,38,59,20,2,119
198886775,49,3,2,4,58
198889741,58,3,2,1,64
198896434,71,17,3,3,94
198903354,16,39,2,1,58
198928278,62,39,6,13,120
198929479,57,21,61,1,140
198932438,121,3,2,13,139
198933094,18,17,2,6,43
198959062,92,16,28,20,156
198988702,38,33,2,1,74
198996308,114,3,2,2,121
199001961,19,3,2,3,27
199004051,49,7,2,7,65
199008892,10,6,2,2,20
199010125,15,9,2,1,27
199013781,35,11,2,1,49
199021729,83,11,81,4,179
199040876,158,29,2,1,190
199040982,139,26,5,5,175
199041597,30,3,2,5,40
199042113,29,3,2,1,35
199055355,36,3,2,1,42
199070037,57,29,22,6,114
199072379,71,28,5,1,105
199077826,68,18,2,2,90
199114875,150,12,9,4,175
199116561,32,23,12,2,69
199118102,60,3,2,2,67
199122966,30,17,7,1,55
199135534,162,40,61,35,298
199155775,29,17,5,17,68
199197894,72,23,5,11,111
199204960,93,8,13,1,115
199205515,71,21,84,27,203
199214147,70,13,32,12,127
199215324,103,9,33,3,148
199251899,163,49,3,18,233
199265033,15,7,8,1,31
199268587,80,36,26,6,148
199310867,63,40,5,2,110
199315091,93,28,21,1,143
199321598,83,13,2,5,103
199322678,98,3,2,5,108
199333562,101,9,20,1,131
199335802,75,23,44,42,184
199339330,40,14,9,4,67
199342258,12,3,2,1,18
199343445,21,5,2,5,33
199344671,57,9,30,8,104
199347284,11,10,2,1,24
199350676,13,3,2,1,19
199352949,162,68,31,22,283
199355924,34,32,21,3,90
199374144,58,5,3,5,71
199377530,10,5,2,1,18
199403893,13,5,2,3,23
199411017,19,15,2,1,37
199411785,130,22,36,11,199
199419820,15,3,2,1,21
199423308,174,44,39,9,266
199438797,19,3,2,1,25
199441902,39,51,38,2,130
199452956,43,30,2,8,83
199454396,11,3,2,1,17
199456300,11,3,2,1,17
199470856,28,19,68,1,116
199477606,23,54,2,4,83
199477886,43,3,2,2,50
199482855,27,20,2,1,50
199503403,88,3,2,1,94
199504695,10,37,23,3,73
199509842,167,5,2,1,175
199514795,34,14,2,1,51
199517225,44,3,2,1,50
199517693,51,11,6,3,71
199524536,51,5,8,2,66
199549190,14,7,2,1,24
199550070,104,44,22,5,175
199552354,72,55,31,9,167
199553141,87,4,2,1,94
199553475,10,7,2,1,20
199554533,46,27,42,26,141
199582821,62,49,8,5,124
199585439,138,4,23,1,166
199603886,17,3,2,1,23
199610139,16,3,2,2,23
199629393,122,16,34,5,177
199640194,120,12,3,1,136
199652206,12,10,2,2,26
199654068,101,12,6,4,123
199659565,27,19,3,6,55
199663479,43,25,17,29,114
199665144,11,3,2,2,18
199667683,14,3,2,1,20
199667811,178,22,13,21,234
199684627,67,7,2,1,77
199703112,57,3,2,2,64
199707706,16,6,2,1,25
199719329,39,17,2,1,59
199723801,12,4,2,1,19
199726070,29,3,2,1,35
199744815,40,66,31,9,146
199784074,19,14,2,1,36
199787002,34,30,2,2,68
199794341,57,4,2,46,109
199801844,41,40,2,12,95
199802314,110,3,2,1,116
199811819,194,89,85,7,375
199812707,19,3,2,1,25
199815936,34,26,5,16,81
199820748,25,52,7,3,87
199826684,12,13,2,2,29
199833494,226,3,2,4,235
199833963,138,38,13,5,194
199845160,31,27,43,1,102
199854087,198,29,30,2,259
199876964,73,19,92,2,186
199885270,61,8,4,1,74
199886108,45,9,14,1,69
199896395,33,82,58,79,252
199900115,26,3,2,1,32
199906111,178,24,2,1,205
199907998,11,3,2,1,17
199910426,51,3,2,2,58
199915334,22,3,2,4,31
199917366,128,33,2,1,164
199930363,21,12,2,1,36
199945386,36,3,2,1,42
199946858,81,41,35,8,165
199967134,147,3,14,1,165
199970709,27,3,2,1,33
199990559,181,24,41,17,263
199991221,10,6,2,1,19
199993401,72,18,55,32,177
199994581,90,26,22,5,143
200000578,142,3,2,1,148
200005943,12,3,2,1,18
200010960,10,9,2,1,22
200021116,67,17,2,5,91
200027811,41,3,2,1,47
200037417,18,5,2,1,26
200045693,39,11,2,1,53
200055116,66,32,21,12,131
200060468,86,66,44,13,209
200075269,50,16,2,4,72
200088840,84,6,4,4,98
200088868,80,32,46,22,180
200102818,13,3,2,1,19
200106605,111,4,2,1,118
200112509,141,43,56,1,241
200113644,99,7,11,1,118
200119298,39,40,18,6,103
200121475,69,12,2,3,86
200126072,77,3,2,6,88
200139800,29,11,2,1,43
200140581,374,21,3,33,431
200143058,101,39,2,49,191
200145607,12,27,2,1,42
200146152,38,47,67,35,187
200158943,98,11,2,1,112
200160593,20,21,2,1,44
200171381,17,38,2,1,58
200176996,71,3,2,2,78
200204367,23,3,2,2,30
200205173,34,29,15,3,81
200225944,22,3,2,1,28
200233241,73,6,5,8,92
200246711,19,3,2,1,25
200247072,22,20,2,3,47
200247080,36,24,19,10,89
200262594,46,14,14,3,77
200275816,33,3,2,1,39
200278089,59,41,2,15,117
200279254,135,3,2,5,145
200300056,11,3,2,1,17
200301504,85,29,76,5,195
200327543,83,3,2,1,89
200330439,57,99,11,98,265
200333447,30,62,3,1,96
200334762,115,9,10,10,144
200351893,28,3,2,1,34
200353515,13,3,2,2,20
200370388,69,83,52,5,209
200375489,31,21,2,5,59
200376910,241,3,2,2,248
200377491,10,3,2,2,17
200385560,13,3,2,1,19
200405939,42,3,2,1,48
200406153,30,45,17,26,118
200417391,83,3,2,1,89
200438498,12,3,2,1,18
200440585,12,3,2,1,18
200445375,20,3,2,2,27
200446214,132,68,36,11,247
200452269,26,23,4,7,60
200469738,11,3,2,1,17
200500336,36,24,3,21,84
200507297,32,3,2,17,54
200508605,55,4,2,1,62
200520593,16,3,2,1,22
200522142,104,42,99,2,247
200526183,60,26,15,9,110
200533117,133,7,3,9,152
200537510,13,8,2,1,24
200539980,145,3,2,2,152
200543821,108,3,2,5,118
200545645,180,84,38,3,305
200563509,60,14,44,3,121
200640719,173,13,6,21,213
200660521,15,3,2,1,21
200662022,135,8,42,36,221
200663789,14,3,2,5,24
200666323,108,19,6,6,139
200667727,11,14,2,1,28
200678483,99,92,38,9,238
200679692,124,35,2,12,173
200681709,36,15,39,1,91
200699044,78,36,2,9,125
200702452,28,3,2,6,39
200703039,47,11,5,6,69
200704649,10,3,2,2,17
200706090,30,3,2,1,36
200711888,10,6,2,3,21
200724701,14,14,2,1,31
200730327,55,3,2,1,61
200731172,12,24,9,1,46
200735348,29,66,9,52,156
200743040,20,12,2,1,35
200743669,32,3,2,1,38
200753723,32,78,5,2,117
200761267,11,3,2,2,18
200772654,40,14,4,1,59
200776808,31,21,10,3,65
200781307,22,48,14,1,85
200782259,13,3,2,3,21
200784587,50,3,2,3,58
200785654,49,10,2,2,63
200792609,60,32,16,5,113
200798173,12,28,2,6,48
200833665,41,5,2,10,58
200834546,40,3,2,2,47
200850604,61,20,14,14,109
200855950,147,56,84,2,289
200894587,12,3,2,1,18
200909966,67,8,2,6,83
200915874,76,51,12,20,159
200920396,40,3,2,4,49
200922888,123,7,20,7,157
200962238,20,15,7,1,43
200983059,52,6,2,11,71
200991499,17,3,2,1,23
200993039,49,28,12,9,98
200993138,88,5,78,1,172
201021487,19,37,6,3,65
201036325,23,38,2,1,64
201045675,20,29,2,15,66
201072489,71,19,2,1,93
201077515,33,16,2,1,52
201089310,15,42,20,3,80
201096310,11,3,2,1,17
201100412,10,5,2,1,18
201103576,315,15,2,1,333
201115394,18,3,2,1,24
201115589,35,3,2,2,42
201122762,79,20,34,41,174
201131415,73,34,8,3,118
201135822,19,3,2,2,26
201136547,62,18,150,15,245
201143294,17,3,2,1,23
201146311,100,69,43,15,227
201146698,57,27,10,9,103
201153974,55,38,12,23,128
201153989,117,29,46,2,194
201161680,56,21,2,5,84
201166457,72,5,2,1,80
201193008,49,13,2,2,66
201200389,88,37,17,7,149
201207488,32,3,2,1,38
201208463,206,69,11,2,288
201223591,55,59,36,12,162
201229630,10,36,11,11,68
201236155,175,44,10,2,231
201258189,11,4,2,1,18
201266615,104,71,95,17,287
201291723,91,6,2,1,100
201292591,105,42,2,9,158
201298193,25,28,19,4,76
201312509,41,61,30,3,135
201314520,67,31,36,18,152
201315814,28,3,2,1,34
201318916,28,23,5,1,57
201323552,10,8,2,1,21
201337007,60,11,2,6,79
201360841,36,10,4,4,54
201363032,30,3,2,1,36
201392417,19,4,2,1,26
201395370,14,6,2,1,23
201409866,17,7,2,1,27
201422000,62,13,4,1,80
201447088,14,3,2,1,20
201453387,163,25,48,17,253
201455453,47,10,5,5,67
201461667,50,25,4,13,92
201465528,63,3,2,9,77
201468951,107,5,2,1,115
201470888,38,10,2,5,55
201474560,133,32,35,7,207
201488800,108,3,2,7,120
201489098,20,10,2,1,33
201497731,16,20,14,31,81
201522602,84,3,2,2,91
201525241,44,12,73,1,130
201528751,50,33,3,8,94
201547810,122,3,2,1,128
201555963,11,3,2,1,17
201571047,19,3,2,1,25
201572247,113,12,13,45,183
201575870,35,47,4,2,88
201582787,148,8,3,3,162
201592665,77,3,2,2,84
201636400,53,39,18,18,128
201648125,32,75,53,3,163
201653760,98,18,94,18,228
201656139,24,3,2,3,32
201678912,14,11,2,1,28
201688920,132,18,10,1,161
201696424,82,3,2,1,88
201696428,84,12,8,13,117
201715518,101,20,45,2,168
201721337,104,21,10,8,143
201728983,84,26,3,49,162
201742741,15,3,2,3,23
201753113,22,13,3,1,39
201757060,121,20,47,3,191
201762686,46,18,22,29,115
201768519,22,36,16,15,89
201770734,26,18,4,10,58
201777629,60,12,2,3,77
201805747,17,3,2,4,26
201843249,94,41,17,44,196
201849707,349,3,2,4,358
201850316,21,3,2,5,31
201851650,143,105,36,13,297
201854926,12,3,2,1,18
201857689,156,3,2,1,162
201869757,10,3,2,3,18
201879247,41,3,2,3,49
201879303,35,4,3,1,43
201889486,80,27,12,2,121
201891094,16,3,2,1,22
201892111,145,3,2,1,151
201900931,37,22,28,10,97
201902708,70,17,15,15,117
201945089,63,3,2,9,77
201981212,18,57,17,2,94
201981353,41,94,6,13,154
201983403,21,14,3,4,42
201998729,42,3,2,1,48
202001188,10,3,2,3,18
202001862,17,3,3,2,25
202002346,46,25,2,5,78
202007710,14,9,2,1,26
202010266,33,11,3,1,48
202011822,54,42,20,12,128
202019748,18,3,2,1,24
202029790,14,8,2,1,25
202049500,61,47,18,27,153
202054440,51,33,32,1,117
202056345,11,6,2,1,20
202077262,14,3,2,1,20
202077856,43,3,2,1,49
202090237,105,3,2,2,112
202093129,12,16,5,1,34
202107868,72,16,13,7,108
202126700,41,38,2,2,83
202139217,43,11,14,1,69
202143118,39,5,2,1,47
202143333,104,3,2,7,116
202153522,24,3,2,1,30
202167441,50,3,2,7,62
202186161,127,3,2,18,150
202197302,113,65,51,51,280
202197865,74,21,28,10,133
202215077,19,3,2,1,25
202224969,57,53,39,3,152
202231823,134,53,17,4,208
202232761,16,10,2,1,29
202237159,176,3,2,4,185
202239716,58,3,2,1,64
202241726,125,32,4,5,166
202270523,82,28,16,14,140
202286317,65,20,2,1,88
202291391,33,33,10,33,109
202293386,19,17,2,1,39
202299285,59,37,2,1,99
202313825,59,19,3,2,83
202316974,17,3,2,1,23
202319418,77,61,7,1,146
202335453,30,15,44,3,92
202345844,26,3,2,1,32
202346365,17,6,2,4,29
202377333,89,3,2,4,98
202400253,76,9,4,11,100
202409758,64,26,20,10,120
202415195,48,5,2,2,57
202428508,11,3,2,1,17
202434811,35,3,2,1,41
202435566,53,3,2,1,59
202440694,133,3,2,10,148
202443749,247,3,2,1,253
202458406,190,22,38,1,251
202472692,128,25,2,1,156
202485523,31,5,2,1,39
202490881,79,6,2,1,88
202509709,62,3,2,1,68
202514076,69,27,25,2,123
202520117,12,3,2,1,18
202525181,62,35,35,1,133
202534844,39,43,5,10,97
202550177,20,15,2,1,38
202561671,15,5,2,1,23
202568538,71,6,34,10,121
202576707,61,3,2,3,69
202597406,55,18,16,48,137
202603689,11,3,2,1,17
202618287,26,17,10,1,54
202621583,18,3,2,1,24
202622875,42,20,20,1,83
202633428,81,21,2,13,117
202650475,42,90,25,22,179
202657878,18,3,2,1,24
202667031,12,3,2,1,18
202668547,46,3,2,1,52
202669964,10,12,2,2,26
202689194,35,27,3,25,90
202698789,16,3,2,1,22
202713442,181,28,10,48,267
202723373,14,3,2,1,20
202731562,58,24,12,76,170
202743861,114,16,30,4,164
202744702,10,3,2,5,20
202767898,23,23,30,3,79
202767937,15,3,2,1,21
202774051,62,6,14,1,83
202782304,14,11,4,1,30
202790133,137,8,2,14,161
202803583,63,23,27,1,114
202832991,12,3,2,1,18
202833544,76,3,2,1,82
202833683,47,22,52,7,128
202843734,25,6,2,1,34
202851021,14,3,2,3,22
202880669,16,3,2,1,22
202885070,280,28,38,7,353
202886568,96,34,2,4,136
202892869,40,34,10,13,97
202896429,40,15,10,1,66
202900809,10,11,2,1,24
202907891,69,3,2,1,75
202922739,16,3,2,1,22
202927338,83,3,2,1,89
202945889,48,3,2,1,54
202953769,295,55,2,4,356
202963697,38,10,2,19,69
202979005,115,13,2,9,139
202985015,47,31,2,1,81
202986977,44,6,2,1,53
202991135,23,3,2,1,29
203000799,10,33,2,1,46
203014312,163,16,22,7,208
203020687,55,23,20,4,102
203022763,150,3,2,2,157
203025036,16,3,2,1,22
203026005,11,3,2,1,17
203038349,113,11,10,1,135
203040313,20,16,2,1,39
203042801,47,3,15,1,66
203048038,25,3,2,1,31
203052565,70,20,28,3,121
203057426,58,17,2,3,80
203057590,1204,3,2,20,1229
203060321,37,5,2,1,45
203082357,38,69,18,5,130
203091727,17,3,2,1,23
203102979,19,3,2,2,26
203109609,78,26,2,2,108
203116795,65,3,2,1,71
203145706,25,40,31,11,107
203161290,243,147,49,62,501
203165690,90,48,26,26,190
203183134,242,3,2,14,261
203201234,64,6,2,1,73
203202160,112,16,2,1,131
203204853,92,49,77,6,224
203208080,67,3,2,3,75
203236637,16,3,2,1,22
203250111,144,3,2,61,210
203257818,89,15,25,3,132
203265682,27,15,2,1,45
203267013,13,4,2,1,20
203277466,42,78,2,2,124
203291888,57,3,2,1,63
203293597,45,4,2,1,52
203295389,46,4,2,4,56
203302856,51,8,71,4,134
203311501,116,5,2,20,143
203318114,10,3,2,3,18
203320123,102,22,8,30,162
203326718,97,67,3,2,169
203330245,38,3,2,1,44
203335826,111,7,9,4,131
203341828,48,111,2,14,175
203347854,22,16,42,2,82
203349088,58,16,3,18,95
203356569,42,13,3,1,59
203361360,49,26,10,2,87
203367140,20,3,2,1,26
203371890,11,3,2,1,17
203373632,29,3,2,1,35
203380448,34,7,2,1,44
203390169,136,49,7,1,193
203404305,10,10,2,1,23
203427818,12,3,2,1,18
203432074,87,71,116,28,302
203443933,21,3,2,2,28
203444932,37,3,2,9,51
203453826,81,13,24,4,122
203458275,27,24,2,8,61
203461652,122,47,3,2,174
203463927,59,52,2,9,122
203465720,38,18,3,1,60
203466452,13,22,2,5,42
203467701,57,27,25,5,114
203469123,19,9,2,1,31
203475957,142,18,43,22,225
203479728,28,27,2,13,70
203486634,140,16,3,1,160
203518770,74,3,2,1,80
203520478,13,3,2,1,19
203524921,61,58,17,27,163
203534570,34,3,2,1,40
203536206,86,7,39,1,133
203539951,41,6,2,1,50
203544109,51,8,2,1,62
203545423,26,26,2,2,56
203546741,77,25,46,2,150
203549116,81,79,23,63,246
203555846,57,31,2,22,112
203562392,69,3,2,8,82
203573285,16,3,5,1,25
203590429,197,58,19,1,275
203597016,81,13,34,1,129
203599251,14,3,2,2,21
203616363,83,3,29,2,117
203621811,39,3,2,1,45
203629831,11,3,2,1,17
203631067,59,3,2,1,65
203641167,91,3,2,48,144
203642209,112,3,2,1,118
203642308,41,54,34,39,168
203650689,22,39,2,1,64
203662629,13,3,2,1,19
203666883,82,48,4,3,137
203672214,124,3,2,5,134
203678073,19,36,2,1,58
203679867,11,3,2,1,17
203692418,27,27,2,1,57
203717368,46,8,49,5,108
203721455,13,10,2,1,26
203721625,71,17,26,12,126
203725101,24,15,2,15,56
203732607,13,3,2,1,19
203746794,65,46,31,2,144
203774108,84,3,2,2,91
203776905,82,52,6,5,145
203784754,11,3,2,1,17
203793812,138,18,2,13,171
203793978,45,8,3,1,57
203802704,82,3,2,1,88
203820816,10,8,2,1,21
203820875,18,39,3,2,62
203825136,52,29,3,43,127
203826462,31,34,14,5,84
203840401,78,5,4,4,91
203848181,93,3,2,14,112
203868703,57,38,16,5,116
203890851,47,20,3,5,75
203907572,49,3,2,1,55
203907683,11,3,2,1,17
203923896,32,3,2,1,38
203947419,69,75,66,2,212
203963951,168,51,22,3,244
203968283,109,3,2,12,126
203988805,90,3,120,1,214
203998085,113,16,6,8,143
204019013,57,3,2,3,65
204022289,11,3,2,1,17
204024302,245,39,4,3,291
204039391,145,30,2,91,268
204044144,60,36,18,5,119
204046439,62,23,40,7,132
204061151,71,3,2,1,77
204075976,16,5,3,1,25
204100017,80,3,2,9,94
204103510,42,17,2,3,64
204107336,10,5,2,1,18
204119373,40,32,10,1,83
204119537,114,3,2,7,126
204126984,33,39,2,1,75
204129613,23,32,7,6,68
204141180,44,17,4,1,66
204141477,17,3,2,3,25
204142880,12,12,2,1,27
204153793,120,38,2,19,179
204156698,94,3,15,1,113
204174249,30,3,2,1,36
204186418,36,32,4,19,91
204186638,74,3,2,5,84
204189994,19,45,2,16,82
204194964,18,6,4,1,29
204220919,33,18,9,4,64
204236235,226,70,6,14,316
204240992,10,3,2,7,22
204241322,144,24,6,11,185
204242788,109,25,2,2,138
204253657,106,15,3,3,127
204266412,59,25,11,7,102
204274179,11,3,2,1,17
204285510,12,43,3,3,61
204288153,89,42,73,1,205
204298131,114,3,2,1,120
204302688,230,42,2,2,276
204307928,11,11,14,2,38
204312865,106,3,2,1,112
204317387,121,3,2,7,133
204320523,78,22,8,6,114
204329666,76,8,3,1,88
204348232,44,55,58,48,205
204359464,37,49,6,9,101
204361521,100,14,2,3,119
204368269,47,82,2,14,145
204375697,85,3,2,9,99
204377323,30,25,3,90,148
204381714,13,3,2,1,19
204405166,68,19,18,9,114
204410960,115,32,10,4,161
204412223,121,3,16,2,142
204423270,42,3,2,3,50
204426329,189,3,14,7,213
204426710,52,30,31,24,137
204433767,88,64,13,30,195
204444371,25,3,2,1,31
204445069,30,57,7,11,105
204451299,18,29,2,1,50
204457543,149,15,2,1,167
204458021,39,153,2,2,196
204479824,133,29,3,1,166
204481963,43,98,12,1,154
204490009,126,20,39,12,197
204491222,55,16,30,7,108
204497493,232,61,73,125,491
204498620,76,21,2,1,100
204502777,38,5,2,1,46
204504639,341,29,2,3,375
204534739,51,56,10,41,158
204535760,81,3,2,1,87
204546908,72,3,2,1,78
204563187,60,12,2,2,76
204568305,28,20,3,4,55
204578257,115,79,59,6,259
204594629,48,49,23,2,122
204596619,226,3,2,1,232
204611319,69,8,2,1,80
204613546,130,16,2,1,149
204640012,34,21,3,4,62
204643149,36,24,9,3,72
204648448,89,3,2,4,98
204678719,92,17,2,1,112
204700457,157,31,21,4,213
204724941,144,23,126,5,298
204727761,40,3,2,1,46
204762958,29,49,6,1,85
204765109,48,3,2,1,54
204769904,92,15,27,3,137
204780929,91,61,82,34,268
204780987,69,20,2,1,92
204788718,48,37,44,7,136
204838561,12,5,2,1,20
204842536,43,10,4,3,60
204849774,18,8,2,3,31
204850096,88,13,2,7,110
204857366,17,3,2,1,23
204860254,20,28,6,3,57
204869601,24,13,9,8,54
204870051,50,16,2,1,69
204876739,69,6,2,5,82
204877576,66,56,27,51,200
204883771,79,3,2,1,85
204885503,61,36,84,2,183
204889483,58,3,2,1,64
204901642,12,3,2,1,18
204908641,74,3,2,1,80
204912866,20,10,5,1,36
204929929,51,3,2,9,65
204968720,36,3,2,1,42
204983953,10,12,2,1,25
204994883,99,11,33,5,148
205004247,51,38,14,10,113
205019123,10,21,2,2,35
205022587,29,41,2,1,73
205025546,41,32,2,1,76
205031531,112,28,191,1,332
205040078,22,11,3,1,37
205040675,14,4,2,1,21
205054191,41,16,2,3,62
205056270,10,18,2,3,33
205057438,28,7,28,1,64
205057710,79,21,2,11,113
205067079,223,8,11,1,243
205092677,42,6,2,1,51
205098932,203,3,2,3,211
205122663,61,3,2,6,72
205128240,79,26,3,8,116
205132231,91,3,2,1,97
205173536,119,3,2,2,126
205178473,82,14,2,12,110
205199405,24,3,2,1,30
205214995,19,4,2,2,27
205223133,11,3,2,1,17
205224375,11,6,2,3,22
205237021,88,27,91,17,223
205237109,21,16,3,2,42
205237511,14,18,2,1,35
205257339,14,10,2,1,27
205281391,12,5,2,1,20
205299009,52,44,3,2,101
205304208,66,63,25,19,173
205317201,17,37,2,2,58
205320349,67,3,2,2,74
205322709,14,49,2,2,67
205337976,144,49,179,114,486
205338330,60,5,22,1,88
205358651,16,3,2,1,22
205359555,96,34,2,3,135
205367570,89,47,8,10,154
205370599,11,3,2,1,17
205381426,109,28,5,4,146
205409082,30,33,9,18,90
205413698,102,20,2,4,128
205415836,108,20,17,2,147
205417260,39,30,34,45,148
205429881,143,29,2,11,185
205430207,144,3,2,7,156
205435752,31,3,2,3,39
205450336,25,19,26,7,77
205452568,143,36,4,11,194
205464566,10,5,2,2,19
205486123,162,4,2,10,178
205489969,13,3,2,1,19
205497891,76,3,2,1,82
205499152,64,9,12,2,87
205506782,71,3,2,3,79
205507488,33,3,2,2,40
205527672,90,20,8,1,119
205548386,13,3,2,1,19
205573789,128,3,2,1,134
205609395,32,12,4,25,73
205628350,70,45,21,10,146
205657790,27,26,2,1,56
205681202,52,18,10,14,94
205682513,11,3,2,1,17
205683093,69,3,2,6,80
205693680,57,3,2,1,63
205705772,69,7,20,16,112
205712997,50,3,2,1,56
205713804,68,37,2,2,109
205725118,18,10,9,2,39
205737447,47,3,2,2,54
205740899,12,29,2,1,44
205754993,39,10,26,9,84
205755255,88,3,2,1,94
205757126,150,23,5,14,192
205764703,21,27,2,10,60
205766145,11,3,2,1,17
205769351,384,3,2,5,394
205776114,28,17,2,3,50
205788670,67,3,2,4,76
205795618,60,6,15,11,92
205800073,22,5,2,3,32
205801996,52,26,34,18,130
205811728,42,3,2,1,48
205819425,132,16,12,26,186
205825629,10,4,2,1,17
205825653,39,3,15,4,61
205827515,64,12,51,2,129
205830955,67,3,2,1,73
205831012,119,37,2,6,164
205837127,50,60,39,10,159
205841860,15,3,2,3,23
205853526,19,26,2,2,49
205865932,76,3,2,1,82
205884760,125,5,2,2,134
205890725,13,3,2,1,19
205902474,77,63,4,3,147
205908205,70,3,2,1,76
205910371,80,12,2,1,95
205912096,94,38,2,4,138
205912983,66,23,2,1,92
205918880,38,3,3,1,45
205922225,25,18,2,1,46
205962624,134,9,73,5,221
205973856,19,3,2,1,25
205979165,107,4,2,2,115
205982075,82,16,2,2,102
205990923,93,21,21,22,157
206000303,68,3,2,1,74
206005233,124,8,2,1,135
206011805,10,24,4,1,39
206014449,16,36,2,1,55
206036344,104,3,2,7,116
206062599,95,16,4,1,116
206069823,52,59,4,26,141
206091059,54,49,56,2,161
206091475,91,3,2,3,99
206097207,32,17,2,5,56
206098545,159,32,3,1,195
206098933,56,8,38,2,104
206111187,12,20,2,2,36
206124178,113,3,2,1,119
206125818,58,3,2,1,64
206128779,149,63,10,13,235
206133406,15,15,2,1,33
206144125,23,35,2,5,65
206149206,12,3,2,1,18
206155153,15,34,7,1,57
206159374,129,13,2,3,147
206172511,74,3,2,2,81
206172759,81,16,2,3,102
206173421,68,3,2,2,75
206175367,27,43,2,1,73
206180566,22,24,9,7,62
206183080,28,3,2,2,35
206208734,66,4,2,27,99
206213689,37,3,2,10,52
206219086,12,3,2,1,18
206243905,130,9,18,7,164
206260924,160,60,2,5,227
206269598,10,20,2,1,33
206279419,106,20,3,19,148
206283684,95,6,19,3,123
206286446,77,3,2,1,83
206286545,18,6,3,6,33
206294441,33,31,4,1,69
206302326,54,51,12,32,149
206312098,30,31,9,10,80
206333717,50,72,25,4,151
206334176,32,3,2,24,61
206337133,79,3,49,2,133
206345093,65,21,2,7,95
206354585,45,42,100,4,191
206355629,14,58,2,1,75
206370695,16,3,2,1,22
206379293,12,3,2,1,18
206383313,64,57,16,23,160
206390524,20,3,2,4,29
206397805,10,3,2,3,18
206398100,202,24,2,1,229
206408142,211,29,46,17,303
206426005,58,42,33,2,135
206449055,70,65,2,41,178
206468672,67,3,2,7,79
206468730,77,40,18,5,140
206477149,137,8,103,2,250
206511089,13,3,2,1,19
206520064,46,22,12,5,85
206522482,54,9,2,1,66
206526062,44,7,52,2,105
206534667,26,11,2,6,45
206576531,17,3,2,2,24
206589972,90,3,2,3,98
206590322,78,3,2,1,84
206606477,112,22,67,13,214
206618505,114,23,16,2,155
206618834,11,3,2,1,17
206623077,39,16,2,1,58
206636304,147,6,58,1,212
206637818,42,91,2,14,149
206664484,51,3,2,1,57
206703681,16,3,2,1,22
206703691,70,14,2,11,97
206708422,76,20,2,1,99
206714751,10,4,2,1,17
206726303,40,24,25,5,94
206730347,38,22,16,4,80
206743116,71,30,12,1,114
206750640,14,5,3,1,23
206760596,39,22,17,24,102
206770881,32,31,35,26,124
206771203,37,7,2,4,50
206788492,65,52,25,2,144
206793940,50,3,3,1,57
206804430,98,9,29,20,156
206825585,110,9,26,35,180
206827273,34,3,2,3,42
206830569,135,31,77,5,248
206860453,87,40,2,4,133
206883047,84,3,2,1,90
206889690,56,3,2,1,62
206907120,106,24,30,37,197
206911950,14,11,2,2,29
206917813,138,3,2,1,144
206925909,177,22,36,5,240
206930230,33,3,2,1,39
206947195,130,16,67,45,258
206957535,135,15,10,4,164
206957940,112,15,10,3,140
206961165,47,18,2,1,68
206966227,17,3,2,2,24
206968167,64,3,2,3,72
206989209,22,3,2,1,28
207004724,19,10,2,2,33
207016610,79,3,2,11,95
207019191,236,3,2,3,244
207021288,10,4,2,1,17
207022568,30,15,16,5,66
207041455,47,12,4,1,64
207050522,97,27,35,6,165
207058715,57,39,18,2,116
207093036,87,40,11,26,164
207095598,32,7,2,1,42
207098662,131,13,22,16,182
207108664,21,3,2,1,27
207108740,56,24,2,4,86
207112325,19,31,29,2,81
207127208,75,5,2,14,96
207131898,46,10,4,39,99
207152017,31,43,17,1,92
207153457,99,3,5,1,108
207169657,38,3,2,3,46
207182291,43,30,38,20,131
207225606,23,32,10,15,80
207228735,70,19,2,1,92
207229924,16,4,2,17,39
207234843,11,53,2,1,67
207240450,80,4,37,2,123
207263240,27,19,39,18,103
207277452,78,28,52,7,165
207293425,20,3,2,1,26
207295741,244,3,2,16,265
207313434,118,65,7,1,191
207327133,75,3,2,1,81
207328363,13,3,2,1,19
207335024,19,9,2,1,31
207342405,73,3,2,1,79
207346653,45,3,2,1,51
207352185,158,45,13,29,245
207363597,17,3,2,1,23
207378503,118,63,11,11,203
207379704,63,3,65,7,138
207380777,10,40,2,1,53
207398279,87,3,2,1,93
207398286,23,22,26,27,98
207406261,20,7,20,1,48
207411565,79,28,2,4,113
207414049,131,49,79,1,260
207421194,20,21,2,1,44
207428557,105,25,50,5,185
207447823,36,28,10,1,75
207450562,158,3,2,3,166
207452365,18,25,2,3,48
207463070,15,10,2,6,33
207464518,61,3,11,15,90
207470530,15,6,2,1,24
207480352,125,19,17,3,164
207483251,46,3,2,13,64
207496355,11,3,2,1,17
207504574,95,32,2,3,132
207507406,53,15,3,3,74
207528310,158,46,48,2,254
207545504,89,3,2,1,95
207548212,68,3,2,2,75
207552077,15,3,2,1,21
207553850,94,18,50,26,188
207556564,92,3,2,8,105
207569738,71,3,33,1,108
207572307,15,7,3,1,26
207572670,78,18,6,11,113
207582374,124,25,2,2,153
207594659,147,32,2,2,183
207601206,119,3,2,5,129
207603948,52,9,2,8,71
207606723,88,39,65,7,199
207618627,33,46,27,2,108
207632942,46,21,2,1,70
207637867,11,3,2,2,18
207659161,59,26,3,9,97
207666278,10,6,2,1,19
207667059,73,3,2,1,79
207671128,19,41,2,1,63
207676529,135,5,22,2,164
207686441,68,3,2,1,74
207690361,137,17,2,1,157
207693393,14,3,2,1,20
207693630,11,40,2,1,54
207694785,232,3,2,3,240
207700345,79,60,20,19,178
207724743,12,3,2,1,18
207730279,79,12,2,14,107
207744911,105,112,2,8,227
207748703,77,34,106,1,218
207749499,131,3,2,26,162
207808656,20,3,2,1,26
207810745,18,15,2,5,40
207814925,11,3,2,1,17
207816907,53,12,57,1,123
207835041,73,12,22,1,108
207836763,131,32,2,2,167
207845102,82,3,2,8,95
207845881,143,3,2,69,217
207855827,20,32,2,1,55
207869973,46,3,2,14,65
207882859,122,18,2,25,167
207885149,48,33,2,15,98
207890696,46,29,40,5,120
207893813,13,3,2,1,19
207894588,10,3,2,2,17
207896710,39,4,2,4,49
207903428,133,55,11,42,241
207914654,36,14,13,1,64
207929074,17,3,2,2,24
207937753,21,6,2,7,36
207944852,215,8,2,26,251
207946034,109,45,2,51,207
207949682,28,4,2,1,35
207964087,12,11,2,1,26
207965969,83,37,21,1,142
207970351,145,56,2,23,226
207980175,22,3,2,4,31
207982483,18,21,7,1,47
207986373,36,40,42,1,119
207987878,68,32,2,2,104
208001353,78,10,2,3,93
208008528,175,3,2,24,204
208009971,30,3,2,1,36
208051039,52,47,2,4,105
208060572,14,10,2,1,27
208106550,44,12,5,5,66
208106752,53,10,16,4,83
208112038,204,53,4,15,276
208112041,59,7,36,1,103
208154542,73,17,5,45,140
208160664,103,19,2,5,129
208161062,22,7,4,1,34
208164489,24,20,10,7,61
208164554,28,7,7,4,46
208166289,105,12,2,3,122
208179124,67,12,5,14,98
208181674,35,28,8,2,73
208181694,68,40,106,11,225
208197834,34,36,5,29,104
208199221,31,3,2,1,37
208202839,123,42,49,6,220
208216709,48,25,3,10,86
208217338,54,22,2,13,91
208225182,13,3,2,1,19
208226640,31,3,2,1,37
208228728,17,10,2,1,30
208247140,120,3,2,1,126
208279735,51,20,2,7,80
208295649,162,26,2,1,191
208308575,73,3,2,3,81
208309204,10,5,2,1,18
208319478,48,12,4,2,66
208331311,20,3,2,1,26
208349517,310,3,2,3,318
208358807,96,3,2,4,105
208375401,38,32,4,5,79
208376361,11,3,2,1,17
208385308,34,97,15,1,147
208390192,33,8,2,6,49
208391480,243,8,2,2,255
208403490,38,12,2,1,53
208407940,44,34,34,1,113
208421119,11,3,2,1,17
208422222,53,3,2,1,59
208437697,17,4,2,2,25
208441592,96,3,2,1,102
208453178,38,5,5,5,53
208456941,10,6,2,1,19
208491063,55,44,2,1,102
208495775,44,3,2,6,55
208496271,35,3,2,3,43
208501072,179,3,2,59,243
208523757,46,18,2,1,67
208538335,56,3,2,8,69
208563005,94,3,2,2,101
208566464,29,3,2,1,35
208568409,183,76,2,1,262
208572068,1332,3,2,7,1344
208580973,12,37,2,1,52
208591827,67,15,2,5,89
208608692,20,9,2,1,32
208608912,33,5,12,1,51
208611997,10,3,2,2,17
208613797,77,12,2,5,96
208626965,79,14,11,9,113
208632087,31,3,2,12,48
208645000,42,3,2,4,51
208648489,22,13,2,4,41
208650917,15,3,2,3,23
208657147,39,3,2,39,83
208658837,12,4,2,1,19
208666511,35,32,17,24,108
208679818,26,11,2,1,40
208687369,96,14,22,4,136
208701242,197,46,111,3,357
208709003,67,30,35,11,143
208710304,30,66,2,1,99
208721179,43,3,2,7,55
208722119,16,3,2,1,22
208725254,24,3,2,1,30
208730587,20,3,2,2,27
208761421,69,61,85,4,219
208762490,100,68,2,3,173
208762911,52,3,2,1,58
208795210,66,22,2,1,91
208800582,39,3,36,9,87
208801922,48,42,24,23,137
208806275,32,3,2,12,49
208807639,35,49,5,13,102
208807691,88,13,2,1,104
208812292,66,36,81,41,224
208814346,62,3,2,1,68
208839681,46,37,84,6,173
208873251,95,3,2,1,101
208876818,62,15,8,2,87
208878024,87,36,3,7,133
208888881,44,7,2,2,55
208889623,57,27,14,2,100
208894624,64,67,2,12,145
208903627,30,37,38,17,122
208917647,164,13,2,28,207
208919440,162,3,11,4,180
208935468,11,4,2,1,18
208943207,51,32,51,22,156
208966397,51,91,26,16,184
208966781,20,32,24,5,81
208981776,52,50,31,29,162
208983936,44,34,2,2,82
208985772,24,22,5,1,52
209018903,33,3,2,1,39
209027699,11,3,2,1,17
209029086,60,30,77,12,179
209029244,40,60,3,11,114
209059295,118,30,5,2,155
209110386,58,30,45,26,159
209114734,231,45,2,1,279
209125746,40,21,5,3,69
209128233,55,35,2,11,103
209133063,34,33,3,2,72
209135546,23,3,2,2,30
209136342,97,10,2,1,110
209153426,25,36,2,1,64
209165264,38,20,41,1,100
209169484,104,42,34,46,226
209176715,139,33,2,1,175
209179086,215,3,13,2,233
209189666,41,26,56,1,124
209214286,48,121,28,10,207
209214590,110,16,2,2,130
209229909,22,3,2,1,28
209263497,30,7,2,1,40
209269931,120,36,102,8,266
209271301,46,19,2,1,68
209274272,55,8,3,16,82
209310267,194,3,2,12,211
209313394,65,14,6,1,86
209323341,44,13,2,2,61
209325884,49,8,42,38,137
209341455,15,24,5,1,45
209341797,93,3,2,1,99
209344621,10,14,2,1,27
209345830,11,3,2,1,17
209359526,32,13,2,9,56
209362550,24,8,33,9,74
209385594,74,3,2,1,80
209394525,76,33,2,5,116
209415773,35,34,17,1,87
209416544,17,3,2,1,23
209420789,18,3,2,2,25
209428031,84,37,36,11,168
209429068,107,3,2,1,113
209434040,41,22,18,9,90
209448787,17,9,3,1,30
209453941,68,15,2,1,86
209462598,73,32,15,10,130
209470876,124,52,182,9,367
209487430,90,31,87,1,209
209494454,157,17,2,1,177
209517186,120,107,64,6,297
209521709,263,42,12,1,318
209530415,17,5,2,1,25
209536525,25,113,3,1,142
209545733,66,4,6,1,77
209559538,11,3,2,3,19
209562884,36,3,2,5,46
209583502,101,94,99,6,300
209592065,164,4,2,4,174
209601076,31,3,2,1,37
209607599,44,46,3,9,102
209611433,43,19,11,1,74
209616901,14,3,2,1,20
209619888,515,3,2,203,723
209628886,167,14,48,16,245
209639544,13,6,2,1,22
209675677,93,19,20,9,141
209679324,77,12,2,4,95
209696661,29,51,6,11,97
209699093,90,14,142,17,263
209704982,23,13,7,3,46
209705310,11,10,2,1,24
209716573,23,9,2,1,35
209717043,21,3,2,1,27
209729309,42,31,5,67,145
209735374,105,3,2,3,113
209745316,17,3,2,1,23
209749494,73,20,42,56,191
209750642,12,3,2,1,18
209751375,18,3,2,1,24
209755482,167,16,5,1,189
209756670,23,43,2,2,70
209772948,23,17,36,1,77
209773515,78,22,4,10,114
209775902,98,18,7,5,128
209776915,10,3,2,2,17
209777797,120,28,3,2,153
209778286,88,14,27,10,139
209781723,43,22,2,2,69
209782585,124,22,2,1,149
209784540,20,34,2,1,57
209796954,70,3,2,1,76
209799158,19,3,2,5,29
209860538,279,37,92,44,452
209870609,41,24,19,17,101
209891919,47,16,2,1,66
209898355,155,7,2,27,191
209905152,51,3,2,1,57
209914866,101,85,110,19,315
209926361,32,20,44,1,97
209928326,43,3,2,1,49
209953615,40,12,38,4,94
209955829,92,11,55,8,166
209960433,120,47,45,26,238
209961156,145,34,25,31,235
209966891,10,3,2,3,18
209983741,47,23,43,3,116
209987015,21,11,3,1,36
209999121,11,3,2,1,17
210001441,92,3,2,1,98
210013732,98,19,27,11,155
210013892,58,3,2,1,64
210017101,11,3,2,1,17
210049771,64,3,2,1,70
210057136,14,36,2,1,53
210063006,65,3,6,15,89
210064290,33,29,2,3,67
210085337,57,11,2,2,72
210100662,24,3,2,6,35
210127195,89,8,40,1,138
210136493,40,6,10,6,62
210141387,13,3,2,4,22
210143974,21,62,2,1,86
210147012,10,3,2,23,38
210156769,47,15,32,1,95
210163082,131,3,2,48,184
210168430,117,34,32,16,199
210190973,20,51,2,1,74
210198916,11,3,2,1,17
210209517,85,7,74,1,167
210215897,83,17,63,27,190
210216954,17,19,2,1,39
210218431,35,9,2,1,47
210223353,96,12,10,9,127
210250937,56,9,2,5,72
210280052,100,3,2,3,108
210286467,69,3,2,7,81
210288269,66,28,13,13,120
210293351,84,18,2,4,108
210315631,190,84,26,5,305
210323447,153,12,63,4,232
210326904,147,3,2,2,154
210328987,108,47,47,13,215
210344077,10,14,2,1,27
210357134,94,29,129,2,254
210363346,34,31,31,22,118
210367644,40,48,127,6,221
210377787,50,34,48,23,155
210379181,34,3,2,2,41
210390386,23,6,2,1,32
210392822,50,3,2,4,59
210417026,135,3,2,10,150
210420912,44,3,2,7,56
210425672,26,3,2,1,32
210444269,32,12,2,2,48
210445727,26,56,4,9,95
210445865,115,3,2,7,127
210465631,89,17,2,1,109
210476091,53,3,2,1,59
210476927,37,45,6,12,100
210480559,230,9,15,11,265
210495154,53,88,42,17,200
210496915,65,3,2,2,72
210518857,112,3,2,1,118
210526064,13,5,2,1,21
210527042,26,77,2,1,106
210532267,11,3,2,1,17
210537879,15,3,2,1,21
210548054,17,3,2,2,24
210554817,539,3,2,26,570
210584629,34,3,2,5,44
210585916,129,54,99,2,284
210598009,146,22,7,25,200
210608622,60,22,2,1,85
210612455,26,126,9,211,372
210637186,117,57,2,51,227
210644652,87,3,2,1,93
210673876,32,22,13,1,68
210692770,75,3,2,1,81
210712348,25,3,2,6,36
210712821,12,3,2,1,18
210717669,105,14,2,2,123
210719228,10,4,2,1,17
210721088,58,44,9,6,117
210721633,34,26,2,1,63
210725833,107,39,43,4,193
210738155,19,6,2,1,28
210739628,30,37,26,3,96
210742510,58,3,2,1,64
210753436,69,3,2,1,75
210758983,18,3,2,3,26
210781029,71,39,10,6,126
210787980,15,16,6,2,39
210800560,41,15,2,1,59
210810944,36,18,2,1,57
210815077,73,17,4,4,98
210844802,14,3,2,1,20
210849974,143,8,5,1,157
210853451,12,3,2,1,18
210855266,60,6,2,4,72
210863837,56,3,2,3,64
210877325,11,6,2,1,20
210886205,100,3,2,13,118
210901980,181,3,2,5,191
210935142,78,3,2,1,84
210938540,100,17,12,59,188
210938637,35,6,25,6,72
210939458,22,30,19,2,73
210954144,79,60,41,71,251
210971099,173,17,10,3,203
210982542,61,3,2,1,67
210990465,17,3,2,1,23
211009071,70,22,42,1,135
211020744,137,33,18,14,202
211025859,15,27,2,1,45
211070644,70,5,3,3,81
211076215,33,3,2,1,39
211078199,155,58,91,22,326
211079073,67,3,2,4,76
211082610,78,3,2,2,85
211087355,42,36,5,1,84
211092850,151,51,2,1,205
211118644,17,3,2,1,23
211122840,23,3,2,1,29
211133435,84,23,78,3,188
211135565,21,32,12,1,66
211138684,19,28,2,1,50
211141291,111,27,53,8,199
211143899,111,95,75,12,293
211153276,20,32,2,3,57
211155741,15,3,2,2,22
211165375,20,19,2,3,44
211172633,171,26,18,3,218
211173393,14,6,2,2,24
211204124,30,30,2,5,67
211219581,84,22,16,1,123
211246243,23,3,2,8,36
211250510,65,66,4,50,185
211259911,26,3,2,2,33
211266563,68,17,37,8,130
211266978,150,9,69,1,229
211271117,243,19,107,34,403
211271872,150,55,19,3,227
211272545,128,8,13,26,175
211301078,68,3,2,13,86
211307181,109,6,37,29,181
211315719,10,6,2,1,19
211340576,13,5,2,1,21
211347314,48,87,58,4,197
211356955,86,83,23,93,285
211358155,26,13,2,3,44
211382662,39,51,4,11,105
211383537,11,3,2,2,18
211383862,25,3,2,1,31
211385465,57,41,20,1,119
211385495,76,21,2,1,100
211390995,43,34,12,4,93
211405411,47,23,70,3,143
211414953,118,3,2,1,124
211421177,20,49,35,1,105
211448519,35,75,2,3,115
211454922,36,4,2,9,51
211455907,83,31,7,45,166
211475349,60,33,17,9,119
211477309,20,15,2,3,40
211494140,98,38,2,1,139
211512128,20,56,18,5,99
211516711,57,32,129,41,259
211519925,48,3,2,4,57
211557646,99,49,21,24,193
211559519,43,45,23,6,117
211563326,58,35,2,1,96
211588170,96,22,15,21,154
211595551,15,3,2,1,21
211602716,59,24,4,1,88
211611295,106,7,5,7,125
211612754,10,8,2,1,21
211623606,90,3,17,23,133
211632356,69,18,2,1,90
211674798,50,9,24,1,84
211679563,13,17,2,1,33
211682791,36,3,2,1,42
211692805,13,3,2,1,19
211700179,67,16,26,1,110
211713463,148,13,2,9,172
211731263,20,10,12,1,43
211749701,80,95,46,7,228
211760392,221,66,2,11,300
211761132,58,3,2,1,64
211778031,211,11,11,4,237
211796016,64,26,2,2,94
211798938,72,4,52,1,129
211810078,51,5,2,10,68
211813164,12,23,2,1,38
211814866,19,52,2,1,74
211820876,33,17,3,3,56
211821228,101,53,18,2,174
211827345,81,38,20,1,140
211831051,39,18,12,4,73
211833872,12,3,2,1,18
211834629,11,3,2,1,17
211839948,141,28,5,8,182
211840916,55,10,2,1,68
211850002,45,11,2,2,60
211853965,17,26,2,1,46
211867887,23,39,74,18,154
211877705,66,36,9,1,112
211887061,91,38,81,15,225
211892417,417,91,7,14,529
211894179,21,3,2,1,27
211896861,261,47,83,62,453
211898477,119,38,12,1,170
211919293,83,3,2,1,89
211924389,107,3,2,2,114
211939336,61,23,4,1,89
211941969,19,3,2,1,25
211948021,121,31,2,1,155
211955246,52,26,3,16,97
211959418,35,3,2,1,41
211964963,49,4,2,2,57
211965780,31,3,2,1,37
211988215,42,14,8,10,74
212000070,93,23,10,2,128
212009771,20,3,2,2,27
212018616,103,19,96,40,258
212019844,20,44,3,1,68
212021580,63,29,2,7,101
212024374,30,3,2,5,40
212035301,39,29,16,25,109
212057803,114,51,2,10,177
212064092,93,3,2,1,99
212067189,30,22,49,3,104
212069943,45,23,15,1,84
212080250,85,10,15,1,111
212086673,52,3,2,1,58
212088444,112,25,3,1,141
212089785,81,3,2,2,88
212101122,12,9,2,14,37
212105870,43,73,9,1,126
212110984,14,5,2,1,22
212118400,14,3,2,1,20
212121208,51,36,16,6,109
212125607,62,18,7,1,88
212146685,40,15,32,1,88
212155594,67,19,2,1,89
212158682,34,14,11,8,67
212173826,12,3,5,1,21
212176311,38,3,2,1,44
212179278,52,22,21,1,96
212195857,19,85,3,1,108
212227138,55,21,13,5,94
212231074,65,3,2,1,71
212232764,62,3,2,1,68
212239452,29,57,10,1,97
212250312,44,3,2,1,50
212252231,318,54,6,15,393
212266137,21,6,2,1,30
212275633,11,3,2,3,19
212282925,55,30,37,10,132
212285087,110,9,20,2,141
212297600,38,3,2,1,44
212313541,41,21,2,1,65
212323981,122,36,24,43,225
212325823,210,29,2,36,277
212333634,103,28,4,2,137
212335473,17,3,2,1,23
212342713,71,3,2,3,79
212345721,23,3,2,1,29
212348697,36,11,2,2,51
212360656,150,26,10,40,226
212361181,97,17,15,21,150
212364008,42,18,56,2,118
212368184,22,3,2,1,28
212373627,16,3,2,1,22
212388271,26,17,2,5,50
212393198,53,3,3,5,64
212401487,11,3,2,2,18
212418954,22,3,2,1,28
212434236,16,3,2,4,25
212445869,88,19,2,1,110
212451520,89,32,2,16,139
212458673,44,17,3,3,67
212478640,42,15,6,4,67
212484305,12,3,2,1,18
212490040,99,32,44,1,176
212534885,76,76,69,13,234
212540281,39,10,5,5,59
212541147,27,53,3,1,84
212548568,42,5,2,4,53
212550040,122,36,70,1,229
212563871,94,3,2,2,101
212575451,18,10,11,2,41
212577392,98,27,13,1,139
212604575,25,14,2,12,53
212613072,38,11,5,2,56
212627473,14,33,28,1,76
212632377,185,63,28,7,283
212634067,24,20,2,3,49
212638812,44,15,2,1,62
212647601,76,54,41,14,185
212647725,30,12,4,1,47
212658918,23,12,2,1,38
212661018,18,52,2,1,73
212664133,67,3,2,5,77
212693088,23,41,5,11,80
212695816,73,4,2,1,80
212700012,13,3,2,1,19
212707887,28,19,46,4,97
212715417,138,3,2,1,144
212752141,116,63,24,20,223
212763258,39,25,7,4,75
212764405,14,11,2,1,28
212779057,90,79,13,7,189
212780480,13,8,2,5,28
212791055,44,3,2,1,50
212792860,36,42,6,13,97
212801505,15,17,2,1,35
212807970,11,3,2,1,17
212808753,144,26,14,44,228
212822458,236,35,43,15,329
212827602,32,3,2,1,38
212837698,31,4,2,1,38
212859514,64,11,2,7,84
212864195,101,13,2,5,121
212866812,79,12,2,1,94
212876761,97,58,69,28,252
212889549,12,3,2,1,18
212895534,21,3,2,1,27
212900538,47,14,2,2,65
212901109,44,29,21,7,101
212903235,11,12,8,3,34
212912217,14,3,2,2,21
212912293,86,3,2,1,92
212913286,57,26,75,23,181
212918243,110,13,5,1,129
212949651,19,3,2,1,25
212971068,50,7,2,1,60
212987587,37,17,2,4,60
212994717,151,3,2,1,157
213001875,10,3,2,2,17
213015352,32,3,2,4,41
213016961,12,22,2,1,37
213019930,35,57,23,1,116
213041090,32,12,15,1,60
213057434,10,5,2,1,18
213057672,151,49,20,16,236
213078326,308,3,2,4,317
213084583,306,18,2,3,329
213086306,15,3,2,1,21
213092165,84,19,2,1,106
213092982,41,8,3,3,55
213099243,61,28,22,7,118
213122115,16,14,2,3,35
213128002,50,26,2,32,110
213131081,48,8,2,1,59
213134776,127,14,2,15,158
213145813,58,35,42,3,138
213147500,94,3,2,5,104
213148723,29,33,11,1,74
213149624,78,21,17,25,141
213160652,16,3,2,1,22
213198583,82,105,76,5,268
213201818,26,3,2,2,33
213206212,127,3,2,2,134
213207715,137,42,19,6,204
213225674,106,21,4,4,135
213228166,73,36,20,12,141
213233177,16,3,2,1,22
213234191,217,10,2,5,234
213235626,15,3,2,1,21
213238086,17,20,2,1,40
213239434,72,9,2,9,92
213241309,159,3,2,2,166
213254089,65,4,2,1,72
213274618,11,3,2,1,17
213276062,126,27,4,28,185
213281508,57,3,2,3,65
213285003,57,23,2,6,88
213289268,39,19,4,5,67
213290086,27,22,23,24,96
213314371,25,3,2,1,31
213314789,84,14,2,9,109
213315730,28,16,3,3,50
213327733,68,3,2,1,74
213335702,44,30,2,11,87
213335942,90,26,15,2,133
213338371,42,18,59,4,123
213348771,20,6,2,9,37
213379711,54,27,2,2,85
213390571,103,5,2,3,113
213395293,125,37,16,34,212
213413543,100,3,2,1,106
213417241,19,3,2,2,26
213421227,107,62,10,18,197
213433336,74,4,16,3,97
213434234,11,3,2,1,17
213438618,116,28,3,20,167
213470448,314,30,76,94,514
213533465,34,67,2,6,109
213539930,17,29,2,1,49
213547886,80,15,3,45,143
213562389,57,11,26,10,104
213582969,53,3,2,1,59
213601915,25,41,2,3,71
213602816,14,3,2,1,20
213620904,57,13,6,9,85
213622698,13,80,2,1,96
213636776,125,3,2,1,131
213641207,53,11,30,1,95
213641372,34,65,60,22,181
213644448,106,13,2,1,122
213648646,13,49,2,1,65
213652563,49,39,18,6,112
213656405,121,22,2,1,146
213666864,116,95,19,32,262
213674851,93,19,3,8,123
213691535,52,10,2,2,66
213692679,38,30,3,8,79
213703859,29,33,12,1,75
213705014,60,28,47,2,137
213707448,118,20,93,20,251
213718098,24,3,2,1,30
213731810,13,42,17,1,73
213740291,13,11,2,1,27
213749462,10,8,2,1,21
213749603,13,4,4,2,23
213761016,95,33,14,37,179
213762302,54,25,5,3,87
213771459,68,3,2,1,74
213792270,124,3,3,1,131
213815820,95,8,3,1,107
213822702,134,3,2,18,157
213841837,115,54,21,4,194
213855323,64,45,42,7,158
213855677,86,27,4,15,132
213856490,68,55,43,1,167
213856961,150,19,2,3,174
213859233,124,3,2,10,139
213871148,83,10,2,17,112
213876991,35,40,12,11,98
213879371,11,3,2,1,17
213881400,61,119,214,2,396
213896487,69,7,34,4,114
213902413,132,29,34,1,196
213924681,28,3,2,9,42
213933963,48,3,2,1,54
213944736,35,19,2,7,63
213948881,58,38,48,22,166
213952061,96,40,51,31,218
213967233,115,26,5,28,174
213967452,60,37,56,1,154
213983054,58,31,2,5,96
213983263,31,17,2,1,51
213995640,13,3,2,1,19
213998281,62,3,2,1,68
214005902,15,38,12,1,66
214016407,19,11,2,2,34
214019808,85,15,2,9,111
214021396,10,25,2,1,38
214024774,88,3,2,1,94
214033999,70,15,20,7,112
214060383,154,49,2,10,215
214079944,72,30,17,9,128
214084380,18,10,2,1,31
214089874,65,20,2,2,89
214092993,164,3,2,3,172
214106626,35,3,2,1,41
214109173,142,24,7,2,175
214129074,17,3,2,3,25
214129353,18,16,2,2,38
214137253,59,3,2,6,70
214140049,99,3,8,3,113
214152692,43,3,2,1,49
214155766,102,26,2,12,142
214166044,68,18,2,1,89
214171791,125,20,2,19,166
214178238,136,3,2,2,143
214191435,262,17,103,2,384
214192179,63,127,65,26,281
214221231,11,3,2,1,17
214228913,57,43,5,13,118
214235719,93,3,2,1,99
214254228,83,3,2,7,95
214263303,129,15,2,8,154
214265147,71,14,21,1,107
214281416,79,3,33,38,153
214283825,69,24,2,20,115
214312447,94,58,2,11,165
214330420,26,28,7,1,62
214336890,17,9,5,9,40
214338329,359,3,2,3,367
214342560,130,23,65,40,258
214344967,40,3,2,1,46
214355626,47,16,4,2,69
214368352,83,19,19,39,160
214373260,35,39,53,1,128
214378588,13,3,2,1,19
214387857,23,3,2,1,29
214400523,117,7,2,5,131
214403404,29,3,2,1,35
214422312,54,3,41,1,99
214428295,322,3,2,17,344
214429122,54,34,8,9,105
214430581,100,15,2,1,118
214435794,100,5,2,6,113
214451774,141,28,6,22,197
214483331,16,4,2,1,23
214483425,10,3,2,2,17
214495279,92,3,2,11,108
214497438,16,23,3,1,43
214509321,90,23,68,6,187
214517939,49,46,2,2,99
214524453,25,50,2,1,78
214525560,88,3,15,4,110
214529886,32,20,5,5,62
214530234,31,46,45,19,141
214540520,34,4,2,2,42
214547882,201,22,2,2,227
214550749,72,3,2,1,78
214562198,129,13,12,8,162
214571931,81,14,2,1,98
214575541,56,30,80,8,174
214586910,11,3,2,1,17
214587438,13,11,9,3,36
214594349,38,37,65,8,148
214605380,148,3,6,2,159
214618644,44,3,2,3,52
214619665,38,3,5,1,47
214634740,24,35,2,1,62
214667244,74,25,2,14,115
214689655,107,3,2,23,135
214697034,29,25,3,1,58
214714113,142,39,36,4,221
214715834,64,3,2,1,70
214748556,169,3,2,1,175
214751696,78,5,3,11,97
214753952,11,3,2,2,18
214804043,21,53,26,4,104
214806038,41,38,2,17,98
214809749,56,14,10,7,87
214824267,12,4,2,1,19
214829390,60,14,43,10,127
214832673,10,4,2,1,17
214858906,13,3,2,1,19
214861327,62,3,31,1,97
214878377,114,5,2,4,125
214895624,61,6,3,2,72
214896136,56,4,6,11,77
214897103,93,31,63,1,188
214912295,34,23,62,1,120
214916496,37,26,25,1,89
214917227,54,12,6,4,76
214940482,20,16,8,4,48
214940969,135,3,2,2,142
214947417,28,3,2,1,34
214953681,27,103,6,32,168
214974312,11,3,2,1,17
214976023,15,3,2,1,21
214994479,18,5,2,1,26
214997287,46,18,47,2,113
215006560,13,7,2,1,23
215009843,148,3,2,48,201
215024771,10,46,24,1,81
215034695,82,27,3,1,113
215047968,44,26,66,1,137
215049511,23,6,2,2,33
215070556,48,35,14,9,106
215081118,33,23,2,17,75
215085731,61,3,2,3,69
215094649,20,8,2,1,31
215116894,59,9,8,5,81
215131983,38,17,5,10,70
215164139,125,28,9,1,163
215182024,225,44,69,1,339
215184433,56,23,3,4,86
215191155,23,3,2,6,34
215196446,16,3,2,1,22
215210789,127,64,2,38,231
215235755,36,29,2,2,69
215249751,35,28,20,1,84
215269744,72,18,21,19,130
215288706,113,19,49,21,202
215314386,43,44,12,8,107
215328051,64,30,5,1,100
215328531,14,18,2,1,35
215332855,59,18,2,3,82
215340118,54,27,21,4,106
215346480,12,4,2,1,19
215360202,110,26,23,8,167
215367633,94,52,86,4,236
215372315,133,27,2,5,167
215384800,24,43,4,5,76
215403312,220,8,33,13,274
215427854,16,73,2,1,92
215429089,73,4,6,16,99
215437077,95,21,11,1,128
215443037,21,17,2,1,41
215446879,99,33,4,10,146
215448697,80,11,2,1,94
215449998,10,6,2,1,19
215463925,10,7,2,1,20
215495684,39,34,10,2,85
215503229,27,10,2,1,40
215534242,35,41,3,1,80
215535508,25,17,19,21,82
215537585,629,13,64,104,810
215543242,42,3,2,7,54
215549822,159,17,128,4,308
215567476,29,10,2,1,42
215569514,131,3,2,1,137
215571457,18,15,2,1,36
215571719,88,3,2,2,95
215581155,78,47,9,2,136
215594828,163,21,13,5,202
215594883,297,57,2,4,360
215602654,62,19,2,1,84
215604106,145,70,4,12,231
215606128,101,30,18,26,175
215613518,81,69,2,8,160
215626873,117,3,2,5,127
215633714,51,12,2,1,66
215636541,13,13,2,1,29
215638327,20,19,4,3,46
215654759,85,3,16,3,107
215661309,87,40,4,9,140
215665360,39,59,6,2,106
215668128,29,42,2,19,92
215677322,11,3,2,1,17
215682251,51,14,3,13,81
215685938,47,13,17,2,79
215693596,117,8,47,9,181
215698402,11,20,2,1,34
215725129,68,3,2,10,83
215729068,138,28,54,35,255
215759425,27,31,2,1,61
215760276,18,71,5,1,95
215779545,41,25,36,2,104
215787389,46,4,3,2,55
215805520,22,3,2,2,29
215808247,17,10,6,37,70
215811675,56,42,4,2,104
215816198,105,78,14,13,210
215819356,38,13,2,1,54
215827834,42,35,38,6,121
215838047,32,3,2,1,38
215842631,124,23,41,1,189
215855040,30,3,2,1,36
215859441,108,17,2,1,128
215870290,24,42,29,6,101
215877399,51,13,2,21,87
215884658,42,33,12,4,91
215885720,132,20,2,15,169
215889217,183,3,2,74,262
215910729,10,20,2,1,33
215917911,16,5,2,1,24
215923752,100,3,2,1,106
215924859,52,14,32,11,109
215928811,226,3,2,1,232
215931253,37,29,27,12,105
215944138,45,60,43,16,164
215945826,12,6,2,1,21
215946269,16,25,3,1,45
215948872,74,3,41,7,125
215967370,56,3,2,1,62
215974043,97,30,22,26,175
215987741,111,20,14,5,150
215993404,34,9,30,27,100
215994391,63,19,4,4,90
215995359,10,9,20,17,56
216002814,54,18,2,1,75
216005941,72,39,19,21,151
216007481,53,6,6,1,66
216009411,43,53,5,21,122
216018641,14,4,2,2,22
216033696,67,3,2,2,74
216050611,37,72,14,2,125
216054903,16,3,2,1,22
216060707,58,9,22,1,90
216062676,94,11,3,2,110
216078882,19,59,3,1,82
216085142,90,30,132,1,253
216091811,110,49,135,2,296
216107569,17,3,2,1,23
216129070,20,13,2,1,36
216131528,53,18,2,1,74
216151938,107,27,2,2,138
216166702,54,11,31,10,106
216167187,18,7,3,1,29
216167802,92,22,18,3,135
216183850,48,26,13,1,88
216185341,219,115,24,16,374
216193855,90,19,2,4,115
216194581,148,24,31,14,217
216205295,151,3,2,5,161
216237160,20,3,2,1,26
216245075,33,69,47,63,212
216247391,146,10,12,11,179
216255632,152,14,2,31,199
216258234,191,54,3,1,249
216285556,27,9,54,1,91
216287660,125,32,2,1,160
216288596,61,14,2,1,78
216297853,105,22,2,2,131
216299476,46,55,10,8,119
216301397,48,3,2,2,55
216323551,36,12,2,21,71
216334301,264,3,2,1,270
216342591,243,7,3,1,254
216344385,54,42,2,11,109
216350817,172,4,16,12,204
216375654,91,23,18,1,133
216382064,11,3,2,1,17
216385149,89,24,2,3,118
216401736,27,3,2,1,33
216404373,27,22,2,2,53
216404694,18,6,4,1,29
216410475,38,109,27,25,199
216412018,51,30,9,17,107
216421709,32,83,11,2,128
216440791,61,5,2,4,72
216451301,25,6,2,11,44
216453352,76,12,3,1,92
216471739,125,91,28,31,275
216502983,15,5,2,4,26
216512837,233,28,3,1,265
216514932,78,28,2,1,109
216535372,130,19,3,26,178
216543805,14,3,2,1,20
216560512,11,4,2,4,21
216572380,50,28,2,41,121
216576011,25,18,2,2,47
216578512,107,4,219,6,336
216589328,138,47,43,41,269
216593214,99,3,2,10,114
216599160,39,3,2,1,45
216607231,17,3,2,1,23
216620833,33,33,6,3,75
216629659,58,3,2,1,64
216646053,14,115,129,9,267
216667270,16,37,7,2,62
216686172,31,18,2,1,52
216700631,36,30,2,20,88
216710260,148,3,2,1,154
216718883,26,34,20,26,106
216746989,28,27,3,9,67
216747510,19,3,2,1,25
216753652,42,24,2,1,69
216767711,47,59,9,4,119
216776149,19,21,2,1,43
216783746,60,37,160,1,258
216791905,89,16,2,4,111
216791970,98,83,3,2,186
216807872,44,38,13,56,151
216812057,17,13,2,1,33
216819689,14,10,2,1,27
216828521,16,3,3,7,29
216830339,32,48,3,2,85
216832336,15,17,2,1,35
216836805,113,51,8,1,173
216840296,204,24,17,1,246
216871468,55,3,2,3,63
216875709,53,15,16,1,85
216883496,74,11,8,1,94
216895755,156,3,2,9,170
216897950,37,34,9,1,81
216907673,201,83,2,7,293
216908788,50,26,2,1,79
216910068,59,3,2,1,65
216912171,21,23,16,28,88
216915698,123,42,43,15,223
216920063,10,30,2,1,43
216923102,108,24,4,15,151
216927692,18,3,2,1,24
216942938,15,3,2,1,21
216943268,10,41,2,1,54
216975703,42,24,3,4,73
216988437,74,22,58,1,155
217015678,24,45,2,1,72
217024761,23,3,2,17,45
217042156,15,9,6,1,31
217049132,16,12,2,2,32
217057039,14,13,4,6,37
217060004,11,5,2,3,21
217062228,94,54,24,20,192
217092239,45,36,25,3,109
217095006,24,44,2,4,74
217111518,102,11,6,5,124
217133097,99,18,49,17,183
217139681,28,6,2,1,37
217143976,25,23,17,1,66
217148266,30,15,14,1,60
217156049,92,4,18,10,124
217157984,138,3,2,5,148
217169838,160,13,9,5,187
217174118,134,3,2,2,141
217178172,50,28,2,5,85
217182508,25,3,2,3,33
217204207,60,3,2,2,67
217208407,67,22,12,1,102
217209292,109,3,2,1,115
217226917,25,40,17,1,83
217246435,57,3,2,1,63
217265810,42,35,2,12,91
217274120,39,38,2,30,109
217275280,24,3,3,1,31
217291892,25,20,2,10,57
217294854,93,38,59,5,195
217296729,11,3,2,1,17
217314112,41,3,2,7,53
217315616,61,7,2,5,75
217325840,35,17,6,4,62
217335228,128,13,13,1,155
217336608,68,4,2,10,84
217341418,11,3,2,4,20
217342138,46,3,2,4,55
217363278,21,3,2,3,29
217367857,158,28,4,1,191
217370051,101,4,11,1,117
217374154,120,87,56,34,297
217387372,11,3,2,1,17
217402838,205,31,19,6,261
217411164,20,13,3,1,37
217411974,26,29,24,10,89
217418575,45,30,7,19,101
217422031,11,32,17,6,66
217426091,39,25,14,1,79
217439436,13,3,2,1,19
217440944,14,13,2,1,30
217445985,53,14,21,11,99
217454691,82,31,61,8,182
217464262,125,3,2,37,167
217466344,19,3,2,1,25
217469308,140,40,80,9,269
217474823,156,3,16,1,176
217478570,58,3,2,3,66
217479864,14,14,2,1,31
217489991,119,3,2,6,130
217494430,35,3,2,1,41
217534175,99,22,22,3,146
217536262,28,44,25,14,111
217537101,68,29,2,12,111
217540058,64,15,46,1,126
217545130,58,24,2,2,86
217545828,32,46,9,8,95
217550866,11,20,2,8,41
217551521,57,3,2,1,63
217561402,49,27,7,1,84
217575782,170,6,3,29,208
217576357,155,40,2,2,199
217599112,91,30,94,15,230
217625470,86,3,2,3,94
217625858,57,50,3,15,125
217657498,42,68,2,9,121
217670898,61,26,11,4,102
217689257,67,8,2,1,78
217698593,11,5,2,2,20
217710787,64,39,2,2,107
217715739,85,9,3,3,100
217731572,53,61,2,7,123
217736404,32,19,41,13,105
217743531,40,20,64,6,130
217746595,18,28,2,1,49
217766988,93,39,22,1,155
217778249,76,17,4,1,98
217778972,120,28,2,2,152
217780421,24,12,2,10,48
217784236,32,3,2,1,38
217787138,29,3,2,1,35
217792962,47,3,2,1,53
217793387,132,52,7,4,195
217803429,200,3,2,4,209
217813137,34,3,2,1,40
217815713,29,19,13,6,67
217820669,51,11,4,1,67
217823119,30,27,2,16,75
217826233,30,3,2,3,38
217830227,31,4,2,1,38
217840624,13,6,2,2,23
217847004,131,6,2,8,147
217857205,13,3,2,1,19
217863110,11,3,2,1,17
217863693,32,21,2,4,59
217897376,60,11,15,7,93
217901109,51,27,22,11,111
217917186,28,22,2,1,53
217944204,115,3,2,12,132
217953995,28,3,2,4,37
217960280,26,3,2,1,32
217963558,80,3,2,23,108
217992810,172,60,3,4,239
218013819,14,3,2,1,20
218017681,105,21,2,1,129
218017836,66,6,8,1,81
218020529,67,3,2,57,129
218022716,76,61,7,31,175
218041928,166,59,121,5,351
218049247,85,112,32,10,239
218065636,43,3,2,2,50
218073734,365,11,5,4,385
218089579,10,3,2,5,20
218092248,74,44,28,32,178
218096153,100,26,13,34,173
218134991,137,9,2,13,161
218147346,128,25,2,2,157
218161782,70,3,2,1,76
218168215,158,52,7,1,218
218169506,47,3,2,1,53
218207665,42,32,13,9,96
218214008,10,63,2,1,76
218216440,37,48,16,15,116
218229044,29,9,2,9,49
218231996,78,62,8,2,150
218240244,26,31,22,1,80
218251830,34,14,2,2,52
218253906,14,3,2,1,20
218263052,37,32,14,11,94
218267378,11,10,76,14,111
218268697,133,55,46,41,275
218270345,97,54,16,30,197
218289690,74,29,2,1,106
218294131,22,10,9,1,42
218299836,24,3,2,1,30
218305050,99,3,3,1,106
218307196,55,30,41,12,138
218318311,16,9,2,2,29
218331041,57,63,2,1,123
218333860,10,3,3,1,17
218350481,39,15,10,1,65
218351157,215,3,2,1,221
218361868,104,44,107,1,256
218362487,40,35,19,1,95
218363278,91,40,9,50,190
218371875,90,35,16,14,155
218378262,60,20,3,2,85
218380081,10,4,2,1,17
218388195,34,12,2,8,56
218393407,170,3,2,15,190
218401643,87,35,8,1,131
218416741,99,10,12,5,126
218431822,166,3,2,1,172
218434581,145,11,2,1,159
218439510,69,32,30,7,138
218450877,53,64,21,1,139
218458984,149,62,66,22,299
218463331,14,20,2,1,37
218468352,81,20,2,2,105
218474732,16,3,2,1,22
218476611,176,42,36,4,258
218486299,71,3,2,3,79
218496331,27,13,2,1,43
218501041,20,72,24,1,117
218504329,215,65,93,19,392
218521114,102,53,64,8,227
218525006,24,16,2,1,43
218528241,19,3,2,1,25
218531422,19,3,2,7,31
218537812,84,16,2,1,103
218543040,36,16,39,4,95
218544112,96,8,55,6,165
218549278,66,16,6,10,98
218589308,10,3,2,5,20
218603248,11,3,2,1,17
218604344,52,50,63,9,174
218604569,71,6,2,20,99
218607786,38,3,2,5,48
218613681,84,37,10,21,152
218617989,50,3,2,4,59
218621486,86,14,2,13,115
218649886,98,44,2,21,165
218651478,12,20,2,1,35
218659139,12,9,2,1,24
218665338,63,6,13,6,88
218667549,24,110,34,9,177
218679880,66,28,73,1,168
218683102,10,3,2,2,17
218685774,11,3,2,1,17
218690068,74,7,19,1,101
218692778,76,9,2,9,96
218701955,19,88,3,1,111
218710237,24,12,17,1,54
218723961,62,20,3,4,89
218730430,27,7,2,1,37
218744595,21,5,2,2,30
218754268,11,3,2,3,19
218766092,117,3,2,17,139
218766777,18,35,2,3,58
218775853,58,19,51,1,129
218795241,10,3,2,3,18
218795403,10,14,2,1,27
218811880,30,19,6,4,59
218829518,23,3,6,1,33
218838536,117,30,2,1,150
218840723,24,3,2,3,32
218861458,21,3,2,1,27
218861588,67,3,2,1,73
218895046,78,25,4,4,111
218906319,83,16,2,11,112
218943282,108,62,28,1,199
218947723,64,8,32,19,123
218949225,13,3,2,2,20
218955373,78,3,8,1,90
218967620,289,3,2,1,295
219004728,10,5,2,1,18
219004804,75,3,2,2,82
219009589,55,24,11,1,91
219010201,72,3,15,1,91
219016596,153,39,81,4,277
219024059,23,33,2,7,65
219027972,67,14,3,1,85
219040358,152,44,39,29,264
219040478,94,37,6,1,138
219062298,102,3,2,13,120
219066616,63,56,2,5,126
219069058,66,29,10,5,110
219073597,16,26,2,1,45
219096921,18,3,2,3,26
219099156,101,26,2,5,134
219104793,10,14,2,1,27
219120310,75,10,2,1,88
219142743,35,20,2,3,60
219176581,100,51,21,3,175
219192382,14,41,2,1,58
219200844,47,20,3,1,71
219212279,913,3,2,19,937
219249125,45,19,48,24,136
219252471,85,40,13,3,141
219254732,14,25,2,2,43
219255995,112,34,48,17,211
219266429,34,11,2,2,49
219268755,62,17,2,2,83
219269070,43,8,4,1,56
219273212,144,8,33,1,186
219280528,182,3,2,49,236
219280821,154,3,2,1,160
219285170,37,104,2,16,159
219287814,40,4,3,5,52
219305102,46,3,2,1,52
219307114,44,37,2,1,84
219311823,81,27,30,6,144
219322574,68,49,37,10,164
219324536,20,29,5,1,55
219334247,12,8,2,6,28
219338578,72,9,2,2,85
219345320,12,36,4,1,53
219353851,12,3,2,1,18
219356467,15,13,2,1,31
219356541,78,29,76,1,184
219362330,13,11,2,1,27
219379430,156,37,2,9,204
219403538,18,3,2,1,24
219419937,115,4,4,1,124
219433453,55,3,2,1,61
219454216,37,30,30,18,115
219455416,97,3,2,2,104
219481961,104,5,7,46,162
219489066,42,38,55,10,145
219489145,44,10,2,8,64
219497500,63,34,22,30,149
219508064,20,3,2,1,26
219517854,64,3,2,1,70
219519226,60,6,2,2,70
219528249,54,33,4,13,104
219538899,28,3,2,1,34
219564333,91,18,2,2,113
219576535,101,13,4,1,119
219582513,23,3,2,7,35
219584840,10,3,2,2,17
219612600,16,3,2,1,22
219622227,80,8,2,2,92
219631839,35,23,3,1,62
219632592,22,6,2,1,31
219636507,16,86,5,1,108
219639293,17,3,2,1,23
219640146,56,3,2,5,66
219655660,62,28,4,12,106
219664845,61,12,2,5,80
219668198,26,31,17,5,79
219670858,60,22,22,28,132
219676700,57,37,51,7,152
219678601,114,23,2,2,141
219687984,13,9,5,1,28
219706191,129,3,2,1,135
219706476,46,8,2,1,57
219721609,24,8,42,1,75
219725276,31,7,2,3,43
219731612,19,10,5,2,36
219733251,14,7,2,1,24
219758275,136,3,8,5,152
219760081,103,27,3,5,138
219761523,160,16,7,18,201
219794880,73,3,2,4,82
219807096,119,43,18,12,192
219809238,66,3,2,3,74
219815672,14,3,2,1,20
219817515,78,41,4,4,127
219824872,98,79,80,13,270
219829152,26,3,2,1,32
219833579,73,5,2,3,83
219894749,92,60,4,1,157
219900561,24,24,2,12,62
219901556,11,3,2,1,17
219904256,12,3,2,1,18
219904985,38,75,11,5,129
219907334,135,24,26,1,186
219909762,23,3,2,1,29
219920070,132,51,19,15,217
219921299,73,3,2,1,79
219943114,44,12,2,4,62
219944468,190,68,17,10,285
219956338,41,57,18,2,118
219974328,41,67,55,2,165
219979125,99,3,2,1,105
220000027,19,17,2,3,41
220000477,15,3,2,1,21
220024114,155,3,2,1,161
220035721,75,9,51,2,137
220068652,48,6,17,1,72
220069141,29,44,7,1,81
220093040,67,26,4,4,101
220095075,25,4,2,5,36
220129561,10,3,2,3,18
220139883,35,36,7,6,84
220141044,14,3,2,3,22
220141375,22,3,2,1,28
220145866,171,3,2,1,177
220154969,33,3,2,1,39
220159357,34,11,7,1,53
220167650,34,25,11,13,83
220174367,127,3,2,1,133
220174812,13,6,2,1,22
220177659,43,11,2,4,60
220189158,114,3,2,3,122
220211485,65,12,4,6,87
220214626,81,15,2,1,99
220242626,68,8,2,1,79
220246161,14,3,2,5,24
220248711,75,3,4,4,86
220256790,111,46,42,14,213
220258678,13,6,6,3,28
220259716,22,12,5,1,40
220269225,10,3,2,4,19
220272811,174,3,2,11,190
220292690,183,42,25,55,305
220295215,41,40,9,1,91
220304260,147,5,3,1,156
220311627,25,20,3,6,54
220326140,61,28,2,6,97
220351872,98,46,19,8,171
220354419,48,48,13,1,110
220368342,144,3,2,3,152
220382878,11,3,2,1,17
220383272,39,24,58,9,130
220406219,67,3,2,1,73
220409642,15,44,2,1,62
220411610,40,17,3,7,67
220427457,66,8,15,14,103
220439625,61,3,16,1,81
220440172,156,35,27,18,236
220459684,42,12,2,5,61
220470533,38,3,2,2,45
220481316,176,11,134,1,322
220484113,25,79,84,1,189
220494702,98,49,14,5,166
220501545,175,3,2,1,181
220502419,157,70,24,1,252
220502459,99,21,32,35,187
220523139,59,3,2,4,68
220526605,36,3,2,1,42
220528817,45,37,14,2,98
220552920,29,53,4,4,90
220564251,28,60,5,9,102
220572390,14,3,2,1,20
220601633,131,3,2,3,139
220609489,147,41,18,4,210
220611497,10,5,2,1,18
220612336,30,3,2,1,36
220613344,108,14,8,60,190
220615400,42,36,19,4,101
220643142,123,38,7,3,171
220651746,38,31,8,18,95
220654308,18,3,2,1,24
220656776,214,3,2,2,221
220668372,129,6,10,8,153
220671034,114,35,87,8,244
220677673,43,3,2,1,49
220681240,34,46,23,1,104
220686953,447,3,2,106,558
220705804,58,8,44,9,119
220719952,84,47,18,1,150
220729929,48,183,11,3,245
220732465,16,3,2,1,22
220751302,11,4,2,1,18
220761028,82,21,59,31,193
220767248,106,25,5,3,139
220788484,127,25,30,4,186
220793386,243,5,2,1,251
220795015,12,6,2,3,23
220814034,56,3,3,3,65
220817780,83,33,115,12,243
220818160,29,4,5,4,42
220824182,11,3,2,1,17
220825084,11,3,2,3,19
220827309,79,3,2,11,95
220830156,51,6,26,9,92
220833822,176,57,24,15,272
220853323,13,5,2,1,21
220856553,21,3,2,1,27
220878171,17,50,33,8,108
220880039,57,24,6,1,88
220880366,36,21,2,5,64
220883312,64,24,2,1,91
220889648,32,22,2,7,63
220894715,78,14,2,1,95
220897389,15,19,2,1,37
220906651,31,32,2,12,77
220917059,11,4,2,1,18
220922856,97,16,2,1,116
220926994,47,3,2,1,53
220930392,88,29,28,10,155
220935457,10,7,3,1,21
220948381,34,3,21,1,59
220961203,59,18,19,3,99
220967541,22,36,2,1,61
220979595,120,3,2,1,126
220981419,84,3,2,6,95
220982630,76,3,2,1,82
220995683,43,26,16,1,86
221007190,57,20,7,6,90
221038459,40,17,8,9,74
221038952,10,5,2,1,18
221040016,28,3,2,3,36
221041597,24,4,2,1,31
221047107,21,37,2,1,61
221047473,12,7,14,1,34
221058704,27,3,2,1,33
221059756,182,3,2,12,199
221061466,32,13,7,6,58
221065971,46,17,2,1,66
221087786,49,37,12,6,104
221091815,24,3,2,1,30
221131450,51,33,2,4,90
221134484,82,3,2,5,92
221134607,14,3,2,1,20
221138439,55,36,32,2,125
221149738,56,3,2,1,62
221180035,12,3,2,3,20
221180117,137,30,2,1,170
221189030,49,20,28,1,98
221193225,72,17,4,23,116
221196999,46,26,7,1,80
221197989,85,42,39,34,200
221199045,32,13,2,7,54
221217198,72,33,20,15,140
221217292,10,10,2,1,23
221228238,116,3,2,1,122
221228470,54,11,33,6,104
221232970,46,3,2,3,54
221234014,40,10,10,15,75
221250129,93,9,2,8,112
221261255,30,3,2,1,36
221262240,33,45,2,7,87
221288112,12,6,2,2,22
221305110,144,3,2,1,150
221313476,118,3,2,6,129
221318113,63,19,25,26,133
221321779,94,28,2,4,128
221327260,37,5,2,2,46
221328312,267,3,2,18,290
221334546,47,31,10,13,101
221356650,11,3,2,1,17
221362115,10,12,2,1,25
221390841,38,30,2,3,73
221395860,42,3,2,2,49
221430727,121,3,2,1,127
221440914,46,25,27,2,100
221444148,49,23,2,1,75
221454642,78,7,2,1,88
221468713,81,6,2,1,90
221473496,63,18,6,27,114
221476540,15,6,2,1,24
221480223,203,3,2,2,210
221492729,49,38,2,1,90
221495397,206,16,3,7,232
221500064,151,37,30,15,233
221513915,52,23,50,10,135
221527263,16,14,2,1,33
221528012,68,28,31,14,141
221532073,70,14,3,1,88
221538756,45,3,2,5,55
221555143,52,57,31,6,146
221575434,33,26,16,1,76
221576380,42,90,4,29,165
221583217,75,21,2,6,104
221586387,64,3,2,1,70
221587858,33,3,2,8,46
221589928,12,3,2,1,18
221606213,55,83,33,12,183
221643892,135,3,2,13,153
221648798,36,3,2,1,42
221654208,56,75,3,11,145
221658896,52,3,2,1,58
221664229,72,9,3,15,99
221666012,31,14,11,1,57
221666335,10,3,2,7,22
221681433,108,4,2,1,115
221694566,16,3,2,1,22
221695386,49,108,19,2,178
221701152,67,3,2,4,76
221714636,444,3,2,1,450
221715489,115,28,2,1,146
221716804,72,27,2,2,103
221723697,23,62,24,2,111
221730213,20,3,2,1,26
221732483,101,8,2,2,113
221734148,66,41,36,18,161
221754989,82,8,2,1,93
221756420,178,3,2,1,184
221772921,56,239,48,17,360
221773683,27,47,61,34,169
221776290,69,33,2,4,108
221779840,13,3,3,1,20
221786477,42,44,41,3,130
221788630,12,3,2,3,20
221795888,22,3,2,1,28
221836100,39,5,2,5,51
221841782,23,26,33,9,91
221844079,24,43,14,14,95
221854429,38,16,2,2,58
221857534,118,23,42,1,184
221858441,195,30,3,1,229
221872918,60,8,8,1,77
221878868,12,3,2,1,18
221901584,84,20,27,1,132
221908800,13,3,2,3,21
221909076,118,22,32,1,173
221922274,16,18,2,5,41
221940586,69,19,15,2,105
221944112,17,3,2,1,23
221952561,92,19,14,5,130
221954851,203,23,29,8,263
221960036,10,79,2,11,102
221969442,52,39,5,11,107
221978048,35,3,2,1,41
221992516,38,4,5,1,48
221997911,10,4,2,1,17
222003812,63,14,10,11,98
222011444,14,3,2,2,21
222012831,242,10,2,3,257
222012970,62,24,5,12,103
222020711,115,6,3,1,125
222029976,78,13,2,1,94
222052187,97,25,3,2,127
222058532,100,11,8,11,130
222084812,45,29,7,4,85
222091212,105,47,9,3,164
222092123,11,3,2,1,17
222102134,40,33,20,1,94
222113748,101,6,2,2,111
222117947,11,37,2,1,51
222128084,43,3,2,1,49
222133286,16,3,2,1,22
222135124,15,3,2,1,21
222145089,67,24,2,1,94
222146172,29,22,2,38,91
222150896,15,5,2,9,31
222151421,56,58,55,1,170
222159179,20,3,2,4,29
222160392,25,3,2,2,32
222175544,88,32,3,2,125
222189445,10,12,2,1,25
222190959,131,3,2,2,138
222200787,17,3,2,3,25
222209071,74,27,58,1,160
222226904,12,3,2,2,19
222228125,71,42,24,7,144
222236242,256,3,44,2,305
222244238,28,9,2,2,41
222261768,50,28,2,3,83
222293744,21,21,2,1,45
222296672,100,64,2,2,168
222304582,67,5,2,2,76
222313931,35,55,19,2,111
222334528,74,3,2,4,83
222362453,48,29,66,47,190
222363355,47,12,2,2,63
222364070,39,3,2,1,45
222368578,144,40,23,29,236
222370359,77,3,2,1,83
222376390,12,7,2,1,22
222379497,32,22,7,2,63
222381197,23,3,2,1,29
222391089,147,3,2,4,156
222395556,47,9,2,13,71
222423427,83,3,2,1,89
222440152,20,10,2,1,33
222446658,21,3,2,1,27
222449884,20,3,2,2,27
222456929,141,21,2,9,173
222471545,25,3,2,1,31
222477286,44,17,3,22,86
222506453,43,19,2,1,65
222515736,27,11,2,1,41
222520847,23,7,2,1,33
222524733,61,3,2,1,67
222524779,106,18,83,5,212
222532645,145,10,41,1,197
222534448,16,9,2,1,28
222537211,150,43,3,6,202
222547292,70,49,7,5,131
222565915,44,3,5,3,55
222567842,66,23,3,1,93
222600344,293,60,2,18,373
222601572,72,3,2,8,85
222603020,38,3,2,1,44
222634713,3113,21,2,21,3157
222637824,47,55,98,12,212
222640421,14,3,2,1,20
222672098,96,10,3,7,116
222683517,28,3,2,1,34
222685116,20,18,2,1,41
222697099,85,4,2,2,93
222748361,89,3,2,6,100
222757361,22,37,34,3,96
222769057,130,3,2,1,136
222783003,10,5,2,1,18
222796333,49,48,16,1,114
222820448,70,13,2,1,86
222841174,140,34,103,10,287
222851522,64,3,2,1,70
222854772,193,5,16,6,220
222862133,44,3,2,1,50
222888491,47,31,7,17,102
222911000,93,23,4,17,137
222925179,13,36,2,3,54
222932630,37,36,3,5,81
222942432,40,14,40,1,95
222943263,111,22,2,13,148
222944436,15,5,2,2,24
222950289,11,3,2,1,17
222951053,49,15,7,16,87
222966523,57,3,11,1,72
222976067,20,7,2,13,42
222980865,148,26,21,1,196
222986357,68,17,21,18,124
223014464,11,3,2,1,17
223033106,112,3,2,6,123
223035551,108,24,4,10,146
223044664,19,3,2,1,25
223048191,29,8,3,1,41
223052692,91,12,48,16,167
223053096,118,23,2,5,148
223064934,28,43,2,2,75
223066648,93,3,2,1,99
223067246,117,3,2,1,123
223094305,12,6,2,1,21
223094635,14,3,2,1,20
223107291,108,9,2,3,122
223112476,12,3,17,1,33
223117064,47,3,17,2,69
223130680,79,29,64,1,173
223135913,54,14,20,13,101
223141487,10,12,2,1,25
223148827,16,3,2,1,22
223153949,151,19,32,9,211
223159550,17,14,2,1,34
223171299,112,3,2,1,118
223175357,84,69,20,41,214
223176208,18,3,2,1,24
223178687,89,18,11,4,122
223182031,19,35,2,1,57
223183689,86,11,2,8,107
223198733,95,3,2,1,101
223206788,51,50,13,7,121
223209289,36,3,2,12,53
223213645,52,3,2,1,58
223229048,16,19,3,1,39
223245551,81,20,12,1,114
223249633,18,30,2,1,51
223249867,105,3,2,2,112
223251278,104,32,34,18,188
223261563,26,19,2,1,48
223282409,94,111,55,59,319
223288019,97,3,2,13,115
223312125,121,39,36,2,198
223331906,62,52,40,8,162
223337709,11,3,2,1,17
223341111,71,3,2,2,78
223341556,31,7,2,1,41
223342623,10,4,2,1,17
223351316,97,17,2,1,117
223359526,190,16,2,1,209
223359651,31,64,2,3,100
223366686,108,17,2,1,128
223367571,18,16,3,1,38
223390355,83,8,2,3,96
223390994,96,16,19,1,132
223406494,33,3,2,1,39
223408077,14,3,2,1,20
223418928,54,54,10,1,119
223426266,109,43,26,8,186
223448260,158,3,2,1,164
223462009,144,62,19,17,242
223502134,33,75,2,1,111
223550741,46,16,2,1,65
223560494,32,17,11,21,81
223570476,40,34,21,2,97
223603712,120,17,24,8,169
223608683,168,97,4,5,274
223629818,74,5,49,11,139
223630983,12,3,2,1,18
223654771,25,5,2,1,33
223672123,28,25,2,8,63
223678016,16,14,2,5,37
223699749,69,56,2,1,128
223716688,92,34,2,1,129
223732455,55,52,37,2,146
223735019,28,3,2,1,34
223739281,49,18,2,1,70
223749405,13,3,2,1,19
223752888,11,4,2,1,18
223755770,12,3,2,1,18
223760242,25,3,2,14,44
223770442,28,11,6,2,47
223791626,178,3,2,1,184
223791806,21,9,2,1,33
223795419,38,18,8,20,84
223807188,134,51,9,24,218
223815877,195,31,22,8,256
223826682,14,3,2,1,20
223834010,47,3,2,1,53
223842361,22,3,2,1,28
223856381,104,3,3,2,112
223881706,188,44,22,8,262
223885425,212,32,32,1,277
223911486,10,3,2,5,20
223926883,46,45,47,23,161
223927365,131,20,3,10,164
223957379,48,12,2,8,70
223973537,92,11,5,4,112
223973687,20,3,2,1,26
223978792,19,59,41,1,120
223979298,88,10,9,22,129
223988819,45,60,68,1,174
223992872,119,52,57,28,256
224008190,117,12,2,1,132
224010572,155,5,3,32,195
224030712,255,17,53,16,341
224031214,78,3,2,4,87
224035669,43,7,2,1,53
224040313,22,16,2,1,41
224041828,124,47,45,13,229
224064001,104,43,13,2,162
224089665,87,18,2,3,110
224113091,140,3,2,11,156
224126234,50,5,2,2,59
224158012,12,3,2,1,18
224171277,136,40,164,10,350
224180958,14,5,3,1,23
224199918,129,61,41,6,237
224206540,53,23,13,14,103
224222235,15,13,2,19,49
224248775,11,3,5,1,20
224253837,75,7,2,4,88
224253857,77,35,31,23,166
224257565,230,6,18,39,293
224262940,145,3,2,7,157
224285181,69,3,2,3,77
224290569,105,37,70,5,217
224296895,98,19,2,8,127
224306629,31,3,2,1,37
224310447,76,3,2,1,82
224318263,96,3,2,6,107
224333344,41,3,2,20,66
224352470,22,48,17,1,88
224357707,88,53,4,2,147
224397919,150,51,4,1,206
224415424,93,3,2,2,100
224426634,46,4,2,1,53
224435066,25,5,3,22,55
224435350,43,83,33,8,167
224436134,11,3,2,1,17
224438304,68,50,39,31,188
224441910,41,6,2,3,52
224445825,15,3,2,1,21
224455556,131,16,2,3,152
224458824,10,3,2,3,18
224469902,30,3,2,1,36
224488196,42,5,2,1,50
224499174,33,3,2,4,42
224500170,48,49,37,2,136
224504557,134,66,30,4,234
224515175,48,21,3,7,79
224518028,23,15,2,1,41
224527713,137,3,2,16,158
224534879,73,20,2,30,125
224540491,58,22,3,3,86
224540994,11,3,2,6,22
224551023,10,35,2,1,48
224553747,99,3,2,1,105
224556299,57,28,49,16,150
224563757,37,12,2,1,52
224567775,48,28,41,38,155
224574437,130,19,2,2,153
224581720,139,53,141,14,347
224583896,84,32,2,7,125
224585575,82,3,2,4,91
224606612,51,9,11,8,79
224607464,198,46,2,13,259
224621032,103,21,21,8,153
224622895,17,11,6,1,35
224627839,79,82,31,4,196
224666989,58,28,26,5,117
224671362,51,40,2,13,106
224673306,95,29,2,2,128
224682958,17,61,2,2,82
224684389,32,6,2,4,44
224685992,37,67,2,1,107
224692269,232,3,2,1,238
224700671,53,15,4,1,73
224714798,194,27,66,1,288
224737622,27,22,3,1,53
224741648,52,16,2,1,71
224747146,30,3,2,1,36
224751566,11,3,2,1,17
224760332,52,3,2,1,58
224779229,21,3,2,1,27
224779874,32,28,2,15,77
224785017,124,9,2,1,136
224786439,21,3,2,1,27
224787271,48,3,2,3,56
224797635,18,3,2,2,25
224803994,117,70,104,3,294
224808456,119,39,18,3,179
224813274,73,43,13,5,134
224839791,140,52,21,2,215
224847475,13,12,2,1,28
224853720,51,15,2,1,69
224857741,127,35,14,69,245
224871041,48,49,8,1,106
224871909,116,14,35,3,168
224894877,72,35,8,31,146
224908560,43,10,36,4,93
224934085,71,33,10,40,154
224945630,38,30,28,16,112
224953373,112,33,3,34,182
224955620,80,3,2,2,87
224964709,79,63,15,24,181
224973161,43,13,2,1,59
224975883,66,13,2,1,82
224980200,37,22,2,1,62
224985914,114,28,2,7,151
224988764,60,22,11,1,94
224989880,10,4,2,1,17
224991157,23,3,2,2,30
225009522,110,50,44,2,206
225014988,17,34,2,1,54
225024053,79,3,2,1,85
225025311,144,3,2,7,156
225038395,11,6,2,3,22
225042997,12,5,3,1,21
225043250,74,5,2,10,91
225044189,15,3,2,1,21
225046305,10,3,2,2,17
225051099,47,26,26,7,106
225056477,99,9,52,18,178
225075886,14,44,2,1,61
225095226,13,3,2,3,21
225129215,21,21,2,7,51
225132662,429,3,2,2,436
225132929,89,52,5,1,147
225143518,67,67,37,18,189
225169443,85,14,2,3,104
225200046,10,4,2,1,17
225205171,95,5,102,6,208
225206466,154,40,2,7,203
225208298,131,30,15,25,201
225213699,21,3,2,1,27
225213700,108,17,21,44,190
225219444,41,11,2,1,55
225233205,11,9,2,1,23
225252019,10,5,2,1,18
225258819,16,15,2,11,44
225283211,10,6,2,1,19
225295167,130,17,2,3,152
225296260,16,3,2,1,22
225305416,91,40,15,9,155
225322688,13,7,3,29,52
225325136,48,13,2,6,69
225325614,162,14,38,1,215
225336340,12,8,3,3,26
225339691,61,20,5,13,99
225341627,21,6,2,7,36
225348419,84,21,9,7,121
225348892,78,3,3,1,85
225353013,82,29,13,2,126
225358570,10,5,2,2,19
225366573,24,3,2,3,32
225377007,142,3,2,4,151
225379105,36,4,3,1,44
225389425,23,11,2,1,37
225394944,201,36,39,1,277
225395863,65,15,2,19,101
225400347,10,4,2,1,17
225403782,83,31,2,1,117
225408605,12,3,2,1,18
225425550,160,19,120,3,302
225430213,58,3,2,5,68
225441299,110,3,2,1,116
225460092,111,3,2,2,118
225464459,53,3,11,1,68
225465470,33,16,31,13,93
225485856,11,3,2,1,17
225491669,38,3,12,1,54
225504868,105,3,2,3,113
225507754,88,27,44,26,185
225519467,95,3,2,1,101
225522371,28,24,2,11,65
225524218,126,3,2,3,134
225552750,22,3,2,1,28
225555226,92,34,40,6,172
225555684,145,20,2,8,175
225586116,13,6,2,1,22
225590898,34,13,3,1,51
225595203,12,5,2,1,20
225603626,20,14,2,2,38
225609935,13,3,2,1,19
225617163,21,9,10,2,42
225619753,20,3,2,1,26
225626904,12,3,2,1,18
225657135,35,48,2,3,88
225659003,10,5,2,2,19
225659807,14,4,2,4,24
225670764,78,55,23,4,160
225672590,14,72,15,3,104
225675882,51,51,23,4,129
225676587,110,11,3,1,125
225687173,69,71,31,10,181
225689978,73,11,28,1,113
225724564,21,21,11,1,54
225726954,14,7,4,1,26
225739308,50,44,64,1,159
225743167,63,33,16,11,123
225764493,78,8,8,4,98
225766630,27,49,3,7,86
225771682,43,83,55,3,184
225794598,79,13,2,3,97
225812843,38,62,2,1,103
225825222,39,3,2,1,45
225837850,135,52,95,32,314
225838502,79,27,8,1,115
225838673,25,3,2,1,31
225839359,162,21,72,1,256
225840270,11,3,2,1,17
225849645,60,35,3,1,99
225853259,66,14,2,3,85
225857653,40,32,2,3,77
225859001,56,9,8,2,75
225864322,29,30,12,1,72
225878053,223,13,2,4,242
225888171,23,24,2,8,57
225889322,37,3,2,5,47
225889502,14,3,2,1,20
225901980,59,53,17,34,163
225909983,29,5,5,1,40
225931722,60,28,24,11,123
225936247,10,8,2,1,21
225945986,20,25,14,3,62
225947024,67,46,16,1,130
225962042,56,3,2,7,68
225964850,67,3,14,65,149
225977161,50,17,2,3,72
225982055,65,22,48,20,155
226000769,155,35,45,4,239
226003735,76,56,23,6,161
226031706,10,16,2,1,29
226032818,10,15,2,1,28
226073144,144,36,2,14,196
226090448,15,3,2,1,21
226090529,14,4,2,5,25
226091656,98,32,116,21,267
226093013,10,11,2,1,24
226098118,10,32,2,2,46
226104537,160,3,73,5,241
226116254,10,13,2,1,26
226122365,41,67,47,9,164
226128357,25,28,2,1,56
226141755,72,8,18,2,100
226150168,36,27,8,18,89
226178683,282,81,72,2,437
226181904,16,3,2,1,22
226182383,61,3,19,1,84
226212385,11,3,2,2,18
226221058,58,72,6,11,147
226225790,113,3,2,1,119
226232625,58,33,4,3,98
226234338,28,13,2,25,68
226237062,106,3,2,2,113
226252786,70,25,17,5,117
226272419,24,3,2,3,32
226290627,84,16,2,3,105
226350275,31,3,2,6,42
226364753,46,3,2,3,54
226379918,141,19,4,11,175
226404151,54,3,2,2,61
226408847,17,56,52,11,136
226413027,17,3,2,1,23
226426928,88,10,52,1,151
226460572,95,4,31,1,131
226461814,59,30,14,29,132
226464402,110,25,3,6,144
226495838,11,3,2,2,18
226507519,108,3,2,1,114
226526603,174,3,2,1,180
226528846,20,23,25,3,71
226530571,73,65,13,3,154
226541787,63,4,2,4,73
226545332,78,12,25,1,116
226562856,48,3,2,1,54
226568655,31,11,2,1,45
226569087,15,3,2,1,21
226580800,86,26,12,4,128
226593576,64,43,79,2,188
226595714,19,3,2,2,26
226604886,308,3,2,21,334
226631352,10,6,5,1,22
226634788,39,18,4,1,62
226650580,40,13,2,1,56
226650603,14,3,2,1,20
226651025,19,8,2,1,30
226652266,21,37,4,2,64
226665824,61,9,2,1,73
226673023,58,45,5,2,110
226692052,120,3,2,14,139
226701952,156,3,2,1,162
226704140,140,12,2,3,157
226714626,66,45,2,1,114
226723673,56,15,5,37,113
226739712,156,14,51,1,222
226745899,89,30,2,10,131
226752515,73,5,2,1,81
226758611,90,3,2,2,97
226766419,70,29,25,7,131
226797524,27,30,19,41,117
226805683,16,8,2,4,30
226810965,152,37,7,5,201
226812024,27,10,2,2,41
226814573,53,20,30,1,104
226832987,49,20,2,1,72
226843523,65,22,18,1,106
226853746,61,11,3,1,76
226863855,48,3,2,4,57
226880751,14,3,2,1,20
226891830,72,10,4,2,88
226899202,16,28,2,5,51
226902949,47,27,2,43,119
226907178,194,11,2,2,209
226913564,39,38,10,11,98
226914263,32,18,2,5,57
226922104,23,3,2,1,29
226924037,61,3,2,2,68
226945320,51,3,2,2,58
226959637,73,18,2,5,98
226960740,25,29,9,10,73
226967665,80,5,16,13,114
226985227,33,30,2,10,75
227003981,45,20,2,1,68
227014148,70,3,2,1,76
227018203,24,3,2,1,30
227023650,135,38,25,4,202
227036410,185,44,19,15,263
227045573,31,3,2,4,40
227064817,48,65,2,3,118
227082150,29,22,21,8,80
227083059,62,14,2,1,79
227083934,22,25,5,1,53
227088685,19,5,2,2,28
227101729,42,8,2,2,54
227106493,23,32,36,7,98
227111878,11,4,2,3,20
227112780,55,13,7,7,82
227113534,11,5,2,1,19
227129188,125,45,15,1,186
227142426,285,3,2,3,293
227165804,139,13,29,8,189
227177709,93,11,2,1,107
227192299,67,3,2,1,73
227198151,59,3,2,3,67
227199395,74,27,26,8,135
227217945,48,125,46,11,230
227234333,117,38,2,2,159
227234893,104,22,45,8,179
227247904,81,8,2,1,92
227256329,54,4,2,3,63
227266129,67,57,2,2,128
227273240,33,6,2,7,48
227292882,58,17,17,4,96
227299079,18,3,2,1,24
227305810,10,7,2,1,20
227310541,34,3,2,6,45
227324407,27,27,2,2,58
227338590,15,3,2,1,21
227344906,55,32,21,14,122
227355471,10,7,2,1,20
227377735,49,20,17,2,88
227380914,37,29,41,1,108
227393913,13,19,2,2,36
227394217,27,63,2,18,110
227401071,42,18,46,2,108
227402121,64,3,2,2,71
227418516,13,3,2,1,19
227420119,14,3,2,1,20
227422689,47,3,2,3,55
227444327,11,7,9,1,28
227457572,121,20,6,2,149
227470189,62,3,2,1,68
227484684,24,3,2,1,30
227486065,26,61,17,9,113
227501063,40,4,27,1,72
227516109,21,3,2,1,27
227518371,14,3,2,1,20
227524465,82,80,35,256,453
227535199,49,3,2,1,55
227539469,39,35,2,13,89
227544457,13,3,2,1,19
227553039,49,34,5,1,89
227568019,89,40,71,8,208
227582580,14,3,2,2,21
227594708,209,3,2,1,215
227597061,101,22,58,13,194
227600452,25,5,40,1,71
227604937,133,45,2,41,221
227635841,22,40,7,17,86
227639556,56,3,5,4,68
227642085,67,3,2,1,73
227647453,53,3,2,14,72
227654984,57,3,2,1,63
227671816,170,3,2,12,187
227684255,17,3,2,1,23
227709997,13,5,2,1,21
227715577,109,3,2,9,123
227740014,232,59,18,76,385
227743475,117,13,3,1,134
227755901,95,3,2,1,101
227765993,55,3,2,1,61
227773103,35,30,13,5,83
227798415,67,23,3,13,106
227814730,15,3,2,9,29
227821182,10,5,2,1,18
227851553,35,16,27,9,87
227852672,96,3,2,2,103
227852851,53,60,12,2,127
227856411,107,6,22,2,137
227858656,84,3,2,2,91
227884950,96,3,2,1,102
227902592,60,13,2,1,76
227913203,87,3,2,1,93
227919385,31,34,2,1,68
227934703,68,16,27,3,114
227934796,92,15,2,1,110
227962790,15,4,2,4,25
227984094,84,14,3,7,108
228014333,10,5,2,2,19
228018959,10,8,3,1,22
228047987,41,15,2,2,60
228056849,26,4,2,1,33
228090042,99,28,3,12,142
228091925,32,3,2,1,38
228092448,12,3,2,1,18
228098047,10,3,2,2,17
228106730,65,13,3,1,82
228138977,17,3,2,1,23
228144254,28,3,2,3,36
228146596,116,11,33,2,162
228154700,112,3,2,1,118
228156368,14,3,2,1,20
228164353,105,5,2,1,113
228178070,64,35,23,4,126
228189885,30,5,2,2,39
228191351,13,3,2,1,19
228208677,74,25,13,1,113
228218256,124,19,2,23,168
228226119,17,5,2,1,25
228244946,31,10,2,1,44
228253631,35,23,2,4,64
228257327,134,25,18,2,179
228260527,64,3,2,5,74
228262594,13,3,2,2,20
228275040,46,103,2,5,156
228281887,13,6,2,1,22
228293332,93,9,2,7,111
228293771,20,9,3,20,52
228295916,62,7,2,1,72
228332675,216,24,11,1,252
228334449,94,55,82,1,232
228337419,169,24,2,1,196
228339495,52,3,2,1,58
228346758,13,3,2,1,19
228365585,112,40,25,14,191
228370298,102,29,5,1,137
228376308,94,21,19,1,135
228377990,99,5,104,5,213
228385494,87,3,2,46,138
228387530,54,3,2,1,60
228387688,12,5,2,1,20
228397844,152,76,6,1,235
228400837,26,19,2,3,50
228415178,47,23,4,3,77
228422912,16,47,2,1,66
228425087,27,3,2,1,33
228427411,49,33,2,5,89
228428305,122,6,2,3,133
228431359,38,40,5,2,85
228434170,26,22,3,2,53
228435125,79,9,19,1,108
228444717,11,6,2,1,20
228460653,26,12,14,5,57
228461625,10,4,2,2,18
228463905,145,3,4,65,217
228499561,77,3,2,1,83
228500885,106,18,2,3,129
228501851,28,3,2,1,34
228506670,67,23,2,5,97
228515258,172,12,2,5,191
228537068,141,69,100,1,311
228563526,60,3,2,1,66
228571123,39,30,2,1,72
228583776,45,47,4,1,97
228592806,18,24,2,1,45
228593661,123,3,2,13,141
228594456,46,3,2,6,57
228605215,29,17,5,1,52
228607536,31,31,2,4,68
228612360,16,3,2,1,22
228614383,13,10,2,1,26
228624163,18,12,2,1,33
228637172,102,38,40,4,184
228647456,119,3,2,2,126
228651336,71,3,2,1,77
228658307,63,35,47,3,148
228658581,21,12,2,1,36
228669200,11,40,2,1,54
228670815,80,69,3,1,153
228679501,11,8,2,1,22
228698604,89,83,56,27,255
228708335,90,3,2,1,96
228717210,97,29,16,4,146
228721324,15,9,4,1,29
228725477,44,9,48,31,132
228735827,14,3,2,2,21
228736117,21,3,2,1,27
228754602,71,18,12,1,102
228756141,107,31,78,4,220
228763195,187,3,50,2,242
228763775,112,3,2,8,125
228767585,63,15,2,1,81
228781286,11,3,2,1,17
228783350,31,3,2,5,41
228808864,207,7,74,9,297
228813539,15,54,43,17,129
228846370,96,4,2,2,104
228863819,28,3,2,1,34
228869760,15,3,2,1,21
228873375,30,98,79,16,223
228877483,12,68,2,1,83
228890883,25,12,2,2,41
228914224,12,23,14,2,51
228917166,119,3,2,1,125
228920110,15,3,2,1,21
228925124,118,6,54,13,191
228927393,10,5,2,3,20
228944874,80,17,9,14,120
228962042,18,3,2,5,28
228968865,27,6,2,1,36
228991826,41,34,25,16,116
228999494,23,38,18,3,82
229001161,12,12,2,1,27
229008779,30,11,2,1,44
229009641,53,3,2,4,62
229026444,82,8,49,14,153
229035711,74,36,64,10,184
229044256,78,9,2,3,92
229047666,587,3,2,1,593
229049544,31,14,2,1,48
229052218,11,3,2,1,17
229053438,14,3,2,1,20
229056279,16,36,2,1,55
229067488,45,3,2,1,51
229069789,11,3,2,1,17
229072744,15,3,2,1,21
229092682,15,3,2,1,21
229099346,11,20,2,1,34
229102925,19,43,6,5,73
229105036,171,43,41,5,260
229106563,54,10,13,2,79
229109841,50,3,2,1,56
229123391,88,48,5,6,147
229133700,176,3,2,2,183
229153892,700,3,2,17,722
229158540,227,49,33,49,358
229168402,16,3,2,1,22
229179358,130,67,3,8,208
229184091,37,3,2,1,43
229188011,12,3,2,1,18
229188144,152,9,52,4,217
229196163,44,30,3,8,85
229206619,19,3,2,1,25
229206630,150,3,2,2,157
229219198,132,48,2,199,381
229225464,23,3,2,2,30
229231812,56,41,6,3,106
229237213,52,9,3,1,65
229243382,87,47,6,5,145
229259519,36,50,25,1,112
229263960,42,22,18,4,86
229276277,17,17,2,1,37
229312402,21,9,2,3,35
229325525,25,3,2,3,33
229330280,13,30,2,1,46
229352929,31,73,2,2,108
229378372,18,3,2,1,24
229385767,18,8,2,1,29
229396579,28,3,2,2,35
229410245,15,3,2,3,23
229416337,27,58,64,45,194
229419946,14,3,2,1,20
229425856,120,17,2,1,140
229432634,22,3,2,1,28
229433483,18,3,2,1,24
229437736,73,3,2,3,81
229443571,95,55,2,1,153
229454455,15,13,12,9,49
229455791,26,19,34,1,80
229459780,19,22,2,23,66
229465659,45,37,2,1,85
229487919,140,3,2,15,160
229490318,57,38,16,20,131
229499324,23,3,2,2,30
229508546,20,3,2,8,33
229510245,43,28,12,1,84
229515066,25,3,2,1,31
229527481,173,16,2,9,200
229529035,13,3,2,6,24
229529435,188,19,14,9,230
229531878,128,3,2,18,151
229536878,126,88,2,8,224
229536945,17,5,2,1,25
229551525,60,21,69,57,207
229553421,16,11,2,2,31
229555619,23,3,2,1,29
229558126,11,3,2,1,17
229561416,77,15,2,3,97
229563775,48,3,2,1,54
229578300,24,5,2,1,32
229582315,78,29,11,18,136
229587073,58,43,114,28,243
229598123,108,31,39,2,180
229611465,184,31,2,9,226
229611676,48,51,21,1,121
229612785,19,3,2,4,28
229614068,62,3,2,1,68
229615955,49,3,15,1,68
229617078,10,5,2,1,18
229620299,132,35,34,7,208
229637421,126,37,60,18,241
229641087,82,21,35,11,149
229652005,46,22,2,13,83
229653555,20,41,27,1,89
229661200,102,51,74,1,228
229676623,14,3,2,2,21
229677551,44,39,12,4,99
229677653,133,27,4,1,165
229678094,92,37,2,1,132
229688789,64,3,2,1,70
229689179,56,14,2,3,75
229694818,72,3,16,1,92
229710551,42,4,2,1,49
229715346,96,96,43,5,240
229716104,61,65,39,8,173
229718521,66,23,18,4,111
229723455,14,7,2,4,27
229731382,37,3,2,3,45
229732099,56,3,2,9,70
229744044,15,19,2,1,37
229763971,148,101,15,4,268
229774245,98,15,34,37,184
229808946,60,71,47,87,265
229821977,20,3,2,1,26
229826026,151,4,57,40,252
229829322,68,13,12,1,94
229829742,102,15,32,5,154
229837413,53,38,3,5,99
229840015,18,9,11,19,57
229850127,41,8,37,24,110
229852226,74,13,67,3,157
229855341,20,58,2,3,83
229865968,44,7,2,1,54
229876835,31,33,5,8,77
229915280,48,3,2,1,54
229919084,21,7,2,8,38
229932245,148,17,2,1,168
229949362,72,22,2,1,97
229983074,15,9,2,1,27
229996420,139,46,17,4,206
230001387,35,28,2,1,66
230031786,25,31,8,1,65
230047079,82,13,2,9,106
230056860,12,5,2,1,20
230061033,124,18,39,7,188
230064620,79,21,17,8,125
230080893,16,3,2,1,22
230081484,16,3,2,3,24
230094679,86,7,4,5,102
230105136,46,8,3,19,76
230126850,46,8,32,1,87
230132808,16,3,2,1,22
230148716,83,34,2,3,122
230152385,15,22,2,5,44
230173046,105,7,4,7,123
230177023,12,3,2,1,18
230189216,17,11,2,2,32
230190398,47,47,29,10,133
230193520,119,36,2,2,159
230200361,43,4,2,1,50
230201358,38,38,24,1,101
230206886,45,3,2,13,63
230207521,99,10,2,1,112
230212287,10,3,2,2,17
230217060,42,10,2,1,55
230218602,103,3,2,7,115
230219497,87,3,2,12,104
230243121,86,42,2,1,131
230268165,167,6,4,1,178
230275793,983,3,2,60,1048
230285589,80,22,2,13,117
230286466,82,14,2,1,99
230306642,35,3,2,1,41
230313198,54,3,2,3,62
230317526,157,64,52,26,299
230326217,107,35,2,1,145
230332137,21,4,2,1,28
230337861,87,3,2,6,98
230366323,55,3,4,1,63
230378678,30,12,11,9,62
230383164,99,3,28,2,132
230389369,127,29,2,4,162
230403222,87,75,64,13,239
230427907,231,3,2,1,237
230442015,14,29,28,3,74
230444390,10,6,2,1,19
230452096,72,15,4,1,92
230454123,15,32,17,1,65
230462678,66,3,2,1,72
230478513,122,37,14,11,184
230491939,97,14,3,1,115
230496866,51,21,21,1,94
230498162,19,3,2,2,26
230517527,22,3,2,1,28
230538647,117,31,7,2,157
230551118,78,32,13,1,124
230553662,32,14,48,6,100
230556259,10,9,2,1,22
230575787,40,31,74,4,149
230577834,24,19,3,1,47
230579338,178,28,2,6,214
230586668,34,24,14,2,74
230590739,13,3,2,1,19
230591037,23,4,6,4,37
230593905,102,11,37,2,152
230595406,10,4,2,1,17
230596311,93,10,2,2,107
230596585,148,29,91,7,275
230613733,10,3,2,15,30
230642869,53,38,41,1,133
230645404,43,32,14,23,112
230650776,52,39,28,2,121
230654995,37,3,2,9,51
230664373,20,74,11,1,106
230666072,30,12,5,10,57
230672784,13,3,2,1,19
230680013,10,4,2,1,17
230682493,21,3,2,1,27
230726052,10,5,2,1,18
230726455,74,3,2,1,80
230730119,45,15,8,51,119
230735021,14,3,2,1,20
230753420,21,3,2,4,30
230770405,19,3,2,1,25
230777984,96,25,19,18,158
230783223,108,118,2,5,233
230790509,115,12,2,1,130
230803209,177,9,2,1,189
230805034,18,3,2,6,29
230811992,63,46,75,18,202
230827185,50,32,2,1,85
230835028,40,3,2,1,46
230835861,111,3,2,1,117
230836598,59,7,2,1,69
230839443,46,8,2,2,58
230849480,53,3,2,1,59
230850190,63,3,2,1,69
230860858,59,46,16,14,135
230867534,16,3,2,1,22
230871904,105,60,23,1,189
230881442,21,4,4,1,30
230896119,40,37,19,21,117
230899992,12,3,2,1,18
230921602,148,19,3,1,171
230931744,14,9,2,1,26
230938302,219,3,2,1,225
230943760,40,20,2,4,66
230955673,84,57,2,1,144
230985302,18,56,11,1,86
230986120,196,47,4,15,262
230987489,82,11,41,1,135
230988029,12,14,2,5,33
230988431,33,3,2,1,39
231017264,64,20,19,18,121
231018777,21,21,35,1,78
231019936,64,14,2,10,90
231022067,54,5,2,7,68
231025349,32,5,2,5,44
231037431,57,23,2,1,83
231038265,122,27,51,21,221
231052554,16,3,2,3,24
231055559,126,29,2,9,166
231056011,10,15,2,1,28
231057821,67,26,2,9,104
231064841,40,3,2,1,46
231090484,15,37,2,1,55
231092349,17,14,2,3,36
231115684,20,3,2,1,26
231117779,131,18,26,13,188
231139447,66,3,2,6,77
231144979,47,47,10,8,112
231152556,80,3,2,1,86
231168475,44,15,36,3,98
231168718,124,20,2,9,155
231169891,88,3,2,14,107
231171746,52,20,58,3,133
231175097,61,3,2,1,67
231183995,61,3,6,2,72
231185189,10,3,2,3,18
231189725,30,15,11,7,63
231212762,51,104,9,29,193
231218324,61,9,6,3,79
231232857,18,5,2,5,30
231239940,12,3,2,1,18
231241460,39,23,2,3,67
231272697,18,3,2,4,27
231277206,57,25,36,6,124
231277293,64,31,73,25,193
231277820,45,33,81,2,161
231277905,40,3,2,1,46
231291913,115,25,80,7,227
231297364,75,32,24,2,133
231300683,101,3,2,3,109
231303129,46,36,2,1,85
231303467,44,11,2,1,58
231308637,23,3,2,1,29
231308708,20,3,2,1,26
231325608,85,10,2,23,120
231366263,28,3,2,1,34
231393039,36,17,47,7,107
231395404,10,7,2,1,20
231418253,110,18,2,3,133
231424593,86,54,27,28,195
231426477,17,77,57,1,152
231443118,58,3,2,1,64
231456242,11,3,2,1,17
231465361,70,5,2,1,78
231475074,44,3,2,2,51
231484358,26,17,2,1,46
231495812,27,16,3,3,49
231496817,87,32,12,3,134
231497992,10,24,2,1,37
231498996,46,37,4,1,88
231506376,10,12,2,1,25
231518181,51,41,12,26,130
231523025,16,42,2,1,61
231543964,131,49,63,1,244
231565030,225,3,2,3,233
231570761,157,18,11,5,191
231583555,69,16,2,4,91
231584007,163,13,6,13,195
231587517,49,54,24,37,164
231593626,35,15,39,18,107
231598344,120,30,13,4,167
231602574,94,53,44,2,193
231612701,95,3,2,1,101
231637618,106,51,74,9,240
231661082,36,16,9,2,63
231709601,88,14,19,10,131
231718533,10,4,2,1,17
231726333,51,3,2,33,89
231726517,28,12,2,4,46
231749983,38,3,2,8,51
231751187,22,6,2,4,34
231753349,13,10,2,4,29
231758332,48,3,2,1,54
231762672,12,40,2,1,55
231782358,35,17,2,24,78
231799841,44,18,9,1,72
231806397,13,4,2,1,20
231809902,84,10,3,1,98
231824147,20,3,2,1,26
231830791,22,3,2,1,28
231838729,98,39,28,62,227
231838796,26,12,2,1,41
231853362,217,49,47,40,353
231861659,133,66,25,4,228
231868990,45,17,19,8,89
231869599,25,7,2,1,35
231878074,74,3,2,7,86
231879130,66,67,2,5,140
231889406,93,34,19,3,149
231919718,17,3,2,1,23
231936682,168,44,2,1,215
231944974,127,9,7,12,155
231969125,128,3,2,24,157
231976936,107,28,32,5,172
231979834,689,3,2,6,700
231980783,160,3,2,1,166
231988230,70,66,93,16,245
231993017,10,3,3,1,17
231995798,20,3,2,1,26
231997123,104,15,3,3,125
231999937,52,3,2,1,58
232002170,90,3,2,3,98
232014386,47,3,2,1,53
232014704,102,12,6,7,127
232032336,61,61,13,29,164
232040366,16,3,2,1,22
232054344,45,44,16,2,107
232065216,105,17,69,5,196
232068080,112,45,4,30,191
232071680,71,14,2,2,89
232071781,79,13,12,1,105
232080352,103,7,84,9,203
232087014,37,38,28,1,104
232107572,35,24,13,3,75
232109308,59,11,2,6,78
232120263,33,3,2,12,50
232127579,74,14,3,5,96
232130761,73,3,2,23,101
232138218,67,16,3,7,93
232147190,129,19,12,4,164
232164707,13,21,2,3,39
232177297,10,4,2,1,17
232180774,23,60,26,4,113
232181139,55,68,4,10,137
232196541,28,16,21,54,119
232205974,13,3,2,1,19
232206286,102,3,2,8,115
232217543,37,25,30,1,93
232219852,57,13,21,10,101
232231208,160,22,19,3,204
232233377,36,16,3,4,59
232240678,11,5,2,1,19
232242238,47,3,2,1,53
232262077,10,21,2,1,34
232269154,111,3,6,1,121
232274828,117,55,62,16,250
232276767,155,3,2,1,161
232277946,71,10,5,34,120
232278654,17,26,2,1,46
232298334,76,7,3,28,114
232331245,120,16,2,1,139
232352358,132,30,10,6,178
232358051,80,26,4,13,123
232360444,19,13,3,3,38
232365770,16,18,2,1,37
232376805,17,42,2,1,62
232381139,53,30,2,3,88
232381345,84,17,58,1,160
232397248,56,19,2,21,98
232413808,98,3,2,1,104
232428215,32,71,6,7,116
232428975,15,12,2,1,30
232443657,46,34,35,102,217
232447556,34,26,2,1,63
232448903,37,12,2,1,52
232457001,111,3,2,4,120
232461684,84,38,2,1,125
232463072,34,5,6,1,46
232470819,21,22,3,1,47
232503119,40,18,6,4,68
232506537,71,53,2,1,127
232526329,44,29,3,1,77
232529158,99,33,97,1,230
232529532,15,3,2,1,21
232550790,36,40,21,45,142
232555539,44,11,2,1,58
232564306,82,5,2,2,91
232564371,51,48,16,10,125
232572096,11,3,2,1,17
232578259,25,3,2,1,31
232582569,81,22,30,1,134
232584856,10,10,2,1,23
232587316,51,16,23,1,91
232588216,69,3,2,2,76
232598244,59,3,2,12,76
232598966,21,3,2,8,34
232617983,58,6,30,4,98
232623554,114,29,6,23,172
232633600,31,3,2,1,37
232653036,60,3,2,2,67
232687142,81,27,27,13,148
232696757,204,3,2,1,210
232698158,163,3,2,1,169
232708207,174,39,19,41,273
232724429,16,18,35,1,70
232728666,97,21,79,52,249
232735252,82,6,2,1,91
232745731,77,37,2,6,122
232767565,143,37,26,6,212
232786046,142,97,14,7,260
232795253,12,3,2,1,18
232810967,70,32,8,1,111
232816900,82,21,16,11,130
232830575,55,13,2,3,73
232843835,35,18,25,3,81
232856013,95,37,45,3,180
232864320,23,4,2,6,35
232870608,65,14,2,1,82
232893038,53,19,26,23,121
232899448,12,35,2,1,50
232905961,19,14,2,1,36
232925787,39,3,2,5,49
232926261,10,4,2,2,18
232927645,13,3,2,1,19
232931837,126,15,2,1,144
232940439,77,15,2,2,96
232967145,39,49,3,5,96
232974115,40,3,2,1,46
232978846,110,3,2,1,116
232986793,97,10,3,7,117
232987480,63,22,2,7,94
232987585,25,37,23,1,86
232988527,19,12,2,5,38
233007479,136,56,47,1,240
233022731,127,17,2,13,159
233025705,27,3,2,1,33
233033075,71,19,2,7,99
233049545,138,3,2,8,151
233060616,17,13,3,1,34
233064018,72,3,2,1,78
233067861,79,35,38,1,153
233081408,56,11,86,26,179
233083371,25,6,2,2,35
233083735,72,13,6,19,110
233095892,52,37,9,3,101
233103133,25,14,4,6,49
233106462,11,3,2,1,17
233108276,54,3,2,1,60
233113258,102,31,4,4,141
233125605,165,3,2,1,171
233139376,27,3,2,1,33
233141010,23,18,16,3,60
233153239,25,49,16,1,91
233171231,11,3,2,1,17
233183050,40,3,2,3,48
233192834,30,76,19,2,127
233194332,62,70,4,1,137
233204288,13,3,2,1,19
233211822,30,16,68,13,127
233224159,10,11,2,2,25
233228219,61,16,3,1,81
233234054,38,19,4,5,66
233238943,110,13,83,21,227
233260635,44,3,2,2,51
233277845,16,16,2,1,35
233305746,38,28,28,1,95
233307908,82,3,2,1,88
233363656,25,3,2,1,31
233367991,185,3,2,3,193
233374041,18,3,2,1,24
233374600,70,47,9,4,130
233376734,39,28,13,13,93
233379515,156,3,2,13,174
233380977,137,16,2,43,198
233386682,116,19,2,3,140
233388846,54,95,12,32,193
233389656,49,23,17,1,90
233393663,47,24,5,2,78
233400625,30,6,2,1,39
233401688,84,3,34,3,124
233407709,12,3,2,1,18
233417368,129,3,2,6,140
233433298,71,21,2,3,97
233433856,37,3,2,8,50
233448707,46,16,4,1,67
233460920,220,10,2,2,234
233468549,88,47,74,8,217
233468808,11,11,5,3,30
233471341,71,22,4,4,101
233471811,16,3,2,1,22
233475648,116,3,2,1,122
233500364,22,13,4,22,61
233511522,108,10,2,2,122
233546612,28,42,58,1,129
233554712,60,16,6,2,84
233555627,12,3,2,1,18
233558996,36,96,13,1,146
233559617,62,24,15,19,120
233560484,110,16,2,2,130
233573550,76,28,26,23,153
233573688,50,16,14,1,81
233600742,27,3,2,1,33
233618274,57,43,2,14,116
233620647,81,3,2,9,95
233631432,51,9,8,11,79
233638043,62,33,29,3,127
233649965,12,3,2,1,18
233652518,37,22,86,1,146
233655736,12,24,2,1,39
233660579,43,3,2,7,55
233663424,73,3,2,3,81
233674309,182,18,2,15,217
233679962,51,7,2,1,61
233681896,19,25,2,9,55
233701335,112,11,36,1,160
233716079,155,3,2,11,171
233718284,20,6,2,1,29
233724387,65,21,6,9,101
233738067,47,3,2,3,55
233746218,51,3,2,1,57
233747988,68,71,6,1,146
233753327,153,8,17,6,184
233757023,48,17,2,1,68
233757306,16,11,2,7,36
233759737,90,25,5,13,133
233764397,27,3,2,1,33
233777527,10,9,2,1,22
233809494,12,3,2,1,18
233836749,111,28,10,21,170
233843936,155,31,2,39,227
233848404,92,31,9,2,134
233886962,79,31,17,1,128
233895560,34,9,2,4,49
233896156,66,18,30,4,118
233913436,123,29,2,2,156
233915868,38,3,7,1,49
233920882,114,3,2,1,120
233921579,82,3,12,3,100
233922102,15,27,4,1,47
233931730,39,37,24,11,111
233933565,11,40,2,3,56
233934614,124,9,41,2,176
233939227,46,14,9,1,70
233950631,50,33,10,7,100
233954261,78,13,2,15,108
233954792,28,5,2,6,41
233955564,15,3,2,1,21
233957068,11,4,2,2,19
233971948,11,3,2,1,17
233988084,126,21,5,5,157
233994349,10,3,2,2,17
233998749,45,53,45,12,155
234001367,18,3,2,2,25
234011172,89,12,2,1,104
234012711,75,3,2,4,84
234013156,123,7,3,1,134
234016853,122,3,2,2,129
234035397,26,19,2,1,48
234043486,48,3,2,2,55
234045144,20,10,2,9,41
234054027,89,3,2,1,95
234067825,10,4,2,1,17
234095223,202,30,60,8,300
234096170,85,32,75,2,194
234101008,75,10,2,1,88
234107296,17,3,2,1,23
234113048,107,28,64,2,201
234121667,58,3,2,7,70
234163319,192,6,40,13,251
234170318,142,3,2,1,148
234185755,56,33,55,3,147
234186832,19,45,4,8,76
234188616,243,26,3,1,273
234189026,10,4,2,1,17
234193662,72,3,2,1,78
234204624,53,27,2,1,83
234240998,111,41,2,8,162
234242773,31,3,2,1,37
234255388,44,64,3,23,134
234260070,90,4,2,24,120
234262922,80,15,2,1,98
234274248,19,3,2,4,28
234274910,15,3,2,3,23
234278320,95,3,2,8,108
234279737,46,81,2,1,130
234287706,11,10,2,1,24
234288875,102,3,2,3,110
234291819,73,25,2,6,106
234295375,79,3,10,1,93
234318946,141,58,7,2,208
234322379,100,16,6,18,140
234325494,116,46,58,21,241
234330231,123,3,2,3,131
234333164,97,21,56,3,177
234349432,83,3,2,1,89
234349972,416,3,2,1,422
234364151,86,27,52,17,182
234364671,62,22,8,1,93
234387663,98,40,2,13,153
234399983,55,57,2,12,126
234405179,187,52,56,2,297
234411178,82,53,2,2,139
234416371,48,3,2,1,54
234426371,23,3,2,1,29
234428786,84,3,2,10,99
234461072,140,24,58,18,240
234473730,11,3,2,1,17
234490116,39,3,2,2,46
234502446,147,8,25,1,181
234506489,53,30,2,1,86
234537654,99,15,11,4,129
234555548,76,12,3,1,92
234563040,116,10,9,11,146
234573120,45,20,2,6,73
234576828,17,22,2,1,42
234578914,34,25,2,8,69
234580263,10,4,2,1,17
234585134,93,3,2,4,102
234590103,19,14,10,1,44
234590845,42,3,2,1,48
234592780,106,39,22,5,172
234596857,13,3,2,1,19
234601434,13,30,23,1,67
234605761,41,8,3,47,99
234623340,151,3,2,1,157
234641715,163,14,33,11,221
234644495,26,3,2,1,32
234653070,37,19,26,2,84
234656289,99,5,2,4,110
234662251,72,3,2,6,83
234663416,105,70,7,1,183
234701997,12,15,2,2,31
234724077,196,3,2,4,205
234747813,27,34,10,1,72
234754203,71,16,2,2,91
234760444,113,40,90,7,250
234762199,79,10,2,3,94
234764591,161,7,22,30,220
234765977,74,8,13,1,96
234774763,142,48,57,1,248
234782001,244,69,82,56,451
234784053,46,23,2,2,73
234788034,214,3,2,10,229
234789452,49,33,5,2,89
234794137,75,3,2,1,81
234794611,47,97,35,12,191
234801232,65,3,2,15,85
234806061,34,18,18,4,74
234836136,74,31,17,4,126
234836321,150,19,46,3,218
234844461,13,3,2,5,23
234859282,108,3,2,1,114
234871861,19,8,2,1,30
234887324,41,3,2,5,51
234888726,25,23,10,7,65
234891729,21,7,2,1,31
234891968,54,125,21,67,267
234902823,85,8,2,1,96
234907483,87,3,2,2,94
234911725,17,6,4,2,29
234925885,33,39,25,2,99
234927158,24,8,10,4,46
234934525,26,22,2,1,51
234940561,12,3,2,1,18
234950433,13,5,2,1,21
234957434,263,20,2,2,287
234968038,13,3,2,1,19
234972532,38,43,28,1,110
234988374,45,5,2,8,60
234995354,33,74,46,2,155
235003217,38,11,14,2,65
235020983,58,46,2,1,107
235048544,167,21,20,22,230
235057884,55,36,2,2,95
235062413,44,3,2,40,89
235071364,76,19,15,9,119
235073371,12,3,2,1,18
235085905,46,14,2,1,63
235100960,12,3,2,1,18
235102069,29,9,2,1,41
235108317,134,61,54,3,252
235109972,167,43,3,1,214
235114351,167,17,8,1,193
235117447,53,18,48,6,125
235118566,46,3,2,1,52
235134747,103,8,2,4,117
235135701,10,6,2,1,19
235148518,43,3,2,2,50
235159899,120,26,7,2,155
235180508,105,17,2,29,153
235182819,92,29,17,4,142
235185786,292,38,2,1,333
235214152,643,3,2,3,651
235219244,76,36,6,2,120
235219374,129,14,56,8,207
235243047,55,90,3,4,152
235249926,92,18,2,1,113
235252567,91,28,7,7,133
235256150,1116,3,2,19,1140
235259273,173,23,63,2,261
235261446,38,38,19,5,100
235264103,57,24,7,1,89
235264340,21,12,6,8,47
235275019,225,28,2,2,257
235277644,109,3,2,1,115
235278684,12,47,15,1,75
235287381,118,22,6,48,194
235296913,18,3,2,1,24
235299365,159,39,40,8,246
235302033,45,21,25,15,106
235311610,11,3,2,1,17
235315682,78,15,2,2,97
235316009,20,40,20,6,86
235337579,129,3,2,1,135
235370764,45,56,3,4,108
235371081,26,5,22,1,54
235372328,10,5,2,3,20
235400430,35,22,2,2,61
235401729,60,19,24,1,104
235405538,11,4,2,1,18
235410007,169,74,2,4,249
235412402,13,6,2,3,24
235413040,136,19,49,1,205
235414787,46,3,2,1,52
235420722,59,27,31,1,118
235426119,19,5,2,1,27
235429037,120,3,2,36,161
235430443,96,26,33,72,227
235470612,43,44,2,1,90
235473468,124,20,17,1,162
235476528,206,116,4,6,332
235476978,18,3,2,1,24
235478528,19,3,2,1,25
235481739,71,4,41,2,118
235487354,18,38,2,1,59
235492491,156,3,2,1,162
235494285,70,36,50,65,221
235513510,153,3,28,1,185
235520687,11,3,2,2,18
235521503,11,12,2,1,26
235526005,15,81,2,1,99
235530678,62,32,2,1,97
235583221,107,16,2,1,126
235583427,20,36,6,1,63
235591707,52,13,4,12,81
235622509,94,9,30,35,168
235623029,70,31,4,8,113
235629625,59,30,51,1,141
235649940,47,3,2,1,53
235658692,107,58,7,6,178
235672697,36,75,29,52,192
235678191,59,48,2,2,111
235682290,30,14,8,13,65
235683282,90,3,2,2,97
235693184,69,3,2,5,79
235696501,113,36,2,5,156
235698973,11,5,2,1,19
235708847,32,11,97,37,177
235735339,63,6,2,1,72
235780861,61,7,7,9,84
235788378,41,34,50,7,132
235792355,228,3,2,6,239
235794428,113,25,15,1,154
235822453,104,3,2,1,110
235833528,19,8,2,1,30
235838129,12,10,3,10,35
235838981,168,4,7,12,191
235842054,22,22,3,1,48
235854323,17,3,2,2,24
235859139,12,3,2,1,18
235880823,158,3,2,8,171
235883448,32,3,2,1,38
235890257,78,15,6,1,100
235893131,132,42,29,7,210
235914513,89,16,110,5,220
235915442,47,40,3,19,109
235923835,103,3,2,12,120
235930651,51,58,58,3,170
235932232,39,46,54,31,170
235933066,155,52,62,1,270
235943082,49,44,40,24,157
235956464,69,3,2,1,75
235971696,77,20,11,2,110
235973224,65,60,2,7,134
235982140,82,7,39,1,129
235983413,11,3,2,1,17
236037498,122,3,2,1,128
236040239,57,7,2,4,70
236040982,51,11,2,1,65
236046530,105,8,38,4,155
236046587,57,108,58,6,229
236065071,28,6,2,4,40
236066691,27,43,8,1,79
236095487,11,18,2,2,33
236096759,33,16,7,10,66
236112625,103,17,2,8,130
236137568,70,8,2,13,93
236154795,201,34,2,6,243
236160884,20,80,65,12,177
236168038,85,3,2,1,91
236168647,64,37,153,8,262
236169654,66,3,2,1,72
236173668,104,16,8,10,138
236185575,63,20,2,5,90
236189629,21,17,2,1,41
236228008,119,3,2,1,125
236241642,33,10,2,1,46
236244920,53,3,2,2,60
236260407,86,54,79,3,222
236262704,94,27,2,2,125
236268753,96,27,2,2,127
236280688,68,23,2,29,122
236334105,24,18,3,3,48
236363964,13,3,2,1,19
236365781,385,13,2,3,403
236381876,80,15,134,7,236
236384020,12,21,2,2,37
236388917,410,10,2,3,425
236412353,24,3,2,3,32
236431431,33,79,59,1,172
236443273,13,29,2,3,47
236446174,44,61,2,1,108
236458312,127,98,13,2,240
236478073,16,3,2,9,30
236491777,13,11,2,2,28
236493364,11,3,2,1,17
236513924,20,57,21,6,104
236532874,122,3,2,2,129
236540198,13,3,2,1,19
236547594,10,3,2,5,20
236569706,19,5,2,4,30
236570413,13,3,2,3,21
236594542,163,14,31,1,209
236609356,66,34,24,2,126
236614774,11,4,2,1,18
236618871,60,14,2,19,95
236638032,124,50,3,3,180
236644026,11,5,8,3,27
236646669,127,55,13,80,275
236660661,124,3,2,1,130
236662488,75,3,2,4,84
236688977,11,3,2,1,17
236698456,15,3,2,3,23
236722159,23,3,2,2,30
236727857,11,3,2,1,17
236730893,17,3,2,1,23
236735069,55,18,25,2,100
236735334,132,3,2,5,142
236736911,92,4,3,9,108
236744956,91,3,7,2,103
236748613,102,3,2,1,108
236758511,11,20,2,1,34
236759780,119,18,36,61,234
236769964,133,28,2,3,166
236783227,80,28,23,1,132
236785147,95,10,3,1,109
236809078,142,3,2,3,150
236809667,10,21,2,1,34
236820182,59,3,2,2,66
236831235,187,3,2,1,193
236835780,70,11,10,2,93
236839972,18,3,2,1,24
236852283,47,42,31,34,154
236880573,10,5,2,1,18
236880706,20,3,2,3,28
236894408,27,11,4,11,53
236918263,50,10,2,12,74
236920833,138,65,90,8,301
236937312,30,3,2,1,36
236939323,55,7,6,2,70
236950997,184,10,50,1,245
236962770,86,26,2,9,123
236964176,75,3,2,5,85
236965234,137,33,8,71,249
236970717,63,3,2,1,69
236976170,17,3,2,2,24
236977696,62,121,37,13,233
236978365,147,15,13,5,180
236978607,39,11,2,43,95
236998978,65,38,24,5,132
237008847,92,7,2,8,109
237019167,20,8,2,1,31
237022202,67,17,28,5,117
237024640,24,8,2,3,37
237027431,22,3,2,1,28
237034480,75,74,4,1,154
237037891,67,3,2,3,75
237049488,119,43,46,30,238
237057997,32,3,2,1,38
237059248,18,14,2,1,35
237073659,99,39,29,14,181
237089933,69,3,3,3,78
237094977,101,3,2,1,107
237096348,28,3,2,1,34
237097621,17,18,3,1,39
237106896,118,33,2,4,157
237110137,72,66,15,13,166
237123888,70,10,5,1,86
237124174,102,25,8,2,137
237154798,42,29,2,1,74
237190466,87,32,6,32,157
237199866,11,36,2,1,50
237208813,85,3,2,6,96
237213479,64,3,2,1,70
237220650,53,34,22,10,119
237221697,139,3,2,10,154
237233492,136,3,2,1,142
237250660,93,10,2,1,106
237266855,73,34,2,1,110
237267498,12,3,2,1,18
237282440,141,30,2,1,174
237300349,101,23,68,2,194
237315263,39,16,42,1,98
237322319,25,7,53,5,90
237341749,83,18,2,6,109
237381961,87,3,2,15,107
237383202,166,52,5,79,302
237397039,109,58,3,19,189
237397931,10,3,2,3,18
237409782,94,3,2,1,100
237422607,23,3,2,1,29
237425401,72,30,2,2,106
237426819,52,13,2,1,68
237427830,81,13,18,1,113
237428069,10,15,3,4,32
237433328,54,19,13,15,101
237436620,73,47,36,2,158
237436706,181,9,8,2,200
237456828,160,3,2,1,166
237464524,80,5,2,3,90
237468190,69,3,2,19,93
237474114,50,36,8,5,99
237475225,44,108,21,7,180
237490960,178,55,72,14,319
237494723,15,3,2,1,21
237495337,19,16,2,1,38
237509444,24,12,2,1,39
237510198,68,3,2,15,88
237529790,84,63,10,5,162
237533813,96,41,18,26,181
237546023,76,21,5,1,103
237570292,160,29,47,1,237
237581796,51,3,2,2,58
237596724,71,22,26,17,136
237601400,16,80,31,3,130
237601838,75,17,2,17,111
237633018,18,3,2,1,24
237644125,46,21,4,2,73
237650007,88,3,2,1,94
237654853,80,3,2,2,87
237661872,52,41,11,22,126
237670492,50,46,28,3,127
237675906,95,17,20,2,134
237680501,43,3,36,1,83
237728690,20,3,2,3,28
237759900,43,13,25,41,122
237761894,86,37,21,1,145
237766726,75,3,2,14,94
237770103,19,3,2,2,26
237770533,95,6,2,2,105
237772731,31,9,2,1,43
237776011,29,71,30,3,133
237780243,90,9,2,1,102
237783691,31,38,7,9,85
237809756,44,12,2,1,59
237816308,25,17,8,4,54
237816422,90,22,24,2,138
237821704,74,72,49,13,208
237822490,107,22,33,2,164
237836532,39,3,2,3,47
237836724,19,21,2,12,54
237838566,21,3,2,7,33
237839639,27,26,66,12,131
237850743,37,55,43,3,138
237880145,50,31,3,2,86
237890046,55,24,2,15,96
237892239,23,3,2,6,34
237898363,29,3,2,13,47
237913135,50,8,2,1,61
237923362,35,5,2,2,44
237943486,26,6,2,1,35
237947262,31,51,3,1,86
237955176,60,29,29,27,145
237987856,96,3,2,1,102
238017986,97,11,30,2,140
238026707,138,28,67,1,234
238034902,40,75,19,6,140
238038685,109,53,7,6,175
238049821,12,3,2,3,20
238056106,36,3,2,8,49
238057584,22,4,2,3,31
238066936,61,3,2,1,67
238071342,66,27,3,2,98
238081389,13,3,2,1,19
238086352,35,67,2,1,105
238090133,11,3,2,1,17
238102890,52,28,16,2,98
238109725,176,49,11,1,237
238132713,41,3,2,1,47
238134152,29,22,5,1,57
238137503,37,40,2,1,80
238137539,70,3,2,1,76
238152051,97,3,2,1,103
238163916,50,9,7,1,67
238180645,143,3,2,1,149
238187424,311,3,2,4,320
238188592,77,14,2,3,96
238202461,93,10,3,1,107
238218968,71,91,69,6,237
238242249,79,28,14,1,122
238246471,74,88,6,1,169
238270002,14,3,6,4,27
238290102,110,52,7,23,192
238299188,66,8,2,16,92
238313750,127,19,21,13,180
238320090,34,3,2,1,40
238320941,14,30,5,1,50
238325382,31,6,2,35,74
238327255,85,3,2,1,91
238328721,97,32,32,6,167
238328745,42,3,2,2,49
238354697,43,31,2,5,81
238372456,82,29,16,7,134
238373886,64,29,35,1,129
238374182,60,42,47,10,159
238376466,123,20,11,3,157
238383740,86,13,2,1,102
238386861,11,3,2,1,17
238398261,15,3,2,2,22
238398644,25,17,14,6,62
238400335,11,3,2,1,17
238405377,54,22,2,1,79
238407362,22,23,2,1,48
238430792,77,3,2,1,83
238439073,13,23,4,1,41
238452005,22,34,29,16,101
238455097,107,3,2,1,113
238459423,369,9,27,43,448
238467565,69,20,2,1,92
238468688,117,17,12,3,149
238474349,20,23,2,2,47
238485457,92,29,14,2,137
238485626,151,3,2,5,161
238512464,36,3,2,2,43
238521037,25,31,2,1,59
238534712,27,47,48,4,126
238545246,11,3,2,2,18
238556354,11,3,2,1,17
238562506,52,9,11,2,74
238562832,166,18,4,3,191
238571826,85,6,2,11,104
238578807,11,27,2,1,41
238584935,43,15,41,9,108
238586081,61,3,12,7,83
238598654,15,7,2,1,25
238600138,39,21,14,2,76
238604891,110,44,23,9,186
238607695,10,18,2,1,31
238630026,37,104,4,1,146
238637175,77,53,27,1,158
238645986,56,3,2,2,63
238646467,25,73,2,8,108
238665015,19,9,2,1,31
238666101,21,3,2,1,27
238666632,46,60,5,21,132
238677655,11,43,2,1,57
238683712,94,41,32,77,244
238688639,52,4,9,8,73
238693266,17,3,2,1,23
238699787,132,52,25,16,225
238715324,180,3,2,2,187
238722686,89,3,2,4,98
238727874,34,3,2,4,43
238737559,13,25,2,1,41
238741353,140,28,101,32,301
238744121,13,3,2,3,21
238753888,26,36,2,2,66
238762326,97,74,31,3,205
238764060,20,6,6,2,34
238782180,66,12,11,1,90
238785443,10,21,8,1,40
238786222,11,3,2,1,17
238787834,337,3,2,12,354
238791900,62,58,27,3,150
238794363,38,3,2,2,45
238800059,64,11,3,1,79
238800708,57,22,13,1,93
238806385,58,3,2,1,64
238811690,23,6,2,7,38
238828797,53,18,33,2,106
238832277,20,7,2,1,30
238837059,11,32,2,1,46
238849105,31,43,5,11,90
238859052,101,17,2,1,121
238873405,91,3,2,1,97
238881223,30,3,2,3,38
238883558,24,24,11,2,61
238898768,23,3,2,1,29
238900909,104,4,51,8,167
238907262,63,3,2,1,69
238927126,29,3,2,3,37
238962441,18,5,2,2,27
238969691,47,50,13,1,111
238971268,89,3,14,1,107
238982034,45,22,13,4,84
239024337,121,3,2,8,134
239027946,27,3,2,3,35
239044522,57,5,10,2,74
239074249,70,34,36,4,144
239083956,38,23,3,3,67
239085919,50,3,2,2,57
239107791,16,3,2,3,24
239108122,64,70,47,1,182
239108635,18,3,2,10,33
239114032,56,5,6,1,68
239125253,82,6,2,2,92
239152642,159,74,3,36,272
239166870,76,22,10,4,112
239169161,85,13,19,2,119
239194356,13,30,7,5,55
239203123,51,46,12,1,110
239217627,23,3,2,8,36
239235084,111,30,3,12,156
239236963,52,17,2,8,79
239251773,40,30,4,2,76
239254048,47,7,6,1,61
239268454,28,3,31,4,66
239279655,28,17,4,2,51
239282956,86,4,16,2,108
239297779,79,21,4,1,105
239312769,36,23,40,1,100
239326310,72,7,2,4,85
239339782,18,16,2,1,37
239339830,49,20,24,5,98
239341920,30,42,2,1,75
239343780,48,53,6,2,109
239344229,164,45,27,43,279
239349911,16,20,2,1,39
239352366,57,53,13,19,142
239354401,101,21,2,2,126
239362599,38,56,2,4,100
239378928,54,100,2,13,169
239381329,70,35,28,4,137
239390192,58,43,4,3,108
239398031,84,3,2,21,110
239399358,31,23,10,14,78
239399921,115,12,2,7,136
239401415,11,3,2,1,17
239408066,53,14,2,8,77
239423824,61,3,2,6,72
239440860,11,3,2,1,17
239451481,120,3,2,1,126
239463164,47,56,3,5,111
239478611,54,21,6,5,86
239486219,13,3,2,1,19
239489515,39,23,2,1,65
239499560,29,53,2,4,88
239513511,289,3,2,1,295
239520676,24,3,2,1,30
239522663,106,18,4,1,129
239523109,194,6,5,13,218
239525666,11,3,2,1,17
239537586,21,48,23,4,96
239549795,15,4,2,5,26
239580201,37,62,20,2,121
239601143,57,3,2,1,63
239620612,103,3,2,1,109
239624111,272,24,3,19,318
239644533,114,35,11,10,170
239644996,10,16,2,1,29
239651662,26,24,2,3,55
239652679,49,23,60,6,138
239657263,150,13,74,8,245
239658401,28,31,36,16,111
239685050,16,3,2,1,22
239687151,70,7,13,1,91
239693698,12,8,2,1,23
239698178,39,17,8,5,69
239705086,126,3,2,1,132
239709783,68,9,2,1,80
239716010,21,3,2,1,27
239721904,129,3,2,4,138
239723269,44,71,2,1,118
239730628,58,16,34,2,110
239736409,78,17,2,3,100
239740181,10,4,2,1,17
239772900,261,3,2,14,280
239781504,57,26,2,1,86
239794725,11,3,2,4,20
239804830,23,6,2,12,43
239806702,119,40,2,4,165
239810341,55,3,2,1,61
239831367,10,5,2,1,18
239842684,62,12,27,7,108
239843036,10,4,2,1,17
239875249,19,3,2,2,26
239885246,13,18,2,1,34
239899222,108,24,2,5,139
239906588,109,20,2,1,132
239932143,93,23,42,16,174
239940354,53,25,3,1,82
239953458,16,39,3,22,80
239970702,19,40,2,3,64
239974883,10,52,2,1,65
239981217,147,3,2,1,153
239989211,109,24,15,5,153
239996828,29,24,2,1,56
239997091,81,17,37,11,146
239999649,150,48,45,2,245
240000590,142,16,2,6,166
240015363,510,3,2,2,517
240023087,64,30,44,5,143
240023283,25,3,2,1,31
240027173,12,3,2,1,18
240030551,46,12,2,18,78
240052692,12,4,2,1,19
240056263,29,20,29,20,98
240066495,23,7,9,1,40
240071498,47,14,35,2,98
240074478,13,3,2,1,19
240085661,69,36,11,1,117
240086564,22,9,2,1,34
240088299,10,4,2,1,17
240094804,108,30,5,4,147
240100461,78,3,2,1,84
240103126,30,37,2,1,70
240103391,84,4,2,6,96
240107163,342,294,106,58,800
240108428,114,15,34,23,186
240108696,79,14,11,1,105
240114597,30,17,12,15,74
240122577,16,34,2,2,54
240134350,127,37,2,1,167
240148034,184,3,2,19,208
240153113,80,3,2,4,89
240153779,142,3,2,18,165
240159145,34,6,2,1,43
240177543,20,3,2,3,28
240179778,108,4,14,15,141
240196937,117,37,44,1,199
240197990,22,85,2,2,111
240201757,167,21,2,1,191
240228813,63,6,33,1,103
240233614,51,18,2,2,73
240239047,12,3,2,9,26
240240330,48,15,10,1,74
240243044,57,9,6,1,73
240254970,75,35,25,6,141
240288690,38,3,2,2,45
240294904,10,3,2,2,17
240299657,222,36,3,3,264
240301625,72,7,19,4,102
240315233,117,20,2,1,140
240317797,40,35,3,1,79
240318170,10,6,2,1,19
240318636,12,11,2,1,26
240326079,88,3,4,2,97
240354695,71,10,18,11,110
240361645,80,13,44,1,138
240401723,29,3,2,1,35
240403430,81,15,48,13,157
240406388,14,22,2,7,45
240407296,408,3,2,1,414
240410526,82,46,166,171,465
240412430,31,43,8,3,85
240420566,10,4,2,1,17
240427105,126,11,2,2,141
240455197,94,3,2,1,100
240458206,42,16,7,6,71
240464080,49,20,2,6,77
240468914,13,3,2,5,23
240472688,29,16,31,13,89
240474728,299,3,2,8,312
240477865,49,3,2,18,72
240478038,72,3,2,1,78
240493064,11,12,2,1,26
240519620,22,3,2,1,28
240530297,110,37,42,8,197
240530688,126,12,6,1,145
240540193,67,3,2,1,73
240542563,13,3,2,1,19
240547650,42,18,2,1,63
240551216,11,3,2,5,21
240552578,23,3,2,1,29
240557447,53,26,49,45,173
240563871,14,20,2,2,38
240564269,90,37,2,2,131
240564400,187,43,21,3,254
240568677,21,21,2,1,45
240568776,86,20,44,8,158
240595160,16,53,3,1,73
240597955,31,41,3,3,78
240599852,104,3,2,3,112
240600653,54,14,2,3,73
240615969,129,92,6,2,229
240619748,92,44,2,18,156
240646918,101,3,2,1,107
240651853,185,3,2,2,192
240654796,62,35,7,1,105
240673253,53,3,2,5,63
240675153,79,43,12,2,136
240716505,107,55,4,1,167
240741965,59,18,64,4,145
240749221,33,3,2,1,39
240751089,10,6,2,4,22
240753520,141,12,8,20,181
240755664,154,29,45,1,229
240760577,14,3,2,1,20
240762769,39,19,22,2,82
240777121,50,14,10,5,79
240777589,43,37,7,24,111
240780476,97,3,2,1,103
240783902,64,15,39,78,196
240784955,16,3,2,1,22
240790674,78,7,3,23,111
240798217,97,3,2,1,103
240800217,190,45,3,11,249
240824456,140,3,2,1,146
240855649,35,12,2,1,50
240857795,27,5,2,3,37
240864473,102,3,2,1,108
240869803,74,45,3,11,133
240873889,67,15,38,14,134
240885688,12,11,4,17,44
240889239,36,11,2,1,50
240906007,88,6,47,1,142
240906560,48,24,2,1,75
240907782,122,3,2,2,129
240920157,39,36,15,1,91
240920923,136,3,2,29,170
240928477,10,3,2,2,17
240936596,22,22,73,1,118
240983522,12,3,2,3,20
240984848,83,3,2,1,89
241001312,11,3,2,1,17
241004894,13,15,8,1,37
241020919,172,3,2,7,184
241022271,53,3,2,1,59
241028304,98,14,3,6,121
241048837,31,18,61,13,123
241061232,18,3,2,1,24
241066122,38,18,7,11,74
241094160,113,9,2,6,130
241110635,29,20,34,1,84
241128337,10,20,2,4,36
241141746,155,3,2,5,165
241142228,85,3,2,3,93
241142255,47,31,45,3,126
241144310,49,3,2,1,55
241147358,48,47,67,7,169
241167692,21,7,16,3,47
241170395,78,3,2,1,84
241173191,107,22,2,6,137
241184936,72,11,6,3,92
241186190,10,4,2,1,17
241186664,35,31,2,1,69
241197892,14,13,2,1,30
241205401,14,3,2,1,20
241208949,30,4,2,1,37
241224290,32,18,3,6,59
241228472,66,22,8,16,112
241283606,74,23,39,9,145
241292408,51,26,23,2,102
241298950,52,3,2,1,58
241316216,55,23,2,16,96
241323601,100,43,2,6,151
241339450,180,27,64,2,273
241346218,149,18,13,8,188
241348632,17,3,2,1,23
241356610,29,3,2,1,35
241363325,120,3,2,2,127
241365262,84,7,25,2,118
241368016,51,16,2,4,73
241370878,10,5,2,1,18
241380312,32,38,50,2,122
241380577,210,24,2,21,257
241401002,12,12,4,1,29
241407076,11,3,2,1,17
241425875,99,38,10,15,162
241431037,36,3,2,1,42
241436892,127,3,2,7,139
241438868,19,20,55,3,97
241443041,61,26,2,4,93
241443181,167,22,4,11,204
241446510,20,15,2,1,38
241447814,12,5,3,1,21
241450181,24,34,2,1,61
241451235,62,25,18,7,112
241462522,63,16,4,2,85
241478931,66,3,2,8,79
241482112,29,55,81,10,175
241495074,247,27,2,14,290
241513170,69,3,2,1,75
241517651,27,24,2,2,55
241519159,40,3,5,13,61
241529267,16,4,2,1,23
241534035,34,21,14,1,70
241542590,20,3,2,2,27
241545486,42,56,15,42,155
241555253,25,24,2,1,52
241578932,29,3,2,2,36
241590678,89,38,64,1,192
241597304,39,29,6,2,76
241600430,111,3,2,1,117
241603189,123,23,4,12,162
241625908,12,11,3,1,27
241633942,13,3,2,1,19
241635210,104,4,13,10,131
241676601,15,17,5,1,38
241678826,14,4,2,4,24
241680691,14,11,2,1,28
241687967,91,7,12,12,122
241690811,190,3,2,1,196
241694963,12,3,2,2,19
241696288,105,48,3,20,176
241698220,84,55,4,22,165
241702522,46,8,23,14,91
241714464,29,3,2,1,35
241717660,152,25,2,1,180
241735456,76,33,2,1,112
241735929,163,16,7,1,187
241754331,21,3,2,8,34
241778468,12,3,2,1,18
241779684,196,40,56,78,370
241782315,13,3,2,1,19
241788209,129,23,4,2,158
241791275,55,20,10,6,91
241831025,164,43,17,12,236
241832410,129,3,2,10,144
241835944,12,3,2,1,18
241850803,33,3,2,1,39
241870673,151,22,9,16,198
241871040,96,6,5,2,109
241886115,85,3,2,2,92
241889659,12,3,2,3,20
241897883,22,3,14,2,41
241899746,15,3,2,3,23
241901038,17,4,2,2,25
241906632,61,3,2,1,67
241915983,28,29,2,9,68
241929331,112,36,11,14,173
241949641,167,7,2,2,178
241950163,27,43,24,1,95
241952681,97,4,2,6,109
241957446,40,34,2,1,77
241957522,25,3,2,1,31
241960263,51,15,2,1,69
241968438,74,41,2,7,124
241973606,46,3,2,1,52
241991107,88,41,10,12,151
241991829,14,3,2,6,25
241998017,20,7,2,1,30
242026829,14,39,2,1,56
242038271,36,6,3,1,46
242055799,54,3,2,1,60
242061039,31,16,2,37,86
242066307,254,51,2,38,345
242067802,10,10,2,1,23
242071269,80,31,12,11,134
242076893,70,38,34,31,173
242080478,46,45,3,45,139
242082339,184,25,19,2,230
242099320,49,54,2,1,106
242112215,42,22,2,6,72
242121811,64,43,28,11,146
242128909,135,16,36,4,191
242143402,70,3,2,14,89
242156567,53,64,25,2,144
242160785,136,3,2,1,142
242169877,49,59,2,9,119
242172976,58,46,4,1,109
242199259,12,3,2,1,18
242201570,50,18,5,8,81
242230295,91,3,2,1,97
242233639,21,3,2,1,27
242244540,100,17,31,13,161
242251554,19,3,2,1,25
242272292,99,3,2,1,105
242285782,11,9,3,1,24
242305061,64,21,18,3,106
242314215,227,16,9,7,259
242327220,23,5,2,1,31
242348002,10,3,2,4,19
242368004,82,16,2,5,105
242369099,22,15,2,1,40
242372113,28,22,10,11,71
242384686,63,27,94,19,203
242408122,106,15,122,57,300
242409804,60,38,56,1,155
242433002,14,72,56,7,149
242445248,34,3,2,4,43
242445521,237,3,2,30,272
242449104,27,24,3,4,58
242450565,61,62,66,29,218
242456163,136,30,66,54,286
242456555,58,13,23,3,97
242468258,17,20,11,5,53
242471083,35,21,11,1,68
242473485,147,38,3,1,189
242481589,10,4,2,1,17
242482941,11,3,2,1,17
242490670,140,50,2,53,245
242498032,121,82,43,33,279
242499632,99,21,46,3,169
242501672,106,12,23,4,145
242502737,10,16,2,1,29
242510771,111,33,45,1,190
242526973,55,25,22,15,117
242552936,156,24,2,5,187
242553619,112,3,2,1,118
242556914,52,3,3,5,63
242577598,72,81,12,1,166
242580180,30,52,44,1,127
242594589,10,8,2,1,21
242596958,42,3,2,1,48
242612239,100,4,2,6,112
242641864,24,3,2,1,30
242642413,39,73,2,4,118
242656928,21,3,2,1,27
242659090,42,21,21,13,97
242663975,118,17,5,3,143
242677971,80,23,2,10,115
242678626,21,53,2,1,77
242678888,63,33,5,1,102
242685650,16,14,2,1,33
242693329,54,21,4,13,92
242702152,54,26,2,1,83
242714821,74,30,2,4,110
242721320,29,7,2,1,39
242753993,99,4,26,1,130
242771679,146,3,2,111,262
242773540,174,3,2,2,181
242776720,60,28,2,8,98
242782198,132,3,2,3,140
242795397,66,25,5,1,97
242800689,141,60,4,11,216
242815876,100,3,2,8,113
242819619,66,3,2,4,75
242821622,41,13,33,6,93
242822684,10,4,2,1,17
242835338,21,8,5,1,35
242839239,114,18,3,1,136
242840294,257,3,2,3,265
242860883,80,22,3,2,107
242865496,56,25,29,4,114
242870794,191,3,2,15,211
242873349,79,3,2,2,86
242890197,71,75,2,8,156
242892586,76,45,141,1,263
242892650,132,17,11,11,171
242908778,12,33,2,1,48
242911844,70,3,2,1,76
242913077,39,3,2,1,45
242915229,175,27,94,10,306
242921854,61,3,2,18,84
242928695,76,32,37,4,149
242934746,43,23,2,1,69
242937512,38,33,62,13,146
242955288,23,39,7,1,70
242982553,56,3,2,1,62
242988335,15,23,25,49,112
243029397,97,42,27,62,228
243033830,102,36,53,1,192
243035123,73,10,69,2,154
243038626,39,3,2,80,124
243047396,25,20,4,1,50
243048268,104,13,2,7,126
243049987,10,46,2,1,59
243050538,221,57,8,10,296
243072112,79,3,2,1,85
243081049,53,20,12,3,88
243084164,31,94,70,5,200
243087257,87,3,24,2,116
243094246,17,11,2,1,31
243095932,85,3,2,1,91
243106993,89,26,58,5,178
243107351,104,27,46,12,189
243111353,34,10,51,1,96
243129762,41,3,18,1,63
243135776,17,3,2,5,27
243145801,178,36,6,9,229
243156162,147,52,20,7,226
243169717,144,24,3,21,192
243191847,21,64,2,1,88
243196368,74,3,2,13,92
243201968,98,10,27,6,141
243210743,194,10,2,1,207
243217555,29,22,7,1,59
243230771,52,3,2,1,58
243231136,128,4,2,12,146
243252558,105,93,101,13,312
243255861,45,27,7,6,85
243277217,12,6,2,1,21
243277406,47,12,35,11,105
243281777,35,16,2,6,59
243287774,12,3,2,2,19
243290643,19,31,7,1,58
243299807,96,3,2,2,103
243312604,79,7,20,13,119
243318216,121,32,3,1,157
243321695,61,3,2,4,70
243331479,35,15,2,1,53
243361617,117,34,9,2,162
243363452,34,3,2,7,46
243369742,170,51,55,6,282
243371318,35,36,15,6,92
243383304,26,3,2,2,33
243389364,12,5,2,1,20
243394094,191,12,3,1,207
243399530,54,3,2,1,60
243402890,31,28,13,16,88
243424477,92,53,9,38,192
243426183,14,7,2,1,24
243441114,17,3,2,1,23
243443572,77,17,2,1,97
243480820,14,31,2,1,48
243482682,125,3,2,1,131
243485653,119,30,5,19,173
243488739,46,38,21,5,110
243504398,39,26,2,5,72
243517343,33,63,3,8,107
243525808,49,58,47,20,174
243529845,81,27,3,1,112
243531708,150,8,74,42,274
243546907,12,3,2,4,21
243549562,37,9,2,1,49
243553510,35,3,2,1,41
243556533,43,5,26,9,83
243563540,93,15,38,4,150
243565716,30,21,8,2,61
243589379,36,3,2,1,42
243591520,48,8,23,1,80
243606265,68,25,2,4,99
243622523,18,3,2,1,24
243627130,14,10,2,1,27
243635870,15,10,2,1,28
243646651,11,3,2,1,17
243674102,94,80,11,12,197
243679500,23,3,2,3,31
243681288,42,11,24,4,81
243683301,11,3,2,2,18
243689216,14,16,2,1,33
243689274,19,3,2,1,25
243701003,11,3,2,1,17
243704038,30,18,10,6,64
243711491,126,5,2,1,134
243711779,56,24,2,2,84
243731527,10,3,2,3,18
243735176,50,15,2,2,69
243736428,44,28,61,15,148
243745655,62,3,2,1,68
243758091,139,3,2,4,148
243761372,68,3,2,1,74
243771267,13,3,2,1,19
243784321,21,3,2,4,30
243796200,90,8,2,3,103
243812321,101,24,2,1,128
243828222,20,37,3,2,62
243837863,27,13,2,1,43
243847025,130,3,2,1,136
243857308,85,32,117,9,243
243857882,14,13,6,1,34
243859326,48,22,24,65,159
243869080,119,45,4,6,174
243869085,145,3,2,1,151
243882923,198,3,2,78,281
243888907,25,13,3,2,43
243889916,39,22,22,10,93
243892457,22,3,2,2,29
243893749,79,12,4,7,102
243895231,99,51,28,2,180
243897296,37,6,2,6,51
243902403,140,18,34,9,201
243911383,164,5,7,2,178
243915337,53,37,35,1,126
243931106,70,56,2,8,136
243936640,10,5,2,1,18
243942552,14,20,2,11,47
243943613,19,6,2,1,28
243948268,83,30,7,1,121
243949598,93,3,2,12,110
243953142,57,9,12,7,85
243967919,98,42,2,12,154
243990364,23,5,24,7,59
244000824,81,3,7,3,94
244019570,105,3,2,1,111
244020376,17,3,2,1,23
244034598,45,14,2,8,69
244044980,12,3,2,4,21
244047824,12,9,2,1,24
244059688,81,26,2,4,113
244067298,65,3,2,1,71
244068897,10,3,2,3,18
244078868,82,3,2,4,91
244097174,92,3,2,54,151
244101213,120,46,47,6,219
244110119,46,22,2,1,71
244123087,43,3,2,1,49
244133645,36,21,3,1,61
244151353,51,14,9,27,101
244156864,22,16,13,5,56
244160870,19,20,2,1,42
244161427,18,8,4,3,33
244164570,53,3,2,5,63
244168239,20,25,2,1,48
244181664,20,62,17,2,101
244183486,33,16,92,2,143
244201126,14,8,2,1,25
244214101,31,75,49,4,159
244220953,171,3,2,1,177
244226129,51,72,2,6,131
244228465,46,46,21,6,119
244236655,16,3,2,1,22
244237710,97,19,62,2,180
244256604,89,11,2,1,103
244264298,118,41,35,2,196
244264776,35,3,2,1,41
244271442,10,3,2,2,17
244274436,73,6,2,5,86
244280200,32,24,37,5,98
244282971,11,4,2,1,18
244289976,137,7,2,1,147
244294629,75,43,2,4,124
244311094,123,11,2,2,138
244322315,153,10,64,32,259
244324442,32,52,2,3,89
244326708,81,37,2,25,145
244350793,21,7,2,1,31
244351859,148,44,2,12,206
244353117,188,6,2,5,201
244360744,51,6,7,17,81
244373780,92,47,12,1,152
244383090,156,48,5,31,240
244403247,15,8,2,1,26
244405387,27,3,2,6,38
244414013,185,17,2,9,213
244435441,59,36,18,14,127
244439596,15,8,2,1,26
244445917,17,3,2,1,23
244464351,121,14,2,2,139
244466622,17,3,2,1,23
244472910,73,22,10,13,118
244492423,61,3,2,1,67
244497606,140,12,18,2,172
244497986,60,3,2,2,67
244498998,105,3,2,2,112
244509707,33,41,3,12,89
244510031,54,44,54,1,153
244510901,23,9,2,7,41
244516417,17,3,2,1,23
244525488,85,14,31,14,144
244527312,28,3,2,1,34
244528406,104,54,49,2,209
244534217,128,25,12,46,211
244535044,117,7,53,1,178
244546720,57,13,30,6,106
244567957,103,24,15,5,147
244570361,19,3,2,1,25
244573521,134,58,46,30,268
244587264,212,20,21,7,260
244591711,34,3,2,1,40
244595560,39,63,7,29,138
244600162,30,20,2,1,53
244608988,42,16,15,1,74
244617654,25,17,2,2,46
244648372,21,3,2,1,27
244664684,124,26,9,4,163
244674922,163,22,2,8,195
244677324,94,38,29,10,171
244684488,76,58,2,2,138
244692966,59,3,2,1,65
244697691,26,3,2,1,32
244705793,71,23,2,5,101
244725961,35,16,3,2,56
244732680,14,3,2,4,23
244735930,75,32,54,2,163
244752768,40,3,2,2,47
244756701,21,17,4,1,43
244761670,59,3,2,1,65
244763319,11,21,2,1,35
244771897,20,28,13,1,62
244790218,47,3,2,3,55
244802826,11,3,2,1,17
244807508,11,14,2,5,32
244809650,19,41,6,1,67
244818509,93,27,2,1,123
244822680,12,3,2,1,18
244829968,32,20,11,4,67
244831915,41,27,77,106,251
244833688,113,3,2,4,122
244838479,41,3,2,1,47
244841794,14,3,2,1,20
244841880,176,14,2,1,193
244842849,13,5,2,1,21
244847937,105,16,2,8,131
244861930,13,3,2,1,19
244879228,163,30,13,3,209
244889403,163,26,48,4,241
244902374,64,15,11,21,111
244907539,10,3,2,2,17
244916317,33,14,7,22,76
244922085,84,6,2,5,97
244923210,37,28,65,5,135
244927626,206,26,23,4,259
244931561,19,3,2,1,25
244932393,77,13,35,3,128
244947580,112,3,2,1,118
244948350,54,41,2,2,99
244953979,86,32,4,13,135
244966438,26,29,9,16,80
244970019,16,6,3,11,36
244977492,42,3,2,1,48
244991446,26,57,26,3,112
244998493,125,3,3,1,132
245001427,36,60,2,1,99
245009894,86,42,76,1,205
245010038,73,30,41,1,145
245010676,12,3,2,1,18
245011763,10,3,2,2,17
245016625,30,7,2,2,41
245032352,62,19,5,2,88
245036794,28,24,2,1,55
245037258,23,62,2,1,88
245041870,96,11,50,10,167
245054648,11,17,2,3,33
245063080,60,3,3,2,68
245064494,22,3,2,2,29
245065857,86,3,2,1,92
245085554,93,88,2,16,199
245117628,11,5,2,1,19
245126207,50,15,17,5,87
245148950,68,7,10,10,95
245166822,164,33,2,22,221
245177311,14,8,2,1,25
245182482,41,3,2,1,47
245192379,50,3,2,1,56
245210541,64,11,2,2,79
245221043,26,3,27,13,69
245250856,111,33,2,3,149
245252301,12,5,2,1,20
245289949,18,14,24,1,57
245290109,73,42,7,1,123
245291157,25,3,2,1,31
245305939,17,15,2,1,35
245312355,13,3,2,1,19
245316393,174,10,2,1,187
245331679,20,3,2,1,26
245336455,29,3,2,7,41
245370953,39,28,55,1,123
245375485,19,54,7,6,86
245398502,146,28,38,1,213
245416936,59,5,2,1,67
245427287,12,5,2,1,20
245443148,45,19,39,3,106
245452916,65,30,2,3,100
245462179,11,6,2,6,25
245469929,157,24,20,7,208
245488743,124,3,2,1,130
245491885,134,30,2,2,168
245496831,16,5,2,2,25
245501417,115,8,5,12,140
245502601,27,8,3,7,45
245505804,119,7,6,2,134
245506439,61,91,6,64,222
245540716,79,3,2,4,88
245541743,151,62,14,39,266
245542106,16,25,18,8,67
245546982,38,3,2,1,44
245549987,18,9,2,1,30
245550130,41,7,36,2,86
245552166,85,3,2,17,107
245553088,221,3,2,15,241
245564781,19,43,4,2,68
245570158,47,3,2,1,53
245581477,11,3,2,1,17
245584007,58,31,39,11,139
245600900,29,16,3,2,50
245622191,28,10,2,1,41
245628614,22,14,2,2,40
245653906,140,26,2,3,171
245655311,36,24,2,11,73
245675437,44,8,2,1,55
245701636,51,30,11,24,116
245716073,15,3,2,1,21
245718104,57,8,40,14,119
245739865,118,7,2,10,137
245759312,32,23,31,1,87
245760000,28,10,8,1,47
245784999,102,29,68,1,200
245797677,59,3,2,12,76
245830057,32,3,2,1,38
245830164,50,8,2,1,61
245831054,50,39,7,11,107
245837642,43,17,2,11,73
245841992,59,38,9,1,107
245857965,63,12,30,8,113
245860142,36,19,2,3,60
245872986,72,23,21,5,121
245880637,15,9,2,7,33
245888549,72,15,7,8,102
245889230,61,3,2,2,68
245907757,110,4,2,1,117
245911176,31,23,46,33,133
245912233,33,37,10,3,83
245913309,101,9,2,1,113
245918270,119,49,53,5,226
245920552,35,3,2,4,44
245934750,40,42,9,12,103
245944015,11,4,2,2,19
245954423,169,48,17,62,296
245967882,24,4,8,1,37
245986240,95,31,138,7,271
245992108,82,3,2,3,90
245993230,15,28,7,1,51
246016465,12,3,2,1,18
246018501,25,25,14,1,65
246024502,23,5,2,5,35
246044960,58,22,18,1,99
246054617,24,3,2,3,32
246056082,230,3,2,6,241
246058367,38,3,2,1,44
246058966,20,3,2,1,26
246062577,124,61,5,8,198
246066999,102,22,9,5,138
246070922,38,39,8,43,128
246074131,10,3,2,2,17
246076006,47,34,6,5,92
246087086,12,3,2,2,19
246097967,43,26,18,25,112
246109767,59,72,13,19,163
246110357,89,71,67,1,228
246115012,11,5,2,3,21
246145511,82,20,2,7,111
246164098,11,3,2,1,17
246174005,10,3,2,3,18
246207520,338,3,2,4,347
246207764,28,3,2,1,34
246209684,27,10,17,4,58
246223481,66,23,10,1,100
246226954,10,3,2,2,17
246236914,33,3,2,1,39
246241337,15,3,2,1,21
246243388,10,15,2,1,28
246244567,32,39,30,3,104
246247145,48,3,2,1,54
246260302,61,3,5,1,70
246271147,73,3,2,1,79
246271501,100,6,2,4,112
246295435,110,32,62,6,210
246296168,11,4,2,1,18
246331836,112,3,2,1,118
246365140,10,17,2,3,32
246376758,11,3,3,1,18
246382430,80,17,2,1,100
246395549,91,19,33,1,144
246396368,89,19,3,4,115
246398401,48,10,11,31,100
246408403,85,3,2,1,91
246408980,65,49,5,1,120
246421858,51,28,29,22,130
246428207,84,30,13,1,128
246438115,118,23,16,40,197
246446844,38,3,3,9,53
246457857,17,3,2,1,23
246464161,120,3,2,1,126
246469390,27,3,2,4,36
246475029,72,28,18,1,119
246484721,17,10,2,6,35
246489292,41,81,19,1,142
246493840,16,3,2,3,24
246494486,142,17,9,1,169
246506755,101,6,2,2,111
246512203,20,10,2,2,34
246517314,11,3,2,1,17
246550381,87,3,56,1,147
246552503,131,3,2,8,144
246553084,130,12,5,1,148
246565058,25,5,3,2,35
246568431,17,3,2,1,23
246608050,60,3,2,1,66
246621098,30,3,2,1,36
246623206,35,13,2,1,51
246632613,138,38,32,9,217
246681654,10,12,2,3,27
246683745,130,3,2,1,136
246689740,121,11,14,17,163
246694228,87,16,2,9,114
246697004,10,3,2,2,17
246700435,12,3,2,1,18
246747252,52,9,3,2,66
246750588,20,31,2,1,54
246751914,53,17,34,3,107
246764808,69,5,16,2,92
246767676,176,16,29,3,224
246783080,14,3,2,1,20
246810892,44,26,24,6,100
246814966,17,3,2,1,23
246816238,32,3,2,1,38
246821777,35,3,2,2,42
246822522,20,25,16,1,62
246832945,90,47,23,38,198
246853220,72,7,2,3,84
246865244,83,4,2,6,95
246882118,23,3,2,1,29
246883114,32,12,2,9,55
246883677,77,17,2,5,101
246883711,102,43,4,95,244
246886614,162,56,58,93,369
246888374,11,3,2,1,17
246894566,12,3,2,1,18
246913531,22,3,2,1,28
246934970,63,3,2,1,69
246950934,24,3,2,88,117
246980611,222,32,45,65,364
246985159,42,18,2,1,63
246988726,16,3,2,1,22
246989115,57,15,4,9,85
247010066,15,3,2,1,21
247016370,88,33,3,11,135
247017077,102,38,34,47,221
247030420,18,44,2,1,65
247039172,43,13,2,1,59
247054446,39,50,2,5,96
247060079,29,3,2,5,39
247060300,109,46,8,75,238
247080729,23,22,2,2,49
247098109,25,25,2,1,53
247100577,67,3,2,1,73
247103052,92,3,2,4,101
247110682,68,3,2,5,78
247116677,12,20,2,2,36
247125115,47,14,2,6,69
247146930,61,3,2,1,67
247159900,37,9,2,10,58
247162722,50,13,59,16,138
247165698,122,13,71,2,208
247167196,27,61,33,1,122
247180295,19,3,2,1,25
247197742,128,133,105,11,377
247209580,114,42,2,2,160
247211239,38,3,2,1,44
247216197,52,41,3,2,98
247234452,96,6,2,1,105
247239401,68,3,2,2,75
247247901,10,3,2,2,17
247248937,51,13,2,2,68
247268257,109,18,4,2,133
247275026,38,19,13,1,71
247286172,93,31,59,2,185
247293878,39,3,2,1,45
247302617,431,3,2,6,442
247312606,12,29,2,1,44
247325391,47,3,2,1,53
247326644,18,20,3,1,42
247335082,115,53,2,1,171
247349041,23,4,3,23,53
247353237,32,10,2,1,45
247357428,23,14,15,13,65
247370393,158,30,6,2,196
247392534,87,3,2,3,95
247401460,13,3,2,1,19
247408919,48,59,44,2,153
247417134,131,22,53,27,233
247446607,74,5,2,1,82
247448287,72,3,2,3,80
247456383,40,41,45,3,129
247456796,41,39,2,30,112
247458415,52,3,2,1,58
247483757,100,51,2,1,154
247490371,188,35,39,17,279
247490599,28,9,12,3,52
247492914,104,33,16,18,171
247499187,51,69,6,2,128
247507253,11,6,2,1,20
247512606,92,31,2,8,133
247515965,15,6,3,1,25
247530897,16,10,4,1,31
247543543,11,3,2,1,17
247560185,70,21,2,15,108
247566523,177,7,2,11,197
247604069,211,9,116,1,337
247622600,22,3,2,1,28
247624616,14,3,2,1,20
247640468,66,12,15,3,96
247651812,30,3,2,1,36
247662502,30,7,4,3,44
247669897,11,3,2,1,17
247675398,47,35,36,6,124
247677294,79,11,2,4,96
247691789,106,35,35,4,180
247704227,16,5,2,1,24
247704871,83,3,2,1,89
247720151,142,3,2,8,155
247748373,57,66,51,8,182
247775653,91,46,11,22,170
247788208,83,27,22,2,134
247788658,11,4,2,1,18
247792941,74,20,5,4,103
247801897,10,49,11,1,71
247818214,31,3,2,3,39
247820247,20,45,16,2,83
247821125,109,32,38,6,185
247832396,11,22,16,1,50
247844020,42,27,45,2,116
247884018,10,3,2,2,17
247914965,12,3,2,1,18
247937434,75,31,10,2,118
247954580,43,3,2,1,49
247955002,19,26,2,4,51
247957237,64,86,21,70,241
247969310,134,3,2,3,142
247975640,15,13,2,1,31
247981799,27,11,3,2,43
247989219,27,36,2,5,70
248020858,48,3,2,1,54
248021672,55,42,26,29,152
248023658,134,3,2,8,147
248026570,108,3,2,2,115
248046144,11,3,2,1,17
248055064,22,3,2,2,29
248059750,161,32,30,80,303
248072739,30,131,49,9,219
248072799,22,10,2,1,35
248075897,126,29,91,97,343
248076850,114,3,2,1,120
248082315,12,3,2,1,18
248095531,71,16,31,38,156
248096004,27,65,14,19,125
248096428,11,12,2,2,27
248107843,37,9,27,2,75
248108672,21,31,2,1,55
248113291,18,3,2,1,24
248114203,43,6,29,3,81
248115481,10,6,2,1,19
248127886,62,43,11,47,163
248130644,80,36,50,13,179
248135874,10,4,2,1,17
248141005,30,3,2,20,55
248141024,11,6,2,7,26
248142809,109,51,11,22,193
248186160,66,23,33,21,143
248187431,11,3,2,1,17
248192568,11,3,2,1,17
248202858,22,11,2,1,36
248219008,68,3,87,1,159
248225372,91,36,40,2,169
248233820,48,35,15,5,103
248270837,34,3,2,1,40
248283626,33,3,2,1,39
248295178,142,17,42,7,208
248298909,71,28,3,19,121
248302308,184,3,2,6,195
248302695,43,65,10,2,120
248303178,47,34,10,9,100
248304064,76,4,9,10,99
248321469,49,43,17,6,115
248368254,15,11,2,1,29
248386292,157,3,2,1,163
248396411,189,27,2,9,227
248409180,11,7,3,3,24
248411178,10,12,2,1,25
248411881,55,6,2,7,70
248439791,74,3,2,1,80
248441020,74,3,2,1,80
248442328,131,3,2,1,137
248442678,156,6,39,7,208
248445720,178,11,2,1,192
248460102,152,32,3,1,188
248462763,64,31,63,40,198
248463003,60,23,26,1,110
248463102,24,43,26,20,113
248467608,18,3,2,1,24
248468493,11,7,2,1,21
248484934,161,25,2,21,209
248489986,50,61,12,1,124
248498221,244,28,2,7,281
248508750,128,46,19,24,217
248514267,11,13,2,1,27
248525665,28,35,37,3,103
248535212,62,41,11,14,128
248541169,85,12,32,1,130
248541889,33,32,3,7,75
248551442,61,4,36,13,114
248555862,12,5,2,1,20
248558911,144,3,2,5,154
248572210,230,85,11,8,334
248581838,42,3,2,1,48
248585610,89,17,79,29,214
248591230,86,34,15,5,140
248608325,58,9,3,1,71
248613864,26,3,2,1,32
248621330,12,12,2,1,27
248634413,55,10,3,3,71
248636131,29,29,2,3,63
248649587,61,34,2,12,109
248664869,10,3,2,2,17
248665439,32,57,3,1,93
248677088,37,6,6,1,50
248677510,14,3,2,1,20
248680269,22,30,9,11,72
248691190,12,3,2,1,18
248695655,35,32,14,3,84
248700911,72,3,2,1,78
248703423,40,22,35,1,98
248704367,32,30,46,9,117
248705695,57,25,23,11,116
248707595,144,14,2,5,165
248719939,76,9,4,13,102
248721933,81,45,8,1,135
248724410,472,3,2,11,488
248725267,73,6,2,1,82
248726443,45,20,41,1,107
248738722,33,3,2,1,39
248741409,19,24,2,1,46
248743998,81,20,3,5,109
248746001,30,10,2,1,43
248753592,12,10,2,2,26
248764845,57,21,10,8,96
248774084,17,3,2,1,23
248788322,106,3,2,11,122
248788450,52,47,2,20,121
248800893,50,3,2,6,61
248803822,31,31,2,5,69
248809040,150,3,2,2,157
248813770,45,9,2,6,62
248817419,112,44,35,24,215
248832164,67,13,9,2,91
248836576,40,35,8,51,134
248837013,122,20,19,3,164
248859831,47,3,2,1,53
248861262,10,5,2,1,18
248888026,14,3,2,2,21
248890434,112,3,2,1,118
248902541,11,3,2,1,17
248918816,133,3,2,6,144
248926301,11,3,2,1,17
248930166,54,19,2,12,87
248930888,41,61,93,58,253
248950653,81,14,44,7,146
248970936,85,11,2,3,101
248978197,39,3,2,1,45
248993946,107,12,2,14,135
248995902,22,3,2,13,40
249006051,67,14,14,3,98
249010145,12,5,2,1,20
249010345,178,14,2,10,204
249025777,11,38,2,1,52
249026974,38,12,14,1,65
249041604,48,12,75,13,148
249044647,10,5,2,1,18
249053421,14,4,2,1,21
249054195,24,33,2,3,62
249056995,16,3,2,5,26
249057673,39,3,2,1,45
249062470,12,3,2,1,18
249086058,64,24,18,1,107
249086470,117,29,116,2,264
249087876,34,26,10,2,72
249092906,143,40,74,18,275
249104255,88,45,36,16,185
249112833,205,3,2,2,212
249148576,71,44,37,27,179
249151692,33,3,2,1,39
249154057,222,3,2,1,228
249178022,41,11,2,1,55
249193878,47,5,9,37,98
249201059,31,15,7,3,56
249207426,206,43,27,1,277
249212985,30,65,24,6,125
249219874,30,3,2,1,36
249222554,53,3,3,10,69
249249770,11,6,3,1,21
249253501,12,3,2,1,18
249265020,13,29,3,1,46
249285027,36,3,16,9,64
249290865,87,47,26,62,222
249293422,26,30,23,12,91
249296227,13,29,2,8,52
249307851,13,9,2,1,25
249308475,97,3,2,12,114
249310341,38,22,2,2,64
249322248,49,3,5,6,63
249322473,85,19,2,2,108
249322998,89,3,2,2,96
249326137,131,12,2,3,148
249328151,37,3,2,5,47
249329376,84,25,14,2,125
249349904,42,3,2,9,56
249360799,36,5,11,1,53
249361355,101,35,2,1,139
249364398,77,4,2,16,99
249365861,79,49,9,23,160
249384656,33,40,2,1,76
249386092,197,3,2,3,205
249404528,30,3,2,1,36
249404894,69,7,23,2,101
249410216,73,12,3,2,90
249410276,22,3,2,1,28
249414725,33,17,2,2,54
249421726,69,9,2,3,83
249434801,46,18,8,1,73
249438091,64,12,11,16,103
249447174,14,110,2,6,132
249447411,125,3,2,1,131
249449403,34,4,2,2,42
249471570,25,3,2,1,31
249506477,20,19,2,4,45
249513537,146,29,42,3,220
249531738,88,44,2,35,169
249538751,28,29,2,1,60
249540219,52,17,7,5,81
249543950,39,25,8,51,123
249545533,21,3,2,1,27
249547543,17,19,2,1,39
249550522,49,35,11,1,96
249567939,10,3,2,2,17
249572141,151,34,52,2,239
249583610,97,20,2,1,120
249588381,107,57,7,3,174
249604985,15,3,2,2,22
249616510,178,3,2,1,184
249635569,324,3,2,6,335
249636367,12,5,3,2,22
249640047,13,44,3,2,62
249642073,121,3,2,1,127
249656213,18,5,2,11,36
249664624,16,3,2,1,22
249666078,46,82,36,3,167
249686489,314,34,3,1,352
249704686,32,34,18,16,100
249728072,32,3,2,1,38
249734461,31,38,2,22,93
249734780,71,3,2,1,77
249738544,56,4,5,11,76
249747951,13,4,2,1,20
249767128,36,42,24,1,103
249768529,89,45,14,2,150
249774296,86,23,2,38,149
249782803,77,6,54,20,157
249807658,32,3,2,4,41
249809513,97,8,2,11,118
249817356,86,31,9,5,131
249823583,85,3,2,7,97
249828524,23,19,6,1,49
249836644,63,45,2,1,111
249845063,67,57,50,7,181
249845874,44,3,2,4,53
249865436,63,3,2,1,69
249865564,44,28,15,41,128
249866488,41,15,23,2,81
249869571,22,5,2,1,30
249876586,94,7,14,11,126
249904995,11,29,2,1,43
249924972,125,3,2,9,139
249929828,48,36,3,24,111
249934295,23,3,2,1,29
249938448,22,20,2,2,46
249946846,59,13,42,3,117
249955704,13,16,3,1,33
249974073,90,3,2,2,97
249974751,28,3,2,1,34
249975897,33,3,2,3,41
249991043,49,3,2,4,58
250024055,58,16,3,1,78
250024200,17,10,2,1,30
250058364,13,3,25,3,44
250069621,41,32,2,1,76
250071169,33,43,2,17,95
250080278,49,19,2,3,73
250083147,10,3,2,2,17
250104186,241,11,55,1,308
250104758,56,11,22,5,94
250114127,18,4,2,1,25
250115755,97,90,16,1,204
250117570,138,5,64,1,208
250132688,22,32,2,2,58
250137737,331,3,2,6,342
250173988,37,21,2,1,61
250180315,100,6,3,6,115
250181604,21,3,2,1,27
250193305,22,59,23,2,106
250210369,90,78,12,20,200
250225273,63,11,12,1,87
250251963,16,3,2,1,22
250261913,58,11,15,8,92
250267516,12,20,12,1,45
250279329,170,3,2,2,177
250295581,169,13,15,18,215
250305962,10,15,2,1,28
250312323,80,42,2,1,125
250320092,111,3,2,2,118
250371661,77,13,14,7,111
250383795,84,27,2,2,115
250384566,177,55,67,1,300
250391343,153,28,9,28,218
250398422,49,10,3,25,87
250429247,13,15,3,1,32
250435347,17,6,2,2,27
250455228,104,4,2,1,111
250455765,43,3,2,2,50
250459871,68,32,2,1,103
250470342,24,3,2,2,31
250470716,140,8,7,2,157
250475167,56,26,2,1,85
250488262,146,19,111,21,297
250490001,56,4,44,1,105
250490220,81,10,14,19,124
250492817,26,56,17,14,113
250495445,30,29,2,1,62
250497360,100,3,2,1,106
250502205,91,32,2,1,126
250515790,30,5,18,2,55
250521910,130,6,2,4,142
250527764,108,9,2,11,130
250528018,46,9,3,1,59
250533274,15,3,9,2,29
250548417,90,3,2,7,102
250553656,153,17,3,2,175
250555780,54,3,2,2,61
250565983,65,27,2,4,98
250608009,331,3,2,3,339
250613575,63,28,24,21,136
250638956,57,8,2,1,68
250654546,104,73,44,1,222
250657689,156,17,3,1,177
250672951,167,3,2,4,176
250674829,23,24,2,16,65
250676673,90,3,2,1,96
250676698,50,3,2,2,57
250680953,54,22,7,24,107
250684017,159,3,2,1,165
250692274,124,13,2,9,148
250740166,235,14,32,8,289
250744253,27,3,2,1,33
250749294,50,31,39,34,154
250750045,41,3,2,1,47
250753355,18,11,2,8,39
250754140,82,36,4,23,145
250756649,23,8,2,4,37
250766113,238,3,2,6,249
250767078,70,36,39,78,223
250770025,116,13,2,1,132
250790388,121,24,17,4,166
250795009,90,3,2,12,107
250797576,88,3,2,1,94
250801601,23,46,10,2,81
250816432,49,38,2,7,96
250818127,27,6,2,1,36
250823341,17,23,2,2,44
250835267,66,37,2,22,127
250840228,64,15,16,6,101
250873118,15,38,2,3,58
250874156,28,3,2,1,34
250919407,17,22,2,1,42
250922146,114,3,2,1,120
250928111,13,3,2,1,19
250953486,37,3,2,1,43
250961507,44,8,20,2,74
250987837,237,18,2,1,258
250998189,55,3,2,1,61
251016879,15,4,2,1,22
251018570,11,35,2,1,49
251019608,22,84,4,5,115
251032968,28,3,2,1,34
251035783,82,20,11,2,115
251038554,181,26,2,13,222
251049518,19,24,34,2,79
251059959,36,14,70,4,124
251064862,52,33,2,1,88
251095781,15,3,2,1,21
251113279,63,8,4,2,77
251123809,27,81,4,4,116
251137007,61,3,2,3,69
251150266,38,3,2,4,47
251157140,19,7,4,4,34
251158774,53,44,98,13,208
251164802,122,120,19,19,280
251200691,24,24,6,1,55
251216221,83,47,43,29,202
251225706,172,3,2,3,180
251232261,28,17,2,2,49
251244088,57,3,2,1,63
251246051,186,35,16,8,245
251248283,13,3,2,1,19
251262174,89,57,2,14,162
251303022,75,37,16,2,130
251308258,31,19,2,2,54
251308462,113,26,28,5,172
251317349,106,15,2,8,131
251317406,55,3,2,1,61
251347921,11,3,2,1,17
251350448,326,3,2,1,332
251355908,34,22,36,1,93
251377551,51,16,2,2,71
251422980,68,62,60,15,205
251423299,30,14,2,2,48
251433689,82,15,14,1,112
251436676,181,3,2,4,190
251450739,73,21,84,11,189
251456961,112,37,18,1,168
251468303,28,3,2,1,34
251469333,13,4,2,1,20
251485799,11,9,2,1,23
251487796,16,15,2,3,36
251488466,112,3,2,4,121
251493440,25,48,2,2,77
251511973,127,13,24,2,166
251522171,99,55,18,1,173
251527152,11,3,2,1,17
251539530,149,3,2,18,172
251542885,50,81,19,11,161
251548856,67,25,16,23,131
251563260,43,3,2,4,52
251595193,34,64,3,1,102
251601543,118,3,2,6,129
251633647,86,9,9,4,108
251636003,58,22,35,1,116
251647784,53,15,21,4,93
251655290,11,3,2,1,17
251664455,11,3,2,1,17
251672358,49,72,28,18,167
251681088,175,3,2,8,188
251686268,43,9,2,3,57
251692133,125,7,2,2,136
251701342,10,3,2,3,18
251701914,25,3,2,1,31
251706292,26,47,2,23,98
251707438,42,3,2,2,49
251719102,59,27,11,3,100
251728326,34,6,2,1,43
251729039,111,26,76,1,214
251735082,36,13,14,1,64
251764291,90,38,11,3,142
251769805,10,6,2,1,19
251773191,62,20,19,1,102
251787730,11,3,2,1,17
251797270,19,51,7,1,78
251810754,77,43,20,36,176
251814449,12,6,2,2,22
251818009,10,20,2,1,33
251819519,17,12,2,2,33
251822321,67,21,2,9,99
251824245,85,17,51,9,162
251828132,536,3,2,67,608
251830236,77,43,17,2,139
251842901,20,3,2,1,26
251853509,193,24,28,2,247
251855147,77,3,2,1,83
251856679,144,3,2,8,157
251862325,33,51,2,1,87
251880921,38,3,2,1,44
251910098,60,3,7,1,71
251914653,20,3,2,1,26
251922940,120,3,2,16,141
251925568,67,26,6,3,102
251935182,92,34,23,9,158
251938365,13,8,2,1,24
251940394,125,3,2,1,131
251942351,17,5,2,1,25
251945358,37,5,56,24,122
251953382,104,3,72,1,180
251960066,139,3,2,10,154
251970118,149,36,43,5,233
251980252,126,11,50,7,194
251982690,62,74,2,1,139
251985654,139,3,2,3,147
252003354,95,22,2,1,120
252007876,133,3,2,1,139
252011495,24,23,23,2,72
252018005,71,32,2,22,127
252027289,16,3,2,1,22
252035496,10,5,2,1,18
252059826,27,18,4,1,50
252096154,18,7,2,1,28
252105226,66,83,7,68,224
252105643,62,3,32,2,99
252107923,39,62,17,9,127
252134478,54,32,7,17,110
252162013,10,3,2,3,18
252197240,48,3,2,1,54
252213511,55,3,2,1,61
252223734,219,36,53,6,314
252227951,71,3,2,1,77
252233787,73,83,20,3,179
252239849,104,62,114,59,339
252243026,15,3,2,4,24
252247346,33,12,60,11,116
252250520,38,3,2,1,44
252277908,27,3,2,3,35
252283440,10,3,2,5,20
252311916,118,21,50,22,211
252317072,10,6,2,1,19
252324083,15,3,2,1,21
252328241,315,23,21,27,386
252331364,52,16,2,6,76
252334839,132,47,2,3,184
252334866,64,53,2,8,127
252335069,50,33,82,18,183
252342991,241,13,2,13,269
252362307,75,3,2,17,97
252395427,23,3,2,1,29
252395942,133,52,2,7,194
252398531,88,11,36,23,158
252404831,154,4,2,4,164
252414426,75,63,22,19,179
252416553,30,3,2,1,36
252419570,58,16,21,9,104
252428290,39,48,2,1,90
252429458,156,23,2,50,231
252435413,79,5,3,19,106
252435860,37,3,2,8,50
252453975,91,20,62,1,174
252461461,11,3,2,1,17
252465587,106,21,24,3,154
252479652,188,3,2,2,195
252481220,75,35,2,6,118
252488022,46,14,37,3,100
252509856,12,3,2,1,18
252529772,24,3,2,1,30
252533288,18,3,2,1,24
252537370,10,3,2,2,17
252539882,67,3,2,2,74
252548546,12,27,2,4,45
252549272,103,8,27,1,139
252560899,100,35,2,20,157
252561402,57,32,14,5,108
252563368,10,6,5,1,22
252571631,104,26,21,11,162
252574393,135,23,19,1,178
252581301,114,3,8,11,136
252589085,30,5,37,9,81
252603337,144,26,55,14,239
252608095,101,17,3,13,134
252620486,55,30,2,3,90
252620500,10,7,2,1,20
252625819,48,3,2,1,54
252628742,61,3,3,28,95
252634478,106,3,2,9,120
252641004,162,26,36,26,250
252652368,114,45,36,7,202
252660015,83,20,15,25,143
252660249,11,3,2,3,19
252661101,62,18,2,1,83
252668072,162,31,27,4,224
252671008,141,21,2,3,167
252691044,13,3,2,1,19
252694267,17,3,2,1,23
252700122,17,3,2,1,23
252709851,82,25,40,1,148
252713477,45,35,52,30,162
252722703,20,22,2,1,45
252738557,72,37,41,19,169
252762105,72,26,9,2,109
252769930,21,26,8,1,56
252776265,63,28,33,8,132
252781195,71,63,2,3,139
252783998,34,26,4,1,65
252792237,15,3,2,1,21
252795770,77,16,2,11,106
252799500,151,3,2,2,158
252800856,78,10,16,15,119
252801069,97,23,2,1,123
252803653,87,58,156,40,341
252805315,143,21,3,13,180
252817071,102,50,52,6,210
252846266,53,68,4,1,126
252847524,10,7,2,1,20
252853220,39,32,2,17,90
252857957,60,7,3,7,77
252863865,109,5,9,3,126
252871105,170,44,69,8,291
252884128,64,33,3,3,103
252891959,37,10,7,6,60
252897101,191,3,2,13,209
252897799,10,5,2,1,18
252904940,90,17,10,35,152
252918960,94,19,2,9,124
252940101,55,17,70,14,156
252942757,51,3,2,1,57
252945814,75,33,2,12,122
252947951,56,63,20,7,146
252956382,72,13,47,1,133
252958552,92,11,13,6,122
252984394,52,3,2,1,58
252986054,33,82,15,5,135
252995251,35,28,3,5,71
253001448,99,32,4,14,149
253002469,142,22,2,2,168
253003739,66,9,29,2,106
253030117,45,7,31,7,90
253032131,23,24,16,8,71
253035554,43,9,15,2,69
253036108,17,27,2,1,47
253046692,50,14,2,2,68
253052719,19,9,3,14,45
253063658,36,9,2,3,50
253068542,68,57,7,1,133
253078306,73,18,2,7,100
253078331,83,3,2,1,89
253089157,18,3,2,2,25
253096700,120,3,2,1,126
253099000,34,43,26,1,104
253109312,401,3,2,3,409
253117884,40,40,30,1,111
253123982,104,3,2,11,120
253125750,46,28,3,1,78
253129621,44,5,2,1,52
253139028,95,21,38,6,160
253144757,117,22,61,6,206
253156816,286,3,2,2,293
253172287,96,3,2,1,102
253172873,39,8,3,1,51
253193352,103,16,3,3,125
253196086,74,3,2,1,80
253198988,75,10,3,1,89
253199408,60,29,26,11,126
253207485,26,4,2,6,38
253214960,341,3,6,30,380
253220299,166,22,82,1,271
253232686,72,3,2,14,91
253245726,49,31,2,1,83
253250447,46,3,2,2,53
253251241,145,3,2,9,159
253251271,88,9,59,12,168
253254901,21,3,2,1,27
253279624,19,3,2,1,25
253281197,113,14,19,11,157
253287932,68,67,8,8,151
253322757,22,36,17,4,79
253325174,45,3,2,1,51
253335386,80,28,18,2,128
253336996,78,87,169,11,345
253342020,52,36,14,20,122
253381247,93,34,11,2,140
253387917,122,76,17,6,221
253392967,13,3,2,1,19
253393233,23,12,2,3,40
253435595,29,12,2,1,44
253449882,136,3,16,8,163
253454153,70,17,52,6,145
253458887,22,4,2,1,29
253483341,32,42,54,1,129
253483541,46,17,47,48,158
253501196,148,59,5,8,220
253506145,56,45,6,1,108
253541473,23,8,2,1,34
253567254,332,12,4,10,358
253578455,69,10,2,2,83
253579259,10,5,2,1,18
253580907,217,21,2,5,245
253580981,63,44,98,3,208
253583208,12,3,2,1,18
253586827,40,26,2,1,69
253590297,38,38,14,9,99
253599137,17,3,2,6,28
253610655,150,3,2,22,177
253617566,30,34,34,1,99
253632273,81,19,2,10,112
253639097,10,6,2,1,19
253651552,15,13,2,4,34
253654571,52,15,12,1,80
253673552,34,37,2,5,78
253677676,11,3,2,1,17
253678820,41,23,2,1,67
253682561,19,17,5,17,58
253683395,92,53,44,56,245
253683817,38,25,13,1,77
253705938,55,25,14,5,99
253724127,172,4,2,32,210
253744042,92,6,5,1,104
253744472,21,3,2,1,27
253755887,23,51,29,8,111
253764841,78,13,2,1,94
253767781,116,3,2,2,123
253782485,51,3,2,1,57
253783051,66,23,40,3,132
253784707,21,3,2,1,27
253789819,50,65,13,3,131
253792859,12,27,9,13,61
253798225,55,20,2,22,99
253801164,32,5,2,1,40
253807039,35,3,2,1,41
253823287,51,114,4,3,172
253833313,21,30,16,5,72
253835246,47,15,22,9,93
253837308,133,17,11,1,162
253849753,13,20,6,1,40
253857541,23,3,2,1,29
253871272,49,84,8,23,164
253879204,73,41,47,2,163
253891524,44,49,21,1,115
253895851,17,10,4,11,42
253898197,12,5,2,1,20
253924715,44,28,26,4,102
253932142,27,19,42,3,91
253948722,25,3,2,3,33
253986427,41,18,2,2,63
253987076,85,3,2,1,91
253989331,64,37,5,1,107
253993671,43,3,2,1,49
254002267,94,12,2,3,111
254005891,152,3,39,2,196
254014776,170,3,2,4,179
254017105,22,27,4,13,66
254021411,214,12,46,9,281
254025945,49,3,2,7,61
254026079,42,23,3,7,75
254029855,69,3,2,6,80
254032302,82,24,4,31,141
254033775,74,11,2,1,88
254035572,94,12,2,2,110
254037816,63,35,32,8,138
254039745,23,3,2,1,29
254041511,17,3,2,1,23
254050851,158,3,5,5,171
254053470,111,3,2,1,117
254058820,39,3,2,4,48
254059459,68,3,2,2,75
254061783,49,94,12,1,156
254079522,66,13,2,3,84
254082440,53,3,2,2,60
254101233,42,3,2,4,51
254109079,131,3,2,13,149
254110636,20,18,2,1,41
254112169,37,45,9,2,93
254113000,165,3,2,17,187
254115806,210,5,2,4,221
254122445,11,3,2,1,17
254128533,29,13,2,3,47
254131735,160,7,2,1,170
254138618,16,3,2,2,23
254153428,60,24,107,6,197
254157598,13,9,2,1,25
254165076,41,3,2,1,47
254179723,24,3,2,1,30
254192924,47,3,12,6,68
254193977,55,3,2,1,61
254219758,24,23,2,1,50
254226877,41,48,2,1,92
254228199,11,3,2,2,18
254233565,49,3,2,3,57
254237691,13,60,105,1,179
254254521,54,33,5,6,98
254281351,71,47,28,12,158
254282768,15,12,2,2,31
254284039,239,3,2,1,245
254286748,147,21,26,77,271
254293852,279,9,2,5,295
254324841,48,16,2,1,67
254351433,108,40,2,2,152
254353144,45,16,7,1,69
254376580,23,5,2,1,31
254382196,58,9,7,6,80
254384945,12,42,8,1,63
254390909,91,18,5,1,115
254391395,541,3,2,23,569
254402937,159,17,7,1,184
254405017,42,27,30,1,100
254444889,109,27,2,14,152
254445995,11,3,2,1,17
254465074,27,3,2,1,33
254468539,13,13,2,1,29
254471799,18,21,2,1,42
254474491,50,3,2,5,60
254503756,13,13,2,6,34
254536320,161,3,2,7,173
254547330,56,30,39,47,172
254555293,104,9,2,29,144
254571981,99,4,18,31,152
254577710,10,14,2,1,27
254579091,73,10,2,1,86
254582679,153,32,29,1,215
254585697,11,18,4,2,35
254585796,151,48,2,11,212
254587370,84,44,10,2,140
254589317,80,28,19,3,130
254590864,45,3,2,7,57
254597067,121,10,17,1,149
254601004,54,3,2,4,63
254603620,279,22,6,9,316
254616709,132,54,5,1,192
254640220,11,3,2,1,17
254657136,11,3,2,1,17
254665210,42,28,30,6,106
254673686,48,4,2,1,55
254698548,160,3,2,1,166
254698573,105,32,4,3,144
254698587,94,4,2,1,101
254711396,46,3,2,1,52
254716559,83,3,2,14,102
254736982,14,3,2,1,20
254738250,89,3,2,4,98
254756483,137,37,40,19,233
254761699,160,72,24,4,260
254764869,64,3,2,1,70
254768640,14,15,2,1,32
254782003,107,18,20,1,146
254788137,53,42,21,1,117
254822740,98,47,18,32,195
254832042,17,35,2,1,55
254839418,124,3,2,1,130
254843174,208,3,2,4,217
254845030,10,13,2,1,26
254845131,26,25,3,8,62
254849845,71,51,27,9,158
254852535,121,68,5,17,211
254870892,10,5,2,1,18
254877024,13,13,2,3,31
254894345,52,3,2,2,59
254913426,49,88,30,21,188
254919433,20,3,2,1,26
254925422,41,73,5,2,121
254928058,40,3,2,1,46
254929669,52,3,2,4,61
254932218,76,21,2,1,100
254943089,25,3,2,1,31
254950247,42,3,2,17,64
254964247,33,3,2,21,59
254964458,107,3,2,34,146
254970597,11,3,2,2,18
254977604,43,12,4,1,60
254982359,13,3,2,1,19
255001328,125,49,2,40,216
255006039,16,7,2,2,27
255010767,75,23,13,2,113
255015056,24,21,2,4,51
255015424,66,3,2,1,72
255038394,63,3,2,1,69
255087567,34,22,19,73,148
255091377,164,3,2,13,182
255096250,11,5,2,1,19
255109704,62,41,38,2,143
255125888,78,19,13,3,113
255125931,80,18,64,23,185
255128450,33,37,2,1,73
255130135,93,52,10,60,215
255135231,11,3,2,1,17
255138518,45,3,2,2,52
255144489,20,7,12,1,40
255170679,94,3,2,1,100
255172317,42,3,2,1,48
255189795,52,19,21,9,101
255204774,27,37,5,2,71
255208337,47,3,2,1,53
255221915,121,18,35,23,197
255228959,25,3,2,4,34
255242666,69,47,39,6,161
255244157,51,33,73,1,158
255268704,93,41,35,3,172
255274795,136,6,2,1,145
255279438,70,10,2,1,83
255286100,57,81,14,21,173
255305260,60,3,2,1,66
255306511,44,20,2,1,67
255319582,67,86,25,1,179
255360062,84,3,2,11,100
255366523,41,41,25,5,112
255374298,134,11,2,1,148
255377566,17,35,2,1,55
255384304,28,3,2,1,34
255396185,10,3,2,3,18
255411258,18,3,2,1,24
255427896,45,32,16,19,112
255429965,30,50,6,8,94
255433950,77,3,2,14,96
255457216,30,61,9,1,101
255497357,43,28,2,5,78
255503237,24,61,8,1,94
255516861,74,104,9,25,212
255517305,72,3,2,21,98
255524439,29,33,78,79,219
255527035,29,8,2,4,43
255527882,51,18,16,16,101
255531129,20,6,21,1,48
255543146,11,3,2,1,17
255547778,15,27,6,1,49
255548707,28,42,2,2,74
255562457,10,7,2,1,20
255581110,59,5,2,1,67
255591293,45,31,62,4,142
255594975,80,22,2,1,105
255605416,17,9,24,28,78
255609837,34,3,2,1,40
255611646,33,57,2,1,93
255612190,35,3,2,3,43
255615291,13,11,2,1,27
255615427,161,17,2,4,184
255627316,49,11,2,4,66
255638954,56,22,3,12,93
255640823,28,44,3,1,76
255640906,12,5,2,1,20
255641260,19,3,2,4,28
255642226,35,3,2,4,44
255647319,27,13,2,2,44
255675359,77,23,41,45,186
255684008,36,62,9,10,117
255689097,13,16,2,1,32
255689618,119,15,3,1,138
255695993,13,4,2,1,20
255696882,16,22,13,1,52
255700201,84,21,2,1,108
255709502,24,5,2,1,32
255732558,204,3,2,11,220
255733832,76,3,2,2,83
255734141,153,33,18,2,206
255735822,135,27,23,14,199
255752794,15,22,7,1,45
255784631,29,3,2,3,37
255801315,51,3,2,1,57
255802504,79,74,80,7,240
255811121,40,17,2,1,60
255811139,34,14,2,4,54
255817761,28,27,2,6,63
255820587,14,3,2,1,20
255832803,11,3,2,1,17
255838557,85,3,2,2,92
255841226,168,14,11,2,195
255846449,58,29,18,19,124
255849667,62,39,2,9,112
255855517,80,3,2,2,87
255864106,10,5,2,1,18
255884711,18,8,2,1,29
255894037,35,57,4,7,103
255913684,12,5,2,1,20
255934188,116,31,5,3,155
255945914,33,3,2,1,39
255962283,11,3,2,1,17
255963985,67,34,51,17,169
255964441,123,16,2,1,142
255967942,17,31,30,4,82
255971950,35,3,2,1,41
255975201,87,3,2,4,96
255984789,13,3,2,1,19
255986100,119,26,2,2,149
255995067,96,21,2,2,121
256020149,35,3,2,3,43
256020420,15,18,2,1,36
256027279,110,41,36,18,205
256031738,33,19,4,1,57
256038715,37,78,11,1,127
256039560,123,34,38,5,200
256046035,49,37,25,21,132
256047108,49,3,2,1,55
256050272,42,7,11,1,61
256061047,76,3,2,1,82
256081033,54,25,14,1,94
256081732,128,3,2,1,134
256087624,12,3,2,3,20
256089685,46,10,3,1,60
256090909,29,37,2,2,70
256096373,22,34,10,18,84
256113567,13,8,2,1,24
256120419,44,3,2,12,61
256126437,54,44,102,21,221
256158567,139,18,21,7,185
256165833,13,4,2,1,20
256171614,98,26,2,15,141
256171752,13,56,2,1,72
256179853,12,3,2,2,19
256179929,61,38,62,3,164
256181630,54,3,10,9,76
256183667,15,41,7,1,64
256183932,271,3,2,1,277
256190308,79,50,32,18,179
256212887,88,3,2,1,94
256226726,17,3,2,1,23
256230751,43,3,2,1,49
256235513,53,26,29,1,109
256258772,10,4,2,1,17
256272749,63,41,2,1,107
256288669,19,3,2,1,25
256295767,59,51,8,5,123
256305537,13,3,2,1,19
256309610,46,94,19,8,167
256310178,18,3,2,1,24
256312105,52,10,14,8,84
256327882,11,3,2,1,17
256345462,21,36,13,4,74
256349499,75,3,2,5,85
256356598,107,8,2,1,118
256361973,97,4,2,2,105
256373736,150,31,14,1,196
256393854,82,30,136,7,255
256395205,40,3,2,8,53
256427044,52,27,27,1,107
256439461,84,6,2,1,93
256465363,41,48,2,1,92
256474412,11,3,2,2,18
256488111,11,36,2,1,50
256488267,16,3,2,2,23
256512342,62,21,17,10,110
256522962,19,13,3,5,40
256538067,22,18,3,1,44
256556566,14,17,2,1,34
256570431,18,16,23,1,58
256608300,60,8,2,1,71
256619509,90,33,28,1,152
256624316,111,20,3,5,139
256625550,27,21,8,2,58
256647919,29,3,2,1,35
256649181,82,6,2,11,101
256665828,73,36,2,2,113
256686032,74,68,2,13,157
256687105,18,49,4,1,72
256689213,15,6,2,1,24
256709836,85,40,31,34,190
256737379,31,35,2,1,69
256740189,97,31,72,18,218
256741230,73,31,55,21,180
256746347,11,3,2,1,17
256751678,78,3,2,1,84
256751849,101,18,2,1,122
256751992,35,3,2,1,41
256752341,143,3,2,8,156
256764747,50,13,7,1,71
256767213,56,13,41,4,114
256821851,16,7,2,1,26
256856460,13,8,2,1,24
256861744,73,11,77,4,165
256871197,101,23,2,2,128
256888757,101,24,17,1,143
256889616,60,24,5,2,91
256889813,64,44,6,2,116
256892370,69,52,21,7,149
256906370,38,28,8,5,79
256910424,102,3,2,1,108
256916097,23,58,24,7,112
256939967,43,3,2,1,49
256941214,37,22,2,1,62
256945419,161,3,2,3,169
256963929,15,5,2,5,27
256966306,103,38,90,6,237
256983015,214,3,2,3,222
256996532,23,9,6,1,39
256997970,60,108,9,19,196
257018185,11,3,2,1,17
257029710,171,7,23,2,203
257039327,49,22,19,19,109
257044804,13,13,2,1,29
257056336,81,3,2,1,87
257056683,110,3,2,4,119
257060923,10,29,2,4,45
257072580,13,4,2,1,20
257093480,81,15,42,12,150
257100131,44,3,2,11,60
257103748,84,48,30,25,187
257109034,11,40,2,3,56
257110834,165,34,29,32,260
257131259,49,3,2,3,57
257133462,106,3,2,11,122
257148214,65,22,2,1,90
257148457,10,3,2,4,19
257182838,99,59,48,16,222
257202675,63,72,62,1,198
257202704,12,4,3,1,20
257217554,96,5,17,9,127
257218623,104,3,2,17,126
257225967,160,3,2,1,166
257242628,87,48,14,33,182
257247067,92,10,58,97,257
257248822,36,9,3,2,50
257249256,103,9,4,6,122
257271784,20,16,2,14,52
257275429,71,45,40,31,187
257295400,11,13,2,1,27
257299600,217,3,2,6,228
257301133,110,16,26,1,153
257311836,48,14,3,3,68
257315362,89,5,2,1,97
257344055,63,3,2,3,71
257344738,10,18,2,1,31
257345108,11,5,2,3,21
257345290,11,3,2,1,17
257358491,137,3,2,2,144
257389235,71,3,2,3,79
257391602,18,25,35,36,114
257393258,33,5,2,1,41
257402056,33,4,2,2,41
257411924,46,3,2,4,55
257418657,126,6,29,6,167
257421901,103,3,2,15,123
257427734,19,15,4,1,39
257434492,68,40,53,8,169
257441877,39,14,2,1,56
257451691,90,19,15,3,127
257463500,77,3,2,1,83
257467173,95,26,2,1,124
257471998,81,18,2,9,110
257474655,22,3,2,1,28
257496370,13,3,2,1,19
257499494,108,9,2,2,121
257546867,159,3,2,11,175
257572124,67,3,2,3,75
257574180,49,12,37,3,101
257583896,11,3,2,1,17
257613053,55,56,6,3,120
257616937,218,23,20,16,277
257623817,20,12,2,1,35
257657819,35,3,2,1,41
257671293,58,3,2,2,65
257671843,32,56,16,16,120
257673763,47,27,6,3,83
257684694,64,3,2,1,70
257700679,67,3,2,1,73
257711476,105,11,7,1,124
257733827,20,36,2,15,73
257735557,36,3,2,4,45
257754269,267,21,2,12,302
257784173,23,12,2,4,41
257788799,32,46,59,17,154
257789930,13,3,2,1,19
257791150,95,4,7,4,110
257807537,54,3,2,1,60
257807671,32,13,26,1,72
257827470,54,3,2,1,60
257828530,40,3,2,5,50
257829347,56,20,2,18,96
257839621,10,4,2,1,17
257849725,43,46,3,8,100
257854185,50,3,9,9,71
257855078,14,3,2,1,20
257869554,94,3,2,1,100
257873020,57,26,2,1,86
257882140,24,16,37,1,78
257884237,25,3,23,8,59
257884448,119,3,2,1,125
257887568,36,3,2,1,42
257927107,68,65,35,9,177
257928842,39,32,2,4,77
257952951,15,3,2,1,21
257972610,51,25,29,6,111
257975004,136,59,71,47,313
257977015,51,35,4,2,92
257982634,15,28,2,1,46
257983067,27,11,2,1,41
257985483,10,3,2,3,18
257991190,17,3,2,5,27
257993466,38,19,2,4,63
257996596,14,3,2,3,22
258000295,77,3,2,3,85
258004057,90,6,2,1,99
258009734,124,70,27,50,271
258014169,121,21,2,6,150
258025639,62,77,2,4,145
258036943,126,3,2,1,132
258053417,57,3,2,21,83
258073917,53,48,2,1,104
258080840,76,3,2,1,82
258084630,44,35,26,3,108
258086088,129,3,2,12,146
258092127,10,5,2,1,18
258095045,71,11,8,1,91
258116839,58,51,8,6,123
258123406,113,17,78,1,209
258130541,46,3,2,1,52
258140445,65,23,2,2,92
258143671,17,8,2,3,30
258164180,13,6,2,3,24
258189650,19,35,59,3,116
258213437,42,11,27,8,88
258238391,63,34,7,7,111
258243687,139,53,52,1,245
258246330,150,43,42,9,244
258269525,63,14,2,12,91
258283442,48,16,2,7,73
258284550,11,3,2,2,18
258286892,86,29,83,24,222
258302403,114,3,2,1,120
258302671,79,12,2,6,99
258321321,110,9,2,4,125
258326722,40,14,2,1,57
258333902,11,3,2,1,17
258335120,116,14,68,50,248
258340390,18,24,14,9,65
258342651,83,49,14,30,176
258342766,14,3,2,1,20
258348305,27,5,26,10,68
258355405,19,19,2,9,49
258365127,197,15,45,4,261
258366982,27,5,2,5,39
258387326,165,3,2,13,183
258388085,31,3,2,1,37
258395003,34,65,13,10,122
258396445,72,65,26,11,174
258403306,62,3,2,2,69
258410978,95,9,58,2,164
258416866,94,24,2,12,132
258420312,104,33,51,40,228
258437557,27,3,2,3,35
258444153,170,17,11,5,203
258444252,88,3,2,3,96
258476876,20,24,99,1,144
258476877,72,3,2,1,78
258482908,55,44,24,7,130
258497423,150,3,2,1,156
258506389,69,25,53,15,162
258512376,14,11,2,1,28
258534845,10,4,2,1,17
258536334,150,71,38,5,264
258537833,54,7,4,4,69
258556562,13,11,2,1,27
258566976,22,3,2,1,28
258574657,54,31,14,35,134
258582309,27,3,2,1,33
258586110,21,31,2,1,55
258598079,22,5,2,1,30
258608361,14,10,2,1,27
258609161,14,3,2,1,20
258610933,12,4,4,1,21
258620300,13,3,2,1,19
258629121,82,3,12,1,98
258633226,34,28,49,2,113
258646555,201,34,2,3,240
258647531,14,3,2,1,20
258648943,59,3,2,1,65
258671091,779,3,2,3,787
258672737,13,3,2,1,19
258673359,11,3,2,1,17
258686532,55,27,13,15,110
258696179,229,4,2,8,243
258726412,116,3,2,1,122
258749269,47,39,2,23,111
258759995,19,3,2,4,28
258766469,33,36,13,4,86
258773258,62,17,34,13,126
258779678,12,3,2,1,18
258780837,65,72,32,33,202
258784414,34,21,2,3,60
258785609,35,25,2,13,75
258791096,96,23,80,3,202
258796943,10,6,2,1,19
258798564,52,60,7,5,124
258816674,94,3,15,15,127
258819046,70,39,4,3,116
258842594,55,26,63,1,145
258843591,13,3,2,1,19
258844024,22,3,2,1,28
258845213,14,25,2,1,42
258862944,153,3,2,1,159
258876391,34,3,2,1,40
258880193,45,3,2,1,51
258893364,52,16,5,1,74
258894073,69,16,10,9,104
258904001,84,50,6,36,176
258908218,29,33,18,2,82
258911964,176,45,3,1,225
258912581,49,12,14,1,76
258917472,26,21,19,1,67
258920913,16,19,2,1,38
258924113,161,3,2,3,169
258935687,21,7,6,1,35
258950501,154,33,2,47,236
258950754,56,6,33,23,118
258952790,34,40,9,9,92
258953687,105,25,15,10,155
258963061,84,3,3,10,100
258965033,99,10,65,24,198
258967986,72,34,2,1,109
258972740,55,21,17,1,94
258983650,12,3,2,1,18
259025385,30,11,3,1,45
259043789,46,127,3,1,177
259047680,75,3,2,1,81
259090393,166,18,2,12,198
259092986,51,44,4,1,100
259101849,34,18,9,6,67
259110573,15,18,37,1,71
259115862,71,3,2,4,80
259134357,68,18,26,7,119
259146028,109,3,2,1,115
259165470,90,21,2,3,116
259198389,200,41,15,8,264
259200615,125,16,2,3,146
259203330,64,8,2,3,77
259209389,31,17,2,1,51
259212875,35,17,13,33,98
259216349,45,13,41,1,100
259244642,61,71,89,10,231
259257415,55,24,2,2,83
259261232,310,17,42,13,382
259264529,30,34,42,5,111
259310741,21,29,2,8,60
259310862,33,9,2,2,46
259315708,28,58,6,7,99
259319343,28,3,2,4,37
259324180,25,25,29,4,83
259329081,10,31,3,1,45
259335776,95,5,2,2,104
259338819,20,32,2,1,55
259351369,45,3,2,1,51
259363367,278,40,2,29,349
259363623,76,34,29,7,146
259367973,151,83,4,14,252
259375690,159,20,34,4,217
259381910,24,19,7,1,51
259398645,49,3,2,2,56
259412715,17,18,20,3,58
259412774,70,29,2,1,102
259414368,44,3,2,1,50
259415947,75,50,13,1,139
259416265,38,3,2,1,44
259431905,105,3,2,4,114
259437393,77,55,2,17,151
259457161,78,3,2,1,84
259460263,59,80,2,53,194
259462398,13,3,2,1,19
259481019,56,15,2,2,75
259487772,74,49,55,38,216
259488418,134,3,2,4,143
259489798,27,8,98,87,220
259491641,41,62,10,1,114
259516048,39,3,2,12,56
259524886,316,3,2,1,322
259528426,12,3,2,1,18
259541514,35,3,2,1,41
259551934,13,14,2,2,31
259554911,25,5,2,1,33
259564813,123,26,27,9,185
259570128,14,3,2,3,22
259581619,71,20,44,1,136
259598550,12,3,2,1,18
259599095,85,3,2,1,91
259608904,29,3,2,1,35
259624425,61,15,9,1,86
259640378,122,3,2,2,129
259641151,56,6,2,2,66
259647492,33,24,3,8,68
259656413,30,7,2,7,46
259666399,67,5,2,1,75
259666659,37,41,4,10,92
259669197,81,9,29,1,120
259669585,74,47,36,25,182
259673507,38,15,3,1,57
259677149,218,3,2,3,226
259679082,10,3,2,2,17
259685596,73,24,41,1,139
259686010,13,3,2,1,19
259691698,132,3,2,12,149
259693388,23,5,2,3,33
259698977,39,3,2,8,52
259699585,47,3,2,2,54
259705209,20,3,2,1,26
259722448,32,4,5,3,44
259737380,156,33,42,70,301
259745907,156,3,2,2,163
259777014,106,24,17,1,148
259791719,59,15,14,3,91
259801469,93,25,14,22,154
259804431,45,3,2,5,55
259815085,18,3,2,1,24
259815980,54,3,2,1,60
259822966,15,17,3,1,36
259832843,58,30,31,23,142
259841571,53,32,4,2,91
259849957,31,19,20,4,74
259850398,145,33,4,8,190
259852042,215,9,40,35,299
259854222,52,10,45,58,165
259855928,42,16,2,13,73
259857076,15,3,2,1,21
259862264,89,12,2,3,106
259865290,29,19,2,5,55
259865653,25,74,2,1,102
259877436,14934,57,2,232,15225
259890873,45,102,26,9,182
259904228,15,5,2,3,25
259907731,29,3,2,2,36
259924018,73,21,9,1,104
259931584,23,9,2,2,36
259934097,152,51,4,4,211
259938647,75,3,2,1,81
259945114,52,9,2,20,83
259957774,25,44,2,1,72
259964532,64,57,85,9,215
259971348,29,41,18,24,112
259975020,25,17,2,6,50
259983600,11,3,2,1,17
259986825,115,35,2,4,156
259997911,79,59,7,19,164
259999545,114,13,8,7,142
259999909,92,10,76,1,179
260008698,95,37,17,1,150
260029238,104,14,2,1,121
260035597,140,38,23,2,203
260054377,70,12,2,2,86
260055584,44,13,5,1,63
260073778,316,19,73,44,452
260076907,10,56,19,1,86
260078733,107,5,27,1,140
260096355,141,34,62,9,246
260099339,75,7,22,1,105
260123992,14,3,2,2,21
260142492,71,6,2,4,83
260143142,35,50,9,13,107
260147745,38,47,23,2,110
260162176,89,46,12,10,157
260164011,112,11,2,1,126
260168553,35,43,8,2,88
260173806,11,3,2,3,19
260180058,66,3,2,3,74
260196165,21,3,2,1,27
260197122,55,58,14,1,128
260214065,17,3,2,4,26
260227941,14,6,2,3,25
260242618,55,3,2,1,61
260247436,40,14,2,1,57
260248339,91,5,2,4,102
260250707,62,35,2,1,100
260250873,16,22,4,1,43
260251401,11,3,2,1,17
260255592,42,3,2,1,48
260273283,67,20,5,2,94
260273797,22,51,3,5,81
260277174,44,17,6,13,80
260287948,40,3,2,2,47
260308337,48,43,99,3,193
260325386,18,11,4,9,42
260335673,14,10,2,1,27
260336940,44,49,34,5,132
260344928,20,73,4,1,98
260352185,94,11,13,1,119
260372535,65,22,6,9,102
260374510,17,11,2,1,31
260389174,70,8,5,2,85
260395120,38,35,3,3,79
260412424,19,64,19,7,109
260412954,27,18,18,2,65
260413707,12,64,21,1,98
260415091,13,3,2,1,19
260419394,105,3,2,4,114
260419799,52,3,2,1,58
260441210,35,42,27,2,106
260443179,62,22,3,2,89
260446436,13,3,2,1,19
260448164,39,6,2,1,48
260450591,144,22,2,1,169
260458003,68,3,2,1,74
260462673,188,56,2,1,247
260470015,40,35,8,1,84
260473794,36,36,55,4,131
260476976,69,41,190,1,301
260477083,36,4,6,11,57
260490870,20,25,10,1,56
260491256,10,7,2,1,20
260493178,103,10,7,2,122
260503748,56,5,2,17,80
260505001,10,29,2,1,42
260505516,70,3,2,3,78
260505722,69,3,2,2,76
260515012,51,46,125,19,241
260516377,48,34,20,3,105
260533437,982,3,2,25,1012
260538023,164,65,2,3,234
260546234,173,34,40,22,269
260546936,25,3,2,1,31
260564584,65,3,2,5,75
260570699,137,42,117,53,349
260577232,64,26,2,3,95
260582355,52,16,2,3,73
260586121,29,3,2,1,35
260607341,51,3,2,1,57
260611907,56,30,16,1,103
260618008,138,44,99,11,292
260618089,39,21,21,8,89
260629041,94,32,13,19,158
260629138,72,3,2,10,87
260642911,27,52,13,2,94
260657533,32,23,2,2,59
260701212,34,37,17,22,110
260706240,32,3,2,2,39
260706525,45,70,3,9,127
260709558,107,17,33,1,158
260712010,48,25,6,1,80
260719269,10,4,2,2,18
260720082,10,3,2,2,17
260738238,110,3,2,28,143
260746057,64,13,4,1,82
260747464,114,30,58,22,224
260750909,17,15,6,2,40
260763735,37,18,13,10,78
260768292,133,3,2,5,143
260783835,52,24,2,2,80
260791266,56,3,2,7,68
260813144,26,19,2,13,60
260816464,56,3,2,1,62
260819438,10,5,2,1,18
260821967,117,20,23,1,161
260841838,41,8,7,1,57
260843851,72,46,7,6,131
260852865,12,3,2,2,19
260887612,32,46,56,45,179
260889764,183,24,14,4,225
260897765,29,18,2,11,60
260897848,54,31,12,9,106
260899265,12,3,2,1,18
260900263,81,22,30,70,203
260902898,155,21,2,11,189
260905119,12,25,2,1,40
260909903,43,3,2,3,51
260916843,17,6,2,1,26
260924774,13,3,2,3,21
260934697,146,10,2,8,166
260948490,81,20,2,4,107
260950263,33,3,2,1,39
260950966,82,25,4,1,112
260951093,58,3,2,1,64
260957761,14,6,2,1,23
260961434,29,3,2,1,35
260961435,165,73,45,8,291
260961936,27,15,4,8,54
260985484,22,3,2,1,28
260986803,13,4,2,1,20
260987668,11,4,2,1,18
261002553,80,3,2,3,88
261008340,53,11,15,4,83
261009444,182,5,2,5,194
261010510,11,3,2,1,17
261014467,104,28,36,1,169
261020028,59,15,6,15,95
261029910,110,33,42,10,195
261058090,70,12,2,4,88
261076809,129,3,2,3,137
261077134,40,25,2,2,69
261083298,38,3,2,2,45
261084184,42,32,48,1,123
261102857,122,3,2,3,130
261109472,53,43,85,32,213
261130719,36,23,2,1,62
261133848,57,3,2,1,63
261137030,54,24,23,1,102
261141929,136,19,2,9,166
261165643,28,24,5,1,58
261171414,33,36,31,6,106
261188997,45,27,2,7,81
261201768,28,3,2,1,34
261204341,14,3,2,1,20
261230733,16,5,2,1,24
261236521,147,3,2,8,160
261237825,14,19,2,1,36
261253268,24,105,14,1,144
261258160,45,59,61,2,167
261278601,14,19,2,2,37
261293138,80,91,112,3,286
261293422,64,15,9,3,91
261311609,11,36,2,3,52
261327443,70,28,2,2,102
261329294,10,5,2,1,18
261334720,65,3,2,1,71
261346026,103,28,3,3,137
261363399,32,3,2,1,38
261388268,68,11,2,10,91
261390701,61,80,15,6,162
261401010,42,45,43,26,156
261420244,11,13,2,1,27
261435546,52,53,4,19,128
261453910,27,36,3,3,69
261455124,22,5,2,1,30
261459001,70,32,9,15,126
261463571,40,37,32,1,110
261469082,11,4,2,1,18
261480843,10,24,2,1,37
261509068,58,13,11,11,93
261527328,60,15,3,8,86
261530469,15,4,2,1,22
261531175,58,8,6,2,74
261541905,56,55,34,19,164
261558041,61,34,37,14,146
261559290,23,27,93,1,144
261561695,113,28,2,2,145
261565076,130,57,15,17,219
261574406,42,20,2,1,65
261596491,23,6,2,1,32
261597848,46,3,2,5,56
261610522,120,6,11,1,138
261613235,93,32,5,1,131
261632482,83,60,20,2,165
261661585,42,8,9,1,60
261661774,38,21,6,7,72
261673638,60,72,13,1,146
261678005,59,41,41,4,145
261680878,106,32,3,2,143
261682851,73,3,2,5,83
261700693,15,3,2,1,21
261702640,188,33,19,4,244
261706164,154,44,67,57,322
261721765,108,3,2,15,128
261722683,43,34,35,1,113
261742482,69,3,2,3,77
261748441,35,3,2,1,41
261754126,125,49,2,1,177
261760678,96,9,2,1,108
261761774,63,33,14,7,117
261776465,99,38,70,51,258
261776560,23,40,2,1,66
261781898,11,6,2,1,20
261789756,26,29,2,6,63
261793828,38,50,31,2,121
261794049,16,4,2,15,37
261795264,16,24,2,1,43
261813244,16,3,2,1,22
261817785,165,3,2,9,179
261820545,104,5,4,1,114
261822865,15,3,2,1,21
261823001,13,5,3,1,22
261826045,200,62,55,6,323
261831025,72,5,41,1,119
261834795,77,16,2,1,96
261850470,10,7,2,1,20
261857141,90,6,2,1,99
261864669,146,3,2,1,152
261866166,61,28,114,6,209
261870230,64,71,7,28,170
261886406,54,7,2,1,64
261895348,33,22,3,4,62
261899872,51,10,3,2,66
261903883,25,56,2,3,86
261911244,110,39,41,16,206
261913728,72,51,26,45,194
261917480,10,5,2,1,18
261937944,92,10,2,15,119
261947893,39,55,3,1,98
261954018,22,8,2,1,33
261970278,32,8,2,1,43
261972061,11,22,2,12,47
261977678,63,45,10,4,122
261988633,57,16,18,3,94
262003608,50,30,3,3,86
262003785,63,18,17,7,105
262004752,28,3,2,4,37
262010181,98,3,25,9,135
262016200,62,3,2,1,68
262030507,143,48,7,27,225
262036848,51,8,2,8,69
262045568,14,3,2,1,20
262046548,44,47,34,11,136
262046678,75,7,10,1,93
262046980,15,33,2,1,51
262047714,36,3,2,1,42
262058114,121,3,2,3,129
262083623,13,3,2,1,19
262084005,18,6,2,1,27
262085953,19,3,2,1,25
262092900,62,12,20,9,103
262096816,86,3,2,2,93
262098445,66,5,70,1,142
262099174,23,5,2,2,32
262107284,22,3,2,6,33
262121298,86,10,4,1,101
262125407,21,7,2,7,37
262126600,79,3,11,1,94
262128889,42,16,2,1,61
262130220,182,19,2,1,204
262134098,46,3,2,1,52
262137172,224,19,2,30,275
262146145,12,3,2,1,18
262154420,29,17,9,1,56
262156038,119,3,2,5,129
262171798,93,28,21,1,143
262173907,68,3,2,7,80
262177259,10,7,2,1,20
262188444,19,38,4,1,62
262189217,97,3,2,2,104
262194248,157,34,2,1,194
262226753,61,8,8,13,90
262238600,83,69,67,35,254
262241998,89,22,2,1,114
262254994,60,27,2,9,98
262269178,74,17,27,1,119
262289943,97,33,78,7,215
262299630,11,4,2,5,22
262302117,35,3,2,1,41
262306756,125,11,2,1,139
262313523,103,9,2,1,115
262323830,10,3,2,16,31
262342339,64,72,56,8,200
262352799,33,49,25,1,108
262357222,111,26,2,7,146
262362050,43,3,2,1,49
262364996,46,23,62,11,142
262394092,72,18,2,5,97
262410181,16,3,2,1,22
262412930,139,13,59,8,219
262442863,43,10,9,1,63
262452339,56,10,57,1,124
262473665,79,3,3,4,89
262498926,204,3,2,4,213
262506973,132,61,27,29,249
262509797,27,62,23,12,124
262510484,15,3,2,1,21
262515187,15,3,2,1,21
262517601,82,3,2,1,88
262522552,52,9,2,1,64
262543305,27,40,17,6,90
262554511,50,9,37,1,97
262560665,34,18,15,32,99
262565293,10,5,2,1,18
262571479,87,39,55,24,205
262572185,10,4,2,1,17
262592819,209,18,31,6,264
262595595,72,24,3,123,222
262602885,103,82,2,10,197
262606592,52,17,2,2,73
262610960,87,3,2,5,97
262625007,45,3,2,5,55
262638011,65,17,42,4,128
262644577,99,13,4,18,134
262645078,17,22,2,1,42
262661291,321,73,2,3,399
262680223,143,39,2,1,185
262683784,53,23,20,11,107
262685783,135,22,22,9,188
262719942,132,54,2,58,246
262724833,71,48,62,13,194
262727792,11,3,2,1,17
262734858,81,11,60,1,153
262787449,18,11,2,1,32
262788013,105,78,177,30,390
262790272,74,3,2,1,80
262796535,68,3,2,1,74
262800149,13,3,2,1,19
262804836,88,11,19,2,120
262826758,75,3,12,1,91
262826787,44,8,13,4,69
262827872,68,3,2,4,77
262843653,96,47,25,1,169
262844459,115,31,7,2,155
262879532,44,3,2,3,52
262884282,145,16,2,24,187
262888082,79,10,2,1,92
262891709,20,3,2,1,26
262913874,149,9,6,2,166
262954566,123,19,2,1,145
262977278,124,3,2,15,144
262977657,15,3,2,1,21
262978266,10,7,2,1,20
262991866,150,17,48,36,251
263015926,91,3,2,5,101
263016310,18,17,2,1,38
263031696,56,3,2,1,62
263031735,80,3,2,1,86
263038763,85,4,4,1,94
263039094,16,46,9,14,85
263042730,19,5,2,3,29
263047403,75,25,19,12,131
263047824,154,26,95,1,276
263055362,55,21,2,2,80
263058880,77,32,41,1,151
263067871,37,3,2,1,43
263076379,33,8,2,3,46
263101967,88,5,4,3,100
263112626,63,3,2,1,69
263124432,40,20,2,3,65
263140782,18,3,2,1,24
263141245,34,3,2,1,40
263149053,102,3,2,3,110
263151989,104,3,2,3,112
263158500,63,8,2,12,85
263158528,27,28,14,12,81
263182757,107,10,2,1,120
263202169,69,37,7,3,116
263211850,21,3,16,5,45
263217338,242,47,4,2,295
263220368,97,9,2,4,112
263230152,113,22,3,1,139
263233004,62,12,22,4,100
263233553,98,51,2,1,152
263236873,10,8,2,1,21
263237935,91,3,2,1,97
263246119,39,12,2,1,54
263253461,111,28,31,68,238
263262843,15,3,2,1,21
263276882,122,3,2,2,129
263308898,12,3,2,1,18
263310412,88,21,56,2,167
263319226,40,17,4,9,70
263323388,87,3,2,2,94
263326102,58,25,5,2,90
263332382,105,83,2,1,191
263334216,160,3,2,2,167
263353662,17,14,3,2,36
263365474,12,34,2,1,49
263392413,133,41,59,5,238
263395738,79,27,26,4,136
263399835,96,17,24,2,139
263406441,71,3,2,25,101
263412636,45,53,2,1,101
263422182,24,12,2,3,41
263425386,48,3,17,3,71
263430455,14,3,2,1,20
263451941,72,28,14,9,123
263458157,148,4,2,80,234
263461210,183,14,42,2,241
263475716,19,6,2,1,28
263476377,12,4,2,1,19
263502000,21,6,2,1,30
263508540,89,3,79,1,172
263539634,132,3,2,1,138
263550632,95,17,13,9,134
263554675,127,3,2,2,134
263582199,70,19,24,1,114
263584760,57,3,2,17,79
263593659,60,3,2,1,66
263600790,118,49,57,1,225
263601477,79,37,4,11,131
263605220,39,3,2,4,48
263607381,57,22,7,1,87
263609676,119,3,2,1,125
263609836,11,3,2,1,17
263613703,67,3,2,3,75
263616689,79,11,4,1,95
263624086,83,26,3,3,115
263640133,122,58,9,14,203
263648245,10,7,2,2,21
263664359,60,19,24,14,117
263666306,11,3,2,1,17
263669593,31,77,2,3,113
263670570,23,7,2,1,33
263675897,62,15,5,10,92
263679876,10,36,2,1,49
263686628,22,18,2,17,59
263700789,52,8,7,1,68
263716657,41,3,2,1,47
263718193,33,25,2,8,68
263718871,70,3,2,4,79
263726588,113,34,18,4,169
263729284,25,3,2,1,31
263740827,130,48,66,4,248
263744670,123,39,24,1,187
263759017,47,24,16,2,89
263779408,20,10,2,4,36
263780947,10,12,2,2,26
263797727,29,3,2,5,39
263800442,16,5,2,17,40
263800726,46,4,8,11,69
263824972,82,72,7,3,164
263843180,81,11,3,5,100
263845429,473,3,2,24,502
263850012,42,15,17,2,76
263864649,25,3,2,1,31
263864764,196,34,27,2,259
263870290,62,44,2,15,123
263883336,69,64,73,55,261
263885485,43,19,30,1,93
263888891,359,3,2,2,366
263893309,40,3,2,7,52
263901577,76,3,2,1,82
263902230,110,36,64,1,211
263910797,85,24,2,2,113
263921895,86,3,2,1,92
263935139,74,3,2,1,80
263957530,119,12,2,1,134
263957986,53,21,2,1,77
263964024,45,16,2,1,64
263974354,29,3,2,1,35
263985558,255,3,6,11,275
263997687,22,14,2,2,40
264000206,77,29,3,1,110
264016834,194,13,2,1,210
264021217,103,22,22,25,172
264033960,39,4,2,1,46
264053200,68,9,2,9,88
264062137,13,3,2,1,19
264085076,159,3,2,17,181
264091701,15,13,4,1,33
264093816,10,5,2,1,18
264096807,64,19,67,1,151
264107492,48,13,23,2,86
264108027,45,31,3,23,102
264120051,46,3,2,3,54
264140853,44,15,3,1,63
264141811,39,17,2,12,70
264143901,89,26,2,4,121
264153623,81,3,2,1,87
264155966,60,14,29,6,109
264158682,10,5,2,1,18
264159105,16,11,2,1,30
264174745,53,18,3,24,98
264179507,234,5,25,3,267
264199677,10,3,2,2,17
264206729,26,3,2,2,33
264213635,64,3,2,1,70
264223009,27,3,2,1,33
264225572,11,3,2,1,17
264229863,14,3,2,1,20
264236682,92,8,2,17,119
264239191,55,9,2,13,79
264246798,143,3,2,13,161
264248551,149,22,61,40,272
264257655,16,35,15,11,77
264261335,68,14,20,1,103
264261623,138,49,127,5,319
264289536,62,14,2,1,79
264298288,57,120,15,12,204
264298488,56,3,2,35,96
264300187,51,30,4,2,87
264308742,77,7,15,22,121
264313652,74,22,2,27,125
264316909,17,22,2,1,42
264327705,64,3,2,1,70
264331165,615,19,2,23,659
264336411,25,42,31,14,112
264358835,246,30,32,15,323
264365191,51,12,6,7,76
264366178,88,25,2,15,130
264389853,17,21,20,6,64
264402611,63,69,2,1,135
264404278,60,33,7,24,124
264404935,85,14,2,2,103
264448763,16,19,27,13,75
264455199,30,81,2,11,124
264460702,33,31,4,1,69
264473308,32,15,2,6,55
264491491,47,57,4,1,109
264505425,88,37,17,5,147
264507973,33,47,3,4,87
264517872,54,13,2,3,72
264520656,46,30,18,23,117
264540534,171,41,2,2,216
264546529,94,20,49,5,168
264575361,10,22,2,1,35
264583574,92,26,52,55,225
264584999,19,3,2,1,25
264608034,72,81,18,11,182
264611268,108,42,4,6,160
264612021,24,6,2,4,36
264636703,21,11,2,1,35
264639127,121,46,2,18,187
264652026,33,29,3,8,73
264652429,11,3,2,1,17
264654329,46,28,7,8,89
264658503,18,18,2,4,42
264689423,39,15,64,2,120
264691001,53,20,26,1,100
264696019,17,3,2,1,23
264697979,52,14,2,3,71
264702549,76,13,2,8,99
264707519,87,18,22,22,149
264714177,52,14,2,3,71
264727024,148,28,3,52,231
264731954,61,3,2,2,68
264737613,46,61,49,4,160
264740615,11,4,2,1,18
264744615,51,5,2,1,59
264746175,208,50,77,2,337
264769938,23,8,6,3,40
264777533,16,4,2,1,23
264779185,111,17,31,1,160
264783183,63,45,5,17,130
264799327,74,41,18,29,162
264801263,49,68,8,15,140
264802545,11,3,2,1,17
264804898,197,7,24,15,243
264817469,58,5,4,4,71
264821592,109,24,3,2,138
264859006,38,3,2,1,44
264871389,18,20,2,1,41
264872696,49,3,2,1,55
264873509,17,19,2,1,39
264879577,45,16,3,11,75
264888825,13,3,2,1,19
264890724,69,19,150,4,242
264893708,43,54,2,3,102
264899802,17,9,2,2,30
264901300,25,39,2,2,68
264908982,44,9,42,1,96
264913172,87,3,2,1,93
264914758,138,62,33,22,255
264914907,94,61,38,1,194
264917263,98,23,14,8,143
264917608,135,3,2,2,142
264918001,154,3,2,1,160
264919914,47,3,2,7,59
264924511,64,3,2,1,70
264927183,20,3,2,1,26
264930973,78,18,2,15,113
264939316,248,3,2,15,268
264941166,53,30,2,25,110
264957921,31,22,2,5,60
264959593,68,27,60,25,180
264961392,68,28,4,6,106
264965022,103,27,8,25,163
264967539,102,8,3,2,115
264970854,39,44,18,2,103
264983363,336,3,2,8,349
264993793,151,106,56,35,348
264997605,77,3,2,19,101
265016561,136,65,30,36,267
265017646,31,3,5,7,46
265026454,42,32,4,7,85
265032479,16,3,2,1,22
265049476,88,9,30,24,151
265051472,92,3,2,7,104
265058009,55,9,36,13,113
265078645,71,11,2,2,86
265082926,18,3,2,1,24
265087703,44,10,2,4,60
265099602,46,38,9,19,112
265111571,58,23,30,7,118
265138028,17,3,2,2,24
265146825,17,3,2,1,23
265170362,56,3,19,7,85
265174159,107,24,18,1,150
265217494,39,8,2,1,50
265219904,35,3,2,1,41
265242051,64,27,2,1,94
265243379,56,43,40,9,148
265248674,14,9,2,1,26
265255168,49,17,2,8,76
265259951,81,41,2,1,125
265259966,13,3,2,1,19
265268223,131,38,2,1,172
265273420,24,3,2,1,30
265273939,92,43,25,4,164
265284206,76,48,71,35,230
265302014,132,3,5,1,141
265302703,19,37,6,3,65
265315033,11,3,2,1,17
265321065,225,10,3,23,261
265340279,18,3,2,1,24
265341457,123,29,2,1,155
265343355,24,39,2,1,66
265343366,60,3,2,1,66
265363196,21,3,2,1,27
265365166,66,10,79,1,156
265377751,40,24,6,14,84
265394776,53,24,54,7,138
265399994,96,3,2,1,102
265431435,26,38,44,9,117
265461829,11,3,2,1,17
265462484,128,44,11,12,195
265466053,121,9,2,15,147
265486396,32,30,3,5,70
265498573,30,6,2,1,39
265504285,36,32,10,1,79
265536059,88,13,2,19,122
265539784,146,10,7,17,180
265543630,39,4,6,6,55
265557506,36,29,16,1,82
265562886,24,67,2,1,94
265572897,171,23,6,15,215
265583561,73,29,21,46,169
265592208,64,33,2,8,107
265604068,155,17,97,10,279
265607208,89,20,47,8,164
265608317,144,34,4,5,187
265630260,37,3,2,4,46
265631130,96,5,18,18,137
265633565,70,5,10,1,86
265648798,10,6,2,1,19
265655434,45,32,2,1,80
265658238,20,66,31,2,119
265666936,241,26,82,29,378
265675764,102,65,98,25,290
265678534,140,17,103,7,267
265678598,52,53,2,3,110
265682475,52,3,2,1,58
265690776,11,3,2,1,17
265692281,30,3,2,1,36
265697920,73,14,4,1,92
265716154,297,3,2,2,304
265718965,12,3,2,1,18
265728333,53,3,2,1,59
265729657,17,3,2,1,23
265731865,72,57,39,9,177
265735987,418,3,2,25,448
265739943,11,32,2,1,46
265742852,16,14,5,15,50
265747254,98,3,2,36,139
265747703,14,6,2,1,23
265772531,41,3,2,1,47
265778423,92,29,6,3,130
265787056,33,10,2,1,46
265789383,10,14,2,1,27
265790018,155,34,14,25,228
265793647,155,21,3,16,195
265845144,134,22,4,1,161
265845320,33,23,2,3,61
265855655,29,67,28,10,134
265875252,40,80,3,2,125
265880609,79,20,6,5,110
265888044,34,20,3,1,58
265894013,11,3,2,1,17
265904098,58,13,77,2,150
265909076,41,60,46,54,201
265910356,53,22,2,1,78
265924518,70,3,2,14,89
265939179,100,11,2,5,118
265967956,62,26,2,3,93
265972215,13,3,2,1,19
265978472,173,82,81,17,353
265980043,98,3,2,1,104
266013771,24,3,2,1,30
266013821,25,9,9,1,44
266015367,44,4,3,1,52
266021585,39,4,2,2,47
266025792,96,26,62,11,195
266051488,133,22,33,9,197
266053900,10,6,2,1,19
266068695,65,3,2,1,71
266071967,52,26,48,10,136
266079964,70,23,7,14,114
266080973,20,3,2,1,26
266085801,43,33,8,7,91
266089248,15,3,2,1,21
266100499,222,29,2,1,254
266103791,11,64,2,1,78
266110304,121,3,2,1,127
266112569,16,14,4,2,36
266119286,39,3,2,5,49
266142774,52,19,25,4,100
266154712,24,44,31,1,100
266157156,89,31,34,4,158
266170169,42,30,6,8,86
266171083,105,13,12,1,131
266187192,67,3,2,3,75
266194950,88,32,5,6,131
266195399,20,3,2,1,26
266225811,40,10,35,3,88
266230139,83,43,11,7,144
266233003,85,3,2,1,91
266245816,26,54,2,1,83
266254087,93,15,2,1,111
266273242,29,4,2,8,43
266273585,12,12,2,1,27
266275094,29,28,31,2,90
266276838,10,8,2,1,21
266277257,95,3,2,2,102
266294629,89,9,2,1,101
266306094,38,15,3,14,70
266311934,106,57,83,6,252
266329848,15,57,2,1,75
266338452,56,57,2,1,116
266344474,80,32,35,36,183
266351043,186,3,2,15,206
266354076,50,3,2,1,56
266357352,12,3,2,1,18
266362409,27,27,2,1,57
266370091,23,34,4,14,75
266374629,60,19,5,6,90
266375527,88,17,15,1,121
266399013,21,10,2,10,43
266422036,108,3,2,8,121
266429455,10,6,2,1,19
266432767,25,30,6,1,62
266435364,57,19,9,6,91
266435432,138,15,2,1,156
266442553,13,3,2,1,19
266444698,61,4,2,1,68
266446993,160,3,2,1,166
266447368,11,14,2,1,28
266458142,25,30,9,19,83
266460438,41,16,4,6,67
266465565,36,8,2,1,47
266465747,39,65,23,2,129
266467823,36,13,29,3,81
266496910,10,23,2,1,36
266498692,85,12,8,1,106
266518796,85,14,2,12,113
266519721,36,3,2,2,43
266522742,83,3,2,5,93
266523675,13,3,2,1,19
266525435,23,3,2,2,30
266530771,87,39,14,2,142
266556668,26,42,3,8,79
266571341,10,8,5,8,31
266583101,72,71,67,11,221
266588381,10,3,2,2,17
266605403,207,66,57,19,349
266621798,93,3,2,2,100
266625684,72,12,21,5,110
266629389,206,3,12,117,338
266632335,96,3,2,14,115
266636456,59,30,2,14,105
266643041,55,20,14,12,101
266652493,11,3,33,3,50
266654428,36,23,2,1,62
266679566,13,3,2,1,19
266709677,107,58,51,16,232
266739683,66,12,36,1,115
266740890,17,13,2,1,33
266753942,67,3,2,1,73
266761492,13,9,2,1,25
266761855,10,31,2,1,44
266763090,23,3,2,1,29
266764682,83,3,2,1,89
266767337,136,3,2,3,144
266772888,41,64,28,4,137
266793653,12,3,2,1,18
266813339,26,3,2,1,32
266815226,23,3,2,1,29
266833163,58,7,2,7,74
266834883,10,10,2,1,23
266839295,46,58,16,1,121
266839840,15,13,2,1,31
266866081,60,17,5,25,107
266868392,55,26,3,21,105
266879387,204,3,2,4,213
266884181,76,3,2,1,82
266926443,11,3,2,2,18
266939006,50,13,22,1,86
266944307,47,70,33,10,160
266946975,36,37,2,1,76
266947108,43,29,46,32,150
266969532,13,6,2,1,22
266976935,91,5,2,4,102
266988450,11,5,2,2,20
267005173,147,32,2,1,182
267026179,30,15,2,1,48
267032621,17,23,7,5,52
267034648,61,22,9,17,109
267045169,100,28,13,12,153
267056394,47,3,2,19,71
267071919,20,11,2,1,34
267072789,14,39,38,1,92
267076795,86,86,52,3,227
267082321,31,15,6,1,53
267085979,81,6,30,6,123
267099717,48,55,2,2,107
267110390,45,10,128,10,193
267115194,34,3,2,1,40
267135995,56,36,36,18,146
267179443,23,9,2,1,35
267184256,35,35,22,19,111
267189427,85,3,2,3,93
267190873,41,28,4,11,84
267195217,34,20,2,1,57
267205540,10,5,2,1,18
267214718,34,3,2,2,41
267215520,80,28,3,1,112
267217502,85,15,5,1,106
267217916,294,3,2,9,308
267219996,86,6,30,1,123
267235580,116,68,2,3,189
267245558,66,48,2,1,117
267248430,19,6,2,1,28
267253538,46,29,13,14,102
267269937,47,41,7,2,97
267282750,11,3,2,1,17
267291234,28,3,2,1,34
267333086,103,43,3,31,180
267355391,91,17,51,1,160
267358151,52,5,2,23,82
267378915,71,4,2,1,78
267381566,29,6,9,4,48
267388131,11,3,2,1,17
267390871,24,9,9,40,82
267395596,34,36,10,1,81
267402390,39,43,5,11,98
267405639,60,3,2,1,66
267410091,78,34,2,9,123
267411114,54,35,2,1,92
267412461,249,3,2,2,256
267430658,30,20,54,8,112
267450916,45,15,35,5,100
267485105,71,18,2,6,97
267485343,23,4,2,2,31
267489768,126,12,3,8,149
267498906,69,12,104,19,204
267504867,135,18,8,27,188
267506756,77,59,8,9,153
267512091,105,19,2,29,155
267517547,230,21,2,18,271
267519449,40,6,2,1,49
267534851,23,62,45,3,133
267544551,198,47,9,13,267
267554040,81,21,2,4,108
267572439,11,13,2,1,27
267578482,19,3,2,1,25
267579537,43,10,3,18,74
267585867,100,17,2,1,120
267595609,50,3,2,1,56
267597037,13,7,2,2,24
267609767,82,3,2,1,88
267621937,132,56,3,13,204
267637198,78,30,18,6,132
267649386,12,10,5,1,28
267655233,109,45,88,1,243
267656308,94,26,24,2,146
267656536,14,3,2,1,20
267664371,18,11,3,1,33
267673943,11,4,2,1,18
267701388,83,3,2,2,90
267703939,59,3,2,1,65
267709285,59,34,29,15,137
267712635,154,3,2,4,163
267734487,247,46,2,8,303
267758536,22,16,2,1,41
267761872,71,43,2,3,119
267763693,147,37,7,1,192
267766060,179,56,2,6,243
267766262,82,3,2,1,88
267799760,16,11,2,1,30
267812904,88,3,2,1,94
267848825,42,3,2,1,48
267867257,14,3,2,1,20
267873491,11,10,2,2,25
267878009,101,26,25,1,153
267902257,85,25,89,21,220
267902673,57,48,11,4,120
267906469,11,3,2,1,17
267909473,11,4,2,1,18
267916231,32,10,2,1,45
267927239,14,18,2,1,35
267927899,204,54,2,6,266
267942939,72,66,20,1,159
267943034,36,3,2,1,42
267949883,11,3,2,1,17
267951909,35,30,2,1,68
267952628,40,9,2,2,53
267955917,48,10,32,1,91
267957275,10,3,2,3,18
267987330,85,11,2,1,99
267991082,95,3,2,3,103
268009059,10,35,2,1,48
268010240,16,3,2,1,22
268011115,74,35,11,6,126
268045494,158,3,2,15,178
268048582,50,3,2,3,58
268051564,108,3,2,4,117
268058746,90,17,5,2,114
268061266,49,3,2,1,55
268067448,37,12,13,2,64
268080874,39,27,59,10,135
268084658,23,11,2,16,52
268087087,24,104,3,1,132
268111605,13,18,2,1,34
268126008,44,33,19,3,99
268128644,13,6,2,1,22
268130551,24,14,2,19,59
268134127,14,12,2,1,29
268137037,108,5,2,6,121
268154918,131,6,30,1,168
268171079,28,4,4,2,38
268180654,40,3,2,1,46
268182676,65,7,2,1,75
268200185,19,48,69,1,137
268203926,78,41,77,1,197
268204739,64,11,3,23,101
268204994,11,3,2,2,18
268209584,10,5,2,1,18
268211477,12,3,2,1,18
268235922,13,3,2,4,22
268246400,50,3,2,1,56
268247199,388,3,2,11,404
268263491,21,7,2,2,32
268278526,54,11,2,1,68
268279637,87,49,10,16,162
268285416,57,3,2,1,63
268296423,21,3,2,1,27
268298546,92,17,33,37,179
268307678,58,3,2,1,64
268336036,16,3,2,1,22
268343565,41,42,37,10,130
268346015,153,5,12,3,173
268355842,46,23,2,1,72
268362490,43,39,2,1,85
268366651,179,3,2,18,202
268368777,76,3,2,1,82
268388768,172,17,37,45,271
268391731,98,23,77,1,199
268398719,17,16,6,2,41
268405047,55,19,2,2,78
268407928,108,15,2,3,128
268410097,68,48,50,9,175
268419587,52,3,46,31,132
268428433,86,54,7,30,177
268434027,51,3,2,1,57
268434220,56,43,14,24,137
268454130,21,23,2,1,47
268454457,13,3,2,1,19
268463770,60,9,30,4,103
268487114,150,3,3,9,165
268494465,54,3,2,1,60
268503342,94,15,22,11,142
268509828,47,68,2,1,118
268512867,98,29,2,2,131
268518103,26,16,9,58,109
268520951,88,12,3,1,104
268527261,223,45,2,4,274
268530825,112,3,2,1,118
268543071,113,14,2,6,135
268546020,36,32,2,2,72
268554764,69,19,17,22,127
268558018,51,76,60,41,228
268565114,24,39,4,8,75
268567658,14,30,26,22,92
268581957,14,63,2,3,82
268591755,18,17,9,4,48
268600781,45,6,2,3,56
268608077,80,46,19,4,149
268611749,60,6,2,6,74
268620183,10,5,2,1,18
268639846,144,5,58,10,217
268641142,14,3,2,2,21
268651137,30,31,2,2,65
268652143,67,39,5,15,126
268657745,33,13,2,16,64
268657957,82,11,6,14,113
268659244,62,41,2,18,123
268685579,43,4,2,3,52
268688786,47,3,2,1,53
268696602,203,34,40,12,289
268699485,56,3,2,2,63
268713898,12,6,2,4,24
268719277,47,21,13,1,82
268722394,13,50,2,1,66
268724501,51,41,20,1,113
268725849,149,12,3,1,165
268726244,15,4,2,1,22
268728763,89,67,2,18,176
268729458,44,25,46,13,128
268732233,55,3,2,1,61
268741644,18,3,2,1,24
268749692,47,3,2,4,56
268775366,179,4,2,2,187
268777432,12,3,2,1,18
268783545,14,3,2,1,20
268806625,10,10,2,1,23
268825021,26,3,2,1,32
268830632,84,3,2,5,94
268832354,186,12,2,12,212
268836013,66,26,2,3,97
268843592,72,24,21,1,118
268849280,12,3,2,1,18
268851089,120,37,54,15,226
268854418,50,3,2,2,57
268860782,90,71,48,13,222
268863502,13,3,2,1,19
268876986,257,10,84,1,352
268880491,10,7,2,1,20
268905863,124,44,21,9,198
268914050,78,12,6,22,118
268931331,69,47,57,66,239
268935742,110,3,2,1,116
268937902,78,65,56,28,227
268957850,16,5,2,4,27
268970949,128,9,2,8,147
268973713,108,44,45,23,220
268976825,117,32,10,22,181
268978614,12,3,2,3,20
268985563,10,12,2,1,25
268989579,51,85,29,1,166
268993072,11,13,2,7,33
268999495,140,12,29,3,184
269005170,116,35,81,30,262
269014531,100,12,2,7,121
269021459,15,3,2,1,21
269024321,45,51,2,39,137
269029071,15,3,2,1,21
269035060,11,3,2,1,17
269039559,110,3,2,1,116
269052581,72,4,2,1,79
269059033,19,7,22,1,49
269061415,58,18,33,3,112
269128919,81,3,2,1,87
269130369,11,3,2,5,21
269133317,157,6,10,50,223
269134177,35,31,2,1,69
269139690,11,8,8,1,28
269146820,41,17,2,1,61
269148888,108,3,2,1,114
269153299,11,3,2,1,17
269154137,64,5,36,45,150
269165892,10,10,2,1,23
269166845,63,108,23,7,201
269189615,15,3,2,7,27
269196429,85,40,32,31,188
269204631,39,64,15,3,121
269213277,36,10,4,8,58
269217018,112,36,10,9,167
269219125,23,8,7,1,39
269221607,110,58,24,3,195
269229884,100,3,2,3,108
269230248,35,9,2,1,47
269240464,157,27,17,9,210
269248868,102,19,27,6,154
269249734,51,3,2,1,57
269255391,12,16,3,1,32
269260186,32,13,6,1,52
269265551,11,3,2,1,17
269275601,68,3,10,1,82
269275966,114,13,17,2,146
269293169,67,4,3,1,75
269293852,16,9,2,1,28
269294641,118,17,2,1,138
269302644,175,38,114,109,436
269309578,22,23,2,1,48
269314120,35,12,8,2,57
269316367,10,3,2,5,20
269317524,33,50,3,3,89
269324699,21,3,2,10,36
269326407,37,3,2,1,43
269334870,143,35,49,10,237
269343180,185,9,23,1,218
269346751,69,8,3,3,83
269377989,187,67,2,13,269
269386300,15,4,2,1,22
269389129,30,29,3,7,69
269390222,55,31,5,17,108
269407766,11,20,4,1,36
269421970,67,3,2,9,81
269441680,402,3,2,17,424
269446398,137,28,2,10,177
269449284,54,4,2,2,62
269456001,10,24,2,1,37
269456162,19,10,2,1,32
269458050,124,54,20,3,201
269466512,13,3,2,1,19
269482721,70,45,71,12,198
269484212,90,3,2,1,96
269492976,69,3,2,1,75
269495253,97,20,2,1,120
269497008,46,10,6,1,63
269497713,103,8,2,1,114
269506943,48,3,2,11,64
269511376,38,50,5,17,110
269516701,48,3,2,10,63
269537770,52,3,2,1,58
269538074,97,28,2,1,128
269541303,46,21,41,5,113
269542690,19,22,2,1,44
269554175,20,9,2,6,37
269556251,43,16,20,11,90
269572392,10,12,3,1,26
269601563,32,26,24,1,83
269618739,101,34,111,5,251
269621782,130,8,2,12,152
269627345,23,85,77,1,186
269641162,14,5,2,1,22
269654444,95,7,2,6,110
269663115,35,3,2,15,55
269666239,100,44,24,7,175
269666772,59,21,2,1,83
269687942,14,3,2,1,20
269695210,29,29,41,2,101
269697428,188,35,25,7,255
269704390,22,3,2,2,29
269705499,49,23,17,1,90
269706819,69,3,2,2,76
269724555,51,19,55,13,138
269729219,39,34,7,4,84
269729672,17,50,2,1,70
269729917,19,4,2,2,27
269733861,111,47,2,17,177
269745362,16,3,2,1,22
269749767,60,3,2,1,66
269752441,12,3,2,1,18
269757948,116,3,2,5,126
269765725,12,3,2,1,18
269769231,97,32,3,2,134
269801363,27,4,4,8,43
269805710,25,9,2,1,37
269826042,66,54,90,15,225
269827837,72,3,2,1,78
269832149,20,3,2,2,27
269839770,108,3,2,4,117
269856550,19,6,2,2,29
269867858,54,20,3,26,103
269870775,98,25,53,22,198
269875997,75,3,80,1,159
269881111,98,3,2,13,116
269899016,55,3,8,1,67
269900948,11,24,2,1,38
269900999,71,35,2,24,132
269902070,15,3,2,1,21
269908629,64,3,2,9,78
269911925,29,42,9,1,81
269913484,74,48,53,20,195
269914425,45,31,3,1,80
269916153,22,32,12,5,71
269916638,12,3,2,1,18
269927094,14,3,2,1,20
269929400,14,41,3,1,59
269947961,123,10,3,1,137
269959973,59,11,2,1,73
269968756,128,38,90,3,259
269983741,30,6,4,2,42
270003967,12,9,20,3,44
270010594,69,22,2,3,96
270014785,61,28,23,2,114
270033033,76,22,8,6,112
270070680,188,3,2,59,252
270073579,103,49,92,31,275
270079139,45,21,3,1,70
270089211,272,10,32,110,424
270093023,25,19,3,7,54
270103720,18,3,2,3,26
270105759,121,12,2,11,146
270108697,48,18,13,5,84
270109811,27,60,3,4,94
270110029,10,8,2,1,21
270137338,15,8,10,4,37
270165285,103,15,2,4,124
270165391,90,31,2,1,124
270168619,65,38,33,11,147
270169502,11,3,2,1,17
270173506,23,23,49,13,108
270183768,12,3,2,1,18
270184541,80,22,9,33,144
270207304,12,3,2,2,19
270212686,47,25,40,6,118
270213669,34,15,2,2,53
270232537,89,42,5,4,140
270241432,85,12,46,22,165
270259387,23,12,2,1,38
270274000,25,44,2,12,83
270283610,71,20,39,9,139
270295729,163,10,36,7,216
270296984,103,19,8,4,134
270297658,53,23,5,7,88
270298270,69,26,7,4,106
270304605,135,28,4,3,170
270312005,43,4,2,1,50
270318953,56,13,2,1,72
270320192,64,24,9,12,109
270320765,59,38,14,19,130
270346337,46,15,2,1,64
270359483,355,3,2,21,381
270404420,60,23,2,1,86
270409164,17,3,2,1,23
270419246,23,14,7,1,45
270448904,111,22,3,43,179
270449049,88,66,2,11,167
270470673,16,9,2,1,28
270475097,101,3,2,2,108
270476222,23,13,2,1,39
270484701,75,17,2,8,102
270490029,109,31,6,1,147
270491563,11,3,2,1,17
270492901,18,9,2,1,30
270498121,16,11,2,1,30
270498562,49,22,55,1,127
270501622,17,11,2,1,31
270516424,194,45,73,3,315
270517137,40,25,62,7,134
270546432,29,37,58,15,139
270573282,23,3,2,2,30
270574370,316,3,2,1,322
270593940,57,3,2,6,68
270609376,13,6,2,1,22
270613395,223,3,2,26,254
270619371,45,3,7,5,60
270619754,26,29,20,21,96
270631970,43,29,2,1,75
270632331,34,3,2,1,40
270633197,11,3,2,1,17
270638480,41,7,24,2,74
270639322,19,3,2,1,25
270646631,28,28,2,5,63
270648342,64,37,8,7,116
270652580,56,7,2,1,66
270653130,19,3,2,1,25
270659309,17,19,2,9,47
270659815,91,24,33,1,149
270664406,56,24,35,4,119
270678237,22,11,12,1,46
270682586,49,29,37,1,116
270690355,19,3,2,2,26
270692602,65,8,5,26,104
270706201,58,5,2,3,68
270707690,11,3,2,1,17
270708427,112,20,102,24,258
270714128,86,44,4,51,185
270721926,45,45,2,6,98
270726176,97,3,3,1,104
270729094,94,3,2,7,106
270731954,16,3,2,1,22
270735928,24,17,26,1,68
270737531,49,3,2,1,55
270745530,32,14,6,16,68
270747101,71,42,14,5,132
270756385,11,4,2,1,18
270768096,81,35,75,4,195
270779361,43,82,12,33,170
270787258,161,50,25,66,302
270790257,155,41,84,7,287
270806283,10,6,2,3,21
270807004,27,45,5,25,102
270808283,12,3,2,1,18
270810504,46,10,5,10,71
270816777,58,3,2,4,67
270816811,80,11,25,19,135
270832578,69,16,2,3,90
270838982,34,3,2,2,41
270851990,11,4,2,2,19
270856048,98,56,93,16,263
270871134,131,3,2,1,137
270879204,14,3,2,2,21
270887790,134,7,101,28,270
270896177,27,28,19,13,87
270906989,10,9,2,1,22
270908492,44,3,2,8,57
270916776,24,14,11,14,63
270928242,174,21,2,16,213
270929336,84,3,2,1,90
270942681,504,7,2,4,517
270946221,28,34,2,1,65
270947609,24,3,2,1,30
270950282,29,52,32,1,114
270984552,35,3,2,1,41
270989403,99,32,6,9,146
270992383,62,3,2,1,68
270995078,45,18,2,1,66
271003941,153,9,9,3,174
271004637,13,35,6,1,55
271006426,80,3,2,4,89
271012625,109,3,2,32,146
271022400,16,3,2,1,22
271032110,101,23,2,1,127
271043985,69,84,69,98,320
271044706,59,5,43,71,178
271053573,11,3,2,1,17
271058177,67,12,52,6,137
271063513,71,3,2,9,85
271077105,80,8,33,1,122
271078688,25,11,2,3,41
271079976,12,16,2,3,33
271093117,31,6,10,7,54
271099750,91,17,2,8,118
271110856,82,44,14,26,166
271130535,64,3,2,1,70
271142135,104,20,4,5,133
271156144,409,3,2,6,420
271161114,152,4,9,12,177
271188736,69,15,6,8,98
271201186,129,5,2,17,153
271206599,70,10,13,8,101
271207125,48,66,34,1,149
271212744,68,9,4,12,93
271215695,67,48,32,17,164
271218445,61,35,43,1,140
271220032,21,3,2,1,27
271241617,93,9,32,2,136
271245003,25,3,2,1,31
271246356,93,20,2,2,117
271260410,51,38,2,29,120
271270543,70,19,21,5,115
271279744,84,27,2,2,115
271280715,122,3,2,18,145
271293138,33,12,2,1,48
271295951,70,20,86,11,187
271299276,180,28,4,3,215
271311062,23,15,2,26,66
271313491,137,18,2,9,166
271322220,70,3,2,1,76
271326831,34,3,2,1,40
271351813,111,26,5,2,144
271357520,31,3,2,2,38
271360746,100,25,2,1,128
271366571,99,22,20,6,147
271369793,64,11,2,1,78
271371240,43,20,14,1,78
271402863,10,3,2,9,24
271403595,160,14,15,4,193
271403990,12,3,2,1,18
271412851,159,3,2,3,167
271419230,18,42,34,1,95
271422953,12,15,18,5,50
271428588,155,46,37,10,248
271436613,14,6,8,2,30
271448601,69,8,6,3,86
271449722,175,5,2,7,189
271457372,55,7,14,3,79
271459272,36,17,28,4,85
271461862,14,14,2,1,31
271466508,96,3,2,1,102
271471737,146,16,26,2,190
271482613,118,75,6,20,219
271487531,13,3,2,1,19
271495697,68,32,68,26,194
271503503,43,39,10,2,94
271504679,15,10,2,2,29
271520788,31,12,52,2,97
271533555,92,29,2,1,124
271534573,91,99,2,1,193
271544270,108,13,30,1,152
271583215,95,3,2,1,101
271584612,120,3,2,1,126
271585139,138,3,2,1,144
271586095,12,4,2,3,21
271604772,46,3,2,3,54
271631729,66,3,2,1,72
271637396,20,3,2,2,27
271639715,58,30,12,30,130
271644463,26,13,4,7,50
271647199,127,3,2,3,135
271648065,125,3,2,1,131
271658626,134,23,4,1,162
271664353,224,22,4,3,253
271669396,51,30,18,4,103
271673868,22,3,2,1,28
271679523,18,4,2,1,25
271681467,49,28,2,10,89
271684243,18,10,2,1,31
271684513,11,4,2,1,18
271691392,29,4,2,1,36
271713886,19,41,5,2,67
271726275,104,3,2,7,116
271738405,71,12,2,1,86
271753454,52,5,2,3,62
271759785,159,24,21,3,207
271760472,171,85,5,26,287
271761539,11,3,2,1,17
271780052,203,23,81,5,312
271787887,236,53,2,4,295
271788122,91,24,2,1,118
271796489,74,3,2,1,80
271801552,67,14,5,1,87
271803452,53,21,2,1,77
271813812,69,38,114,62,283
271816934,15,15,2,1,33
271833431,65,41,3,4,113
271837660,24,21,2,1,48
271849122,11,7,2,1,21
271860401,50,3,2,1,56
271865385,143,3,3,6,155
271868767,58,3,2,16,79
271897444,84,64,29,3,180
271900164,38,15,2,1,56
271904505,18,14,2,10,44
271916113,150,30,154,27,361
271928140,110,47,47,1,205
271944687,29,6,21,3,59
271947531,13,15,2,1,31
271951968,70,24,2,1,97
271960208,51,6,2,2,61
271960811,101,8,20,6,135
271965801,32,4,8,4,48
271972055,99,11,2,2,114
271979250,28,3,2,1,34
271986035,52,17,9,14,92
271987161,62,28,3,1,94
271987530,69,3,2,1,75
271997963,161,47,2,3,213
272001910,13,15,2,1,31
272005183,39,5,40,3,87
272011060,18,3,2,1,24
272030502,20,39,13,21,93
272031213,10,3,2,3,18
272049646,114,24,2,14,154
272053529,58,52,58,8,176
272056216,34,49,2,11,96
272068426,51,11,3,1,66
272071096,16,3,2,1,22
272072972,52,114,14,1,181
272086534,78,33,18,14,143
272097703,35,3,2,3,43
272102383,241,3,2,9,255
272102515,64,3,2,1,70
272134275,15,7,2,1,25
272164028,95,29,2,1,127
272169639,13,28,2,1,44
272173384,160,3,2,5,170
272177943,68,3,2,6,79
272181265,67,34,2,1,104
272182209,60,5,9,1,75
272185010,14,39,13,1,67
272202526,72,13,2,1,88
272203158,37,3,2,3,45
272206995,63,58,22,13,156
272210357,40,59,2,9,110
272214374,120,13,2,11,146
272214563,80,32,55,1,168
272224325,10,4,2,4,20
272228646,99,3,2,3,107
272230636,53,16,2,10,81
272230814,305,3,2,3,313
272234761,42,4,2,1,49
272235188,58,8,3,5,74
272241042,126,29,15,17,187
272243839,85,5,24,2,116
272247394,85,3,2,3,93
272247439,16,52,5,1,74
272252715,35,12,22,8,77
272278584,102,11,3,1,117
272282367,62,4,2,7,75
272298708,136,15,8,2,161
272310402,100,19,17,30,166
272329852,37,3,2,1,43
272337591,40,32,14,3,89
272341610,96,62,2,4,164
272354014,12,3,2,1,18
272373249,68,3,2,2,75
272392442,14,3,2,1,20
272401849,20,30,2,2,54
272416515,90,3,2,3,98
272423929,222,28,2,43,295
272451679,46,36,3,16,101
272454373,17,51,5,1,74
272457579,51,11,4,1,67
272482391,182,3,2,7,194
272490591,25,3,2,1,31
272508937,20,36,4,6,66
272520355,73,3,3,5,84
272538996,29,11,6,4,50
272583203,349,3,2,6,360
272590320,236,3,2,29,270
272590418,75,64,94,2,235
272593875,209,3,2,13,227
272611789,100,22,33,1,156
272626693,121,25,2,15,163
272629886,26,10,13,3,52
272636076,74,3,2,5,84
272637254,139,56,70,18,283
272637523,49,3,2,1,55
272640588,60,3,2,8,73
272642420,170,3,2,2,177
272649234,100,36,2,2,140
272663283,17,12,2,5,36
272683788,17,31,9,19,76
272685382,10,9,2,1,22
272701537,105,3,2,3,113
272711014,21,3,2,3,29
272721266,20,5,2,13,40
272732039,24,8,2,1,35
272732667,32,21,8,3,64
272774350,23,17,2,1,43
272794019,11,3,2,1,17
272811802,10,8,2,1,21
272819241,67,18,7,9,101
272846077,57,28,2,19,106
272877844,25,3,2,2,32
272879774,57,3,2,2,64
272884063,17,4,2,1,24
272904912,68,3,2,1,74
272906606,153,33,80,48,314
272921228,15,3,2,1,21
272948337,524,3,2,12,541
272960802,50,6,10,1,67
272966012,40,45,18,24,127
272979136,38,15,2,1,56
273005454,90,42,101,1,234
273010277,90,38,42,30,200
273011928,127,3,2,6,138
273021471,15,3,2,2,22
273023941,16,11,3,2,32
273037889,16,21,4,8,49
273042772,72,24,2,3,101
273046009,69,9,2,2,82
273072238,83,3,2,10,98
273078515,48,15,2,1,66
273090757,117,3,2,1,123
273091270,71,20,11,3,105
273096606,23,3,2,1,29
273108815,42,41,2,2,87
273112071,76,22,10,1,109
273124902,20,3,2,1,26
273126639,29,33,32,4,98
273131667,91,3,2,2,98
273152016,26,13,2,1,42
273153164,23,19,2,5,49
273164517,92,34,53,10,189
273182579,91,22,3,1,117
273183819,28,23,2,12,65
273204533,53,5,25,3,86
273207819,52,5,2,13,72
273222633,13,3,2,1,19
273237801,106,3,10,1,120
273241189,16,3,2,1,22
273243791,10,6,2,1,19
273261994,102,40,73,11,226
273272819,14,11,2,1,28
273286931,150,21,2,1,174
273287571,143,18,3,17,181
273300313,100,45,49,1,195
273300860,22,15,2,1,40
273305660,15,3,2,1,21
273312928,11,3,2,1,17
273317239,17,3,2,2,24
273317426,12,22,6,6,46
273318227,81,3,6,1,91
273318613,26,15,3,1,45
273322411,69,11,2,4,86
273328384,45,18,14,18,95
273333091,21,3,3,3,30
273343324,108,37,65,2,212
273362059,11,6,3,1,21
273377281,80,3,2,4,89
273404063,97,3,2,5,107
273413764,32,20,15,22,89
273415004,38,12,2,5,57
273432605,84,10,2,2,98
273443829,98,33,7,13,151
273452361,208,10,2,1,221
273492336,20,3,2,1,26
273492352,45,43,28,18,134
273501419,60,3,2,1,66
273507081,20,35,3,1,59
273509588,12,3,2,1,18
273512501,11,3,2,1,17
273517609,13,22,37,2,74
273517819,85,6,7,2,100
273522403,102,19,14,8,143
273528574,150,54,168,4,376
273530525,10,5,2,1,18
273531998,33,20,25,3,81
273532177,155,26,2,58,241
273535565,56,3,11,1,71
273539163,39,40,7,1,87
273541815,176,25,14,38,253
273544111,12,3,2,1,18
273564149,70,3,2,1,76
273573487,83,34,2,1,120
273603304,87,33,35,2,157
273620851,138,215,27,4,384
273622332,23,27,18,1,69
273630073,31,29,2,1,63
273634521,39,28,9,3,79
273637039,10,6,2,1,19
273639132,56,3,2,1,62
273646678,15,23,6,2,46
273661458,37,35,54,1,127
273665378,24,17,2,1,44
273687442,23,37,2,3,65
273709791,110,30,94,2,236
273711983,52,3,2,1,58
273712429,36,10,2,1,49
273716081,249,10,14,10,283
273722740,206,51,2,4,263
273733662,22,22,2,1,47
273734906,71,58,3,2,134
273735462,140,57,17,8,222
273735640,137,28,2,19,186
273764613,115,45,3,3,166
273776002,10,4,2,1,17
273780551,44,34,2,13,93
273809864,60,12,33,9,114
273820703,20,13,2,1,36
273827918,101,55,90,4,250
273839843,20,21,18,2,61
273842896,90,30,2,6,128
273848333,55,9,2,1,67
273855184,31,13,2,6,52
273858179,36,3,2,4,45
273900831,129,19,6,1,155
273906886,12,3,2,1,18
273912481,300,10,2,2,314
273928920,17,5,2,2,26
273931150,66,28,34,15,143
273936034,24,35,2,1,62
273945637,27,3,2,1,33
273957855,10,40,2,4,56
273976851,76,3,2,1,82
273996677,290,3,2,6,301
273998187,13,5,2,1,21
274007177,102,26,50,81,259
274015367,11,3,2,1,17
274019769,202,3,2,6,213
274027477,29,3,2,1,35
274031436,12,3,2,1,18
274039366,58,83,69,3,213
274040808,164,3,26,3,196
274046360,92,34,113,4,243
274055556,16,3,2,1,22
274086635,22,3,2,2,29
274109945,20,3,2,1,26
274115438,46,28,30,3,107
274120149,69,35,32,23,159
274133460,11,3,2,1,17
274141173,93,3,2,1,99
274141476,190,37,13,1,241
274142577,130,12,6,1,149
274144247,20,3,2,1,26
274145641,43,29,47,85,204
274157501,112,63,8,32,215
274158330,14,16,2,4,36
274167407,14,26,2,1,43
274168533,104,21,2,10,137
274176779,34,14,4,16,68
274186044,27,3,2,1,33
274195281,154,3,2,2,161
274199827,40,33,7,24,104
274203858,29,59,36,3,127
274204622,12,4,2,1,19
274211471,51,13,6,1,71
274213438,32,3,2,7,44
274225203,94,15,2,2,113
274225693,28,13,36,1,78
274227235,49,43,4,1,97
274227403,37,23,2,1,63
274231004,88,49,52,3,192
274233968,40,13,3,1,57
274247727,149,33,2,25,209
274263526,23,33,6,7,69
274286223,166,10,13,1,190
274290611,79,41,2,56,178
274294113,123,3,2,1,129
274333219,30,32,45,1,108
274340477,60,24,4,4,92
274351120,285,12,3,4,304
274356728,46,3,28,1,78
274358799,58,32,35,42,167
274375027,49,6,2,11,68
274376475,44,14,82,1,141
274389024,77,50,44,26,197
274392565,44,9,29,1,83
274418341,16,25,2,1,44
274432691,47,3,2,1,53
274436782,73,22,9,13,117
274478213,118,45,13,9,185
274481768,91,32,34,45,202
274517320,22,6,12,1,41
274521047,23,68,5,1,97
274536069,39,45,11,1,96
274536688,96,3,2,2,103
274551835,91,26,20,74,211
274555218,88,51,8,7,154
274555781,10,3,2,2,17
274559687,18,3,2,1,24
274561427,144,3,2,1,150
274561535,99,3,2,10,114
274563426,307,3,2,2,314
274588090,75,3,2,1,81
274588313,53,13,2,1,69
274601246,89,15,2,6,112
274620087,20,16,2,2,40
274622492,17,3,2,12,34
274634665,17,24,2,1,44
274635054,45,4,2,20,71
274640861,74,8,2,2,86
274643265,103,3,2,1,109
274646719,28,46,4,10,88
274648921,73,39,25,16,153
274654049,11,3,2,2,18
274659509,10,4,2,1,17
274677435,12,3,2,1,18
274689928,196,13,3,6,218
274710453,47,18,16,23,104
274737110,56,9,9,6,80
274745581,59,3,2,1,65
274768637,20,3,2,1,26
274773544,152,3,2,2,159
274781253,73,16,14,3,106
274786302,42,26,2,1,71
274792970,37,8,2,1,48
274797305,48,36,23,2,109
274800506,26,25,2,1,54
274805756,13,13,2,3,31
274837741,136,3,2,1,142
274857229,34,7,25,1,67
274877959,26,3,2,1,32
274880687,36,16,2,2,56
274885329,123,3,2,7,135
274892397,38,26,2,6,72
274909151,11,3,2,1,17
274930160,84,3,2,2,91
274930705,94,32,22,9,157
274931090,66,3,2,1,72
274932401,89,26,22,1,138
274943274,62,93,17,2,174
274944897,211,48,34,6,299
274950898,35,18,2,2,57
274951450,37,5,2,1,45
274971507,152,3,2,1,158
274980704,36,12,2,2,52
274992117,153,41,24,31,249
274994258,35,4,2,1,42
274995376,13,9,14,1,37
275006180,12,3,2,1,18
275008090,154,45,140,7,346
275026112,65,21,3,9,98
275029411,61,22,2,10,95
275032025,14,8,2,1,25
275043539,57,40,13,22,132
275058734,59,15,19,3,96
275064715,115,9,17,22,163
275071367,113,30,22,1,166
275073039,13,3,2,1,19
275079447,12,8,2,1,23
275082926,11,3,2,1,17
275088503,83,3,2,1,89
275096459,48,35,109,3,195
275118526,47,14,2,3,66
275143072,57,23,22,16,118
275152911,55,17,3,1,76
275168376,12,3,2,1,18
275172610,153,29,35,14,231
275174334,85,3,34,4,126
275179200,170,62,19,49,300
275184133,92,13,2,4,111
275189511,11,3,2,1,17
275232655,473,15,29,47,564
275236663,62,32,33,29,156
275241919,126,3,2,1,132
275251995,62,3,2,4,71
275267169,44,57,7,98,206
275281835,16,3,2,2,23
275298459,26,22,44,1,93
275303853,191,50,48,21,310
275308527,10,6,2,1,19
275317745,15,9,4,1,29
275326486,209,21,20,15,265
275328023,10,3,2,4,19
275330756,99,20,2,1,122
275333843,11,10,2,1,24
275336013,13,9,2,6,30
275337394,187,3,2,12,204
275348958,40,6,4,1,51
275350420,20,14,2,1,37
275361158,196,3,2,24,225
275374903,11,3,2,1,17
275375178,50,10,2,1,63
275378234,75,3,2,1,81
275379931,31,25,5,4,65
275388259,158,11,13,25,207
275389912,10,3,2,2,17
275413512,13,7,2,4,26
275427022,11,6,2,1,20
275427547,44,31,7,6,88
275451790,20,22,13,7,62
275465235,30,3,21,1,55
275490203,132,43,49,3,227
275502378,18,12,6,2,38
275502723,46,25,15,13,99
275506707,11,3,2,1,17
275522847,147,129,2,12,290
275523824,16,3,2,4,25
275541130,17,3,2,1,23
275542492,75,3,34,2,114
275542922,20,3,2,1,26
275556530,13,31,3,1,48
275561183,16,4,2,1,23
275598625,67,38,71,1,177
275601206,47,3,2,4,56
275605724,74,23,6,9,112
275606346,12,3,2,3,20
275610492,27,3,2,1,33
275611587,17,62,2,3,84
275615697,115,33,2,13,163
275624114,24,25,2,1,52
275630453,58,20,2,1,81
275638423,35,3,2,1,41
275642503,107,15,103,1,226
275662310,84,61,4,1,150
275681180,17,3,2,1,23
275690653,22,3,2,1,28
275707725,11,39,46,1,97
275709989,55,24,2,1,82
275721895,36,44,8,21,109
275733621,85,15,2,4,106
275746628,68,21,31,55,175
275762471,72,11,20,1,104
275771724,14,30,2,1,47
275787053,13,9,2,1,25
275788326,16,3,2,1,22
275825086,121,28,6,19,174
275825366,58,33,16,34,141
275826625,20,18,18,3,59
275833415,13,3,2,1,19
275834727,14,3,2,1,20
275843656,17,22,4,9,52
275846141,36,36,5,1,78
275847868,91,19,2,2,114
275859073,77,15,11,2,105
275862249,93,11,2,2,108
275871829,13,3,2,1,19
275874627,70,18,28,5,121
275876297,121,3,2,1,127
275893727,53,3,2,1,59
275905560,77,3,4,11,95
275913254,53,3,2,2,60
275931006,19,10,4,1,34
275933547,13,10,2,2,27
275939943,131,33,3,1,168
275944393,155,56,65,32,308
275944851,72,3,2,1,78
275956122,116,29,3,2,150
275958060,14,4,2,1,21
275965035,10,12,2,1,25
275985790,11,13,2,5,31
275992769,135,35,11,1,182
276011970,61,27,34,15,137
276015941,11,3,3,1,18
276019938,38,3,2,1,44
276029512,62,21,52,11,146
276086882,90,3,2,1,96
276088575,97,5,2,1,105
276093821,18,9,6,1,34
276096576,54,5,2,1,62
276103385,67,29,23,3,122
276135482,19,10,2,40,71
276140958,11,3,2,1,17
276159370,13,12,16,1,42
276169560,66,3,2,1,72
276178215,78,3,2,2,85
276179286,149,26,11,1,187
276208390,10,22,2,1,35
276214239,11,3,2,1,17
276214924,89,29,2,2,122
276222339,204,70,3,9,286
276226296,57,3,2,1,63
276230255,11,18,2,1,32
276238686,21,3,2,2,28
276243447,25,4,2,1,32
276244276,94,3,2,14,113
276251875,22,28,2,1,53
276260143,67,80,24,11,182
276272528,122,16,21,12,171
276285848,174,24,3,41,242
276294488,10,4,2,1,17
276295312,79,28,25,6,138
276296087,38,14,2,1,55
276298581,64,48,14,30,156
276302911,62,19,57,5,143
276306903,15,7,2,1,25
276313173,27,19,14,5,65
276332091,21,3,2,14,40
276361772,54,3,2,1,60
276362863,78,13,2,4,97
276365518,38,86,86,43,253
276396825,45,3,2,8,58
276398025,139,29,2,3,173
276401953,13,3,2,1,19
276412382,79,35,25,5,144
276421074,88,3,2,1,94
276421080,57,3,2,3,65
276421545,92,10,2,15,119
276427312,116,3,2,9,130
276428024,13,3,2,1,19
276442460,20,17,2,1,40
276447383,18,3,2,1,24
276451670,52,3,2,1,58
276458593,64,3,14,1,82
276494741,102,5,24,4,135
276497608,130,26,2,2,160
276541170,11,3,2,1,17
276543297,11,3,2,1,17
276551130,130,63,16,6,215
276563552,117,3,2,1,123
276575842,89,22,22,11,144
276579903,19,3,2,1,25
276582259,40,32,4,1,77
276586653,23,24,6,1,54
276591503,37,31,8,1,77
276592989,19,3,2,1,25
276593866,12,17,10,8,47
276599086,114,10,14,28,166
276599256,30,7,2,3,42
276614288,140,3,2,9,154
276626664,18,18,2,2,40
276631484,86,31,24,1,142
276638395,38,48,6,22,114
276638979,19,3,2,5,29
276661468,36,3,2,1,42
276663821,73,29,33,29,164
276683763,28,3,2,1,34
276683910,66,3,30,1,100
276689394,13,3,2,2,20
276692361,50,32,64,20,166
276695693,84,9,2,1,96
276700998,208,30,14,11,263
276703341,23,21,10,55,109
276706927,60,24,4,12,100
276710402,10,26,2,1,39
276715805,56,31,2,1,90
276719453,14,38,2,1,55
276726238,77,33,4,4,118
276726625,183,9,58,1,251
276741114,335,3,2,2,342
276745962,10,12,2,6,30
276749440,17,64,7,2,90
276750207,162,59,73,9,303
276771670,25,3,2,2,32
276791340,94,9,28,2,133
276821331,119,3,2,8,132
276830726,222,3,2,2,229
276833917,51,68,15,10,144
276835517,31,3,2,2,38
276838148,87,8,63,46,204
276843512,56,31,2,1,90
276854544,148,3,2,5,158
276854770,55,63,16,21,155
276856367,86,16,63,1,166
276857264,72,24,18,16,130
276864010,174,3,2,2,181
276876197,12,3,2,8,25
276879063,18,3,2,1,24
276881758,45,3,2,4,54
276904001,25,73,15,1,114
276911737,30,11,3,30,74
276912199,64,11,12,1,88
276913658,211,3,2,4,220
276919811,217,19,31,1,268
276950165,13,3,2,2,20
276954218,64,18,6,5,93
276954539,280,24,31,10,345
276974203,83,13,32,23,151
276976311,53,3,2,2,60
276977516,108,35,2,3,148
276994235,50,33,23,26,132
276998975,123,3,2,1,129
277013768,50,3,2,1,56
277017714,119,3,2,43,167
277028634,10,5,2,1,18
277032988,20,3,2,3,28
277043720,101,20,28,11,160
277052516,10,15,2,1,28
277052942,90,16,15,1,122
277052988,34,17,37,1,89
277055216,80,3,2,5,90
277066182,11,4,3,1,19
277072318,93,3,2,2,100
277076671,88,10,33,5,136
277077640,29,96,46,2,173
277090424,104,4,3,7,118
277109358,41,3,2,1,47
277135720,10,3,2,3,18
277135824,33,32,3,1,69
277137465,10,3,2,3,18
277143051,130,24,9,93,256
277147555,10,5,2,1,18
277153719,29,3,2,1,35
277156682,42,3,2,1,48
277158122,58,17,2,2,79
277160472,86,133,79,1,299
277163465,95,3,2,15,115
277164494,22,19,13,12,66
277168276,11,16,2,1,30
277184205,102,28,46,5,181
277192000,107,13,7,1,128
277193664,132,3,3,4,142
277197766,14,3,2,1,20
277202023,46,3,2,1,52
277203866,78,3,2,1,84
277215447,85,22,10,2,119
277218690,71,3,2,1,77
277258390,38,19,2,1,60
277272829,21,5,5,1,32
277276985,14,27,2,3,46
277283908,85,31,98,3,217
277285649,22,14,10,3,49
277321505,13,3,2,3,21
277326421,69,23,18,7,117
277340036,60,24,10,1,95
277358331,49,7,2,3,61
277379668,101,38,5,29,173
277381403,76,3,2,1,82
277387511,10,13,2,1,26
277415372,19,3,2,2,26
277415499,41,22,15,8,86
277417486,27,16,3,10,56
277425101,94,26,32,8,160
277434670,10,3,2,2,17
277454769,22,3,2,1,28
277456638,125,160,148,8,441
277458021,97,27,17,13,154
277462649,33,23,47,1,104
277470404,59,3,2,1,65
277477078,313,3,2,3,321
277490511,403,47,2,9,461
277502017,62,3,2,1,68
277518951,54,42,9,2,107
277529731,125,35,20,8,188
277543583,64,25,2,1,92
277556967,40,29,4,41,114
277559718,108,3,2,16,129
277566427,34,29,86,12,161
277570962,42,10,7,1,60
277581743,119,46,2,10,177
277588590,110,3,2,9,124
277589394,25,8,2,3,38
277590786,105,21,10,10,146
277599066,45,38,7,5,95
277599242,19,14,2,8,43
277604411,53,80,9,15,157
277607791,29,3,2,1,35
277612431,69,24,2,4,99
277627328,29,44,2,24,99
277630604,89,18,53,14,174
277633812,63,14,12,7,96
277652283,125,18,2,1,146
277669274,48,63,16,28,155
277676758,143,3,2,11,159
277696499,55,16,29,17,117
277705338,65,13,2,2,82
277709151,44,27,12,3,86
277709199,135,61,11,2,209
277711686,20,24,2,1,47
277725845,175,14,36,3,228
277728666,59,13,37,1,110
277733641,35,9,2,1,47
277747848,109,32,26,11,178
277781612,75,3,2,2,82
277786033,30,39,2,3,74
277788688,46,30,14,25,115
277823592,109,51,87,12,259
277829244,69,13,7,41,130
277839141,37,3,2,1,43
277850265,49,32,2,1,84
277852521,14,3,2,1,20
277856134,166,3,2,7,178
277856950,140,66,28,17,251
277864936,10,3,2,2,17
277871054,16,3,2,1,22
277874575,80,24,27,2,133
277875408,37,3,2,2,44
277884757,97,42,102,18,259
277890443,36,11,2,1,50
277903685,57,14,2,1,74
277909076,13,3,2,1,19
277909705,104,7,2,1,114
277922737,34,9,3,1,47
277926010,54,3,8,1,66
277928207,126,49,3,1,179
277945108,11,3,2,1,17
277947051,75,3,2,1,81
277949944,22,3,2,2,29
277960184,197,3,2,3,205
277963188,17,3,2,1,23
277963974,71,49,65,5,190
277975086,16,11,9,1,37
277980409,42,3,2,1,48
277986611,18,3,2,1,24
277994482,13,3,2,1,19
277995628,41,20,8,6,75
278002983,16,14,2,3,35
278009521,165,6,5,12,188
278025013,145,28,138,1,312
278034533,111,21,73,8,213
278035313,128,38,4,4,174
278038093,74,3,2,1,80
278055443,92,59,69,8,228
278062099,57,19,2,1,79
278063681,12,11,2,1,26
278074939,42,6,40,7,95
278089122,41,3,2,1,47
278093019,48,9,8,4,69
278097810,60,30,59,2,151
278108204,51,3,2,1,57
278110876,105,33,10,3,151
278111595,21,15,3,1,40
278117027,96,14,3,1,114
278123435,12,3,2,2,19
278123673,108,39,46,13,206
278130460,177,29,2,5,213
278131056,41,3,2,1,47
278134674,85,24,60,29,198
278135691,149,3,2,1,155
278143449,10,3,2,2,17
278149667,56,3,2,1,62
278164894,59,19,75,4,157
278170251,76,15,2,5,98
278180244,20,3,2,1,26
278193261,66,3,2,7,78
278217755,144,5,31,1,181
278229295,47,39,19,1,106
278229570,142,36,12,17,207
278230576,11,3,2,1,17
278235399,188,35,2,2,227
278239648,93,53,106,1,253
278246859,48,28,46,1,123
278247029,72,23,22,48,165
278249176,129,41,10,2,182
278261438,12,38,2,4,56
278261760,23,20,2,1,46
278263415,142,3,2,1,148
278275545,106,10,2,1,119
278277596,46,3,2,1,52
278285232,59,3,2,1,65
278287395,54,14,16,5,89
278301506,139,3,2,8,152
278309662,84,19,63,3,169
278311226,140,59,2,32,233
278311261,88,3,2,11,104
278314821,182,7,78,1,268
278324344,108,13,32,4,157
278324408,28,4,2,2,36
278329691,32,3,2,1,38
278330089,11,3,2,1,17
278335515,13,3,2,1,19
278340566,37,15,14,3,69
278344705,61,34,42,2,139
278382938,19,24,35,4,82
278391241,121,25,37,1,184
278392116,28,4,2,1,35
278402645,57,60,9,27,153
278407292,69,23,41,28,161
278418249,42,3,2,1,48
278426467,12,4,2,2,20
278440301,75,45,81,25,226
278457070,122,30,71,25,248
278466730,133,22,5,1,161
278486588,42,18,20,6,86
278491374,392,3,3,36,434
278499453,21,58,4,5,88
278503406,114,3,2,3,122
278503437,81,57,16,42,196
278525925,97,21,2,2,122
278562040,149,40,16,17,222
278565220,13,5,2,1,21
278575454,63,9,14,7,93
278581760,60,39,12,9,120
278610864,90,5,4,12,111
278625505,63,34,66,4,167
278632608,94,3,25,1,123
278633958,52,115,11,1,179
278635159,111,3,2,6,122
278636776,23,3,2,1,29
278644405,66,34,20,11,131
278644438,42,24,2,1,69
278657017,46,6,62,3,117
278661615,26,20,2,1,49
278666251,78,9,2,1,90
278677333,11,3,2,1,17
278684070,62,16,2,6,86
278688996,59,25,2,6,92
278697657,50,46,30,9,135
278702188,99,34,15,5,153
278702482,30,3,2,2,37
278703642,51,19,48,18,136
278715046,79,3,2,1,85
278740857,11,3,2,1,17
278752313,127,20,2,2,151
278765752,111,4,2,1,118
278769801,58,3,2,3,66
278777670,90,3,2,18,113
278784240,40,26,29,5,100
278800898,14,14,2,2,32
278801854,12,3,2,1,18
278808642,134,3,2,2,141
278821835,78,9,5,1,93
278831376,48,3,2,1,54
278834731,28,3,11,3,45
278904847,64,4,31,6,105
278905484,29,96,2,1,128
278912622,11,4,2,1,18
278927997,10,16,2,1,29
278936448,184,32,39,4,259
278950938,28,3,2,1,34
278958113,298,3,2,5,308
278969143,45,14,2,1,62
278974916,17,45,9,9,80
278978159,49,45,4,1,99
278982384,63,14,47,1,125
279005019,24,99,14,8,145
279007594,50,7,12,18,87
279013443,52,3,2,4,61
279022442,108,8,2,4,122
279023260,80,29,2,1,112
279041012,57,37,32,2,128
279043435,61,4,3,6,74
279064563,82,6,7,51,146
279090820,70,3,2,4,79
279091685,107,3,2,1,113
279094196,106,57,58,5,226
279101438,118,3,2,1,124
279102875,132,46,142,15,335
279120072,38,3,2,1,44
279125059,70,21,7,3,101
279126287,13,11,3,9,36
279136022,21,13,2,1,37
279157677,87,3,2,1,93
279161267,127,8,2,5,142
279163426,107,77,56,22,262
279166289,30,3,2,1,36
279172871,205,77,32,7,321
279184197,35,14,2,4,55
279190476,46,39,19,11,115
279193457,13,33,3,1,50
279198697,103,13,2,3,121
279202338,52,11,2,1,66
279233464,65,3,2,1,71
279258991,25,16,2,2,45
279269530,17,18,2,2,39
279272630,28,3,2,5,38
279278739,701,3,2,9,715
279313486,62,22,37,15,136
279326200,82,6,4,13,105
279329263,57,15,2,4,78
279333328,34,29,2,17,82
279354825,63,23,2,1,89
279365808,157,6,2,1,166
279366493,69,19,2,7,97
279368738,28,49,5,31,113
279372247,68,26,5,1,100
279374838,11,3,2,5,21
279381669,145,16,16,1,178
279397865,39,58,2,19,118
279399451,15,17,2,1,35
279416822,56,3,2,3,64
279428611,125,7,2,8,142
279440367,57,5,9,3,74
279441756,53,23,2,6,84
279448057,103,13,2,3,121
279451256,17,3,2,1,23
279451744,107,15,2,22,146
279462308,11,16,2,5,34
279493572,98,23,59,5,185
279496147,60,13,2,2,77
279497423,11,5,2,1,19
279500863,70,26,12,13,121
279503625,26,35,2,1,64
279507387,112,3,2,1,118
279518339,82,3,2,1,88
279520153,61,3,2,1,67
279544803,138,3,2,9,152
279545722,39,3,2,1,45
279547571,151,3,2,1,157
279549120,132,13,63,4,212
279549884,31,12,2,1,46
279592547,106,3,2,1,112
279600606,38,98,43,48,227
279603356,54,18,3,1,76
279604884,151,37,26,25,239
279608202,10,3,2,3,18
279632012,232,42,133,25,432
279639281,25,7,2,1,35
279642288,19,3,2,1,25
279645121,16,3,2,4,25
279656821,54,7,2,1,64
279658405,46,34,30,1,111
279667778,103,16,2,1,122
279670463,67,41,28,4,140
279674657,65,17,3,17,102
279678099,32,3,2,1,38
279692057,22,11,3,1,37
279693570,11,3,2,1,17
279695758,14,17,2,1,34
279701151,39,6,4,1,50
279720651,172,49,45,1,267
279764691,345,3,2,45,395
279801881,91,38,58,24,211
279804056,97,55,3,7,162
279804473,91,3,2,1,97
279807910,138,35,19,16,208
279813236,29,39,19,1,88
279833771,182,51,28,4,265
279834427,13,20,3,4,40
279851659,53,3,2,1,59
279859840,93,18,2,1,114
279866799,23,26,6,1,56
279867204,65,74,46,7,192
279867975,51,23,2,2,78
279874070,79,3,2,1,85
279883359,25,34,8,22,89
279891613,51,47,86,2,186
279896939,71,3,2,5,81
279898526,48,35,6,7,96
279906450,17,3,2,1,23
279906475,75,23,2,1,101
279908727,220,16,4,3,243
279922843,13,3,2,1,19
279925581,14,3,2,2,21
279948314,14,20,2,1,37
279951443,121,4,2,12,139
279966831,97,3,2,1,103
279992365,24,3,2,1,30
279998940,75,61,2,2,140
280013820,59,22,2,1,84
280015309,11,14,2,1,28
280015768,112,22,14,24,172
280018386,67,3,2,1,73
280019003,245,3,2,1,251
280020510,140,42,2,2,186
280027116,70,19,10,7,106
280027817,191,33,3,18,245
280028344,10,6,2,1,19
280029529,64,13,84,3,164
280037897,11,14,2,1,28
280038268,66,3,2,1,72
280040717,18,5,2,1,26
280056215,70,4,4,3,81
280058545,58,3,2,1,64
280066469,47,3,4,10,64
280075065,67,46,21,12,146
280081853,26,32,24,2,84
280090444,101,3,2,20,126
280091979,18,14,2,1,35
280097930,107,4,2,2,115
280108224,11,3,2,1,17
280135972,49,3,2,2,56
280148033,47,58,44,35,184
280151623,23,3,3,1,30
280156655,231,61,20,2,314
280161952,203,3,37,6,249
280177112,17,3,2,4,26
280177857,224,4,34,2,264
280182108,10,3,2,6,21
280192157,93,50,17,1,161
280192253,260,7,2,23,292
280197171,72,3,2,6,83
280200935,68,3,2,1,74
280204388,47,3,2,3,55
280226313,47,3,2,1,53
280227017,88,24,5,4,121
280227832,44,20,2,6,72
280231268,58,36,2,6,102
280237640,151,27,56,6,240
280242215,93,3,2,1,99
280248350,66,7,8,1,82
280252272,296,3,2,4,305
280260400,33,3,2,2,40
280261621,17,3,2,2,24
280267438,15,8,2,3,28
280268458,272,3,2,10,287
280287658,25,28,11,1,65
280297798,31,71,18,31,151
280298536,56,3,2,2,63
280314535,57,3,2,1,63
280335008,14,25,2,2,43
280335654,141,11,5,3,160
280375201,143,3,2,1,149
280395798,28,10,7,1,46
280401592,16,34,2,6,58
280403602,38,17,2,1,58
280411908,94,11,29,5,139
280415008,13,13,2,1,29
280431323,81,12,48,2,143
280440981,11,3,2,1,17
280468058,11,3,2,1,17
280473368,122,44,52,7,225
280497352,86,17,11,3,117
280516515,13,3,2,1,19
280520353,25,11,2,3,41
280523172,17,15,2,1,35
280560930,96,19,49,1,165
280578858,31,14,2,1,48
280590623,159,8,2,1,170
280625976,12,3,2,1,18
280639202,39,34,7,1,81
280646649,58,3,2,1,64
280665075,11,17,4,1,33
280683380,73,10,8,13,104
280691251,52,9,15,2,78
280709915,10,5,2,1,18
280714197,16,4,2,2,24
280719263,32,10,2,1,45
280730807,19,32,2,11,64
280731585,21,3,2,3,29
280739114,71,3,2,9,85
280741966,17,3,2,1,23
280757826,42,23,3,1,69
280757983,156,6,289,80,531
280763439,21,34,12,1,68
280765381,68,10,14,3,95
280770836,72,10,13,3,98
280778060,57,29,73,4,163
280780464,26,5,2,1,34
280781841,62,3,2,10,77
280783059,10,5,2,1,18
280789608,116,3,2,5,126
280800869,24,18,2,4,48
280806070,58,3,2,1,64
280810299,12,5,2,1,20
280811036,130,3,2,1,136
280812022,30,11,2,2,45
280828209,98,33,11,22,164
280842755,48,58,2,3,111
280843896,109,9,6,32,156
280847275,19,3,2,1,25
280853847,14,3,2,1,20
280859772,15,3,2,1,21
280863277,57,47,2,4,110
280866327,156,19,60,11,246
280882511,103,3,2,1,109
280896565,89,4,2,5,100
280902303,15,62,13,1,91
280912001,35,3,2,1,41
280914559,119,3,9,7,138
280943359,12,3,2,2,19
280948352,95,41,11,40,187
280950391,37,3,2,1,43
280951735,94,12,8,4,118
280956166,11,3,2,1,17
280960683,19,4,2,1,26
280962253,24,3,2,1,30
280966347,215,10,3,3,231
280981924,132,3,2,1,138
280982867,566,6,2,12,586
280991090,29,3,2,1,35
280991213,16,3,2,1,22
281003769,29,3,2,7,41
281014464,37,23,2,1,63
281016169,34,34,2,16,86
281030379,50,10,2,3,65
281030690,99,11,19,3,132
281031232,88,18,55,8,169
281032646,56,11,15,3,85
281035061,37,33,6,13,89
281041305,31,15,32,2,80
281044949,46,63,3,3,115
281046831,58,9,15,1,83
281076099,10,6,2,1,19
281082559,22,6,7,7,42
281090655,41,8,2,1,52
281101721,56,21,27,12,116
281103427,10,24,6,1,41
281127410,56,15,3,2,76
281130897,29,43,6,5,83
281132013,59,11,18,6,94
281134061,128,17,39,1,185
281158487,102,4,2,1,109
281159500,68,4,2,12,86
281169299,50,29,33,1,113
281175004,72,13,33,22,140
281179673,61,3,2,1,67
281185310,84,9,19,1,113
281186317,17,3,2,1,23
281193853,11,28,2,1,42
281194136,21,3,2,1,27
281212996,21,8,2,1,32
281217595,81,24,23,1,129
281234891,12,3,2,1,18
281236503,28,62,2,1,93
281236999,60,27,33,25,145
281245043,83,3,2,1,89
281250532,175,7,2,3,187
281259679,20,23,2,1,46
281265346,40,10,7,1,58
281268179,110,14,5,4,133
281286246,35,32,54,38,159
281287570,181,39,85,1,306
281298877,50,28,2,3,83
281307533,25,16,7,6,54
281308302,28,3,2,1,34
281316518,44,3,2,1,50
281328601,62,13,2,7,84
281338294,10,5,2,1,18
281340629,235,31,29,3,298
281341791,1924,3,2,122,2051
281345707,78,3,23,1,105
281358920,31,16,44,8,99
281362952,208,28,2,3,241
281369624,76,3,2,1,82
281373786,150,3,2,10,165
281380440,50,3,2,1,56
281386870,18,11,2,20,51
281387606,101,3,2,2,108
281393904,41,15,2,12,70
281394087,53,30,2,10,95
281395713,119,12,14,7,152
281400560,32,93,36,7,168
281401189,195,19,3,12,229
281402364,11,3,2,1,17
281403576,13,3,2,1,19
281409525,24,30,14,12,80
281418931,193,87,2,14,296
281422062,74,29,39,1,143
281424743,10,3,2,4,19
281440976,280,7,12,1,300
281444757,116,3,2,1,122
281445164,55,27,2,3,87
281449701,96,53,2,4,155
281474637,11,3,2,1,17
281478277,178,44,38,53,313
281484974,42,11,14,3,70
281490947,151,3,2,5,161
281504290,33,3,2,1,39
281513784,94,14,32,1,141
281516759,43,36,44,19,142
281519741,57,4,19,2,82
281542911,105,3,2,19,129
281545675,78,28,19,91,216
281549926,10,37,2,1,50
281557729,25,29,13,12,79
281565269,96,50,96,19,261
281571689,14,3,2,1,20
281579061,671,3,2,11,687
281584799,22,4,2,1,29
281584817,24,3,2,1,30
281604135,33,50,46,47,176
281615772,47,3,2,1,53
281631894,36,35,2,1,74
281639240,74,3,2,1,80
281649691,58,20,6,10,94
281673872,69,35,2,5,111
281677055,40,38,22,50,150
281696080,46,8,2,2,58
281706032,47,13,46,13,119
281708174,71,30,7,9,117
281715269,42,30,2,11,85
281717810,160,11,136,29,336
281735270,27,29,4,5,65
281735389,126,35,39,16,216
281745502,57,19,2,8,86
281748028,64,69,21,83,237
281749865,64,13,18,2,97
281759849,29,3,2,1,35
281761205,49,25,2,1,77
281772286,276,3,2,9,290
281781323,33,14,36,1,84
281782048,91,3,2,3,99
281789910,64,10,2,2,78
281804023,13,3,2,2,20
281808986,135,148,47,1,331
281814695,33,3,2,1,39
281867143,89,26,21,17,153
281894930,81,3,2,8,94
281897286,36,18,5,1,60
281898385,14,3,2,2,21
281899782,18,9,2,2,31
281908780,18,3,2,1,24
281940749,57,3,2,7,69
281954943,28,30,16,4,78
281981772,104,29,2,32,167
281986188,26,23,21,1,71
282006689,80,3,2,1,86
282015122,45,18,59,1,123
282029221,26,3,2,1,32
282032855,76,13,2,1,92
282035140,110,59,73,1,243
282048261,66,7,2,2,77
282049901,58,3,2,23,86
282055498,138,17,22,10,187
282086681,11,5,2,2,20
282099304,79,116,61,166,422
282099318,15,6,2,2,25
282111375,24,78,18,7,127
282118499,67,40,2,3,112
282122889,76,15,2,2,95
282127376,83,7,3,1,94
282131431,87,23,4,1,115
282140679,18,61,20,5,104
282162577,26,3,2,1,32
282169601,15,5,3,1,24
282171699,10,17,2,1,30
282178963,112,18,21,1,152
282179736,69,33,2,4,108
282181973,33,25,33,1,92
282212669,11,3,2,1,17
282217984,155,41,2,3,201
282234437,12,7,4,3,26
282246086,11,4,2,1,18
282246743,127,3,2,4,136
282274841,11,3,2,1,17
282276278,54,9,2,1,66
282284566,75,3,2,4,84
282302098,70,10,2,4,86
282305111,78,10,45,16,149
282315132,19,3,2,4,28
282331707,14,6,2,1,23
282336204,68,14,19,21,122
282342457,52,57,11,22,142
282346064,121,16,2,1,140
282357283,25,3,3,1,32
282359762,123,37,137,3,300
282368199,10,4,2,1,17
282372761,11,6,2,1,20
282382222,33,40,15,1,89
282385393,26,3,2,5,36
282412176,117,15,105,5,242
282414232,39,50,25,45,159
282428395,22,30,13,9,74
282430554,25,19,72,1,117
282448669,12,22,2,1,37
282452963,43,34,17,1,95
282453569,42,3,2,1,48
282488027,61,35,8,12,116
282513911,36,16,2,1,55
282529088,21,25,14,3,63
282537753,17,3,2,1,23
282548076,47,13,12,32,104
282550924,64,3,2,4,73
282553947,20,5,2,1,28
282555953,57,22,2,1,82
282566508,158,15,11,1,185
282581777,73,5,2,11,91
282603239,13,7,2,1,23
282607349,62,3,2,1,68
282612878,20,3,2,1,26
282620765,106,3,2,2,113
282640449,25,19,2,11,57
282643049,114,31,164,4,313
282644143,19,3,2,1,25
282659863,126,57,93,1,277
282670012,32,17,6,3,58
282683301,152,32,12,9,205
282702623,67,13,10,3,93
282708046,33,57,16,2,108
282714600,39,55,8,1,103
282715054,47,33,15,12,107
282716375,11,8,2,1,22
282724546,20,12,5,1,38
282728292,58,65,67,9,199
282740690,91,81,123,5,300
282750572,43,3,2,1,49
282818606,14,10,2,1,27
282823254,12,44,2,2,60
282827864,149,12,12,30,203
282830821,11,3,2,1,17
282838756,28,9,2,1,40
282841451,60,3,2,2,67
282846974,181,20,2,29,232
282857443,86,3,2,1,92
282864999,131,24,22,3,180
282896222,92,34,3,1,130
282897854,50,30,115,12,207
282903723,35,3,2,1,41
282909060,93,25,13,1,132
282913974,26,3,2,3,34
282922269,34,25,2,1,62
282939437,111,10,2,1,124
282945627,206,3,2,1,212
282952313,48,3,2,2,55
282954938,76,30,2,3,111
282955639,80,3,2,1,86
282958650,102,3,2,3,110
282965209,19,47,15,2,83
282968036,13,8,3,1,25
282968398,18,5,2,1,26
282978099,61,16,2,6,85
282983900,172,26,27,2,227
282988875,36,35,2,9,82
282989869,64,33,5,24,126
283002402,23,38,2,8,71
283010662,25,3,2,1,31
283016064,25,3,2,1,31
283024241,41,5,2,1,49
283028352,11,3,2,1,17
283029566,193,85,2,4,284
283043213,101,42,13,19,175
283047724,13,3,2,1,19
283050203,14,3,2,1,20
283061832,80,86,10,3,179
283074039,41,61,2,7,111
283081737,24,10,7,8,49
283088801,19,25,2,22,68
283090042,14,7,2,1,24
283094406,85,26,31,70,212
283104896,55,19,2,3,79
283113075,72,23,9,25,129
283122536,30,3,2,3,38
283123812,55,24,5,1,85
283124772,82,18,18,16,134
283130158,16,9,2,1,28
283132692,10,4,2,1,17
283136557,88,20,24,24,156
283138272,13,3,2,1,19
283147987,24,3,2,1,30
283159318,46,38,2,44,130
283162589,22,3,2,1,28
283180647,61,88,71,26,246
283182670,212,30,2,5,249
283189243,100,38,4,6,148
283198747,15,3,2,4,24
283210299,14,6,7,2,29
283218052,39,26,20,12,97
283225748,115,3,2,4,124
283228757,47,3,2,1,53
283236514,171,3,2,14,190
283236643,62,29,4,1,96
283264629,29,41,66,1,137
283275937,11,3,2,1,17
283277165,56,30,2,14,102
283280816,198,22,4,66,290
283286241,81,3,2,1,87
283295084,20,7,2,1,30
283315610,143,59,50,2,254
283320024,68,15,13,7,103
283328716,11,3,2,1,17
283331907,20,3,2,4,29
283341001,144,3,2,1,150
283341374,92,3,2,23,120
283345166,180,3,2,12,197
283345989,29,3,2,9,43
283358494,11,3,2,1,17
283359214,145,17,6,1,169
283420758,11,3,2,1,17
283420880,90,22,2,10,124
283421756,189,96,88,49,422
283422344,157,24,10,18,209
283433356,100,3,2,1,106
283456915,52,46,2,2,102
283461481,29,16,25,4,74
283462497,32,45,46,32,155
283464122,23,3,2,1,29
283475794,385,3,2,6,396
283476247,63,14,2,1,80
283491855,14,3,2,1,20
283516977,103,3,2,2,110
283523466,56,18,2,2,78
283541130,10,3,2,2,17
283541625,49,3,2,3,57
283565581,18,6,2,36,62
283568367,92,3,2,32,129
283580270,187,17,123,19,346
283593474,54,8,2,1,65
283598440,23,47,24,14,108
283609341,13,3,2,1,19
283623238,10,14,3,1,28
283687681,23,35,2,1,61
283699590,118,38,5,7,168
283702356,204,5,2,2,213
283703711,110,25,16,20,171
283714542,69,16,7,7,99
283715569,22,3,2,1,28
283718583,143,16,22,2,183
283721659,10,3,2,3,18
283723102,19,3,2,9,33
283731784,14,3,2,1,20
283737967,105,7,2,1,115
283749759,80,3,2,1,86
283764090,219,41,43,25,328
283765405,29,15,3,9,56
283770141,79,16,31,16,142
283787890,101,15,2,7,125
283798875,11,4,2,1,18
283802208,12,3,2,1,18
283808123,104,32,86,9,231
283813966,13,3,2,1,19
283815531,19,14,2,8,43
283833909,142,3,2,2,149
283834871,16,3,2,1,22
283836166,25,37,2,6,70
283840815,141,3,2,1,147
283861517,75,15,14,24,128
283873933,62,8,2,4,76
283875007,27,54,15,41,137
283882253,52,3,2,1,58
283894288,197,21,2,10,230
283903722,25,18,3,2,48
283908398,10,4,2,1,17
283939359,131,22,6,4,163
283949022,54,28,2,14,98
283950616,11,3,2,1,17
283974097,67,17,2,74,160
283980822,45,22,2,2,71
283982831,122,14,66,6,208
283985391,88,48,3,1,140
283995299,123,11,2,8,144
283998891,80,10,2,11,103
283999182,205,3,2,2,212
284002125,104,36,133,17,290
284003926,11,4,2,1,18
284010029,45,3,2,1,51
284010923,87,24,48,16,175
284016910,15,11,2,1,29
284018487,130,109,2,1,242
284024449,10,4,2,1,17
284025046,60,111,2,1,174
284035633,30,26,35,8,99
284044915,20,8,2,4,34
284054895,99,39,78,57,273
284056792,104,11,6,21,142
284066401,54,26,3,3,86
284068175,174,38,8,3,223
284072339,72,37,17,1,127
284072995,94,9,94,4,201
284079402,46,48,81,27,202
284095511,81,3,2,2,88
284106608,19,37,2,5,63
284106830,88,43,113,10,254
284110818,57,3,2,1,63
284122670,20,3,2,1,26
284128483,41,3,2,1,47
284128994,13,24,6,1,44
284130378,13,3,2,2,20
284142367,37,3,2,2,44
284144205,11,3,2,1,17
284149377,14,3,2,1,20
284159785,179,33,54,1,267
284163261,14,16,2,1,33
284188389,109,34,29,22,194
284195878,20,8,2,1,31
284198136,88,24,3,1,116
284210841,63,52,17,47,179
284216576,11,21,2,1,35
284222678,20,31,2,36,89
284226020,12,3,2,1,18
284251901,53,58,22,16,149
284254012,62,31,30,3,126
284265168,16,3,2,1,22
284265392,43,6,2,1,52
284268653,12,3,2,2,19
284272481,113,7,2,1,123
284278656,62,17,8,2,89
284280337,13,3,2,1,19
284280707,43,45,52,7,147
284288955,20,20,4,1,45
284291290,49,25,2,7,83
284292649,18,30,5,1,54
284297968,18,18,9,2,47
284305673,41,35,26,1,103
284308536,270,3,2,2,277
284324374,149,38,12,13,212
284325797,52,15,20,1,88
284328216,23,3,2,2,30
284333784,114,9,52,5,180
284342209,92,23,29,16,160
284350543,226,30,2,6,264
284352506,24,13,2,2,41
284362833,32,17,3,1,53
284368171,346,88,6,12,452
284370665,91,3,2,1,97
284374091,11,3,2,1,17
284377705,52,3,2,1,58
284383691,43,36,35,7,121
284399338,106,3,2,3,114
284402059,52,95,53,21,221
284404221,325,3,2,1,331
284416606,32,3,2,1,38
284417093,55,10,3,19,87
284425954,46,3,2,12,63
284432499,87,110,18,7,222
284433216,12,3,2,1,18
284433337,94,57,39,37,227
284433450,87,71,61,1,220
284444235,21,3,2,12,38
284444622,37,3,2,1,43
284450798,98,8,2,4,112
284457587,110,47,65,2,224
284465359,124,34,2,1,161
284479533,59,51,14,10,134
284481984,26,13,2,19,60
284483304,120,16,2,1,139
284483664,86,33,35,8,162
284485497,65,31,42,7,145
284497467,12,11,2,1,26
284498682,105,55,75,1,236
284502432,35,19,81,1,136
284523639,34,35,15,5,89
284531486,120,18,2,6,146
284550660,91,42,24,22,179
284567678,43,3,2,1,49
284576589,27,8,2,4,41
284592105,163,29,8,12,212
284597534,123,14,2,21,160
284606577,12,3,2,1,18
284617119,293,22,106,23,444
284618715,22,8,2,3,35
284630533,21,3,2,12,38
284647395,26,3,2,1,32
284655612,149,54,10,16,229
284657271,93,29,2,13,137
284657685,55,35,68,3,161
284657751,71,29,35,3,138
284662954,30,32,4,3,69
284666456,11,5,2,1,19
284670230,159,3,2,4,168
284702760,10,3,2,2,17
284716028,10,4,2,1,17
284717758,22,3,2,1,28
284720197,152,5,5,1,163
284741935,20,78,26,3,127
284760552,174,31,8,13,226
284791085,69,4,2,1,76
284816506,14,6,6,1,27
284828476,20,6,2,14,42
284829265,166,3,2,16,187
284834457,81,20,15,51,167
284837227,40,3,2,2,47
284851910,46,12,3,1,62
284863108,122,13,29,3,167
284863976,79,51,64,27,221
284865762,73,10,20,3,106
284882030,15,3,2,1,21
284882457,50,12,5,12,79
284883139,97,26,2,4,129
284885559,74,3,2,2,81
284897498,146,28,2,1,177
284904521,10,55,2,2,69
284906434,12,10,2,1,25
284913308,33,78,34,47,192
284916073,10,4,2,1,17
284931308,142,3,2,3,150
284938405,16,6,2,2,26
284947357,60,28,65,12,165
284950094,10,4,2,1,17
284961894,51,3,2,13,69
284971436,11,17,2,1,31
284980555,10,5,2,1,18
284990198,43,22,27,2,94
284991752,145,17,2,2,166
285000968,52,34,28,1,115
285001203,92,3,2,8,105
285011191,41,3,2,1,47
285013824,14,3,2,2,21
285029014,14,3,2,1,20
285031750,145,21,6,11,183
285034250,35,19,10,12,76
285050505,39,22,4,7,72
285075491,12,3,2,2,19
285082586,98,35,25,29,187
285094017,34,3,2,3,42
285116954,94,31,4,1,130
285122415,14,22,2,3,41
285142763,110,3,2,1,116
285157910,53,13,19,1,86
285159337,159,46,32,16,253
285167145,21,3,2,2,28
285173348,10,3,2,2,17
285178155,103,28,19,3,153
285184266,20,57,13,1,91
285190682,168,10,2,18,198
285192488,33,53,19,1,106
285221342,68,12,13,2,95
285224466,21,5,6,13,45
285249038,33,22,84,2,141
285265786,13,10,2,3,28
285274613,149,3,2,2,156
285287055,107,11,13,16,147
285302859,35,60,11,1,107
285307120,65,8,40,8,121
285307262,10,4,2,1,17
285308670,144,7,15,1,167
285312045,18,16,16,7,57
285314527,11,39,2,1,53
285315030,71,32,41,27,171
285326675,59,3,2,4,68
285327821,136,3,8,2,149
285337697,22,31,21,2,76
285354039,66,3,2,1,72
285362306,30,60,47,19,156
285367417,39,18,32,12,101
285384214,13,3,2,1,19
285385708,74,59,2,7,142
285399106,151,3,2,4,160
285409794,78,22,9,1,110
285414803,35,3,2,1,41
285424723,10,4,2,2,18
285429774,20,42,5,27,94
285445760,70,8,2,2,82
285452460,77,21,120,18,236
285453249,64,33,52,2,151
285458516,12,3,2,1,18
285460886,22,31,15,1,69
285477516,323,3,2,8,336
285484368,20,38,2,1,61
285486682,68,24,14,1,107
285495421,26,14,2,1,43
285508461,77,3,2,1,83
285514877,166,45,3,20,234
285519891,67,7,66,6,146
285532191,75,56,3,8,142
285567201,122,3,2,17,144
285568118,77,6,3,1,87
285571096,40,28,52,13,133
285581901,189,26,2,1,218
285588792,75,15,2,8,100
285591276,97,32,48,13,190
285600314,45,24,80,34,183
285601934,66,10,2,1,79
285609097,18,17,4,1,40
285638570,36,32,8,4,80
285639463,10,14,2,5,31
285646550,80,3,2,1,86
285656645,11,3,2,1,17
285659016,72,10,7,7,96
285663136,155,31,5,17,208
285668289,26,3,3,19,51
285671805,140,14,2,1,157
285674965,12,3,2,2,19
285685505,38,3,2,8,51
285716891,10,12,25,1,48
285718355,34,33,3,4,74
285719045,125,3,2,1,131
285723533,30,54,10,1,95
285743592,13,3,2,1,19
285743860,143,3,2,1,149
285752605,58,12,63,7,140
285767334,47,44,29,5,125
285781001,26,15,4,3,48
285782959,97,58,13,8,176
285783713,52,24,2,5,83
285797763,48,22,2,16,88
285798941,48,3,2,15,68
285809065,122,15,6,2,145
285822577,34,3,2,3,42
285827133,82,24,12,2,120
285832806,88,15,2,4,109
285834216,100,4,2,1,107
285842163,10,15,2,1,28
285844052,65,21,2,5,93
285884734,98,16,2,2,118
285884965,31,13,7,1,52
285893687,129,44,9,3,185
285930153,95,27,2,6,130
285937917,62,29,27,1,119
285969496,60,5,2,3,70
285981733,40,33,2,1,76
286021298,12,3,2,1,18
286023001,40,40,2,7,89
286028605,82,3,2,1,88
286029605,57,16,4,1,78
286039879,86,12,2,1,101
286041902,148,42,11,1,202
286044781,91,3,2,1,97
286074284,134,23,2,19,178
286085669,10,4,2,1,17
286093737,45,71,18,4,138
286101177,11,3,2,1,17
286108792,15,26,2,1,44
286126536,39,3,2,4,48
286129257,49,4,5,6,64
286129269,59,9,2,1,71
286129320,17,16,2,1,36
286148426,13,7,2,1,23
286150011,47,70,38,13,168
286164026,25,8,2,2,37
286173970,12,4,2,1,19
286179572,31,3,2,1,37
286191010,54,15,22,17,108
286192740,42,16,2,3,63
286193325,92,3,2,3,100
286194018,112,23,3,7,145
286194696,61,3,2,1,67
286205101,57,8,2,1,68
286211392,182,61,50,1,294
286212137,120,6,2,1,129
286214866,69,23,4,2,98
286228225,159,53,2,1,215
286238729,14,3,2,1,20
286262368,89,24,24,15,152
286272170,33,3,2,1,39
286278234,53,9,4,6,72
286279482,11,3,2,1,17
286289342,142,70,17,20,249
286294737,34,57,36,8,135
286296665,12,3,2,1,18
286306994,40,25,41,19,125
286319548,99,4,2,3,108
286324825,12,13,2,3,30
286343905,69,28,13,18,128
286367379,70,19,8,6,103
286372338,14,92,29,1,136
286372455,79,26,53,1,159
286387575,409,3,2,9,423
286390539,10,3,2,4,19
286393278,71,49,4,3,127
286397936,96,3,2,1,102
286402560,32,17,18,4,71
286407214,91,25,16,35,167
286407627,41,19,2,9,71
286418729,48,9,3,3,63
286425504,171,3,2,1,177
286432624,64,25,2,12,103
286435034,22,10,2,1,35
286468801,147,19,8,1,175
286492302,18,40,54,6,118
286500606,187,9,2,6,204
286511322,35,3,2,2,42
286512585,32,4,3,1,40
286521348,18,3,2,1,24
286535793,60,3,2,1,66
286544039,43,55,3,1,102
286556221,78,37,2,12,129
286566911,59,3,2,1,65
286576583,60,33,11,55,159
286584966,54,3,43,13,113
286593992,33,8,2,3,46
286604178,149,3,2,1,155
286610830,14,5,2,3,24
286619101,101,3,2,1,107
286620216,57,3,2,9,71
286654342,208,32,69,5,314
286660084,207,44,44,1,296
286664332,65,7,114,43,229
286665501,45,28,8,1,82
286669896,12,3,2,1,18
286678069,42,68,25,20,155
286690402,76,56,56,2,190
286691725,31,19,9,19,78
286698167,79,14,62,2,157
286708394,11,3,2,1,17
286726734,15,3,3,2,23
286730411,64,3,2,2,71
286735874,16,38,2,1,57
286738836,68,3,2,1,74
286740366,57,38,41,2,138
286747583,220,6,2,12,240
286755429,35,13,16,1,65
286761933,47,42,29,1,119
286763665,89,3,2,3,97
286777689,24,52,26,1,103
286793485,45,19,4,7,75
286798220,234,17,12,10,273
286821588,12,4,2,4,22
286824532,27,10,2,1,40
286833631,39,13,38,1,91
286837851,42,35,2,10,89
286851191,103,37,3,23,166
286865120,179,19,4,5,207
286881128,129,26,41,3,199
286906127,102,3,2,1,108
286912143,32,3,2,1,38
286921250,55,18,2,10,85
286939209,16,3,2,1,22
286950657,75,17,6,3,101
286973165,18,7,2,3,30
286976810,22,23,2,18,65
286980885,100,3,2,4,109
286985484,10,6,2,1,19
286991606,131,34,14,9,188
286992205,109,19,36,1,165
286995354,50,8,3,1,62
286995725,21,68,18,1,108
286997354,74,58,56,59,247
287017181,105,19,2,1,127
287031666,27,3,2,1,33
287031890,105,3,2,9,119
287045950,44,11,2,3,60
287053751,72,32,2,6,112
287064632,45,20,2,1,68
287084860,13,3,2,1,19
287085597,12,3,2,1,18
287102671,151,17,55,9,232
287107848,120,52,3,25,200
287152166,18,17,2,3,40
287156643,96,71,73,42,282
287156697,36,7,2,1,46
287166372,113,28,77,11,229
287170506,115,20,2,1,138
287174767,23,3,2,1,29
287179340,76,3,2,1,82
287183439,49,19,2,1,71
287185660,10,3,2,4,19
287191884,98,38,42,1,179
287199101,35,12,2,2,51
287204266,21,14,2,6,43
287206167,159,38,67,59,323
287209545,63,25,9,21,118
287214543,221,3,2,6,232
287225611,179,21,94,7,301
287226652,119,62,2,7,190
287229797,104,28,55,10,197
287238249,27,43,34,1,105
287256022,12,8,2,1,23
287257258,65,3,2,1,71
287258840,156,3,2,7,168
287261978,14,90,2,3,109
287267018,51,7,2,1,61
287273731,53,15,2,1,71
287279674,17,28,37,1,83
287286303,61,33,4,25,123
287300539,109,14,121,3,247
287302422,30,3,2,1,36
287303859,76,31,9,13,129
287310175,49,29,16,13,107
287324460,13,3,2,1,19
287330534,144,3,2,1,150
287354721,123,56,31,2,212
287357424,64,60,3,2,129
287361676,87,23,2,11,123
287369477,70,15,3,9,97
287389881,141,3,2,2,148
287390005,18,26,22,1,67
287390396,53,3,2,1,59
287393717,92,29,7,7,135
287396889,87,13,69,1,170
287403742,48,39,3,31,121
287408446,33,26,37,10,106
287420811,50,3,2,2,57
287428081,62,32,2,7,103
287428306,49,3,2,18,72
287452152,29,3,2,3,37
287460297,41,20,12,1,74
287473918,45,3,2,1,51
287486987,42,18,83,1,144
287503758,23,31,2,3,59
287504847,23,100,2,3,128
287511514,215,4,30,2,251
287511966,44,3,2,4,53
287513778,10,9,2,2,23
287515103,21,8,2,2,33
287516531,152,9,2,1,164
287543484,11,3,2,1,17
287553531,51,17,61,11,140
287564483,21,47,2,1,71
287565631,39,3,2,1,45
287575293,39,3,2,1,45
287599226,26,14,7,3,50
287601435,159,27,2,1,189
287609603,59,3,2,1,65
287614368,11,3,2,1,17
287615065,49,23,76,3,151
287619409,146,6,13,12,177
287622573,71,18,23,3,115
287631993,46,37,4,1,88
287635773,15,3,2,1,21
287643015,19,3,2,3,27
287651143,14,24,2,1,41
287651755,38,29,4,8,79
287652767,34,46,60,10,150
287652776,57,77,2,4,140
287655464,66,35,29,37,167
287656032,17,3,2,1,23
287676708,30,12,2,5,49
287686762,71,12,7,4,94
287690394,54,9,2,1,66
287700342,79,28,6,25,138
287714893,44,64,9,2,119
287733252,47,15,16,3,81
287748868,60,3,2,1,66
287752836,60,3,2,1,66
287754944,11,3,2,1,17
287760369,87,8,2,1,98
287778742,60,6,2,3,71
287795460,64,19,46,1,130
287796087,131,22,15,13,181
287797844,49,4,6,45,104
287815382,41,19,2,1,63
287818433,26,11,59,1,97
287818474,141,18,2,10,171
287822452,97,3,2,5,107
287828855,57,3,2,2,64
287847142,143,18,2,3,166
287850771,35,80,24,1,140
287852400,55,3,2,1,61
287855124,13,9,2,1,25
287863793,66,31,17,18,132
287864854,21,41,17,4,83
287875622,156,3,2,1,162
287881747,122,32,2,3,159
287883598,21,7,2,3,33
287889885,54,8,8,23,93
287901045,10,5,2,1,18
287902553,584,3,2,3,592
287910422,80,7,13,13,113
287918806,12,5,2,1,20
287920684,60,4,2,1,67
287943415,122,41,7,2,172
287946347,114,3,2,2,121
287956283,46,30,2,1,79
287962818,21,4,2,1,28
287974691,52,29,2,10,93
287981052,22,4,2,1,29
288018038,14,9,2,2,27
288019246,32,22,12,1,67
288022508,16,7,2,6,31
288054849,21,18,2,1,42
288062651,48,27,2,1,78
288064147,122,30,5,4,161
288071238,45,17,2,1,65
288079821,17,6,2,1,26
288079984,109,34,15,7,165
288094643,10,3,2,2,17
288097241,26,15,2,1,44
288098702,215,37,45,38,335
288099168,58,15,4,1,78
288101250,103,3,2,1,109
288101772,89,14,15,6,124
288115579,80,26,27,5,138
288120088,73,3,2,2,80
288131229,112,43,2,3,160
288137233,21,8,2,2,33
288140888,53,3,2,1,59
288154048,17,33,2,1,53
288160629,45,17,3,8,73
288163132,44,13,3,2,62
288163419,21,3,2,1,27
288187900,94,23,4,15,136
288195035,19,35,2,11,67
288208125,10,4,2,2,18
288208233,44,3,2,1,50
288212158,17,32,23,1,73
288224281,244,73,2,1,320
288226482,58,3,2,1,64
288228018,46,3,2,1,52
288229714,125,53,2,7,187
288255305,85,67,107,3,262
288257676,118,44,138,6,306
288263790,59,3,17,1,80
288268841,56,15,26,5,102
288271348,77,65,15,1,158
288281751,18,3,2,1,24
288301540,10,14,2,3,29
288304685,46,3,2,1,52
288325702,73,3,2,6,84
288366135,14,32,2,1,49
288370112,36,3,2,4,45
288377678,14,3,2,1,20
288384520,49,29,31,22,131
288403031,132,3,2,3,140
288403840,156,26,3,1,186
288418008,324,3,2,2,331
288436530,24,3,2,1,30
288441737,53,3,5,1,62
288455622,16,3,2,4,25
288464336,76,19,31,4,130
288468274,16,8,2,1,27
288497801,20,8,2,1,31
288509713,80,34,2,11,127
288510490,11,36,2,1,50
288517455,68,17,18,16,119
288527666,11,3,2,1,17
288536329,44,3,2,1,50
288545736,39,47,50,19,155
288549889,11,3,2,1,17
288556703,43,3,2,1,49
288559620,184,18,6,6,214
288572672,22,48,14,28,112
288574212,17,8,2,5,32
288575376,88,15,2,5,110
288581387,143,9,5,32,189
288594257,18,17,2,4,41
288601028,42,43,78,21,184
288602763,21,3,2,1,27
288607252,21,3,2,4,30
288610773,30,27,2,1,60
288649476,79,11,2,6,98
288657098,119,37,51,1,208
288665118,70,4,3,6,83
288686197,31,86,69,3,189
288692035,85,9,30,9,133
288698259,115,3,2,3,123
288714611,10,5,2,1,18
288719337,21,30,24,2,77
288727745,11,16,2,3,32
288730924,74,21,2,1,98
288746708,631,3,2,3,639
288747963,12,3,2,1,18
288761528,67,15,3,1,86
288780311,68,28,2,2,100
288791578,68,3,2,1,74
288804055,11,3,2,1,17
288805961,43,4,2,16,65
288814091,23,4,2,4,33
288826740,79,22,6,6,113
288832510,181,21,35,4,241
288843204,42,38,8,1,89
288844957,33,3,2,3,41
288854120,187,15,69,14,285
288855028,34,6,2,1,43
288889694,70,8,6,6,90
288896120,57,6,81,3,147
288899435,44,70,2,3,119
288907320,15,7,2,2,26
288912262,180,41,3,2,226
288912560,18,10,2,1,31
288913873,35,29,2,3,69
288916681,74,3,2,1,80
288932459,11,11,2,1,25
288946771,11,3,2,1,17
288954586,105,3,2,1,111
288960209,62,17,13,1,93
288960974,67,31,12,3,113
288963049,13,3,2,1,19
288981689,82,20,78,12,192
288988679,197,41,26,19,283
289000464,83,17,9,1,110
289019880,47,22,2,1,72
289021297,41,23,7,3,74
289021679,37,13,5,5,60
289025136,10,22,2,1,35
289068709,22,7,56,2,87
289078329,67,16,3,1,87
289080887,25,10,2,1,38
289085289,109,3,2,1,115
289090353,17,8,2,1,28
289097222,56,3,2,1,62
289113147,16,3,2,1,22
289113188,112,3,2,1,118
289113803,127,15,8,9,159
289119537,146,68,7,17,238
289122286,102,6,2,11,121
289137263,59,3,2,4,68
289140642,21,70,17,1,109
289145020,31,3,2,1,37
289147918,74,24,17,67,182
289153929,91,3,2,1,97
289165094,33,34,29,2,98
289168384,66,6,2,2,76
289174449,21,14,8,13,56
289176653,63,28,6,1,98
289178214,86,37,15,1,139
289184928,80,3,2,1,86
289190372,13,3,2,1,19
289210424,30,7,3,2,42
289215129,23,3,2,1,29
289225883,28,81,56,3,168
289230660,32,3,2,1,38
289252948,19,13,2,1,35
289257977,97,41,2,11,151
289266259,77,37,69,4,187
289269954,21,4,5,1,31
289292005,72,6,8,1,87
289296318,95,53,17,17,182
289314256,174,16,29,15,234
289315346,102,3,2,8,115
289324985,22,3,2,3,30
289348350,54,3,2,1,60
289359511,44,34,32,1,111
289361383,131,3,2,1,137
289363284,34,3,2,1,40
289371476,10,3,2,2,17
289378303,48,30,3,3,84
289403587,135,32,2,1,170
289411118,118,16,2,2,138
289428570,15,13,2,1,31
289428891,975,3,2,12,992
289431295,12,3,2,1,18
289431752,38,3,2,7,50
289434108,55,3,2,2,62
289440205,38,36,4,1,79
289444785,68,89,32,4,193
289448883,24,34,16,1,75
289460221,154,5,2,17,178
289467519,10,7,2,2,21
289467774,36,3,2,3,44
289476375,85,15,4,1,105
289485369,133,89,48,24,294
289491343,16,19,6,2,43
289503865,190,16,9,2,217
289506440,119,61,36,39,255
289516275,52,6,2,7,67
289520585,174,26,38,2,240
289547565,22,4,2,2,30
289557706,10,21,22,5,58
289558883,56,16,4,1,77
289559907,129,3,72,1,205
289566781,41,16,3,9,69
289567909,68,19,2,1,90
289574962,12,19,2,4,37
289588309,97,37,40,3,177
289588665,46,26,2,5,79
289608929,50,49,21,9,129
289609179,131,25,2,1,159
289633992,50,104,86,20,260
289643519,100,14,49,18,181
289645388,171,3,2,11,187
289647279,44,26,15,1,86
289649472,70,43,16,1,130
289674936,11,3,2,2,18
289675167,68,6,2,25,101
289737475,12,3,2,1,18
289742374,141,3,2,10,156
289742791,64,3,4,1,72
289744067,25,30,27,37,119
289752345,66,12,16,3,97
289768455,71,13,3,1,88
289789786,120,7,10,15,152
289801559,18,33,2,1,54
289807614,213,29,29,27,298
289807789,10,39,2,1,52
289808722,26,3,2,1,32
289820820,212,7,2,38,259
289826428,69,3,2,2,76
289826820,48,9,6,1,64
289827579,10,9,2,1,22
289832733,23,3,2,1,29
289836170,46,3,22,4,75
289846096,41,20,3,8,72
289866037,157,35,11,9,212
289886848,44,97,2,2,145
289892726,77,7,3,12,99
289896342,55,3,2,6,66
289905038,14,3,2,1,20
289912839,71,7,2,10,90
289913536,87,28,25,29,169
289925186,17,3,12,2,34
289930936,90,3,2,2,97
289939442,21,4,2,1,28
289951597,54,91,7,5,157
289960188,43,30,2,1,76
289967751,25,21,2,1,49
289970959,48,24,7,7,86
289979548,29,3,2,2,36
289995691,63,3,2,3,71
289995825,46,24,41,4,115
290003872,44,3,2,1,50
290008312,41,7,2,1,51
290018987,130,30,2,27,189
290020092,160,17,2,1,180
290027224,43,22,8,3,76
290029082,10,6,2,18,36
290046678,71,23,3,1,98
290052970,10,16,2,1,29
290070885,23,45,31,13,112
290093609,107,49,22,10,188
290100013,10,5,2,1,18
290104751,42,32,14,8,96
290107932,145,21,2,3,171
290113470,11,3,2,2,18
290113645,14,9,2,1,26
290114188,39,44,14,25,122
290120650,74,3,2,9,88
290146270,123,39,20,4,186
290156135,44,12,12,2,70
290179048,83,41,67,32,223
290181347,60,44,3,1,108
290186209,69,39,70,6,184
290187303,16,5,2,2,25
290187822,11,3,2,1,17
290206574,116,75,2,8,201
290216816,42,3,2,1,48
290222313,47,3,2,1,53
290227485,40,7,2,5,54
290232055,18,3,2,1,24
290241048,86,3,2,7,98
290257116,35,27,8,4,74
290258786,51,9,18,2,80
290281854,143,3,2,4,152
290290896,13,3,2,1,19
290315462,12,3,2,4,21
290318633,22,3,2,1,28
290323078,29,23,6,1,59
290324029,20,68,9,3,100
290331436,15,11,2,1,29
290335718,17,35,20,1,73
290342220,41,12,11,28,92
290344725,12,14,2,1,29
290348401,138,3,22,7,170
290364239,61,16,2,2,81
290379648,10,8,2,1,21
290386857,148,55,101,3,307
290414223,88,5,3,3,99
290414823,31,39,4,6,80
290426855,554,3,2,2,561
290446530,35,3,2,1,41
290462219,93,3,2,4,102
290462343,97,57,77,46,277
290467388,14,3,2,1,20
290473584,57,3,2,3,65
290480417,15,32,2,1,50
290481182,170,34,2,1,207
290481929,55,18,2,8,83
290483372,18,3,2,1,24
290484795,30,3,2,3,38
290502947,38,3,2,8,51
290540702,26,3,2,1,32
290547672,45,29,30,3,107
290548755,82,3,2,1,88
290577249,134,17,100,5,256
290584273,17,4,2,1,24
290587268,10,12,2,1,25
290593562,25,11,29,17,82
290614264,122,20,28,3,173
290614888,55,51,63,4,173
290617776,96,9,4,4,113
290618820,67,12,16,2,97
290623214,85,24,20,18,147
290638275,85,19,11,73,188
290639495,42,15,21,1,79
290663505,27,3,2,2,34
290681832,54,3,2,7,66
290698300,16,3,2,1,22
290703737,63,47,6,5,121
290711659,82,13,49,6,150
290728517,28,20,4,1,53
290733699,79,15,15,9,118
290733839,48,3,2,1,54
290752289,77,47,21,78,223
290754641,21,9,2,1,33
290769295,112,42,10,1,165
290778502,36,3,2,3,44
290788286,17,19,11,58,105
290817685,60,3,2,1,66
290818061,38,47,10,2,97
290831308,76,44,33,25,178
290831323,85,13,59,12,169
290833802,51,30,35,15,131
290851793,56,21,10,8,95
290862599,12,3,2,1,18
290878141,86,32,2,3,123
290890482,95,8,3,9,115
290895395,101,7,21,20,149
290905677,79,26,37,6,148
290929427,23,23,91,7,144
290930241,22,3,2,1,28
290934540,78,21,2,20,121
290984756,130,50,92,3,275
290985249,12,3,2,1,18
291001687,118,60,19,20,217
291008850,42,61,2,1,106
291016984,71,3,2,1,77
291017231,117,17,218,3,355
291019784,62,21,2,9,94
291027473,42,3,2,1,48
291037751,16,7,2,10,35
291041121,116,29,6,1,152
291053464,68,42,53,15,178
291060696,139,12,8,6,165
291065965,275,29,2,41,347
291084407,40,42,4,2,88
291141665,144,3,3,9,159
291145003,94,47,4,52,197
291157609,31,27,7,7,72
291166597,117,83,16,12,228
291168102,59,3,2,1,65
291171618,200,3,2,1,206
291187096,14,4,2,1,21
291195308,44,3,2,4,53
291217372,17,12,2,2,33
291230387,56,37,11,31,135
291245747,179,25,24,2,230
291256959,11,52,2,1,66
291267143,119,7,2,1,129
291271476,66,3,2,1,72
291271653,47,7,9,6,69
291279748,78,3,2,1,84
291282521,123,21,18,7,169
291282874,33,3,2,1,39
291283252,73,3,2,9,87
291283800,50,10,2,1,63
291311489,29,52,2,1,84
291313337,122,5,2,1,130
291313748,32,3,2,1,38
291318429,10,3,2,4,19
291331327,117,3,2,1,123
291331931,14,14,2,1,31
291357647,16,9,2,1,28
291366238,25,23,7,1,56
291374909,16,14,2,6,38
291383328,10,3,2,2,17
291392951,20,12,8,5,45
291413727,60,3,6,2,71
291421843,11,5,5,1,22
291436765,121,15,68,22,226
291448701,188,21,2,15,226
291465098,184,23,26,6,239
291466733,20,3,2,6,31
291466990,21,3,2,1,27
291469549,136,3,2,6,147
291477713,21,21,34,6,82
291486261,44,3,2,1,50
291494473,44,26,2,1,73
291496981,18,55,29,1,103
291504945,83,69,67,26,245
291505531,55,26,18,18,117
291513347,26,17,4,1,48
291515287,21,3,2,1,27
291516962,319,3,2,5,329
291528858,18,32,24,1,75
291531286,19,23,2,1,45
291531739,82,3,2,7,94
291538222,58,10,2,1,71
291544834,175,33,72,4,284
291553384,15,5,2,5,27
291565762,95,3,2,2,102
291568450,162,18,2,8,190
291571092,43,39,12,10,104
291573509,100,94,23,49,266
291576835,158,80,3,1,242
291588063,78,3,2,6,89
291599263,12,5,2,2,21
291609742,32,11,9,2,54
291611981,43,3,2,5,53
291619497,112,43,20,21,196
291672845,100,3,2,2,107
291691096,42,26,5,2,75
291692712,89,22,2,1,114
291713320,129,30,4,2,165
291715499,11,8,2,1,22
291725672,10,22,2,2,36
291727834,82,33,103,2,220
291736649,57,42,3,13,115
291737729,84,46,6,2,138
291737944,29,39,24,6,98
291739950,24,22,8,4,58
291743984,52,26,2,1,81
291747233,11,4,2,1,18
291755729,73,6,30,33,142
291779820,103,21,31,3,158
291780477,40,3,2,20,65
291781784,90,3,2,3,98
291800215,44,77,19,4,144
291802405,47,10,2,7,66
291807500,231,3,12,1,247
291815845,89,24,2,3,118
291822092,45,7,2,1,55
291849421,28,3,2,1,34
291850549,49,29,2,3,83
291860859,12,3,2,5,22
291874000,238,13,8,2,261
291880932,241,3,2,2,248
291895648,133,32,35,16,216
291901817,182,103,60,11,356
291908968,95,3,2,8,108
291914201,46,33,10,16,105
291915972,27,3,2,1,33
291930776,98,3,2,9,112
291957134,35,17,27,1,80
291967753,192,25,40,18,275
291980953,76,3,2,12,93
291981754,20,3,2,1,26
292000125,36,3,4,1,44
292008683,44,48,2,12,106
292012552,105,57,17,12,191
292013455,15,9,2,2,28
292022103,71,25,132,1,229
292026655,14,4,2,1,21
292036674,16,7,2,1,26
292040685,26,15,2,2,45
292044205,49,6,5,8,68
292050610,79,53,2,8,142
292066384,63,47,42,26,178
292068670,116,27,31,25,199
292068765,17,13,8,11,49
292071404,45,29,2,10,86
292088823,44,3,2,9,58
292098340,92,29,42,3,166
292101896,16,3,2,4,25
292106805,48,21,50,21,140
292116433,120,23,30,3,176
292154427,114,22,3,1,140
292167930,80,18,4,2,104
292170317,86,31,12,6,135
292182380,16,30,5,2,53
292184893,27,23,3,1,54
292188611,96,25,6,39,166
292203424,45,18,19,20,102
292204221,44,3,2,79,128
292209508,30,58,14,12,114
292217610,73,9,3,1,86
292221975,78,12,30,1,121
292235640,71,68,108,3,250
292246211,33,85,29,10,157
292257572,37,48,13,1,99
292270840,33,12,25,3,73
292277916,38,3,2,3,46
292283091,34,15,46,7,102
292297201,13,8,2,2,25
292334960,65,3,2,1,71
292345825,84,14,85,4,187
292346996,14,3,2,1,20
292351299,87,37,45,3,172
292355668,57,12,6,2,77
292359842,20,6,2,19,47
292362968,11,3,2,1,17
292368788,35,3,2,1,41
292374062,24,23,19,4,70
292376262,604,3,2,2,611
292377595,37,22,17,7,83
292404584,24,11,2,1,38
292406204,53,23,7,16,99
292411698,50,28,3,5,86
292415939,19,3,2,3,27
292420110,86,8,13,2,109
292427869,42,23,9,8,82
292430695,130,5,2,7,144
292468417,28,5,2,10,45
292470875,59,16,10,1,86
292484350,12,3,2,1,18
292488799,52,28,26,9,115
292494953,20,3,2,9,34
292496104,108,5,19,1,133
292497290,57,9,8,13,87
292499633,95,33,4,4,136
292507760,118,103,57,40,318
292510554,44,15,48,6,113
292512233,76,10,2,4,92
292518817,60,47,7,1,115
292530177,25,5,2,1,33
292533183,90,10,12,7,119
292536252,56,33,80,23,192
292537341,17,3,2,1,23
292538028,36,12,2,1,51
292550713,44,74,12,27,157
292554523,111,6,2,1,120
292563361,157,9,2,3,171
292564263,147,3,2,34,186
292567801,93,3,2,1,99
292585351,27,4,2,1,34
292587780,82,3,2,1,88
292600994,109,3,2,5,119
292628599,14,3,2,2,21
292641370,57,12,4,13,86
292644737,12,3,2,2,19
292649331,68,18,13,1,100
292654840,47,11,2,1,61
292669524,124,8,31,4,167
292675905,55,30,6,2,93
292678896,111,3,2,3,119
292680946,60,39,4,12,115
292687121,52,3,2,1,58
292694461,26,3,2,4,35
292699760,123,4,67,1,195
292701424,14,3,2,1,20
292707530,52,28,36,1,117
292721037,15,4,2,1,22
292723528,38,48,3,1,90
292768117,16,3,2,3,24
292775293,54,21,14,8,97
292786871,63,19,2,3,87
292795478,86,12,6,2,106
292807133,10,4,2,4,20
292816181,17,3,2,4,26
292821995,14,19,2,1,36
292822234,40,3,2,1,46
292843829,122,11,7,1,141
292853915,210,3,2,10,225
292855910,15,4,2,1,22
292860853,18,28,41,1,88
292874255,11,3,2,1,17
292888892,123,3,2,2,130
292893511,151,3,2,1,157
292894884,29,24,6,4,63
292917266,28,34,13,1,76
292927729,85,3,2,1,91
292948764,25,26,28,3,82
292954203,287,3,2,15,307
292956954,76,3,2,8,89
292958844,24,42,5,3,74
292974396,102,10,49,4,165
292981408,22,57,2,2,83
292984828,10,3,2,2,17
292994046,20,12,2,3,37
292999976,17,3,2,1,23
293005050,16,3,2,1,22
293045402,30,10,2,1,43
293045534,24,26,21,2,73
293050658,67,14,45,2,128
293054404,11,3,2,1,17
293063952,180,3,2,5,190
293066774,76,26,7,16,125
293071054,82,15,34,1,132
293086012,44,3,2,1,50
293100067,13,5,2,13,33
293109956,50,5,8,1,64
293149285,16,3,2,1,22
293154712,29,3,2,1,35
293171820,132,176,122,175,605
293181592,56,29,2,11,98
293189089,10,6,2,1,19
293201863,96,3,2,15,116
293229183,54,12,9,1,76
293231067,23,3,2,1,29
293253855,43,27,40,10,120
293269711,37,3,2,4,46
293274376,43,4,2,1,50
293291246,85,38,58,4,185
293298296,101,9,2,2,114
293337891,38,63,10,5,116
293341616,37,16,2,1,56
293344797,124,12,4,12,152
293358826,120,8,2,1,131
293364104,224,33,2,1,260
293371744,10,6,2,1,19
293381444,46,8,2,1,57
293391153,211,23,16,3,253
293413605,65,63,17,4,149
293419908,113,3,2,1,119
293420749,46,14,5,21,86
293455302,10,3,2,4,19
293461089,213,3,2,1,219
293466946,10,5,2,2,19
293487517,12,28,2,1,43
293505087,127,79,113,18,337
293509018,86,3,2,1,92
293514318,96,5,2,2,105
293534817,20,34,3,17,74
293535830,19,48,5,3,75
293541593,32,16,4,1,53
293544318,23,26,3,14,66
293557957,63,30,13,1,107
293565320,54,3,2,2,61
293574202,27,3,2,1,33
293574546,50,18,21,5,94
293575523,68,16,40,10,134
293608549,92,3,2,1,98
293637581,92,19,21,1,133
293639181,96,6,2,2,106
293667435,48,3,13,2,66
293672551,10,5,2,1,18
293705330,16,23,2,1,42
293709572,46,10,11,24,91
293718217,12,7,2,1,22
293727496,47,9,2,3,61
293749178,88,16,6,3,113
293755463,33,32,26,17,108
293768326,12,19,2,1,34
293768473,30,50,51,3,134
293773371,96,3,2,1,102
293787572,23,14,3,2,42
293788425,167,38,48,3,256
293799360,42,3,3,3,51
293812042,11,3,2,1,17
293828547,70,13,2,2,87
293832637,98,83,25,7,213
293852912,172,76,4,2,254
293886621,40,23,71,52,186
293901431,115,47,18,24,204
293917169,64,3,2,6,75
293917405,45,23,2,1,71
293926994,19,3,2,14,38
293939237,51,6,3,12,72
293945180,37,38,8,2,85
293945622,97,3,2,17,119
293969090,11,3,2,1,17
293977237,23,11,2,2,38
293993330,10,3,2,2,17
293993796,12,3,2,8,25
294018119,69,7,2,1,79
294018699,11,3,2,1,17
294028215,195,39,10,5,249
294051377,141,3,2,23,169
294063939,11,15,2,3,31
294079430,61,90,4,1,156
294086595,164,38,11,4,217
294091390,43,3,2,1,49
294095991,33,15,26,2,76
294101000,12,5,2,1,20
294104974,54,88,26,2,170
294119488,88,18,10,12,128
294146766,37,49,16,1,103
294160372,10,3,2,4,19
294167928,18,6,2,1,27
294168196,62,34,4,3,103
294182747,102,25,2,1,130
294185607,60,30,9,4,103
294193105,10,15,2,1,28
294193586,105,47,2,65,219
294205558,78,3,2,1,84
294214993,67,17,15,10,109
294228516,49,41,55,2,147
294238479,18,3,2,1,24
294241065,180,29,9,9,227
294245903,164,40,2,15,221
294250921,101,14,41,14,170
294255452,58,30,12,1,101
294258668,59,9,4,1,73
294271589,60,27,19,13,119
294286573,14,3,2,1,20
294289891,120,12,3,1,136
294303070,101,21,2,6,130
294311799,86,3,2,1,92
294312895,103,108,24,30,265
294319017,60,33,11,1,105
294341948,99,3,2,1,105
294352066,17,22,2,1,42
294354348,16,3,2,1,22
294375985,54,32,18,8,112
294396637,200,63,65,18,346
294396678,77,10,2,17,106
294414404,105,32,15,2,154
294425822,32,48,5,16,101
294429824,75,71,2,8,156
294434030,147,6,16,1,170
294434464,17,3,2,2,24
294437373,69,18,4,2,93
294460972,46,3,2,1,52
294470111,20,4,2,2,28
294472222,90,20,5,1,116
294476493,10,13,2,2,27
294479092,105,24,31,31,191
294479755,11,3,2,1,17
294487111,19,7,2,1,29
294493711,76,8,15,1,100
294518685,18,3,2,1,24
294527108,72,8,2,1,83
294533943,70,3,7,2,82
294536733,41,16,29,4,90
294554160,35,3,16,9,63
294556665,36,9,17,17,79
294563919,27,12,2,12,53
294564920,69,5,2,8,84
294566281,124,3,2,5,134
294573039,93,10,2,4,109
294581946,14,3,2,1,20
294591756,64,61,53,12,190
294592290,205,31,48,19,303
294601559,64,15,2,4,85
294626538,109,14,32,1,156
294630399,99,17,16,14,146
294650276,161,26,11,1,199
294652499,52,3,3,19,77
294655361,14,28,2,1,45
294658165,79,18,2,4,103
294673978,42,4,2,3,51
294681056,20,53,14,2,89
294704932,59,3,2,2,66
294706842,29,62,18,19,128
294709982,69,15,23,13,120
294715077,12,46,22,1,81
294720045,153,3,2,2,160
294751592,109,80,14,30,233
294754408,11,3,2,4,20
294784802,36,15,9,10,70
294790711,11,3,2,1,17
294810592,78,41,2,1,122
294821182,17,3,2,1,23
294861839,31,34,6,4,75
294861884,37,8,2,6,53
294869630,84,12,2,10,108
294875212,48,3,2,1,54
294876931,186,3,2,9,200
294878465,42,4,2,3,51
294891083,10,3,2,2,17
294894098,71,25,27,19,142
294905390,13,3,2,1,19
294907455,38,4,2,2,46
294920210,74,58,7,9,148
294921000,81,19,19,2,121
294927026,71,3,2,1,77
294927259,74,35,5,13,127
294934526,133,18,122,5,278
294943851,11,3,2,1,17
294960107,11,10,2,1,24
294973012,83,13,3,1,100
294981059,16,6,2,5,29
294986838,26,48,14,18,106
294989012,14,12,3,1,30
294990220,48,38,10,11,107
295001807,150,35,2,6,193
295015276,56,20,4,9,89
295020100,11,5,2,1,19
295022362,46,47,8,2,103
295030003,49,11,2,1,63
295035230,47,10,3,2,62
295050243,64,3,2,1,70
295074832,28,40,15,1,84
295079770,18,3,2,1,24
295086105,91,3,2,1,97
295094349,86,27,4,18,135
295100728,18,3,2,1,24
295127973,12,3,2,1,18
295129409,96,3,2,2,103
295130244,11,3,2,1,17
295130854,12,3,2,1,18
295140299,15,12,8,1,36
295147231,55,19,153,1,228
295153139,32,47,45,1,125
295182353,57,5,2,6,70
295186329,20,22,12,3,57
295195968,104,51,57,12,224
295196053,123,42,37,1,203
295197592,13,46,56,2,117
295203018,90,3,2,2,97
295205170,20,3,2,1,26
295214595,93,25,10,27,155
295219012,75,46,43,6,170
295220825,124,3,2,5,134
295229516,17,8,2,3,30
295237938,29,11,3,1,44
295239891,27,19,31,16,93
295244550,39,25,25,1,90
295244886,47,68,23,11,149
295254422,168,106,2,15,291
295273388,242,57,4,22,325
295284330,11,3,2,1,17
295291776,125,11,2,1,139
295291874,199,8,2,8,217
295292893,22,44,19,31,116
295295426,18,3,2,1,24
295311298,35,7,15,14,71
295314084,104,3,2,2,111
295323013,14,10,6,1,31
295324461,11,4,2,1,18
295325077,254,3,2,20,279
295328320,29,29,11,4,73
295335048,128,3,2,1,134
295348439,128,3,2,4,137
295374868,25,3,2,1,31
295398256,117,3,2,1,123
295420800,10,5,2,1,18
295426663,33,19,2,5,59
295428150,178,29,20,8,235
295449285,17,14,2,2,35
295452069,16,3,2,1,22
295467403,12,3,2,1,18
295503865,68,31,38,1,138
295524725,73,23,6,6,108
295534321,13,5,2,3,23
295538371,122,30,3,4,159
295542887,105,76,3,14,198
295544454,14,3,2,3,22
295556434,12,4,2,1,19
295559959,12,3,2,2,19
295561917,97,32,3,20,152
295563967,26,3,2,3,34
295564603,27,23,4,1,55
295569315,146,3,2,3,154
295582588,29,3,2,5,39
295583408,114,37,8,9,168
295583580,134,15,135,1,285
295587364,217,14,2,5,238
295588860,30,17,2,3,52
295599427,28,50,2,6,86
295608023,10,3,2,3,18
295613033,75,13,2,5,95
295613963,44,73,3,1,121
295621801,19,20,5,3,47
295623968,67,3,2,1,73
295624486,43,23,2,6,74
295642140,32,3,2,1,38
295642187,228,3,2,17,250
295655820,19,3,2,1,25
295662712,17,3,2,1,23
295663506,48,16,2,2,68
295665117,23,29,2,1,55
295684668,86,3,2,5,96
295686545,70,12,2,1,85
295694317,29,10,6,4,49
295702371,61,14,7,2,84
295703572,47,14,2,12,75
295728296,81,23,4,10,118
295730875,68,3,2,1,74
295732098,82,16,32,2,132
295736048,18,3,2,4,27
295736761,73,33,2,20,128
295737730,38,16,9,3,66
295738573,215,28,4,15,262
295742229,33,45,64,5,147
295766155,48,53,84,1,186
295782318,27,3,2,2,34
295793442,26,10,3,1,40
295810686,51,31,28,10,120
295813371,149,3,2,2,156
295834544,65,31,3,1,100
295836127,55,8,10,1,74
295836598,95,33,19,13,160
295840305,64,11,13,5,93
295854913,13,3,2,3,21
295856472,204,3,2,1,210
295869955,15,3,2,1,21
295884239,140,31,7,1,179
295901687,32,3,2,6,43
295927008,93,3,2,1,99
295935192,77,27,3,8,115
295936993,148,3,2,7,160
295940261,81,28,2,2,113
295940974,16,54,5,3,78
295943543,20,4,14,5,43
295971816,13,3,2,1,19
295973621,34,3,2,1,40
295974665,61,3,2,5,71
295977438,164,107,21,3,295
295999134,11,3,2,1,17
296007890,13,3,2,2,20
296014009,271,3,2,6,282
296027595,140,40,50,25,255
296030200,66,9,2,1,78
296033097,102,18,4,13,137
296035953,11,44,60,3,118
296061808,30,8,42,1,81
296079306,23,3,2,1,29
296087824,11,3,2,1,17
296095624,12,3,2,1,18
296109057,59,3,2,1,65
296115747,71,32,18,1,122
296120244,20,39,30,5,94
296131174,15,3,2,3,23
296138800,79,28,2,1,110
296139730,22,10,2,14,48
296152866,16,3,2,1,22
296168800,96,24,13,6,139
296171098,167,3,2,1,173
296171112,73,13,43,4,133
296203973,55,15,8,4,82
296208246,21,12,2,3,38
296219587,31,3,2,5,41
296236346,17,6,2,1,26
296236844,69,29,20,1,119
296237601,76,20,17,10,123
296245821,206,28,49,4,287
296246918,76,22,2,5,105
296251226,50,81,30,11,172
296255548,63,23,3,42,131
296256799,73,18,3,8,102
296268246,22,6,2,1,31
296278801,49,3,2,3,57
296296872,11,3,2,1,17
296327327,10,5,2,1,18
296330919,26,12,8,1,47
296333126,12,3,2,4,21
296334822,120,7,2,1,130
296352545,129,106,77,9,321
296360892,11,3,2,1,17
296363736,17,20,2,1,40
296372486,72,30,12,7,121
296379818,97,32,89,4,222
296386093,21,7,2,1,31
296386254,60,3,2,1,66
296387219,21,39,4,41,105
296418947,120,5,2,1,128
296424200,47,23,2,1,73
296447531,45,3,2,2,52
296448674,77,30,13,1,121
296460741,76,3,2,3,84
296472207,114,24,2,1,141
296495449,22,35,2,1,60
296496723,48,39,2,2,91
296497753,99,26,7,7,139
296505534,20,54,19,4,97
296510216,28,3,2,2,35
296525261,29,70,2,1,102
296545706,46,3,2,1,52
296549821,84,3,2,9,98
296555983,26,11,7,3,47
296560285,74,11,12,7,104
296562095,102,42,173,15,332
296569377,61,3,2,1,67
296597461,31,12,4,1,48
296598312,28,58,4,2,92
296603396,11,5,2,2,20
296603929,28,5,2,3,38
296623485,10,16,2,1,29
296629333,159,29,2,11,201
296649788,12,8,2,1,23
296656388,11,3,2,3,19
296658307,22,4,4,6,36
296661976,26,3,2,1,32
296665891,18,7,2,1,28
296673221,549,3,2,9,563
296677836,28,22,2,1,53
296689264,60,54,22,41,177
296710709,32,10,15,2,59
296715076,18,19,10,1,48
296721636,90,48,2,3,143
296732128,47,28,2,10,87
296745633,142,3,2,3,150
296748010,13,35,2,1,51
296749559,58,27,45,3,133
296752677,82,28,23,22,155
296762104,96,50,46,4,196
296763179,16,26,2,1,45
296822749,114,17,2,16,149
296823953,10,5,2,1,18
296843670,23,30,2,2,57
296848834,48,3,2,3,56
296859250,26,33,2,9,70
296868698,81,30,17,1,129
296868989,21,4,7,7,39
296882454,26,3,2,1,32
296883173,78,22,2,20,122
296884671,85,33,23,2,143
296901495,78,3,2,1,84
296903752,60,31,45,1,137
296916198,33,3,2,1,39
296923608,50,27,17,20,114
296928131,20,3,2,2,27
296944788,13,19,2,1,35
296946450,105,6,2,6,119
296950139,62,3,2,1,68
296950976,85,3,2,1,91
296951733,45,23,5,14,87
296959453,26,35,25,1,87
296960196,27,3,4,1,35
296964772,10,4,2,2,18
296972834,73,45,9,2,129
296981793,27,3,2,1,33
296982713,15,14,20,2,51
297002906,109,37,96,20,262
297016439,10,4,2,1,17
297017934,13,3,2,1,19
297025258,20,10,5,3,38
297035516,10,73,19,1,103
297037899,34,29,2,1,66
297046988,45,67,2,7,121
297052191,127,42,78,16,263
297065268,84,3,2,1,90
297071716,12,5,2,1,20
297073783,63,9,2,2,76
297094583,45,68,2,11,126
297106551,18,39,37,1,95
297108266,16,3,2,1,22
297115646,66,3,2,1,72
297121587,35,25,2,1,63
297134471,45,12,26,1,84
297143445,129,15,23,1,168
297147758,80,30,15,2,127
297150605,40,20,2,2,64
297159023,49,20,30,37,136
297163678,45,56,23,1,125
297182879,15,16,2,2,35
297191791,192,13,3,1,209
297193964,89,34,2,1,126
297207710,21,7,2,2,32
297209644,231,3,2,24,260
297222846,98,59,95,1,253
297230253,84,29,73,25,211
297233175,35,9,47,5,96
297233403,84,32,12,7,135
297235575,171,38,5,51,265
297259565,150,28,2,1,181
297266746,44,3,2,3,52
297272375,28,3,2,4,37
297272639,12,3,2,3,20
297317447,50,3,2,1,56
297331406,43,55,9,48,155
297333607,81,3,2,1,87
297334781,41,3,2,2,48
297337921,41,9,2,1,53
297339653,24,28,3,22,77
297343171,26,6,2,1,35
297347740,126,23,32,23,204
297364601,36,19,13,1,69
297368100,27,3,2,1,33
297372718,28,31,3,3,65
297388910,77,16,11,12,116
297402360,46,3,2,2,53
297406721,11,30,23,29,93
297419469,55,58,25,8,146
297423945,140,12,68,5,225
297424730,113,30,80,4,227
297425247,62,3,2,1,68
297445497,47,18,6,1,72
297445634,124,8,2,15,149
297463647,31,50,17,3,101
297470964,29,3,11,8,51
297525033,82,3,2,1,88
297542552,136,16,2,2,156
297552952,40,25,12,9,86
297583588,35,17,6,11,69
297584625,56,33,3,8,100
297586170,80,55,2,5,142
297594428,57,30,37,13,137
297597441,71,33,5,6,115
297599740,43,27,2,4,76
297606367,60,22,30,13,125
297606377,75,10,10,6,101
297628952,71,3,2,1,77
297658282,39,20,2,1,62
297670302,21,3,2,1,27
297671280,17,3,2,1,23
297679423,116,21,4,12,153
297683355,27,23,4,1,55
297693336,64,3,2,2,71
297701144,66,3,2,1,72
297737303,67,3,3,55,128
297742100,33,32,5,4,74
297756998,100,3,2,1,106
297769435,10,3,2,2,17
297774654,74,27,8,1,110
297776250,46,37,33,6,122
297776770,27,3,2,1,33
297780882,16,8,6,3,33
297785749,81,19,2,1,103
297793473,20,25,2,1,48
297812777,10,5,2,1,18
297815151,37,6,3,1,47
297815761,63,8,54,5,130
297816624,39,3,2,1,45
297817716,134,30,16,16,196
297817759,12,8,2,1,23
297823444,91,7,17,3,118
297836868,25,3,2,1,31
297838694,13,3,2,1,19
297853756,99,37,6,12,154
297862554,52,3,2,1,58
297881856,117,11,77,9,214
297886563,86,58,60,42,246
297889815,11,3,2,1,17
297889881,93,6,12,3,114
297896119,60,48,14,11,133
297900852,64,3,2,1,70
297902430,33,3,2,4,42
297908968,10,3,2,3,18
297923179,74,11,13,1,99
297936411,11,12,2,4,29
297939572,120,26,2,1,149
297944004,404,48,26,24,502
297948115,105,3,2,1,111
297964128,32,3,2,1,38
297969849,12,3,2,1,18
297985861,72,3,4,5,84
297989372,98,5,39,2,144
297993960,45,10,2,1,58
297994041,60,22,2,1,85
297994988,10,8,2,1,21
297997046,56,50,37,5,148
298008199,29,15,2,2,48
298018108,83,48,3,4,138
298028411,38,14,14,4,70
298032230,21,59,3,1,84
298034313,56,3,2,2,63
298059979,133,6,2,2,143
298061610,11,3,2,1,17
298067109,49,57,35,9,150
298075759,33,28,2,1,64
298079917,160,3,2,1,166
298095822,70,3,2,1,76
298112000,19,4,3,1,27
298134314,91,24,2,2,119
298151523,15,3,2,1,21
298160706,62,63,36,5,166
298169243,152,19,4,11,186
298171247,22,5,2,2,31
298173916,16,13,2,1,32
298208352,40,26,2,21,89
298242267,12,3,2,1,18
298247618,10,34,2,1,47
298248836,20,3,2,30,55
298260151,17,3,2,4,26
298260216,22,10,2,1,35
298272483,21,19,3,20,63
298277759,83,19,50,1,153
298281658,97,3,2,1,103
298287913,51,20,40,1,112
298294543,30,9,3,5,47
298298099,147,25,2,9,183
298300360,113,3,2,2,120
298303810,25,3,2,1,31
298330501,96,22,24,13,155
298332155,119,86,102,3,310
298345975,64,31,14,1,110
298349700,101,26,2,9,138
298380206,70,30,32,1,133
298403782,107,3,2,7,119
298404646,51,18,8,11,88
298405123,117,11,3,4,135
298405575,11,3,2,1,17
298408270,30,6,15,4,55
298416648,21,77,18,1,117
298418028,125,24,16,1,166
298433081,82,36,35,48,201
298433172,50,3,2,6,61
298434270,62,18,2,1,83
298436636,12,3,2,1,18
298438164,13,11,2,2,28
298442322,12,4,2,1,19
298452828,33,27,27,1,88
298457208,22,14,8,1,45
298466040,46,21,11,6,84
298466375,29,37,2,10,78
298467203,53,3,2,1,59
298472744,12,47,2,1,62
298492875,15,3,2,1,21
298495345,96,28,2,1,127
298516753,15,3,2,10,30
298542991,126,12,2,1,141
298567785,21,31,5,6,63
298567787,83,17,2,1,103
298577248,71,19,48,10,148
298581970,81,15,2,3,101
298583834,123,4,84,1,212
298583947,26,24,2,3,55
298611278,158,59,29,10,256
298620709,105,6,10,10,131
298623539,196,83,13,45,337
298629134,18,3,2,1,24
298629693,75,18,2,1,96
298631401,22,5,2,1,30
298632310,24,43,53,25,145
298639670,554,3,2,12,571
298644823,11,10,2,1,24
298648083,67,3,2,1,73
298657958,557,3,2,5,567
298676118,52,3,2,5,62
298690141,81,47,2,1,131
298702864,13,10,2,1,26
298738889,12,3,2,1,18
298744756,46,3,3,1,53
298748386,125,25,2,1,153
298786621,24,4,3,1,32
298789533,11,12,2,1,26
298795138,47,28,10,9,94
298795422,63,4,3,1,71
298795934,53,70,60,1,184
298801937,88,63,74,2,227
298814195,165,19,32,4,220
298815622,58,3,2,1,64
298817898,82,12,2,1,97
298822952,38,19,33,1,91
298828630,89,51,2,63,205
298844706,28,3,2,4,37
298844868,58,8,4,1,71
298847715,13,3,2,1,19
298861634,74,3,2,1,80
298871250,258,3,2,13,276
298872790,47,17,4,2,70
298881480,38,3,2,1,44
298883930,54,3,2,9,68
298887837,26,46,4,1,77
298909210,26,3,2,4,35
298923963,11,3,2,1,17
298930021,57,26,2,9,94
298937231,59,39,77,1,176
298942674,84,6,9,4,103
298945078,16,3,2,1,22
298948369,140,31,27,7,205
298971014,52,11,2,1,66
298971478,77,47,42,1,167
298978251,12,3,2,1,18
298982677,32,3,2,1,38
298986447,119,3,2,9,133
299010453,13,5,2,1,21
299012102,82,7,4,5,98
299029336,184,67,51,3,305
299035400,50,28,9,1,88
299038581,76,3,2,1,82
299054634,68,108,3,16,195
299068017,129,17,11,1,158
299071814,36,16,2,1,55
299075132,59,27,37,2,125
299077166,54,8,2,5,69
299080175,12,6,2,1,21
299083930,87,6,23,2,118
299088908,48,26,2,2,78
299094134,12,15,3,1,31
299096451,12,68,2,1,83
299102359,41,3,2,1,47
299113226,36,9,2,1,48
299129227,37,10,6,1,54
299134870,90,31,31,1,153
299151685,48,47,13,7,115
299157375,157,28,3,1,189
299164822,165,10,7,2,184
299175295,50,68,10,2,130
299180833,45,20,10,12,87
299201508,178,3,2,1,184
299225546,10,8,2,1,21
299242691,136,9,18,3,166
299250314,41,69,62,28,200
299257100,12,3,2,1,18
299268788,26,45,7,1,79
299279698,163,32,2,1,198
299285269,49,50,2,2,103
299288399,10,27,2,1,40
299291316,37,3,2,1,43
299300391,19,39,42,1,101
299301192,131,49,29,20,229
299316617,64,41,42,71,218
299331111,92,12,2,1,107
299342999,20,26,3,1,50
299382371,17,32,7,6,62
299383897,91,25,36,2,154
299386194,12,3,2,1,18
299407355,90,33,4,8,135
299414318,34,118,67,47,266
299419205,93,82,2,13,190
299423248,106,13,3,1,123
299450571,19,11,2,1,33
299452054,107,37,13,23,180
299456640,137,3,2,3,145
299458022,30,10,2,1,43
299468423,121,38,3,1,163
299478521,16,19,2,10,47
299490330,32,48,15,1,96
299490428,38,9,2,1,50
299493471,33,114,2,34,183
299503075,142,16,2,3,163
299516830,77,22,2,3,104
299521956,10,6,2,1,19
299524827,65,25,19,11,120
299528940,14,5,2,1,22
299541515,13,3,2,1,19
299555967,20,21,35,40,116
299566170,1252,3,2,8,1265
299568048,29,21,2,2,54
299570847,69,15,2,1,87
299575369,61,62,43,1,167
299585368,38,19,3,56,116
299588365,152,36,2,9,199
299592560,90,31,6,1,128
299608462,46,17,2,8,73
299618367,107,7,2,1,117
299625462,13,13,49,18,93
299628692,125,25,7,32,189
299679337,156,19,2,7,184
299679794,61,18,2,1,82
299684541,10,39,5,1,55
299684665,45,3,2,1,51
299688277,101,21,2,8,132
299694581,35,19,3,11,68
299714147,14,3,2,1,20
299744042,177,3,2,8,190
299751384,29,3,2,1,35
299758616,129,17,2,5,153
299760065,90,52,64,48,254
299765323,16,3,2,1,22
299779242,41,35,2,4,82
299785799,10,3,2,2,17
299793738,23,20,5,4,52
299801268,36,29,2,1,68
299805947,65,4,22,5,96
299821519,82,17,34,28,161
299830189,45,20,19,5,89
299836592,37,3,2,1,43
299843560,20,28,21,8,77
299846859,189,16,66,3,274
299852097,37,10,2,4,53
299858570,108,25,38,1,172
299864164,125,3,2,3,133
299878067,124,49,31,11,215
299899973,42,16,10,2,70
299906053,138,3,2,3,146
299907263,1111,3,2,4,1120
299908872,28,99,35,5,167
299913978,77,17,92,12,198
299928433,36,50,2,1,89
299933729,48,10,30,2,90
299951665,28,7,3,1,39
299976977,52,19,2,1,74
299983967,36,82,10,4,132
299989199,151,3,2,2,158
300000523,112,57,73,38,280
300000962,53,10,2,1,66
300021457,47,19,2,10,78
300022463,69,76,6,7,158
300039551,13,7,2,1,23
300051359,16,36,7,7,66
300072518,61,48,4,1,114
300074209,62,4,2,15,83
300079424,53,51,129,4,237
300086094,109,31,19,7,166
300110531,27,3,2,1,33
300126844,16,3,2,2,23
300129220,13,7,2,1,23
300143227,31,25,16,15,87
300146837,94,12,15,15,136
300152699,86,7,2,1,96
300168179,30,10,3,1,44
300175051,23,26,9,5,63
300179528,54,3,2,2,61
300182173,11,3,2,1,17
300191499,11,3,2,1,17
300195242,77,40,54,6,177
300202265,40,3,2,2,47
300212891,10,23,22,1,56
300220343,86,4,2,52,144
300224988,33,10,4,6,53
300225843,41,4,2,1,48
300237882,16,51,26,12,105
300240776,66,3,2,1,72
300265532,164,3,2,1,170
300270958,21,19,50,3,93
300271809,206,3,2,1,212
300286430,49,16,18,1,84
300289974,58,40,40,2,140
300298782,63,18,42,10,133
300316997,87,30,44,33,194
300332206,28,34,5,1,68
300335461,29,3,2,1,35
300347482,110,68,3,1,182
300357330,108,23,13,2,146
300357856,54,4,137,1,196
300363547,30,39,2,15,86
300370832,197,44,54,4,299
300389219,12,3,2,7,24
300401036,16,6,2,1,25
300402286,130,10,8,2,150
300405502,34,4,32,1,71
300415670,35,3,2,1,41
300421606,191,3,2,3,199
300423519,47,76,35,17,175
300446969,10,3,2,2,17
300480508,49,44,34,27,154
300482338,11,3,2,2,18
300495984,184,3,2,1,190
300531007,41,3,2,1,47
300531776,64,43,3,10,120
300563586,67,24,13,11,115
300564640,125,38,2,2,167
300578957,147,3,2,1,153
300580720,49,13,2,2,66
300582627,71,3,5,4,83
300589875,159,69,31,5,264
300590970,11,70,3,1,85
300603848,50,21,2,1,74
300642048,67,10,2,1,80
300677853,15,12,2,1,30
300693070,51,3,2,1,57
300695488,191,46,2,4,243
300697600,33,13,2,1,49
300702606,67,70,45,94,276
300704487,52,3,2,1,58
300704489,38,22,10,1,71
300706266,49,14,4,15,82
300708103,11,23,2,1,37
300710844,36,25,2,1,64
300731975,10,3,2,2,17
300737593,72,33,2,10,117
300740142,173,31,3,4,211
300764855,45,3,2,2,52
300766876,43,20,5,4,72
300770698,18,10,2,1,31
300778579,11,3,2,1,17
300783435,107,17,2,1,127
300804984,68,49,27,1,145
300812906,63,34,6,2,105
300818767,197,53,2,1,253
300821560,56,24,29,15,124
300827280,21,25,29,9,84
300843910,29,21,4,4,58
300864111,53,59,20,4,136
300865841,142,24,7,1,174
300883030,17,3,2,2,24
300887088,36,6,2,1,45
300902823,77,3,2,1,83
300906453,97,34,23,10,164
300911045,95,3,2,1,101
300928965,67,27,46,1,141
300935724,118,3,2,4,127
300943095,35,15,33,28,111
300947657,69,3,2,1,75
300954202,42,27,2,1,72
300966912,20,32,2,29,83
300976813,52,43,27,1,123
301001345,113,3,2,2,120
301001532,37,14,2,1,54
301015054,60,26,6,8,100
301015897,150,3,2,9,164
301028276,10,10,2,3,25
301030255,55,11,11,1,78
301036019,167,37,39,4,247
301044041,51,10,2,2,65
301048534,18,8,2,1,29
301059914,176,4,2,1,183
301061001,111,32,61,4,208
301077051,150,31,23,1,205
301081617,26,33,31,5,95
301107284,51,40,26,2,119
301111221,115,26,2,3,146
301125950,1047,3,2,4,1056
301130348,32,49,6,1,88
301132166,54,49,2,1,106
301133255,44,3,2,1,50
301136809,11,3,2,2,18
301146521,11,3,2,1,17
301166191,117,3,2,2,124
301168968,29,17,9,3,58
301169945,147,48,18,2,215
301171895,79,32,18,7,136
301172787,82,3,24,7,116
301185254,56,107,25,21,209
301189751,109,19,2,1,131
301191634,22,3,2,1,28
301194554,40,23,2,1,66
301202255,62,4,2,26,94
301205916,61,69,25,6,161
301208705,38,4,16,4,62
301212909,105,18,4,2,129
301217412,236,3,2,5,246
301234183,21,3,2,1,27
301235093,27,34,60,1,122
301244090,102,13,2,9,126
301247061,12,3,2,6,23
301252901,18,3,2,1,24
301260305,101,12,12,21,146
301263191,37,29,3,1,70
301306820,39,12,2,17,70
301309380,66,21,19,8,114
301327471,19,6,2,1,28
301337895,38,3,2,4,47
301352684,311,28,2,3,344
301357338,35,3,2,1,41
301364402,167,23,2,36,228
301377088,15,3,2,1,21
301383000,194,22,2,3,221
301392378,14,3,2,1,20
301400249,67,3,2,1,73
301418652,36,27,2,2,67
301433723,12,5,2,1,20
301435479,66,63,11,32,172
301444998,52,3,3,5,63
301472239,13,6,2,1,22
301504312,61,3,2,1,67
301508681,13,14,2,8,37
301510811,102,40,7,5,154
301520697,74,10,2,1,87
301522051,13,3,2,1,19
301528822,136,57,4,17,214
301539965,78,3,2,1,84
301544024,39,52,12,40,143
301559903,113,25,2,11,151
301566679,11,3,2,1,17
301574569,77,18,61,4,160
301599118,64,20,2,1,87
301602841,68,50,7,53,178
301615186,34,3,2,1,40
301618586,118,35,7,13,173
301637615,41,3,2,1,47
301637959,73,12,15,7,107
301648533,18,3,2,1,24
301659238,76,186,11,5,278
301677762,182,41,4,4,231
301700327,116,3,2,1,122
301700962,17,15,7,2,41
301701455,100,3,2,9,114
301713359,26,16,11,56,109
301721690,90,27,11,8,136
301730306,33,3,2,3,41
301734188,10,3,2,3,18
301747362,10,18,2,1,31
301747580,195,3,2,5,205
301779648,23,3,2,1,29
301798486,61,3,2,1,67
301804683,10,10,2,2,24
301810079,32,3,2,1,38
301819107,13,3,2,1,19
301834804,56,3,2,2,63
301839313,46,3,2,1,52
301845505,26,21,3,1,51
301847988,58,12,57,2,129
301894919,124,5,3,48,180
301899189,38,3,2,1,44
301905106,11,3,2,1,17
301911818,18,3,2,7,30
301912889,57,45,2,3,107
301915000,113,23,2,5,143
301915593,129,16,2,23,170
301919383,72,30,2,31,135
301926099,82,3,2,1,88
301940169,33,18,2,1,54
301946201,242,4,2,27,275
301964421,16,3,2,1,22
301970627,82,22,2,4,110
301971019,24,21,34,1,80
301988586,14,21,5,1,41
301991969,62,83,80,11,236
302000765,112,70,5,5,192
302003001,38,45,2,1,86
302004793,122,30,2,2,156
302033693,82,33,4,1,120
302042762,84,37,20,25,166
302053624,17,3,2,1,23
302064957,72,27,4,16,119
302076907,15,8,2,1,26
302092056,28,28,9,3,68
302102362,37,3,2,2,44
302112474,123,3,2,2,130
302118344,10,6,2,6,24
302118840,14,3,2,1,20
302140142,15,3,2,1,21
302155471,50,19,2,1,72
302161806,15,3,2,1,21
302164916,15,10,2,4,31
302174787,175,3,2,2,182
302189603,12,3,2,4,21
302199241,13,3,2,1,19
302200387,32,8,2,1,43
302219302,119,11,10,18,158
302222658,37,39,2,5,83
302234023,420,3,2,12,437
302234168,37,3,2,1,43
302258676,49,3,2,1,55
302262813,124,20,2,1,147
302282681,78,23,24,1,126
302284931,69,23,71,3,166
302295304,152,3,2,2,159
302306251,62,17,2,3,84
302331181,11,3,2,1,17
302345853,12,3,2,1,18
302348670,16,3,2,2,23
302354453,48,3,2,2,55
302356404,12,3,2,2,19
302363398,59,10,111,5,185
302367861,111,28,2,60,201
302375203,79,27,26,22,154
302376633,133,28,50,11,222
302378669,108,46,2,12,168
302380197,109,55,34,37,235
302381508,100,12,2,2,116
302384943,10,4,9,1,24
302385136,11,11,5,1,28
302401331,87,37,13,4,141
302404361,52,55,33,20,160
302408813,84,29,31,8,152
302417677,14,3,2,1,20
302427086,10,3,2,2,17
302438866,66,17,2,1,86
302466477,242,3,2,1,248
302467086,30,15,2,1,48
302480819,51,3,2,1,57
302490544,11,3,2,4,20
302499820,59,32,7,2,100
302501450,130,77,8,7,222
302546282,367,15,2,3,387
302562283,158,8,2,1,169
302577631,12,10,2,1,25
302578925,18,3,2,1,24
302582278,26,19,3,5,53
302603587,36,12,35,2,85
302603904,47,24,2,7,80
302619231,210,71,93,58,432
302625010,131,3,2,26,162
302641461,99,6,11,3,119
302642130,36,105,5,1,147
302645830,14,31,5,1,51
302647011,78,3,2,1,84
302650754,51,16,5,2,74
302653939,59,5,2,1,67
302660614,53,16,16,1,86
302660736,60,90,18,7,175
302661946,20,27,2,1,50
302686702,33,40,17,24,114
302688844,179,19,2,13,213
302696022,12,3,2,1,18
302696113,52,17,21,2,92
302699349,289,14,11,16,330
302713561,88,8,42,16,154
302720763,107,7,3,1,118
302721128,117,3,2,1,123
302727550,37,3,2,1,43
302731493,31,15,2,1,49
302735117,13,9,2,1,25
302759631,97,3,2,1,103
302773739,233,39,26,71,369
302774383,194,3,2,16,215
302786715,85,54,75,33,247
302793965,44,10,29,25,108
302808494,148,50,133,11,342
302809565,272,10,2,63,347
302813681,11,3,2,1,17
302818888,12,3,2,1,18
302839626,10,13,2,1,26
302851076,67,3,2,3,75
302859004,146,38,27,22,233
302864082,10,3,2,2,17
302875075,11,3,2,1,17
302887430,91,47,36,5,179
302892125,65,17,29,75,186
302904160,95,9,2,1,107
302912093,117,52,111,4,284
302973300,31,3,2,2,38
302982957,95,21,16,6,138
303004564,41,52,3,1,97
303012085,168,3,2,13,186
303026771,42,12,9,2,65
303033834,22,8,2,13,45
303035022,123,3,2,10,138
303054690,80,24,14,32,150
303057826,27,7,2,1,37
303065307,42,50,30,9,131
303076334,20,3,2,1,26
303076550,16,3,2,1,22
303088694,10,4,2,1,17
303103761,153,116,44,79,392
303105345,12,3,2,1,18
303119466,32,37,2,6,77
303137048,19,47,5,1,72
303137721,59,11,2,1,73
303163462,10,5,2,1,18
303163653,12,6,2,1,21
303181748,14,5,4,1,24
303188526,15,17,2,3,37
303193570,45,26,64,63,198
303194167,175,48,2,2,227
303218226,11,32,3,5,51
303221067,72,39,27,8,146
303232200,46,3,2,1,52
303233855,81,3,2,1,87
303255421,174,45,42,1,262
303256673,159,42,34,3,238
303270839,57,3,2,1,63
303292008,68,3,2,12,85
303296658,95,19,2,1,117
303299209,50,106,16,3,175
303300315,294,3,2,1,300
303308914,51,3,2,1,57
303319151,50,21,2,1,74
303322246,122,3,2,1,128
303328027,41,17,6,5,69
303334886,38,16,2,10,66
303350822,70,9,21,4,104
303354997,50,25,2,5,82
303359714,15,7,2,2,26
303362121,111,10,10,2,133
303369292,22,3,2,1,28
303375978,163,4,2,6,175
303376329,136,3,2,2,143
303378211,43,49,12,8,112
303381613,46,28,14,1,89
303391392,56,6,21,1,84
303398173,120,21,30,1,172
303408986,113,29,2,3,147
303419460,39,4,2,1,46
303420392,98,20,17,24,159
303428705,44,15,2,1,62
303434416,99,23,2,9,133
303453619,50,77,2,3,132
303455442,125,40,16,1,182
303456627,117,38,47,18,220
303456705,10,8,2,1,21
303457410,87,13,23,1,124
303460866,79,24,4,3,110
303466571,60,20,2,1,83
303479333,32,50,2,5,89
303485904,33,12,6,35,86
303487911,74,14,12,60,160
303491323,148,3,6,3,160
303493502,81,18,13,5,117
303537807,22,31,4,1,58
303558163,18,4,2,8,32
303558827,50,3,2,10,65
303561686,56,21,6,1,84
303568036,138,4,2,4,148
303574332,11,3,2,1,17
303582695,11,3,2,1,17
303586160,45,3,2,1,51
303606948,60,9,2,2,73
303608286,45,25,12,10,92
303608908,82,4,3,13,102
303612500,57,14,2,1,74
303613886,35,61,27,1,124
303628272,65,3,2,1,71
303641120,106,58,2,5,171
303644740,131,29,15,23,198
303649982,68,33,4,2,107
303665913,79,3,2,2,86
303678868,112,47,60,4,223
303686054,34,10,2,1,47
303690056,10,5,2,1,18
303696681,67,37,59,4,167
303698532,109,36,69,18,232
303705327,24,10,2,1,37
303716040,68,8,6,11,93
303723246,14,6,2,1,23
303731925,12,4,2,1,19
303741244,60,15,53,10,138
303762383,65,3,2,1,71
303781016,12,17,2,2,33
303791015,50,7,2,1,60
303800143,68,4,45,5,122
303800334,188,45,81,1,315
303803438,99,3,2,26,130
303811907,108,11,60,36,215
303817855,113,3,13,3,132
303825572,91,59,9,7,166
303831533,12,11,2,1,26
303845781,68,27,17,9,121
303846268,78,18,17,1,114
303852813,54,58,83,48,243
303853379,167,26,3,1,197
303862237,59,3,2,2,66
303863824,35,19,2,1,57
303869604,40,15,13,1,69
303881108,38,34,4,4,80
303883499,37,15,4,3,59
303885208,52,8,9,1,70
303912473,34,61,24,1,120
303914471,11,3,2,9,25
303924061,81,14,2,1,98
303938906,105,35,30,23,193
303940963,33,5,5,2,45
303957456,103,12,21,17,153
303980806,16,3,2,1,22
303987910,95,6,2,1,104
303994771,66,15,4,20,105
303995867,38,3,2,2,45
304001717,24,34,2,1,61
304023215,152,74,21,12,259
304037454,66,19,2,7,94
304047119,46,26,2,5,79
304056083,140,85,14,26,265
304069580,65,18,55,1,139
304072437,65,10,3,3,81
304076405,805,12,2,146,965
304092621,116,3,2,1,122
304102467,124,32,3,24,183
304117077,161,10,61,10,242
304120486,36,40,2,10,88
304121904,16,3,2,3,24
304137928,176,3,2,3,184
304142670,33,11,2,3,49
304168487,125,20,2,2,149
304171920,72,13,2,28,115
304184138,44,3,2,13,62
304192956,13,4,2,2,21
304194806,22,18,34,1,75
304203664,72,18,2,2,94
304204840,20,3,2,1,26
304221762,16,3,2,1,22
304226735,70,6,20,7,103
304230006,85,16,38,2,141
304231625,49,7,2,3,61
304267399,90,38,5,2,135
304283411,111,82,42,9,244
304297258,21,40,33,8,102
304298395,31,9,4,1,45
304305381,23,15,2,1,41
304311960,12,11,2,1,26
304333574,37,11,6,1,55
304335304,167,3,2,1,173
304344684,98,3,2,1,104
304357701,108,48,2,1,159
304381615,98,3,9,24,134
304400230,21,8,3,1,33
304405132,33,3,2,1,39
304407507,58,23,11,5,97
304408351,13,3,2,1,19
304431673,36,3,2,1,42
304437132,24,29,2,6,61
304446597,63,28,27,6,124
304465490,151,3,2,3,159
304466789,128,7,2,79,216
304468069,74,3,2,33,112
304475248,15,16,2,1,34
304483428,22,11,2,1,36
304504552,55,6,3,7,71
304505203,67,9,2,1,79
304510303,54,17,2,11,84
304556986,10,8,2,1,21
304565199,30,51,6,4,91
304579136,14,4,2,3,23
304579814,12,3,2,1,18
304632780,18,3,2,2,25
304639524,69,13,27,2,111
304641256,11,25,2,4,42
304645836,61,33,25,22,141
304648852,59,17,20,5,101
304649994,89,16,2,9,116
304654582,48,15,15,13,91
304655397,12,7,2,1,22
304666860,173,10,8,3,194
304686458,171,11,13,1,196
304688524,54,33,67,2,156
304698769,54,14,2,1,71
304699612,11,3,2,1,17
304702190,23,39,5,2,69
304727477,85,3,2,1,91
304734727,67,17,2,6,92
304740218,24,22,35,100,181
304740469,67,3,2,67,139
304750221,72,28,2,9,111
304757206,65,3,2,1,71
304762703,55,3,2,3,63
304781634,134,20,2,3,159
304793870,19,4,2,1,26
304798419,60,21,2,5,88
304811328,66,9,2,1,78
304860870,70,24,2,4,100
304891480,31,24,15,7,77
304894637,48,3,2,2,55
304895902,40,16,47,1,104
304896373,70,3,2,8,83
304910215,48,3,2,8,61
304911860,36,42,14,1,93
304936563,18,3,2,1,24
304943026,82,3,2,4,91
304945256,57,37,2,7,103
304959145,23,32,26,1,82
304996770,173,33,3,44,253
305006634,40,3,2,2,47
305025750,11,3,2,1,17
305040185,18,16,2,3,39
305042676,11,4,2,1,18
305045989,22,3,2,2,29
305046247,103,15,35,24,177
305073278,63,17,24,6,110
305089217,47,103,11,13,174
305090013,45,16,36,11,108
305093364,10,23,2,1,36
305107915,111,4,7,6,128
305113802,177,4,2,10,193
305129482,51,3,2,1,57
305131817,119,3,2,1,125
305132169,95,3,2,2,102
305135544,86,27,4,1,118
305137149,217,14,2,1,234
305141909,32,5,7,13,57
305153886,119,38,58,86,301
305174519,54,9,2,1,66
305174684,59,23,64,6,152
305178833,16,14,2,1,33
305188738,70,48,57,14,189
305232771,11,3,2,1,17
305239517,27,3,2,1,33
305248529,22,3,2,1,28
305253413,44,40,5,17,106
305253463,11,3,2,1,17
305253744,15,17,2,1,35
305284237,10,5,2,3,20
305284664,30,7,2,8,47
305289921,17,3,2,1,23
305295915,46,28,2,1,77
305300601,353,9,2,12,376
305307570,10,6,2,1,19
305308749,125,3,2,3,133
305312718,24,3,2,1,30
305320106,11,8,2,1,22
305328206,102,20,67,1,190
305328571,64,27,2,11,104
305332496,18,16,3,2,39
305335402,13,3,2,1,19
305339905,34,3,2,1,40
305341802,33,24,4,1,62
305345828,40,3,2,82,127
305345833,94,40,88,9,231
305358630,139,3,2,1,145
305370375,24,12,4,1,41
305370658,155,3,2,1,161
305377439,28,7,2,6,43
305394370,40,3,2,5,50
305396958,31,18,10,2,61
305411870,21,6,2,3,32
305425489,42,3,11,1,57
305435213,11,5,2,1,19
305440759,112,34,12,1,159
305465965,20,18,2,2,42
305469084,144,52,2,3,201
305469503,13,3,2,1,19
305483172,44,35,2,1,82
305483952,34,3,2,3,42
305490742,33,121,110,2,266
305509217,82,83,19,18,202
305514349,145,3,2,15,165
305526132,12,3,2,2,19
305528501,20,3,2,1,26
305537780,33,25,7,1,66
305548707,90,9,21,8,128
305557178,78,26,4,3,111
305568150,53,3,2,1,59
305568750,70,3,2,1,76
305570466,11,3,2,1,17
305578397,132,3,2,3,140
305591623,79,33,21,2,135
305595502,22,32,2,1,57
305611942,40,58,22,29,149
305614597,11,3,2,1,17
305616232,170,13,2,5,190
305616636,56,6,2,5,69
305622189,75,29,117,8,229
305628826,103,23,2,10,138
305640989,52,37,15,2,106
305644905,14,3,2,1,20
305646697,75,17,58,18,168
305647138,81,78,4,1,164
305681437,11,3,2,1,17
305696994,129,85,120,5,339
305713530,66,20,2,2,90
305714641,148,39,2,1,190
305722585,88,6,26,1,121
305726071,63,19,9,11,102
305727569,33,11,2,2,48
305727943,35,92,15,1,143
305736939,150,43,40,2,235
305742116,55,7,18,1,81
305747720,28,3,12,1,44
305750354,63,61,9,2,135
305763716,79,9,2,1,91
305783127,63,36,18,7,124
305795560,205,53,46,1,305
305797422,61,3,2,1,67
305815856,57,3,2,11,73
305840042,19,7,2,2,30
305843619,89,36,45,31,201
305861396,89,25,38,6,158
305863165,126,5,2,1,134
305874950,16,3,2,1,22
305876680,66,49,2,7,124
305886421,56,3,2,1,62
305890216,50,3,2,17,72
305890249,176,3,2,1,182
305894360,92,16,131,31,270
305905805,18,24,2,1,45
305915821,49,3,2,1,55
305928392,14,10,2,3,29
305937031,78,15,27,28,148
305949884,16,3,2,1,22
305993665,162,3,2,1,168
306023658,37,13,13,6,69
306024360,111,15,3,4,133
306024636,55,3,2,1,61
306025396,12,3,2,1,18
306038945,10,6,3,1,20
306043264,39,7,2,1,49
306044528,58,26,8,3,95
306047774,15,34,29,1,79
306053117,19,3,2,1,25
306058495,21,97,55,1,174
306059315,11,3,2,1,17
306062877,46,32,27,1,106
306068271,38,11,2,9,60
306075022,60,21,12,6,99
306075325,30,3,2,1,36
306089025,153,27,11,14,205
306102391,71,3,2,1,77
306111533,11,3,2,1,17
306113112,33,11,2,2,48
306126065,52,3,2,1,58
306133735,92,3,2,1,98
306139808,67,26,35,1,129
306143195,99,19,15,3,136
306151451,88,11,14,23,136
306158506,169,52,7,12,240
306166168,18,21,5,6,50
306172828,67,5,2,5,79
306174811,16,9,9,1,35
306182510,118,3,2,1,124
306202032,37,3,6,3,49
306221194,76,17,40,1,134
306243991,158,18,2,1,179
306249870,29,3,2,1,35
306266745,262,37,31,79,409
306268351,113,3,2,3,121
306271996,123,5,5,2,135
306272428,137,29,2,1,169
306275658,15,3,2,1,21
306285223,35,83,2,1,121
306289763,83,3,2,6,94
306299650,111,3,2,1,117
306301240,193,3,2,1,199
306302430,75,32,17,23,147
306318032,29,17,3,1,50
306328973,55,31,31,11,128
306350676,131,4,25,8,168
306350740,34,3,2,1,40
306351710,67,3,2,8,80
306354962,344,20,2,2,368
306355708,31,24,20,1,76
306387224,141,34,88,69,332
306398240,12,3,2,1,18
306400992,44,3,2,1,50
306404335,63,24,7,4,98
306425985,83,3,2,8,96
306432722,10,7,2,1,20
306436259,173,39,11,31,254
306445694,45,20,10,4,79
306448473,100,17,8,41,166
306453009,21,19,2,2,44
306459063,58,48,78,24,208
306483390,12,3,2,2,19
306483465,90,34,4,8,136
306488353,99,42,2,6,149
306489877,57,19,40,5,121
306493255,50,19,16,2,87
306499339,14,12,3,4,33
306530676,17,5,3,4,29
306532947,58,12,3,4,77
306551616,10,14,2,1,27
306573422,76,6,6,11,99
306598815,161,8,2,2,173
306616909,48,10,2,8,68
306623297,53,46,6,20,125
306625052,47,3,2,8,60
306636513,21,3,2,1,27
306642989,31,5,2,37,75
306647532,61,3,2,1,67
306650547,11,5,2,1,19
306654329,12,3,2,1,18
306669152,17,3,2,1,23
306676530,71,5,2,1,79
306691632,60,3,2,1,66
306703212,11,5,2,1,19
306716639,157,17,5,1,180
306725953,54,3,2,1,60
306726982,66,13,3,34,116
306735299,51,3,2,1,57
306742280,102,10,52,30,194
306744564,105,16,2,1,124
306747473,43,20,2,2,67
306761776,25,6,10,2,43
306775921,56,46,76,1,179
306801011,108,47,68,11,234
306801561,18,28,5,4,55
306803543,11,3,2,1,17
306828882,25,11,2,5,43
306830605,47,37,4,1,89
306845035,65,3,2,1,71
306845315,12,28,2,7,49
306852669,12,23,3,1,39
306854467,215,3,2,30,250
306864705,37,4,2,12,55
306864834,19,3,2,1,25
306878851,32,3,2,6,43
306881043,29,5,2,4,40
306881654,91,3,2,1,97
306891267,51,14,5,2,72
306891784,13,3,2,4,22
306898092,108,3,2,1,114
306915015,75,22,28,19,144
306928659,23,4,2,1,30
306929354,151,7,7,10,175
306929965,148,3,2,4,157
306944054,91,3,2,1,97
306965808,25,6,2,1,34
306968242,50,11,62,30,153
306987152,68,29,3,3,103
307001107,32,42,6,3,83
307009646,137,3,2,6,148
307014908,97,27,2,1,127
307018360,31,3,2,1,37
307021204,53,30,2,4,89
307038065,74,17,4,33,128
307040922,36,38,3,5,82
307041277,15,18,20,3,56
307041871,47,3,2,1,53
307043593,11,16,2,1,30
307056374,34,44,7,2,87
307065422,37,21,33,7,98
307068385,237,46,25,35,343
307073444,105,66,104,23,298
307085224,82,31,52,13,178
307099183,81,9,27,1,118
307120790,100,3,2,1,106
307120803,37,28,23,2,90
307122973,23,3,2,1,29
307123590,47,25,2,1,75
307154882,13,3,2,1,19
307156791,142,53,9,19,223
307197082,17,3,2,1,23
307206031,84,3,2,1,90
307207142,125,81,31,3,240
307210689,19,5,2,1,27
307212925,48,25,2,1,76
307216040,44,3,2,1,50
307227560,49,18,2,7,76
307228149,57,72,2,119,250
307238090,36,21,2,5,64
307239574,98,20,25,3,146
307241499,16,3,2,1,22
307244079,206,39,13,7,265
307245616,42,3,2,2,49
307258274,60,15,4,7,86
307260004,151,34,37,8,230
307260604,11,3,2,3,19
307282756,18,6,2,1,27
307289077,47,23,2,1,73
307307896,13,3,2,1,19
307341335,35,3,2,2,42
307348543,58,3,6,3,70
307354889,39,13,17,1,70
307355115,218,23,27,27,295
307366497,125,3,2,11,141
307369732,27,48,3,1,79
307399813,40,16,6,4,66
307405199,57,40,23,48,168
307405733,30,14,2,6,52
307407560,233,3,2,4,242
307410904,12,3,2,1,18
307411421,85,44,5,35,169
307413841,21,28,2,3,54
307414855,51,13,2,1,67
307423896,21,6,7,7,41
307440463,12,4,2,1,19
307447412,41,10,2,2,55
307459647,34,9,2,2,47
307461722,40,40,2,16,98
307481966,38,36,26,12,112
307488394,36,44,4,1,85
307493205,11,3,2,1,17
307500182,95,48,2,1,146
307500335,26,12,19,1,58
307508990,45,10,63,13,131
307513474,108,47,6,16,177
307520482,80,6,3,2,91
307523505,94,35,19,24,172
307525451,99,5,66,38,208
307527188,18,3,2,2,25
307534433,59,3,2,1,65
307537467,210,3,2,1,216
307559165,48,14,12,30,104
307563479,15,47,2,1,65
307571196,53,49,65,3,170
307572020,169,38,30,19,256
307579808,231,15,22,11,279
307602916,31,63,31,11,136
307618342,11,25,2,7,45
307629263,153,15,2,16,186
307630504,79,24,29,4,136
307641682,130,51,25,25,231
307655612,87,24,42,1,154
307656104,58,28,27,7,120
307692394,81,22,2,1,106
307704349,101,14,32,1,148
307705477,14,3,2,1,20
307705972,107,40,5,4,156
307712498,71,5,7,9,92
307716061,77,25,2,6,110
307733412,24,23,2,1,50
307745196,29,12,2,1,44
307761296,160,32,60,32,284
307764307,77,88,102,38,305
307764537,118,10,3,1,132
307785428,84,37,19,5,145
307786628,12,3,2,1,18
307791220,18,11,2,4,35
307793172,283,84,87,3,457
307804613,28,3,2,1,34
307857332,116,38,54,26,234
307861219,276,3,2,25,306
307862441,65,17,2,7,91
307881153,40,27,7,5,79
307907892,28,54,7,1,90
307909620,13,3,2,1,19
307916283,47,13,2,1,63
307926582,100,3,2,2,107
307941786,349,3,2,5,359
307958070,22,29,15,1,67
307969288,15,3,2,1,21
307971350,11,8,2,1,22
307982734,60,11,2,1,74
307993511,59,25,12,4,100
308011905,62,9,40,7,118
308017192,23,55,6,2,86
308035745,47,3,2,1,53
308036032,11,3,2,1,17
308037392,26,6,9,2,43
308041172,32,20,2,1,55
308080422,125,21,6,3,155
308087994,56,33,13,3,105
308091632,54,15,2,1,72
308098540,36,8,19,3,66
308112671,11,3,2,1,17
308115889,103,32,39,9,183
308139093,49,3,2,1,55
308142038,223,3,2,9,237
308143849,28,3,2,5,38
308148134,45,25,31,23,124
308164734,106,18,2,101,227
308167734,10,3,2,2,17
308170430,78,35,3,5,121
308179285,31,38,5,1,75
308186534,16,23,4,1,44
308195281,208,28,55,15,306
308198665,15,3,2,1,21
308209796,54,35,19,1,109
308213444,87,42,22,23,174
308215832,90,23,18,4,135
308217763,93,38,10,15,156
308235733,21,3,2,7,33
308271984,31,3,2,6,42
308281871,148,38,13,36,235
308299724,36,9,2,25,72
308315990,75,48,9,1,133
308323336,141,13,3,5,162
308325187,77,3,2,1,83
308329285,100,22,2,1,125
308338830,53,85,52,26,216
308339692,10,9,2,1,22
308342855,12,3,2,2,19
308351405,129,12,32,12,185
308370859,85,32,8,12,137
308370918,87,13,2,1,103
308382280,10,5,2,1,18
308392201,54,10,7,1,72
308402185,15,3,2,1,21
308408461,11,33,9,1,54
308412552,57,8,2,1,68
308418348,20,4,6,51,81
308425887,20,3,2,2,27
308443956,12,15,2,2,31
308446317,18,24,6,3,51
308447706,54,11,8,1,74
308453992,40,17,8,50,115
308454040,15,3,2,1,21
308464654,79,20,42,5,146
308475805,85,15,49,5,154
308480849,12,24,2,1,39
308483824,46,4,2,2,54
308491268,99,3,2,3,107
308513121,26,3,2,1,32
308516421,107,3,2,1,113
308518087,45,20,27,13,105
308525458,100,3,2,1,106
308560096,31,46,13,1,91
308565083,84,8,4,14,110
308565419,23,3,2,2,30
308569509,46,23,2,29,100
308593806,31,61,2,5,99
308604529,11,3,2,1,17
308608200,12,3,2,1,18
308614176,221,51,3,19,294
308617257,43,32,2,23,100
308619753,145,15,2,3,165
308655764,34,35,25,38,132
308678372,20,3,2,1,26
308679227,52,3,2,2,59
308679534,18,3,2,1,24
308681118,20,11,19,1,51
308687410,35,20,6,108,169
308687584,28,34,2,5,69
308705079,148,20,2,4,174
308724926,257,39,12,15,323
308747602,30,38,3,2,73
308756701,63,36,17,11,127
308772253,58,67,80,7,212
308772836,22,7,2,1,32
308787863,76,63,8,27,174
308799489,452,3,2,5,462
308807053,21,17,2,1,41
308809565,63,3,2,1,69
308816529,48,12,2,1,63
308834867,52,29,13,61,155
308852272,69,39,24,1,133
308860119,124,31,4,9,168
308864953,57,33,9,1,100
308874207,16,3,2,2,23
308878018,47,29,14,4,94
308883952,39,40,18,21,118
308911518,70,26,9,1,106
308920987,71,3,17,7,98
308926780,107,15,13,1,136
308933114,18,9,3,1,31
308940596,35,15,48,1,99
308941753,11,9,2,2,24
308943184,10,41,2,1,54
308947008,196,11,28,6,241
308955429,32,43,52,1,128
308963558,95,29,2,1,127
308984572,44,9,2,1,56
309006778,89,41,102,55,287
309032732,16,3,2,1,22
309040656,22,18,4,14,58
309045357,102,24,2,4,132
309046819,102,8,37,8,155
309047849,11,6,2,1,20
309061136,12,3,2,1,18
309070899,46,66,9,4,125
309107667,74,7,6,2,89
309109061,12,3,2,1,18
309110198,13,6,2,1,22
309116962,16,4,2,1,23
309132900,109,25,5,16,155
309135382,23,3,2,1,29
309136232,98,52,4,9,163
309144639,63,19,119,64,265
309164979,107,82,23,3,215
309166558,78,58,4,11,151
309179052,75,37,34,2,148
309197026,52,15,22,39,128
309198106,10,4,2,1,17
309209547,78,3,30,1,112
309214312,18,3,2,1,24
309214579,66,41,50,66,223
309217353,173,3,152,9,337
309224164,31,3,2,1,37
309235972,115,29,14,10,168
309238254,36,12,2,1,51
309256823,76,69,21,3,169
309272500,60,3,2,1,66
309278080,21,12,2,3,38
309287245,17,3,2,1,23
309299688,126,3,2,4,135
309301908,14,5,2,3,24
309310570,86,3,2,17,108
309317873,48,8,11,5,72
309333032,25,28,2,1,56
309334154,40,3,2,1,46
309336843,11,3,2,1,17
309340164,14,35,2,1,52
309343068,45,36,14,15,110
309363604,44,18,3,3,68
309364706,26,3,2,4,35
309369158,10,3,2,4,19
309369788,20,3,2,6,31
309374278,22,14,2,3,41
309375927,27,14,2,1,44
309377887,142,7,48,3,200
309380924,77,98,21,2,198
309382605,203,6,9,1,219
309383426,80,38,139,1,258
309404772,194,3,2,2,201
309406912,36,9,3,1,49
309407847,23,10,15,1,49
309420016,160,19,2,14,195
309427700,71,49,2,11,133
309428708,50,45,26,9,130
309438746,79,13,42,3,137
309484506,30,3,2,1,36
309498573,85,75,54,44,258
309499261,24,68,15,5,112
309512458,12,3,2,1,18
309518692,102,3,2,1,108
309520079,45,3,2,1,51
309532578,50,38,31,36,155
309535164,130,6,2,9,147
309558648,27,3,2,1,33
309572487,20,10,2,3,35
309575225,44,3,2,1,50
309584043,13,6,3,2,24
309586693,11,6,2,1,20
309587742,24,4,3,1,32
309588391,180,212,2,9,403
309592829,15,3,2,2,22
309606566,117,20,25,27,189
309621279,49,11,2,2,64
309624548,25,3,2,1,31
309635416,168,78,3,8,257
309656651,19,5,2,2,28
309657911,26,58,23,1,108
309658016,11,3,2,1,17
309666089,12,3,2,1,18
309668894,136,10,5,33,184
309677357,28,16,13,2,59
309686487,96,3,2,6,107
309698144,15,25,22,2,64
309700307,19,7,2,1,29
309705221,33,12,2,1,48
309711389,13,4,2,1,20
309725130,17,21,5,1,44
309737956,72,7,15,6,100
309740630,14,9,2,1,26
309740899,76,14,2,1,93
309741347,44,3,2,1,50
309751561,16,3,2,1,22
309753917,31,12,18,1,62
309766891,15,3,2,1,21
309782937,102,4,7,1,114
309785936,10,6,2,2,20
309803520,104,7,17,8,136
309811984,30,29,19,20,98
309813618,35,56,46,2,139
309821540,15,5,2,4,26
309825991,21,4,2,3,30
309834235,52,22,22,25,121
309839460,27,3,2,1,33
309840480,59,50,29,32,170
309840693,11,3,2,1,17
309862871,10,9,2,2,23
309862942,123,49,2,1,175
309867481,158,14,2,14,188
309868084,26,49,13,5,93
309870948,36,93,30,33,192
309887190,36,44,2,1,83
309894202,91,16,16,8,131
309902779,121,3,2,2,128
309917782,26,44,19,10,99
309921361,11,3,2,1,17
309934059,50,13,2,2,67
309934507,86,12,28,8,134
309943136,53,54,19,3,129
309943833,42,3,2,3,50
309948444,98,3,2,1,104
309961293,31,6,2,1,40
309982576,26,17,5,4,52
309998059,35,3,2,1,41
310001595,55,3,2,4,64
310023662,12,5,2,1,20
310034436,234,19,23,36,312
310039011,106,33,59,9,207
310045091,15,3,2,1,21
310056466,52,17,2,5,76
310057457,27,11,4,1,43
310070873,145,41,15,1,202
310084901,78,107,7,16,208
310095138,83,7,2,1,93
310127735,57,55,33,9,154
310132743,15,5,2,2,24
310135327,53,4,2,1,60
310157188,95,3,2,4,104
310157450,111,182,3,39,335
310166892,57,3,2,1,63
310179527,60,26,10,5,101
310181907,12,3,2,2,19
310191468,72,51,35,52,210
310199573,12,7,2,1,22
310216462,83,23,6,17,129
310229187,23,8,6,8,45
310242788,139,65,8,2,214
310242959,11,3,2,1,17
310244327,63,19,43,1,126
310265295,31,11,2,1,45
310302237,122,16,22,1,161
310303311,69,54,80,1,204
310315480,45,7,2,4,58
310324211,199,33,17,5,254
310335975,57,57,14,7,135
310338697,243,54,91,5,393
310362616,50,17,15,13,95
310369724,11,9,2,2,24
310370062,135,30,41,12,218
310370090,46,5,2,1,54
310388209,56,24,2,6,88
310403464,57,12,2,3,74
310407127,47,12,2,4,65
310419200,199,8,7,4,218
310425001,52,18,2,3,75
310445941,113,44,18,1,176
310447590,21,24,3,1,49
310449772,45,29,2,1,77
310452297,90,29,37,1,157
310454254,13,16,3,3,35
310464252,57,18,2,1,78
310472571,17,37,7,1,62
310495411,10,6,2,1,19
310498759,113,32,41,12,198
310501059,79,34,3,4,120
310509733,107,40,86,19,252
310517913,117,13,8,3,141
310519654,47,22,2,1,72
310525219,95,8,5,1,109
310532671,42,4,7,1,54
310546939,59,3,2,1,65
310549578,137,36,2,7,182
310552816,11,21,2,7,41
310564518,128,48,4,29,209
310568551,17,35,4,1,57
310586265,102,3,2,1,108
310593709,107,43,31,1,182
310629076,46,3,2,1,52
310629418,80,3,2,1,86
310635656,34,11,2,1,48
310642089,41,35,2,1,79
310652672,78,29,8,3,118
310671574,11,3,2,3,19
310675891,11,3,2,1,17
310680118,34,12,2,2,50
310691666,104,22,39,7,172
310700698,32,33,15,4,84
310704703,11,3,2,1,17
310708695,41,24,2,3,70
310712992,40,24,24,20,108
310713677,53,3,2,1,59
310719268,82,33,56,14,185
310733614,139,18,10,1,168
310735856,67,19,3,1,90
310743642,20,34,3,5,62
310745964,19,3,2,1,25
310752840,42,3,2,3,50
310769412,199,6,16,1,222
310771915,38,46,29,1,114
310788305,10,3,2,3,18
310801123,32,3,2,1,38
310803489,143,23,2,1,169
310810284,35,3,6,7,51
310812606,52,5,40,1,98
310820344,51,19,3,9,82
310825497,10,3,2,4,19
310825911,21,18,2,1,42
310826972,39,3,2,2,46
310829321,124,65,99,7,295
310840995,46,3,2,1,52
310848493,123,14,2,1,140
310851412,16,17,2,1,36
310854796,14,6,2,1,23
310865306,15,3,2,1,21
310873778,80,3,2,1,86
310880815,11,4,2,1,18
310885518,42,9,2,10,63
310896279,58,3,2,8,71
310901824,66,3,2,5,76
310908121,11,3,2,1,17
310916941,33,3,3,1,40
310919413,27,29,29,1,86
310925996,36,21,72,1,130
310928951,59,18,9,10,96
310946293,83,5,2,1,91
310954050,10,45,2,1,58
310955766,15,3,2,1,21
310961364,122,64,26,5,217
310969828,61,9,2,1,73
310974343,109,64,46,18,237
310976732,118,105,18,22,263
310980437,30,37,14,4,85
310994719,91,57,20,51,219
311004900,14,3,3,7,27
311014983,121,24,3,148,296
311028590,12,4,2,1,19
311029840,14,8,3,2,27
311041290,118,13,2,3,136
311050365,66,33,50,28,177
311070950,70,3,2,5,80
311092829,58,9,8,1,76
311098718,116,20,7,1,144
311100855,63,3,2,1,69
311110542,11,3,2,1,17
311113990,64,3,2,1,70
311117023,78,11,44,12,145
311125346,73,130,8,1,212
311127590,135,15,15,38,203
311139429,14,3,2,5,24
311153636,31,3,2,42,78
311164566,21,9,2,1,33
311165260,25,3,2,1,31
311171691,30,14,2,1,47
311199292,20,3,2,1,26
311208171,60,11,34,6,111
311208834,92,44,89,16,241
311219415,53,3,110,2,168
311231831,85,3,2,6,96
311234812,119,44,3,14,180
311236091,31,93,12,8,144
311237154,45,17,2,8,72
311247548,59,11,13,3,86
311251031,16,3,2,8,29
311262871,10,4,2,1,17
311273819,15,3,2,1,21
311275742,17,5,2,1,25
311292630,44,3,28,1,76
311298252,36,12,6,51,105
311298634,118,3,2,29,152
311298876,57,8,2,1,68
311299610,67,3,9,1,80
311317269,64,3,2,2,71
311325462,35,40,2,1,78
311335605,65,39,11,14,129
311340701,24,59,2,1,86
311345888,110,3,2,1,116
311364426,208,52,31,25,316
311416225,77,15,2,2,96
311434222,200,17,3,8,228
311434873,13,3,2,1,19
311439044,55,60,22,13,150
311463099,10,8,5,4,27
311469450,217,40,3,40,300
311472972,49,37,2,3,91
311486723,55,3,2,1,61
311494309,22,31,7,2,62
311499083,13,3,2,1,19
311507381,72,21,4,27,124
311517512,78,3,2,5,88
311517907,113,31,2,12,158
311522517,54,3,2,8,67
311533034,28,28,15,5,76
311534877,11,3,2,1,17
311536211,57,112,35,4,208
311553832,16,3,2,1,22
311553918,398,20,2,151,571
311561423,225,47,86,16,374
311562783,12,3,2,1,18
311599475,117,3,2,1,123
311607873,26,3,2,1,32
311617306,41,3,2,1,47
311619502,41,9,46,5,101
311623009,125,3,2,1,131
311627720,31,3,2,1,37
311633035,80,28,41,3,152
311653480,78,3,2,27,110
311678774,14,3,2,1,20
311680841,112,62,4,5,183
311704515,165,19,2,2,188
311706811,42,35,2,1,80
311714248,46,18,2,2,68
311728687,10,4,2,1,17
311738974,25,3,2,1,31
311761236,98,8,28,1,135
311777708,297,53,95,5,450
311780177,14,7,2,1,24
311784444,18,7,2,1,28
311798275,83,9,2,3,97
311805063,35,30,48,33,146
311813985,48,16,18,1,83
311841093,40,68,9,2,119
311846822,68,173,2,11,254
311854899,117,11,2,1,131
311856009,101,24,95,1,221
311856377,53,41,130,13,237
311866380,226,3,2,25,256
311867152,21,3,2,3,29
311868470,92,15,2,1,110
311884387,15,13,2,2,32
311893653,144,50,3,1,198
311903690,51,51,63,27,192
311935640,12,10,2,1,25
311939329,55,15,9,5,84
311945283,60,36,14,1,111
311949305,103,20,3,3,129
311951775,15,3,2,1,21
311959723,19,30,2,1,52
311963453,15,9,2,18,44
311966620,12,3,2,1,18
311990453,54,12,13,4,83
312005181,11,16,2,1,30
312015609,43,3,2,1,49
312016798,26,24,11,41,102
312023329,10,10,2,1,23
312037609,110,12,30,10,162
312039883,111,6,159,4,280
312040082,37,12,2,1,52
312044689,96,19,2,1,118
312047694,58,17,12,1,88
312048036,51,3,2,25,81
312049185,12,3,2,1,18
312052114,46,5,79,2,132
312053317,99,26,12,1,138
312058223,50,3,2,1,56
312061346,21,3,2,1,27
312079016,26,37,13,5,81
312085033,45,28,7,1,81
312092901,54,3,46,4,107
312097511,27,54,42,8,131
312103189,13,13,2,1,29
312114061,66,10,27,9,112
312115245,13,3,2,1,19
312116435,11,13,2,1,27
312124907,45,9,29,12,95
312131447,105,43,31,10,189
312141325,34,35,65,2,136
312141629,14,3,2,2,21
312146357,10,3,2,3,18
312165231,101,26,27,4,158
312173019,11,3,2,1,17
312200607,97,26,65,1,189
312224809,62,5,2,1,70
312228304,82,3,2,5,92
312231029,42,10,8,1,61
312243212,30,35,10,3,78
312266919,63,3,2,1,69
312270860,11,3,2,1,17
312279561,78,3,2,2,85
312280542,38,13,19,1,71
312280898,11,3,2,1,17
312296238,93,25,2,5,125
312300520,10,4,2,1,17
312304828,12,3,2,1,18
312308072,32,3,2,1,38
312308400,72,45,27,8,152
312311184,76,9,68,23,176
312313214,228,3,2,1,234
312316351,12,3,2,1,18
312319390,16,28,10,1,55
312320200,11,3,2,1,17
312348449,90,21,2,2,115
312354680,11,10,2,1,24
312381051,99,47,20,13,179
312389223,25,19,2,1,47
312390731,84,33,14,16,147
312436352,72,28,13,6,119
312436666,114,3,2,8,127
312442723,235,35,2,3,275
312450382,85,31,12,1,129
312460667,32,4,2,4,42
312469300,58,52,49,1,160
312478798,55,42,115,89,301
312501585,32,3,2,1,38
312525522,10,5,2,5,22
312525581,25,22,20,8,75
312536078,89,50,2,8,149
312536280,153,13,2,5,173
312538030,118,3,2,17,140
312560648,14,3,2,2,21
312565790,15,3,2,1,21
312567867,65,3,2,1,71
312568477,18,3,2,13,36
312575212,188,33,31,4,256
312578241,122,7,28,8,165
312578685,274,17,3,3,297
312595825,182,11,21,27,241
312601753,10,14,2,1,27
312653884,75,12,11,9,107
312663438,19,3,2,1,25
312667942,103,15,48,2,168
312682082,69,30,32,2,133
312693421,77,5,3,5,90
312707813,65,14,7,20,106
312714966,173,12,7,4,196
312744731,19,48,4,1,72
312746709,26,12,2,1,41
312748893,99,10,2,2,113
312749298,186,3,2,5,196
312765289,11,3,2,1,17
312767694,111,39,5,7,162
312771877,31,20,2,1,54
312794891,205,46,3,8,262
312798029,33,42,21,1,97
312801235,17,3,2,2,24
312801593,16,61,2,4,83
312804741,28,8,2,1,39
312806335,60,15,2,9,86
312816011,180,42,18,1,241
312823844,144,42,2,1,189
312832492,27,8,2,1,38
312847065,133,3,2,1,139
312854977,19,44,2,1,66
312857471,26,5,2,1,34
312864831,14,7,2,1,24
312870962,97,31,9,18,155
312884305,14,38,2,1,55
312889557,81,9,2,2,94
312906710,15,29,35,1,80
312910461,66,61,5,2,134
312924580,14,8,2,3,27
312936142,49,3,2,1,55
312936865,10,3,2,2,17
312939626,41,38,2,4,85
312956674,20,3,2,5,30
312962020,75,3,2,8,88
312973720,19,3,2,1,25
312974197,87,26,6,17,136
312977273,105,6,2,4,117
312978164,83,3,2,5,93
313012008,118,20,57,2,197
313017801,93,15,33,56,197
313032202,39,66,7,9,121
313048824,16,11,2,1,30
313053379,159,3,2,26,190
313072882,11,4,2,1,18
313078226,92,40,5,12,149
313089279,70,23,6,23,122
313090882,66,36,3,12,117
313111655,66,3,2,1,72
313125298,151,3,2,5,161
313127467,100,3,2,1,106
313142215,24,9,9,10,52
313143589,118,15,20,2,155
313161957,39,17,6,2,64
313162302,102,11,2,5,120
313166474,136,3,2,1,142
313169143,110,25,24,6,165
313169897,21,33,11,3,68
313170577,22,35,4,4,65
313176586,44,63,12,12,131
313183354,47,23,10,5,85
313183902,50,9,54,5,118
313191521,45,33,8,14,100
313208721,50,3,2,1,56
313217519,10,13,2,1,26
313237269,102,39,3,17,161
313238864,101,26,37,9,173
313246587,32,3,2,1,38
313247335,198,3,2,1,204
313256366,68,9,2,3,82
313283203,50,20,2,2,74
313284213,149,11,5,2,167
313287358,44,17,2,3,66
313287503,116,70,10,13,209
313320118,43,10,2,1,56
313338841,42,25,41,12,120
313350092,41,31,23,1,96
313359348,126,18,2,10,156
313365162,59,104,10,25,198
313369613,26,3,2,1,32
313397328,45,31,4,1,81
313398423,28,30,4,4,66
313413334,18,20,2,1,41
313415916,10,4,2,1,17
313418862,21,3,2,1,27
313429888,19,3,2,1,25
313438860,384,4,3,17,408
313438865,66,4,10,19,99
313441351,28,12,5,1,46
313451066,51,33,22,4,110
313456502,10,50,2,1,63
313465200,32,31,16,5,84
313466156,18,5,2,1,26
313474375,78,45,30,32,185
313475031,93,14,12,2,121
313477415,55,3,2,8,68
313478604,11,3,2,1,17
313518205,15,17,6,9,47
313525138,21,35,2,1,59
313531189,48,6,2,1,57
313538820,51,3,2,24,80
313542956,12,3,2,1,18
313557899,136,3,4,3,146
313569679,58,3,2,2,65
313576672,10,3,2,2,17
313578103,14,10,2,3,29
313583626,69,15,5,7,96
313608773,204,3,2,30,239
313609972,20,75,9,8,112
313613024,35,42,10,23,110
313622574,10,5,2,2,19
313623062,18,3,2,1,24
313632843,26,13,2,1,42
313634490,19,20,2,4,45
313656516,93,3,2,1,99
313672521,11,4,2,7,24
313691836,86,3,2,4,95
313694241,44,32,2,1,79
313704086,43,3,2,1,49
313704849,11,3,2,1,17
313705323,34,7,2,1,44
313721695,22,35,2,30,89
313731359,41,18,2,11,72
313756933,59,48,4,10,121
313775777,57,7,2,20,86
313780201,60,38,38,1,137
313781618,109,72,66,11,258
313787533,118,3,2,1,124
313791494,91,3,2,3,99
313803955,34,17,14,2,67
313804101,78,25,3,1,107
313807758,31,19,11,3,64
313819477,215,3,2,1,221
313826710,21,14,2,1,38
313852319,14,60,4,1,79
313853803,333,3,2,7,345
313866753,65,16,2,1,84
313869031,25,68,2,2,97
313869047,116,3,2,1,122
313872097,115,50,19,8,192
313876544,146,26,21,36,229
313877884,62,24,24,1,111
313879578,59,23,2,5,89
313885032,21,13,5,3,42
313887645,296,22,78,12,408
313907298,45,11,14,1,71
313908135,97,15,2,6,120
313916169,56,34,11,4,105
313921087,12,54,8,1,75
313928120,63,31,63,1,158
313929297,45,40,10,11,106
313951819,10,3,2,3,18
313964287,11,23,2,17,53
313979969,99,13,2,18,132
313993192,63,8,25,1,97
314006837,78,13,103,11,205
314025148,23,3,2,2,30
314034469,79,10,2,4,95
314037113,12,11,2,4,29
314070264,28,47,102,24,201
314071804,67,23,25,25,140
314102064,61,14,2,2,79
314110005,197,3,2,8,210
314125862,20,3,2,1,26
314126971,74,3,2,5,84
314139246,127,32,21,32,212
314146560,46,28,7,1,82
314148892,49,21,20,21,111
314158789,12,18,2,1,33
314162110,132,20,27,60,239
314177246,18,78,2,8,106
314185064,65,43,3,3,114
314186758,75,7,2,3,87
314191247,137,10,2,11,160
314197994,27,3,2,1,33
314210824,278,4,7,10,299
314223574,17,15,6,1,39
314245208,80,17,9,1,107
314245481,26,22,3,6,57
314253943,121,70,3,9,203
314263350,13,3,2,5,23
314282268,200,5,7,1,213
314283500,115,32,5,7,159
314286657,23,30,13,2,68
314292814,67,5,2,4,78
314303633,11,3,2,1,17
314326281,156,10,11,1,178
314328774,44,12,11,21,88
314346384,42,116,9,4,171
314357701,70,3,2,2,77
314376305,10,4,2,1,17
314384311,213,12,39,3,267
314395324,106,54,12,3,175
314395785,50,15,3,1,69
314396276,38,22,26,6,92
314424258,24,3,2,1,30
314425599,86,3,2,6,97
314432159,39,59,15,4,117
314433191,14,3,2,1,20
314436315,157,3,2,1,163
314457858,27,42,13,16,98
314472802,74,29,2,1,106
314481774,66,22,31,3,122
314494549,58,34,43,21,156
314498628,31,3,2,1,37
314505724,29,16,2,2,49
314510064,17,3,2,2,24
314511009,57,22,3,3,85
314512436,49,45,56,22,172
314519778,10,15,4,1,30
314532688,53,47,27,6,133
314535512,76,12,17,1,106
314537631,10,12,2,1,25
314540723,18,5,2,4,29
314540738,77,25,27,17,146
314544154,187,39,4,1,231
314548314,55,3,2,1,61
314548898,110,3,2,2,117
314551102,13,3,2,4,22
314568248,68,8,2,1,79
314569902,61,3,2,16,82
314572656,24,22,2,1,49
314599164,54,56,33,4,147
314604997,19,3,2,7,31
314618682,13,4,2,7,26
314627530,53,6,9,5,73
314630987,102,31,14,57,204
314638614,95,19,2,44,160
314643356,81,3,2,2,88
314647865,144,3,3,5,155
314662504,117,10,2,3,132
314664957,45,3,20,1,69
314694493,20,3,2,1,26
314722639,27,52,6,1,86
314733612,216,8,2,4,230
314741243,12,7,2,1,22
314748051,103,3,2,1,109
314757725,29,8,2,1,40
314764078,70,6,22,1,99
314790581,14,3,2,1,20
314810877,63,25,34,4,126
314812923,41,6,2,1,50
314816166,20,10,3,1,34
314821592,26,3,2,1,32
314825384,79,3,2,1,85
314849972,88,4,2,5,99
314856484,18,7,2,1,28
314858607,146,65,34,3,248
314865287,29,26,29,23,107
314874967,93,24,2,4,123
314878039,12,16,9,3,40
314887059,10,5,2,1,18
314895156,23,28,2,2,55
314932328,10,12,2,1,25
314954213,64,12,8,11,95
314968540,143,11,10,40,204
314994627,113,31,33,8,185
314996420,25,35,14,2,76
315004804,125,4,3,1,133
315025428,55,22,2,1,80
315031697,68,3,2,1,74
315043236,116,31,8,1,156
315046525,22,63,8,3,96
315061179,23,3,2,2,30
315081283,65,26,42,11,144
315082682,12,41,2,1,56
315090124,74,29,6,3,112
315093066,78,33,31,23,165
315104651,186,21,79,11,297
315110173,14,3,2,1,20
315119368,68,16,2,3,89
315119994,271,83,32,54,440
315130254,54,34,4,37,129
315153940,68,9,2,1,80
315161333,24,3,2,1,30
315163825,80,3,2,1,86
315197806,357,3,2,3,365
315200343,30,72,2,7,111
315207567,200,3,2,4,209
315208713,107,3,2,1,113
315235949,135,3,2,1,141
315241917,25,32,10,3,70
315256480,25,23,2,12,62
315261228,100,27,128,4,259
315263085,58,6,2,4,70
315279645,13,3,2,1,19
315283712,68,3,2,1,74
315294920,49,14,4,17,84
315300482,71,3,3,1,78
315300711,12,7,2,1,22
315307639,11,3,2,1,17
315339848,42,3,2,12,59
315345375,31,13,4,3,51
315351337,90,7,16,1,114
315355607,69,24,23,3,119
315359805,18,16,6,4,44
315365099,12,3,2,1,18
315375046,96,3,2,2,103
315389308,154,65,98,15,332
315390331,14,6,2,1,23
315397334,10,10,2,2,24
315397553,256,3,2,1,262
315398400,73,43,35,3,154
315407968,17,3,2,1,23
315422475,69,12,2,4,87
315424236,49,82,11,2,144
315425939,96,21,11,58,186
315434921,34,19,48,23,124
315442093,63,13,39,18,133
315459029,51,19,14,5,89
315462025,77,7,6,21,111
315475108,64,33,15,3,115
315491856,88,41,41,8,178
315526602,55,27,16,6,104
315529290,50,32,45,14,141
315532977,103,46,32,22,203
315535593,133,39,60,15,247
315541714,101,3,2,3,109
315551372,104,15,2,2,123
315565785,254,54,26,14,348
315567302,56,23,39,42,160
315568864,27,34,2,2,65
315584456,26,10,4,8,48
315590874,203,3,2,2,210
315595091,78,32,14,1,125
315597074,43,21,2,7,73
315599343,17,3,2,1,23
315599833,115,41,8,5,169
315601718,38,23,2,7,70
315605732,13,6,2,3,24
315612587,38,28,6,1,73
315616967,12,3,2,2,19
315618209,29,26,18,11,84
315628668,99,32,9,6,146
315639347,35,13,8,15,71
315654196,66,9,6,5,86
315654336,128,3,2,16,149
315682130,265,4,3,2,274
315687503,186,19,16,18,239
315691784,16,3,2,1,22
315695860,44,18,31,16,109
315699103,38,3,2,7,50
315699730,115,3,2,1,121
315702565,50,54,7,10,121
315705717,13,3,2,1,19
315721871,68,26,2,1,97
315724848,61,3,4,2,70
315738470,119,26,13,41,199
315741088,57,3,4,6,70
315749300,46,24,4,7,81
315754855,104,12,3,1,120
315758585,22,3,2,3,30
315766229,105,23,7,10,145
315767577,61,37,2,3,103
315780312,72,12,3,1,88
315785401,25,91,2,1,119
315787177,66,42,34,8,150
315790142,63,3,4,5,75
315795738,14,14,4,1,33
315798093,75,3,2,2,82
315808750,45,3,2,1,51
315809179,44,25,24,12,105
315809752,62,12,3,2,79
315824736,174,3,3,6,186
315852869,26,34,22,3,85
315860874,36,6,2,4,48
315862007,13,3,2,1,19
315864660,69,9,2,12,92
315874607,46,5,11,7,69
315884930,54,13,47,2,116
315898393,16,8,2,2,28
315919900,26,44,2,8,80
315927742,54,3,25,8,90
315931069,15,7,2,1,25
315937953,274,5,40,3,322
315941707,68,9,2,5,84
315946502,114,10,3,6,133
315954808,21,4,13,1,39
315955203,63,3,2,10,78
315970539,19,20,2,4,45
315972905,35,11,2,2,50
315975767,47,13,4,1,65
315982204,194,16,2,1,213
316022108,42,16,2,1,61
316023300,19,6,4,1,30
316024422,33,36,19,5,93
316042726,119,3,2,1,125
316048371,59,3,2,7,71
316060105,21,31,2,11,65
316061346,28,21,80,42,171
316089708,85,3,2,54,144
316101372,98,35,21,9,163
316113630,31,37,25,6,99
316149170,37,3,2,3,45
316149594,12,3,2,1,18
316151122,67,6,2,1,76
316160847,99,12,34,1,146
316161435,15,22,2,1,40
316170428,19,6,2,4,31
316174810,156,14,2,1,173
316184679,157,23,5,2,187
316192847,192,17,4,1,214
316195666,11,3,2,1,17
316235732,10,12,2,1,25
316238607,110,3,2,1,116
316239733,73,48,2,1,124
316242307,43,23,3,7,76
316261416,13,29,2,6,50
316262234,50,41,73,3,167
316280284,78,3,2,4,87
316282000,61,19,16,16,112
316297978,11,5,2,3,21
316310267,25,10,2,1,38
316314063,11,3,2,1,17
316350999,21,3,2,1,27
316362725,48,7,2,4,61
316363287,42,21,3,5,71
316378362,12,5,2,1,20
316378821,85,4,17,1,107
316379650,89,3,2,1,95
316385206,81,19,2,4,106
316398112,120,13,2,8,143
316398627,70,17,2,1,90
316401344,17,3,2,1,23
316404450,15,8,2,1,26
316417886,12,3,2,1,18
316427909,69,5,5,13,92
316430899,12,3,2,1,18
316435085,91,29,18,12,150
316461178,10,4,2,1,17
316471880,10,3,2,2,17
316513835,19,3,2,1,25
316523269,59,3,2,1,65
316524564,38,3,2,17,60
316524775,46,25,88,12,171
316529609,101,20,25,2,148
316530533,19,22,2,1,44
316553585,52,22,4,10,88
316555140,92,19,2,4,117
316559543,12,3,2,1,18
316564870,49,12,6,18,85
316566045,36,25,2,5,68
316567181,24,49,3,5,81
316610657,11,39,2,8,60
316636511,176,3,2,2,183
316663946,12,5,2,2,21
316673264,31,19,2,1,53
316689761,49,6,2,1,58
316692156,11,3,2,2,18
316706013,182,3,2,1,188
316719792,49,22,15,1,87
316720711,38,3,2,1,44
316754613,45,3,2,2,52
316756387,10,3,2,2,17
316789154,10,9,2,1,22
316789289,28,44,4,7,83
316797626,67,44,2,1,114
316831632,147,3,2,23,175
316832409,24,3,2,1,30
316834798,52,23,19,33,127
316837342,78,46,43,3,170
316880750,82,145,32,3,262
316883305,84,21,2,1,108
316887578,87,10,37,37,171
316889782,22,3,2,1,28
316890012,25,44,2,2,73
316890883,148,3,2,7,160
316891431,45,31,20,18,114
316894580,53,21,2,9,85
316923526,65,19,26,2,112
316937204,47,19,4,19,89
316946616,58,3,2,5,68
316947853,93,26,6,1,126
316949286,18,3,2,1,24
316976368,155,24,2,1,182
316976775,53,25,13,1,92
316977643,44,3,2,11,60
316986260,57,22,37,6,122
316987999,26,22,2,1,51
316995089,21,12,2,1,36
317015165,212,13,2,2,229
317016613,58,19,40,17,134
317030510,26,38,2,1,67
317055564,47,19,3,2,71
317063407,357,3,2,5,367
317073653,36,13,2,6,57
317084008,13,3,2,1,19
317091206,84,3,2,8,97
317097721,36,3,2,1,42
317098548,57,23,25,1,106
317100120,109,30,2,13,154
317105032,523,3,2,2,530
317105719,94,39,2,1,136
317105777,273,3,2,2,280
317108418,47,3,2,1,53
317122478,110,19,2,21,152
317133853,33,11,5,22,71
317134383,13,3,2,1,19
317137331,21,11,2,1,35
317137926,101,28,15,1,145
317140690,65,47,34,4,150
317151824,55,39,2,1,97
317155245,167,43,11,19,240
317159975,61,98,58,30,247
317180850,47,3,2,1,53
317191626,75,77,32,4,188
317192853,24,3,2,1,30
317201898,35,7,18,7,67
317210094,41,30,54,6,131
317225310,16,3,2,8,29
317226032,117,8,2,1,128
317229110,93,8,2,4,107
317243123,15,3,2,1,21
317265831,19,43,2,7,71
317266955,138,38,87,83,346
317280943,51,70,14,42,177
317282789,118,23,3,19,163
317290497,58,36,2,1,97
317296676,69,48,2,5,124
317299520,93,18,82,9,202
317304544,243,30,56,38,367
317305947,45,15,80,2,142
317310428,80,7,2,8,97
317312518,45,49,5,2,101
317318588,75,3,2,1,81
317330801,121,28,7,6,162
317341007,59,19,2,1,81
317346892,47,3,2,3,55
317369485,132,41,35,4,212
317371994,160,7,19,17,203
317376832,85,6,5,1,97
317380375,14,4,9,1,28
317385764,41,36,2,1,80
317385903,192,7,48,3,250
317387021,116,20,2,1,139
317389367,30,9,66,5,110
317390426,109,3,2,4,118
317396251,24,20,2,4,50
317400749,15,50,2,1,68
317400961,18,46,9,1,74
317409026,25,14,3,1,43
317421502,144,3,2,10,159
317431309,38,4,2,1,45
317435533,26,19,3,4,52
317447740,48,65,71,51,235
317454407,93,3,2,1,99
317460283,19,4,2,1,26
317464729,62,28,25,1,116
317490950,38,8,36,1,83
317498292,18,3,2,2,25
317516543,52,44,47,2,145
317527249,48,16,2,14,80
317530525,110,4,6,1,121
317535095,42,25,8,1,76
317555406,19,3,2,1,25
317565432,124,21,83,2,230
317581152,12,3,2,1,18
317609642,11,12,2,1,26
317621372,55,3,2,1,61
317625363,22,24,2,1,49
317641230,19,23,12,9,63
317648741,12,3,2,1,18
317649258,16,8,2,3,29
317673561,71,21,58,2,152
317674812,11,3,2,1,17
317677373,79,23,57,17,176
317713958,76,88,55,27,246
317717069,83,11,2,6,102
317721400,73,3,2,1,79
317724647,12,7,2,2,23
317725537,10,13,2,1,26
317743930,149,4,2,3,158
317765199,35,16,2,9,62
317765510,21,3,2,3,29
317766148,27,28,27,2,84
317771356,54,3,2,1,60
317773390,146,3,2,1,152
317779842,107,48,59,7,221
317786515,37,27,3,7,74
317789622,54,10,14,11,89
317806547,14,3,2,4,23
317812014,84,3,36,1,124
317820250,46,26,38,16,126
317836054,101,4,2,2,109
317854235,10,3,2,2,17
317874309,143,3,2,3,151
317882465,21,15,3,1,40
317892685,56,3,2,1,62
317923030,77,15,5,1,98
317927161,16,30,4,2,52
317930673,33,3,2,1,39
317930964,47,27,10,31,115
317936361,169,3,2,1,175
317938586,45,3,2,8,58
317962126,48,37,2,1,88
317985856,58,123,36,17,234
317998709,77,3,2,1,83
318007720,20,10,2,1,33
318020458,69,3,2,1,75
318029273,13,3,2,3,21
318032953,119,10,6,8,143
318034355,34,13,2,1,50
318036552,176,3,2,22,203
318039843,113,3,2,1,119
318040403,15,3,2,1,21
318043229,22,83,2,1,108
318065667,10,5,2,1,18
318069582,72,97,18,3,190
318069930,25,9,3,1,38
318071483,144,8,3,1,156
318079288,17,20,2,1,40
318087367,117,3,2,9,131
318092717,45,12,2,1,60
318093529,23,7,3,6,39
318111820,27,3,2,1,33
318115090,51,34,2,3,90
318116104,10,7,2,1,20
318131996,39,31,20,9,99
318134437,134,3,2,1,140
318138241,34,3,2,1,40
318148805,156,28,11,14,209
318175802,19,5,2,2,28
318191185,11,18,2,1,32
318193309,89,28,8,1,126
318202939,51,3,2,3,59
318209304,12,3,2,1,18
318209456,11,3,2,3,19
318213724,12,5,2,1,20
318217307,54,50,48,1,153
318234745,66,23,11,2,102
318239191,42,12,11,1,66
318241685,40,15,22,88,165
318265411,25,3,2,1,31
318276330,168,32,18,44,262
318283192,39,53,35,39,166
318285832,79,3,2,16,100
318289699,34,3,2,6,45
318290183,47,12,2,7,68
318313782,47,22,2,7,78
318314828,99,10,2,3,114
318323390,49,23,37,3,112
318341249,52,18,59,2,131
318351915,133,5,3,9,150
318368310,61,3,2,1,67
318396570,48,3,2,1,54
318400064,16,3,2,1,22
318401776,25,3,2,1,31
318409195,74,3,2,12,91
318409204,53,43,60,32,188
318411628,74,18,2,1,95
318431342,64,34,2,1,101
318432459,74,8,2,2,86
318437792,44,19,2,9,74
318456516,27,15,2,1,45
318462668,2195,3,2,7,2207
318463602,13,3,2,1,19
318490317,79,20,2,3,104
318493742,20,3,2,1,26
318496939,25,9,2,5,41
318505813,139,29,2,3,173
318523396,21,7,3,1,32
318529604,57,37,28,101,223
318538359,38,74,86,1,199
318552390,51,10,2,1,64
318578156,187,21,2,1,211
318584811,26,34,51,3,114
318597445,74,24,2,1,101
318613076,151,26,3,2,182
318623170,76,25,39,67,207
318625751,14,3,2,1,20
318646109,49,48,35,1,133
318681414,132,36,35,48,251
318681575,61,46,11,3,121
318714957,62,10,2,4,78
318715271,16,3,2,1,22
318721654,37,17,14,8,76
318723501,53,46,39,30,168
318723962,66,41,18,26,151
318736871,84,37,27,2,150
318737367,215,80,2,1,298
318767834,93,3,2,3,101
318777490,35,33,3,7,78
318781376,89,35,18,9,151
318814113,92,13,26,1,132
318818360,22,3,2,1,28
318839669,44,16,7,1,68
318840875,19,35,2,2,58
318847727,83,3,2,1,89
318850597,88,3,2,1,94
318860184,63,17,68,23,171
318862244,56,60,30,8,154
318864466,110,3,2,6,121
318870932,38,15,2,9,64
318878630,78,18,31,13,140
318925911,182,34,2,1,219
318942332,31,31,2,1,65
318948947,11,6,2,1,20
318950894,138,35,2,1,176
318955609,11,3,2,1,17
318969171,75,17,2,15,109
318975906,129,3,2,29,163
318976268,79,3,2,1,85
318983501,363,3,2,4,372
318988415,56,3,2,3,64
318995302,149,54,2,1,206
319001717,74,13,22,1,110
319011921,92,7,2,18,119
319023954,64,10,6,3,83
319036274,35,3,2,1,41
319054190,69,3,2,1,75
319056858,31,30,10,1,72
319094395,52,3,2,2,59
319101613,137,112,2,10,261
319135115,12,3,2,1,18
319140343,33,23,6,9,71
319144128,15,3,2,1,21
319147644,54,3,2,1,60
319156736,23,14,3,13,53
319161738,12,3,2,1,18
319189910,66,10,62,43,181
319211262,42,37,41,8,128
319218470,12,6,2,1,21
319220552,11,17,2,1,31
319229022,32,29,23,24,108
319238174,18,11,2,1,32
319241989,119,10,2,1,132
319246791,11,3,2,1,17
319254015,325,3,2,9,339
319263949,18,77,2,7,104
319270098,63,29,17,28,137
319274466,10,13,2,1,26
319276960,51,3,2,9,65
319293305,106,20,37,7,170
319304365,122,12,6,4,144
319306378,171,3,2,2,178
319321146,18,3,2,1,24
319336368,33,46,2,1,82
319357956,28,9,2,1,40
319363477,37,65,2,2,106
319372154,33,31,11,4,79
319373643,44,27,2,1,74
319377186,55,13,3,4,75
319389987,31,8,2,1,42
319392652,42,3,2,1,48
319400894,62,3,2,1,68
319410877,22,3,2,1,28
319426063,19,3,2,1,25
319473591,113,3,5,2,123
319475108,84,33,29,16,162
319499007,20,18,2,4,44
319513027,89,10,89,7,195
319517537,19,12,5,2,38
319523393,18,3,2,10,33
319526690,41,3,2,1,47
319546742,85,49,2,1,137
319564198,45,13,30,11,99
319568922,59,3,2,22,86
319574845,69,20,2,4,95
319575833,46,3,2,1,52
319588510,93,11,53,8,165
319616555,92,8,6,43,149
319623654,81,6,2,1,90
319640795,97,4,2,1,104
319642007,15,3,2,2,22
319656469,42,22,2,6,72
319657223,98,3,2,1,104
319658798,99,26,53,15,193
319673383,58,23,70,4,155
319680072,82,21,67,3,173
319680758,11,3,2,1,17
319714052,37,22,2,5,66
319714323,18,3,2,1,24
319720584,13,7,2,1,23
319721843,32,57,2,5,96
319728429,103,24,9,12,148
319736674,87,12,19,1,119
319736688,48,23,9,5,85
319755337,22,20,2,16,60
319758353,201,22,5,1,229
319765855,131,3,2,2,138
319770735,26,27,23,3,79
319774241,26,35,66,1,128
319790128,86,8,2,4,100
319798262,11,3,2,1,17
319803514,24,34,2,2,62
319804799,101,26,7,2,136
319808341,89,19,2,2,112
319818496,12,4,2,8,26
319825250,118,25,2,2,147
319830095,26,36,2,2,66
319849949,61,35,2,2,100
319854768,43,3,2,1,49
319867171,183,4,7,1,195
319873036,44,21,103,6,174
319873040,19,11,2,1,33
319905474,39,41,8,7,95
319906754,27,9,2,1,39
319912734,10,13,2,1,26
319922736,91,3,2,1,97
319929698,10,7,2,1,20
319934788,37,10,26,5,78
319974219,13,3,2,1,19
319983733,98,35,38,3,174
319999236,60,32,29,61,182
320001728,12,10,2,1,25
320008033,17,3,2,1,23
320014202,75,18,65,2,160
320022027,98,25,4,24,151
320027813,44,60,28,13,145
320032245,10,15,2,1,28
320064539,12,8,2,8,30
320076491,52,3,2,1,58
320090143,164,3,2,101,270
320101251,227,3,2,1,233
320106974,116,7,8,1,132
320107229,77,30,87,2,196
320108794,23,3,2,1,29
320112923,86,60,25,63,234
320118737,22,51,2,10,85
320132512,49,14,16,19,98
320133970,29,39,3,2,73
320139655,67,26,3,6,102
320181620,56,102,2,3,163
320182897,14,4,2,6,26
320184378,56,3,2,1,62
320185115,375,3,2,5,385
320199712,23,24,2,1,50
320200847,29,3,2,1,35
320231589,36,17,2,1,56
320237954,17,3,2,1,23
320242866,33,10,2,1,46
320275106,138,60,37,20,255
320304071,103,72,23,1,199
320317384,142,93,2,20,257
320317845,67,16,2,1,86
320318782,70,39,11,2,122
320324411,16,15,19,4,54
320326824,53,10,2,1,66
320327338,37,106,24,11,178
320332105,10,3,2,3,18
320332579,13,7,2,1,23
320344296,56,4,3,1,64
320362479,13,3,2,1,19
320381619,107,4,2,9,122
320395547,16,3,2,1,22
320399304,12,4,2,1,19
320414834,109,44,32,70,255
320429220,120,41,35,9,205
320432840,17,3,2,9,31
320436099,55,3,2,1,61
320450221,147,92,59,10,308
320451002,58,21,6,10,95
320452322,149,17,2,23,191
320456858,222,3,2,1,228
320483202,16,3,2,1,22
320492120,10,5,2,2,19
320502574,68,64,157,2,291
320520346,10,14,2,1,27
320531517,20,6,2,1,29
320539008,71,16,20,1,108
320541185,46,3,2,1,52
320556031,28,44,6,7,85
320557185,106,21,33,1,161
320558979,13,41,2,4,60
320566130,12,3,2,3,20
320569631,40,3,17,1,61
320583112,17,33,14,25,89
320584282,54,3,2,3,62
320589081,90,3,2,5,100
320601904,20,3,2,1,26
320605047,146,22,36,8,212
320621021,53,5,28,5,91
320623529,18,3,2,1,24
320625417,41,41,13,3,98
320640667,70,14,2,12,98
320644611,71,28,125,39,263
320655317,21,3,2,1,27
320673243,131,8,2,1,142
320682495,52,32,13,6,103
320690955,82,23,4,19,128
320704373,66,18,2,12,98
320705368,204,27,45,9,285
320712588,256,41,3,1,301
320714859,46,20,4,5,75
320729943,60,32,27,81,200
320734427,87,3,2,10,102
320748367,31,16,2,12,61
320756350,84,20,18,2,124
320783083,18,13,2,3,36
320789453,107,3,2,1,113
320791214,103,55,63,17,238
320806893,61,10,2,3,76
320810013,37,17,2,1,57
320843093,46,3,2,1,52
320845319,14,3,2,1,20
320846376,42,33,2,9,86
320855800,21,9,3,1,34
320859007,57,32,31,16,136
320864392,20,3,2,1,26
320866313,21,23,13,2,59
320873350,119,27,3,17,166
320875965,18,3,2,2,25
320898270,23,39,6,15,83
320898868,21,3,2,1,27
320905789,18,3,2,1,24
320914679,50,21,4,4,79
320925960,28,19,39,22,108
320939256,31,74,3,2,110
320939466,17,31,18,1,67
320941703,11,3,2,1,17
320950727,88,3,2,3,96
320957013,38,18,39,15,110
320974847,10,32,2,3,47
320986713,78,25,9,17,129
320995800,105,109,41,1,256
320997738,22,7,2,5,36
320997846,27,30,25,6,88
321000863,41,15,17,2,75
321004378,83,3,2,69,157
321013271,106,27,2,3,138
321023271,53,12,2,22,89
321030005,190,59,13,42,304
321032034,132,71,134,7,344
321037347,84,58,2,1,145
321043119,14,3,2,1,20
321044594,187,29,5,1,222
321051704,162,3,2,44,211
321053400,10,4,2,7,23
321064292,72,39,2,1,114
321074324,59,40,5,1,105
321092739,170,72,4,11,257
321098893,74,4,3,1,82
321100183,26,3,2,1,32
321101237,40,17,76,21,154
321113190,41,28,2,1,72
321138864,50,13,2,2,67
321149154,22,3,2,1,28
321153464,22,13,2,3,40
321160331,67,26,36,8,137
321171796,18,3,2,1,24
321176796,54,37,2,2,95
321179401,12,5,2,1,20
321184545,128,3,2,1,134
321193304,14,3,2,5,24
321204090,208,19,87,2,316
321217037,105,38,9,1,153
321224596,95,11,49,30,185
321226089,111,60,38,33,242
321234047,19,13,8,1,41
321234524,69,7,3,18,97
321239158,40,3,2,1,46
321267291,13,4,2,4,23
321267379,62,44,15,8,129
321284278,45,14,11,15,85
321307147,84,50,81,1,216
321307324,197,30,42,22,291
321307985,34,38,41,1,114
321317501,22,92,8,4,126
321329473,54,3,2,7,66
321342044,13,3,2,2,20
321348523,104,41,23,1,169
321368287,73,36,10,15,134
321369625,10,4,2,6,22
321374972,103,55,85,3,246
321379304,84,64,24,11,183
321390828,266,3,2,16,287
321392252,63,20,8,1,92
321439961,213,21,47,32,313
321444406,110,3,2,3,118
321478996,128,33,2,2,165
321512941,28,22,10,2,62
321516019,39,24,2,8,73
321526210,17,3,2,1,23
321533543,15,13,2,1,31
321545151,78,6,14,5,103
321555367,38,15,9,6,68
321563433,68,22,7,5,102
321577339,150,40,7,11,208
321586926,74,78,39,1,192
321588391,36,19,2,2,59
321590081,12,12,2,1,27
321592587,21,3,2,1,27
321593543,46,43,17,38,144
321597977,52,3,2,1,58
321604946,82,13,3,1,99
321618838,115,64,25,10,214
321658729,42,13,24,3,82
321660681,22,13,2,1,38
321668191,123,55,8,2,188
321669822,83,20,2,8,113
321676283,64,30,36,1,131
321682390,83,42,5,1,131
321682748,90,21,20,1,132
321686328,62,3,2,5,72
321688577,95,27,110,16,248
321716840,239,3,2,24,268
321730595,10,50,2,1,63
321749905,15,29,2,1,47
321755038,71,14,2,1,88
321769393,90,3,2,1,96
321786755,25,19,68,1,113
321793614,14,49,9,1,73
321794212,21,5,2,1,29
321794947,44,22,40,2,108
321800636,95,45,26,4,170
321802943,69,59,21,2,151
321803304,53,24,23,9,109
321805413,640,10,2,64,716
321812378,14,3,2,1,20
321823877,51,52,17,7,127
321824323,28,3,2,4,37
321826018,82,28,59,20,189
321827575,37,17,14,2,70
321846116,126,4,2,1,133
321857251,154,3,2,4,163
321867590,35,3,2,1,41
321868744,16,3,2,3,24
321871251,34,4,26,1,65
321872804,19,3,2,3,27
321873410,172,29,11,1,213
321884610,60,28,44,1,133
321885998,24,3,2,1,30
321887152,44,24,2,1,71
321895690,151,75,2,44,272
321897711,33,18,2,1,54
321905638,38,18,11,26,93
321909591,55,23,2,2,82
321919841,44,28,13,3,88
321931664,13,29,3,1,46
321936390,71,46,16,82,215
321950547,15,33,60,37,145
321962714,36,111,29,8,184
321970634,17,8,2,1,28
321987376,34,19,10,11,74
321994579,141,22,8,7,178
321995337,16,3,2,3,24
322020848,154,25,15,38,232
322020863,62,16,3,66,147
322028349,26,3,2,1,32
322032163,37,11,8,1,57
322032699,94,10,6,3,113
322059292,73,37,6,15,131
322061487,14,3,2,1,20
322063910,60,30,2,1,93
322069680,46,17,2,1,66
322099204,35,3,2,3,43
322103270,22,6,2,11,41
322112056,34,102,14,5,155
322121731,76,3,2,5,86
322160039,47,29,21,5,102
322167683,157,35,2,11,205
322170704,49,64,2,2,117
322185748,288,3,2,1,294
322186369,27,18,10,3,58
322197871,182,15,2,2,201
322199157,56,28,5,26,115
322208212,48,3,2,1,54
322217981,36,3,2,2,43
322219264,71,40,35,3,149
322220396,35,40,7,3,85
322246325,88,3,2,10,103
322252384,81,45,40,26,192
322264222,14,15,2,1,32
322274164,26,12,2,3,43
322288393,19,15,4,4,42
322288611,24,79,5,15,123
322298476,13,12,2,1,28
322308660,17,3,2,2,24
322320159,126,29,6,5,166
322331522,22,28,27,1,78
322333606,15,3,2,1,21
322347385,100,18,11,6,135
322389626,37,62,4,36,139
322390274,64,42,2,21,129
322401622,13,3,2,1,19
322407709,40,3,2,4,49
322410125,41,3,2,5,51
322423125,35,35,6,31,107
322429666,20,3,2,1,26
322431164,44,3,2,1,50
322433020,111,3,2,2,118
322464849,37,3,2,1,43
322465890,14,3,2,1,20
322469207,24,9,2,1,36
322470023,12,14,2,1,29
322472874,41,44,4,6,95
322475501,238,62,24,6,330
322477685,71,9,2,1,83
322484127,64,14,14,1,93
322492831,59,27,5,14,105
322496514,36,43,15,4,98
322498921,19,13,2,1,35
322514146,47,25,23,1,96
322517425,17,3,2,1,23
322521753,36,26,5,1,68
322523603,196,54,10,6,266
322526849,52,26,7,5,90
322531080,57,3,2,1,63
322536864,88,16,2,4,110
322544593,77,15,23,6,121
322561065,25,17,2,1,45
322572901,49,26,2,2,79
322575392,41,3,2,1,47
322577181,25,30,2,3,60
322591428,24,36,6,1,67
322594634,37,8,2,1,48
322596249,34,3,2,1,40
322608028,124,12,7,9,152
322615043,22,10,5,7,44
322636622,49,36,11,1,97
322636761,354,3,2,1,360
322639655,32,3,2,1,38
322645889,48,35,2,3,88
322657405,85,56,48,6,195
322667564,44,24,2,4,74
322696052,85,3,2,1,91
322697994,67,31,65,1,164
322713761,15,3,2,1,21
322714478,252,19,32,2,305
322724241,11,26,2,1,40
322741233,35,32,27,10,104
322744409,134,15,2,45,196
322758859,112,5,46,4,167
322768009,135,11,42,4,192
322768178,49,9,10,7,75
322791821,151,3,2,10,166
322797764,97,6,112,13,228
322798373,143,3,2,2,150
322804222,96,32,9,10,147
322805669,22,66,2,2,92
322840588,26,6,2,1,35
322849417,12,3,2,1,18
322849685,197,3,2,1,203
322853163,25,13,30,10,78
322865089,24,21,9,8,62
322875085,100,7,2,2,111
322876822,79,4,2,1,86
322882692,44,3,2,1,50
322899734,22,14,3,3,42
322920990,97,43,14,9,163
322926668,32,38,49,1,120
322945899,27,11,18,3,59
322948530,168,26,17,27,238
322949802,27,14,22,4,67
322978383,113,24,55,10,202
322986883,122,3,2,2,129
322994290,74,74,30,6,184
323000542,190,10,14,23,237
323005079,26,3,2,1,32
323016038,20,9,2,4,35
323034419,23,25,2,1,51
323047954,291,3,2,8,304
323053253,16,3,2,1,22
323059794,431,4,4,12,451
323079727,35,3,2,1,41
323084082,81,15,3,1,100
323088638,32,3,2,1,38
323098306,27,3,2,1,33
323101144,103,17,2,1,123
323109414,126,75,8,1,210
323124054,338,3,2,13,356
323162054,205,10,138,19,372
323166116,38,29,2,1,70
323167178,12,6,2,1,21
323177769,36,5,2,1,44
323179624,11,3,2,1,17
323183746,18,5,2,1,26
323186744,26,113,13,1,153
323187778,49,71,4,1,125
323192764,63,3,2,1,69
323194575,93,11,2,5,111
323202681,12,10,2,1,25
323208880,141,62,109,4,316
323210166,91,27,2,3,123
323226585,25,13,2,1,41
323247270,123,93,2,21,239
323268251,189,16,26,2,233
323270033,74,3,2,1,80
323277564,37,95,48,8,188
323280445,90,3,5,1,99
323286893,165,15,6,8,194
323306780,15,5,2,7,29
323308285,19,3,2,1,25
323319444,15,16,2,1,34
323324160,16,9,2,2,29
323334365,29,3,2,1,35
323338304,167,75,27,36,305
323361056,45,3,2,2,52
323362560,26,3,2,2,33
323364669,89,14,45,30,178
323366693,20,32,10,3,65
323373094,121,3,2,12,138
323391965,44,14,5,15,78
323397238,53,57,39,15,164
323398031,21,60,17,1,99
323407044,16,28,2,4,50
323408598,50,3,2,1,56
323415391,80,49,139,11,279
323446913,30,3,2,2,37
323452157,10,4,2,1,17
323458624,75,52,33,8,168
323461382,160,3,2,1,166
323461441,18,8,3,3,32
323466742,108,14,2,7,131
323484238,16,3,2,1,22
323484245,66,61,20,1,148
323484292,77,23,3,7,110
323499114,39,62,5,19,125
323500506,134,32,44,41,251
323500933,42,26,2,7,77
323504005,23,20,8,1,52
323506247,33,3,2,2,40
323517386,31,3,2,1,37
323525757,82,3,2,2,89
323532449,36,3,2,1,42
323545416,89,3,2,1,95
323550594,143,7,2,1,153
323550986,49,3,2,1,55
323556097,42,50,6,3,101
323558962,157,77,51,13,298
323571047,11,3,2,1,17
323577837,10,5,2,3,20
323584670,52,22,2,1,77
323591956,70,17,25,9,121
323606240,79,12,21,14,126
323633864,63,3,2,2,70
323639771,93,20,51,1,165
323645395,11,3,2,1,17
323652312,143,35,6,2,186
323658338,10,3,2,2,17
323661639,114,4,12,19,149
323666299,139,4,2,16,161
323668087,14,3,2,1,20
323678150,45,43,10,3,101
323701832,24,43,3,3,73
323705011,95,11,78,2,186
323706601,95,26,2,2,125
323748015,167,25,4,24,220
323755788,12,14,2,2,30
323767960,88,14,10,33,145
323777424,51,3,2,17,73
323780846,27,16,3,2,48
323783178,56,3,2,6,67
323788051,84,16,2,1,103
323799235,34,21,55,21,131
323799537,35,3,2,1,41
323823178,68,60,29,1,158
323838576,109,28,35,3,175
323846238,138,6,109,1,254
323872333,82,16,2,3,103
323882064,43,3,2,1,49
323887412,74,3,2,3,82
323894951,23,3,2,14,42
323898993,232,16,18,37,303
323912849,172,25,34,5,236
323955101,91,54,3,13,161
323956237,21,3,2,1,27
323958548,14,8,2,12,36
323959407,17,3,2,1,23
323962721,88,6,14,1,109
323969013,73,32,3,10,118
323989244,57,8,2,1,68
323993212,21,3,2,1,27
323996075,63,23,3,6,95
323998038,10,10,2,1,23
324005636,45,4,2,1,52
324008272,126,21,36,3,186
324022185,52,55,37,15,159
324032831,26,3,2,2,33
324054815,90,3,2,1,96
324056439,13,3,2,2,20
324086046,24,16,2,1,43
324097363,55,3,2,3,63
324103246,198,20,2,68,288
324107932,13,3,2,4,22
324113158,23,22,2,1,48
324113880,45,31,4,10,90
324123575,19,3,2,1,25
324144012,65,3,16,4,88
324144174,13,3,2,1,19
324162377,30,84,33,9,156
324162390,85,51,16,1,153
324170286,11,3,2,1,17
324172884,406,43,2,7,458
324177927,581,3,2,2,588
324178153,116,17,16,14,163
324180583,96,6,19,16,137
324181472,32,3,2,1,38
324183308,85,15,6,1,107
324191648,128,73,114,33,348
324193479,102,3,2,1,108
324195741,33,4,2,8,47
324200072,59,18,66,5,148
324221079,11,3,2,1,17
324245252,61,26,17,17,121
324255902,10,3,2,2,17
324265305,51,3,2,1,57
324275131,115,36,41,3,195
324277768,32,21,2,10,65
324278648,46,13,2,1,62
324297269,82,50,34,6,172
324301594,91,20,2,1,114
324310278,60,64,2,1,127
324310867,304,3,2,4,313
324342731,10,5,2,3,20
324368081,127,42,80,27,276
324383583,30,39,32,7,108
324392729,196,3,2,1,202
324412766,39,3,2,1,45
324414184,21,3,2,4,30
324441732,45,90,11,3,149
324445562,103,18,30,18,169
324450691,30,9,2,2,43
324460338,13,3,2,1,19
324468727,11,13,2,1,27
324473725,68,74,65,1,208
324477435,140,36,2,2,180
324483703,28,4,9,4,45
324494328,96,16,2,9,123
324501547,35,26,5,3,69
324512935,59,17,3,2,81
324549171,70,5,57,1,133
324549613,29,17,2,1,49
324552204,24,3,2,1,30
324574521,52,20,14,4,90
324575023,110,20,32,57,219
324579630,280,3,2,2,287
324598780,26,5,4,1,36
324598893,104,6,7,1,118
324602657,13,3,2,1,19
324611667,23,83,15,30,151
324613809,61,24,25,2,112
324619353,99,35,35,17,186
324640614,41,3,2,7,53
324648427,51,17,20,2,90
324659142,75,3,2,3,83
324678383,65,35,2,8,110
324681466,89,7,2,1,99
324682540,10,5,2,1,18
324687072,108,6,2,7,123
324688375,20,10,16,9,55
324689812,75,5,3,1,84
324693156,72,10,2,10,94
324694810,66,20,2,1,89
324698864,42,15,2,15,74
324711696,65,28,32,13,138
324713895,53,6,29,24,112
324717254,21,20,11,1,53
324720388,20,26,10,2,58
324731074,30,20,2,2,54
324745711,82,5,8,8,103
324749558,107,22,6,10,145
324756802,13,16,2,1,32
324775558,130,13,2,1,146
324781712,28,11,4,4,47
324803051,104,23,22,3,152
324808844,96,28,11,12,147
324812706,83,34,48,18,183
324813461,67,32,10,1,110
324816654,109,76,87,11,283
324829988,181,15,5,3,204
324830019,355,3,2,1,361
324835574,132,59,3,6,200
324836456,105,3,2,1,111
324836753,76,3,2,30,111
324839508,83,16,55,9,163
324871430,20,3,2,1,26
324895866,51,53,32,29,165
324907118,87,3,2,18,110
324908641,97,3,2,8,110
324913651,129,5,2,5,141
324918982,128,18,2,10,158
324924099,57,3,2,1,63
324933972,189,63,100,16,368
324935428,20,3,2,2,27
324939620,32,3,2,1,38
324939901,38,42,17,2,99
324940593,131,3,2,5,141
324958538,78,11,2,1,92
324972833,46,3,2,10,61
324975790,59,40,2,20,121
324980556,33,3,2,1,39
324987136,85,3,2,1,91
324988586,211,3,2,1,217
325007303,53,28,2,22,105
325013930,117,71,17,40,245
325029773,112,40,69,1,222
325036517,79,36,2,3,120
325036608,26,65,12,12,115
325040015,18,19,2,1,40
325042118,101,33,2,6,142
325044612,53,16,32,6,107
325044977,238,15,3,2,258
325046258,65,3,2,5,75
325048063,216,30,2,19,267
325050233,32,45,23,6,106
325057253,45,29,57,65,196
325057314,54,67,61,3,185
325072292,139,19,18,11,187
325079931,12,42,7,1,62
325082576,128,6,2,1,137
325087030,60,12,5,1,78
325102741,57,3,2,2,64
325107569,134,20,2,7,163
325137666,11,3,2,1,17
325139911,26,3,2,1,32
325142390,153,38,36,1,228
325179055,39,36,7,4,86
325179779,68,43,2,4,117
325186498,61,22,3,1,87
325189338,10,3,2,3,18
325189688,81,10,12,12,115
325199114,30,57,2,1,90
325214951,149,3,2,4,158
325216428,99,62,58,17,236
325223836,69,31,10,23,133
325240470,204,44,31,12,291
325257973,91,50,19,3,163
325283495,114,13,2,2,131
325284890,289,44,2,1,336
325289019,840,12,2,7,861
325292214,12,10,2,1,25
325313697,104,3,2,7,116
325318366,165,3,2,1,171
325336959,10,3,2,2,17
325344271,23,3,2,1,29
325358368,28,8,2,1,39
325368169,101,30,34,11,176
325370900,21,3,2,1,27
325380280,54,17,2,4,77
325383129,56,13,2,2,73
325387322,84,29,49,1,163
325400459,21,24,2,1,48
325425590,157,28,9,1,195
325425940,62,3,2,2,69
325431333,93,6,53,1,153
325446539,109,16,92,13,230
325447736,26,3,2,1,32
325454238,11,4,2,2,19
325460788,19,3,2,1,25
325462965,20,3,2,4,29
325474861,14,3,2,3,22
325477929,184,7,10,50,251
325486120,71,16,14,22,123
325489640,67,3,2,4,76
325496194,20,24,5,1,50
325508982,75,19,20,13,127
325509654,60,6,2,1,69
325511827,136,3,2,1,142
325542623,75,26,33,6,140
325544704,24,3,2,4,33
325567424,50,6,101,2,159
325587566,60,6,2,3,71
325598843,59,47,3,1,110
325600466,33,26,2,1,62
325601229,14,11,5,13,43
325604354,121,16,27,10,174
325613320,121,24,63,10,218
325614303,33,30,2,1,66
325628465,53,3,2,1,59
325641222,70,9,75,10,164
325643443,17,3,2,4,26
325645468,74,39,59,8,180
325657507,12,22,2,1,37
325696068,38,3,2,1,44
325709218,135,42,3,4,184
325723432,10,19,2,2,33
325752547,130,45,2,2,179
325753259,74,3,2,1,80
325764768,48,21,55,13,137
325767887,86,15,2,3,106
325784567,132,117,2,5,256
325788033,60,15,2,19,96
325789717,45,44,52,10,151
325822896,20,3,2,1,26
325824618,44,39,6,1,90
325840660,27,32,23,1,83
325856020,39,7,2,9,57
325860139,39,26,2,2,69
325866262,16,3,2,1,22
325877779,22,57,2,1,82
325879524,57,34,2,1,94
325893517,107,3,2,1,113
325899979,22,8,2,1,33
325905542,26,25,2,2,55
325910772,10,20,2,1,33
325911079,17,54,2,1,74
325917751,30,6,2,1,39
325921336,11,9,2,1,23
325931698,20,10,8,4,42
325932085,38,14,2,1,55
325932619,17,3,2,1,23
325943346,77,31,2,1,111
325956279,189,33,8,3,233
325969416,131,17,2,12,162
325980356,11,3,2,1,17
325997591,165,22,32,27,246
326000962,40,3,2,9,54
326008289,44,16,51,2,113
326014252,34,75,5,41,155
326020150,67,3,2,1,73
326022392,63,5,8,3,79
326023918,16,3,2,1,22
326026153,26,3,2,1,32
326052285,11,3,2,1,17
326054451,44,5,7,1,57
326084189,98,8,5,18,129
326085228,149,49,50,2,250
326091600,16,3,2,1,22
326103592,169,66,40,21,296
326110471,11,4,2,1,18
326130457,42,89,13,8,152
326132093,11,25,2,1,39
326136253,153,62,35,1,251
326147117,174,26,101,5,306
326152782,35,53,26,9,123
326156692,38,77,5,1,121
326158498,30,55,2,1,88
326158961,13,3,2,1,19
326164294,97,3,2,3,105
326167243,109,3,2,3,117
326175785,117,18,2,1,138
326178851,88,23,5,9,125
326182844,155,17,2,9,183
326183744,11,3,2,1,17
326186594,106,3,2,7,118
326188748,50,10,2,1,63
326190456,25,15,23,6,69
326204172,43,18,5,3,69
326205357,175,75,39,83,372
326214665,116,3,2,55,176
326220563,15,15,2,2,34
326221608,24,16,2,1,43
326223392,40,6,2,1,49
326228038,66,3,2,1,72
326234388,16,3,2,3,24
326251503,18,4,4,6,32
326254895,18,29,2,1,50
326268141,75,19,11,1,106
326274396,104,3,2,1,110
326278387,14,18,2,1,35
326306995,31,55,13,5,104
326324086,11,3,2,1,17
326326923,48,3,3,1,55
326338166,21,3,2,2,28
326345885,29,3,31,9,72
326364241,69,8,54,40,171
326376150,14,32,21,1,68
326387967,14,26,17,2,59
326403320,36,3,2,2,43
326408801,36,26,12,7,81
326411628,160,3,2,2,167
326414112,12,5,2,1,20
326420428,19,26,2,1,48
326424538,202,7,20,1,230
326425551,76,13,10,15,114
326426655,51,3,2,1,57
326431901,102,3,2,3,110
326435213,44,19,20,1,84
326439898,82,52,3,4,141
326443590,56,3,2,1,62
326468800,21,3,2,11,37
326496900,106,16,31,2,155
326507914,10,12,2,1,25
326512312,11,3,2,1,17
326517614,50,41,13,8,112
326527432,44,57,25,24,150
326527633,13,3,2,4,22
326544574,118,11,3,7,139
326552413,12,4,2,1,19
326563930,129,3,5,1,138
326569524,57,4,8,2,71
326579866,106,77,10,11,204
326586222,85,56,20,61,222
326592061,36,41,3,1,81
326594969,10,8,2,1,21
326612791,150,73,14,14,251
326623045,50,3,2,1,56
326627949,61,20,10,12,103
326634395,72,17,19,3,111
326641617,10,9,2,1,22
326642177,32,9,2,1,44
326660411,132,35,45,10,222
326675177,215,25,11,4,255
326680734,36,3,2,1,42
326682621,88,12,6,2,108
326684278,202,25,6,3,236
326700173,43,41,2,1,87
326702991,49,11,2,7,69
326713898,11,3,2,1,17
326716761,69,58,12,24,163
326720939,46,23,3,4,76
326737152,99,23,14,4,140
326756873,37,29,4,3,73
326758453,29,3,2,4,38
326769705,103,26,22,43,194
326776524,151,29,2,5,187
326789895,32,15,5,1,53
326806632,36,25,2,5,68
326807887,97,25,2,14,138
326810032,230,3,2,100,335
326812783,10,12,2,1,25
326813837,53,3,2,5,63
326817891,82,33,57,47,219
326822949,10,3,2,9,24
326831545,41,3,2,1,47
326839706,98,3,2,4,107
326842710,105,22,2,1,130
326875269,21,3,2,1,27
326881291,83,3,2,6,94
326901002,61,3,2,7,73
326935040,64,50,31,18,163
326935131,56,25,2,1,84
326959838,102,8,2,3,115
326965354,79,56,2,4,141
326971404,10,21,3,1,35
326981883,66,41,2,2,111
326982647,11,3,2,1,17
326993720,21,22,2,2,47
326994260,140,21,2,1,164
327006114,10,3,2,2,17
327010515,172,38,2,6,218
327013092,191,30,2,1,224
327022311,103,33,30,4,170
327028830,13,3,2,1,19
327056284,63,13,36,24,136
327061218,314,25,22,3,364
327070254,57,22,2,1,82
327082575,16,3,2,2,23
327085725,108,16,2,2,128
327096751,11,25,2,1,39
327110219,72,14,2,9,97
327120000,156,26,12,1,195
327125438,39,44,105,2,190
327126475,57,32,90,9,188
327129100,124,8,25,8,165
327136053,20,3,2,1,26
327145130,18,3,2,1,24
327151331,81,59,63,34,237
327156020,10,4,4,2,20
327166661,10,4,2,1,17
327167793,15,16,3,2,36
327170082,26,101,19,2,148
327173135,11,3,2,1,17
327181459,105,27,18,3,153
327197992,93,3,2,1,99
327201181,21,22,2,1,46
327203645,78,56,23,35,192
327214509,103,30,38,3,174
327216716,140,6,35,1,182
327221317,63,3,2,5,73
327223457,85,14,6,6,111
327223960,92,58,3,5,158
327228524,11,3,2,1,17
327232754,13,9,15,11,48
327244201,19,3,2,1,25
327250501,69,14,12,14,109
327250756,13,13,2,1,29
327252095,69,60,12,12,153
327275764,86,22,9,34,151
327284445,19,34,2,3,58
327300304,14,3,2,1,20
327305296,77,10,15,12,114
327308502,224,26,2,6,258
327320418,135,22,25,17,199
327330056,53,71,2,7,133
327350985,10,4,2,1,17
327355434,255,20,3,61,339
327356858,52,26,2,24,104
327367361,189,29,66,20,304
327367821,79,11,3,9,102
327377289,21,3,2,3,29
327386857,83,59,63,5,210
327407794,59,11,2,2,74
327414953,109,23,2,1,135
327416711,57,23,2,1,83
327421091,14,6,2,1,23
327435360,40,37,30,1,108
327440674,11,3,2,1,17
327445875,10,17,6,1,34
327475369,6194,3,2,54,6253
327488580,57,3,2,1,63
327496564,120,37,2,6,165
327498393,442,3,2,1,448
327499463,88,18,25,15,146
327511951,76,25,37,4,142
327516475,72,21,5,1,99
327519314,45,57,7,2,111
327525144,65,29,3,4,101
327534230,378,29,21,1,429
327555352,29,3,2,8,42
327558067,39,29,2,1,71
327569388,15,3,2,1,21
327575126,19,3,2,3,27
327576414,32,3,2,4,41
327580587,82,4,2,1,89
327592457,39,11,2,14,66
327603469,24,78,2,3,107
327610323,11,3,2,1,17
327622987,155,30,19,17,221
327627706,29,4,31,4,68
327629776,85,3,2,1,91
327640745,23,44,7,2,76
327640771,72,29,3,13,117
327648601,48,40,17,1,106
327650239,21,15,5,1,42
327657234,60,18,23,4,105
327670631,20,3,2,1,26
327672161,17,37,9,6,69
327682723,19,18,7,8,52
327696398,22,19,7,14,62
327697379,43,87,13,11,154
327703735,36,3,2,1,42
327705130,67,19,2,1,89
327714009,61,11,4,4,80
327716949,79,19,2,1,101
327718760,16,3,2,3,24
327732405,20,42,49,1,112
327741795,60,3,2,1,66
327748192,160,16,50,13,239
327752971,66,23,6,32,127
327756196,29,14,2,1,46
327757292,20,3,2,1,26
327771848,58,3,2,1,64
327780430,44,3,2,1,50
327783495,12,3,2,1,18
327791026,100,29,58,35,222
327807565,115,3,2,2,122
327808779,98,15,10,10,133
327810221,47,25,2,1,75
327814287,39,78,39,22,178
327820170,59,68,4,10,141
327830081,174,20,25,3,222
327845801,52,33,2,6,93
327858769,14,8,2,1,25
327875710,61,5,3,4,73
327877691,111,10,2,12,135
327889419,11,3,2,1,17
327921843,24,3,2,1,30
327925221,44,22,3,2,71
327925651,99,4,2,3,108
327929509,49,40,18,10,117
327937698,101,5,5,2,113
327944642,151,3,3,1,158
327946911,14,24,2,1,41
327951830,59,3,2,8,72
327957899,27,39,2,1,69
327958391,70,59,2,1,132
327958918,10,3,2,2,17
327964245,106,126,27,21,280
327965930,67,10,2,14,93
327974365,12,3,2,1,18
327993758,45,3,3,1,52
328003166,11,3,2,1,17
328007080,82,135,2,10,229
328019179,59,24,10,15,108
328033750,25,19,18,1,63
328067439,24,3,2,1,30
328068949,535,3,2,8,548
328072714,10,7,4,3,24
328087316,31,77,3,2,113
328091493,16,3,2,1,22
328092852,119,24,11,2,156
328093973,39,17,8,2,66
328099310,120,3,2,1,126
328103760,13,6,2,1,22
328113182,13,8,2,1,24
328114501,34,14,2,10,60
328118907,136,3,2,4,145
328122810,14,5,2,5,26
328126122,111,42,32,11,196
328146317,118,17,43,6,184
328155082,88,27,2,1,118
328160786,30,73,21,1,125
328183668,49,38,22,18,127
328199433,13,7,2,1,23
328201575,84,3,2,4,93
328202226,91,42,31,49,213
328210495,81,23,12,11,127
328217938,16,3,3,1,23
328228131,13,3,2,1,19
328230487,81,3,10,16,110
328232131,30,5,2,1,38
328240897,47,3,2,2,54
328245208,39,3,2,1,45
328246060,145,45,38,13,241
328255854,48,46,32,3,129
328262328,30,14,7,1,52
328274033,23,55,4,10,92
328275332,22,3,2,1,28
328297663,61,28,2,1,92
328300513,85,53,8,60,206
328309181,95,3,2,1,101
328313789,99,9,7,1,116
328323214,70,34,21,27,152
328334667,92,28,18,16,154
328340512,28,4,2,1,35
328340522,73,15,26,19,133
328355687,50,3,2,2,57
328358370,70,31,2,3,106
328361275,89,18,11,3,121
328367908,88,4,61,29,182
328368776,55,30,2,6,93
328374721,53,39,18,2,112
328384123,48,3,2,5,58
328387861,96,9,37,7,149
328390245,14,3,2,1,20
328397912,75,14,2,1,92
328408310,15,13,3,3,34
328413297,84,11,49,24,168
328419336,14,10,2,3,29
328424726,93,25,13,14,145
328425056,22,76,5,2,105
328425597,142,17,75,35,269
328432265,166,17,2,3,188
328432372,46,17,2,8,73
328438682,30,3,2,3,38
328454860,13,46,2,1,62
328471510,76,5,48,5,134
328473864,141,3,8,3,155
328479380,60,3,2,1,66
328480357,67,36,18,4,125
328490693,53,60,17,5,135
328508234,113,8,10,13,144
328510613,64,49,12,20,145
328516537,145,3,2,7,157
328524428,43,3,2,3,51
328538792,100,40,24,9,173
328539094,27,18,2,8,55
328555459,106,25,4,3,138
328559577,12,3,2,2,19
328586598,37,58,33,3,131
328587286,44,19,22,1,86
328603207,13,3,2,2,20
328636410,101,4,3,1,109
328641032,58,50,4,2,114
328644783,110,3,2,2,117
328646233,57,50,3,2,112
328652920,84,3,2,3,92
328657744,14,3,2,3,22
328662586,88,69,15,20,192
328686940,51,45,27,1,124
328687534,29,25,2,10,66
328696254,32,20,2,1,55
328698706,333,41,2,14,390
328700117,20,17,2,1,40
328703286,90,3,2,12,107
328717532,41,3,2,1,47
328737821,235,3,2,6,246
328747774,50,11,2,7,70
328763537,69,3,2,1,75
328764000,48,36,19,31,134
328771936,10,4,2,1,17
328776451,14,6,2,4,26
328784279,19,4,10,1,34
328798825,54,3,2,1,60
328799531,149,22,29,16,216
328804811,12,15,2,2,31
328809288,95,36,6,38,175
328809482,58,3,8,1,70
328812302,703,3,2,223,931
328827032,101,3,2,4,110
328833173,130,39,65,6,240
328868002,49,46,32,13,140
328870382,22,3,2,3,30
328875242,118,23,33,9,183
328897778,87,14,2,14,117
328898697,89,14,4,9,116
328900788,30,24,2,1,57
328909780,16,25,2,1,44
328923476,119,25,2,9,155
328926217,38,48,24,3,113
328966397,77,3,2,1,83
328993063,94,5,2,1,102
328998084,78,8,2,1,89
329007229,72,12,3,4,91
329011673,19,40,2,1,62
329011713,105,3,2,1,111
329015312,74,17,2,4,97
329024060,63,17,35,2,117
329026109,16,3,2,1,22
329029202,20,3,2,6,31
329043639,113,35,2,3,153
329048993,35,27,5,2,69
329056214,41,24,9,2,76
329062777,36,3,2,2,43
329064520,44,3,2,4,53
329067782,27,9,2,1,39
329108457,36,3,2,1,42
329114158,13,7,2,2,24
329116108,80,10,38,1,129
329127357,19,9,2,4,34
329132228,152,3,2,1,158
329133758,85,54,17,43,199
329150832,44,51,22,5,122
329158385,11,3,2,1,17
329160065,57,13,5,4,79
329169186,121,47,29,3,200
329170635,22,3,2,1,28
329199714,81,16,3,25,125
329200897,39,3,2,1,45
329204722,11,6,2,1,20
329208414,125,3,2,1,131
329209848,22,13,36,1,72
329212003,27,3,2,1,33
329213633,53,21,2,2,78
329219170,141,22,71,13,247
329234285,99,13,52,7,171
329237792,52,3,2,4,61
329246177,57,10,2,1,70
329253629,98,43,24,1,166
329253683,33,5,5,17,60
329260421,22,3,2,1,28
329302402,88,8,3,1,100
329314036,65,3,2,1,71
329327870,114,3,2,1,120
329339189,20,3,2,1,26
329343164,206,10,2,1,219
329350672,71,11,2,1,85
329356411,122,36,11,4,173
329371757,54,11,2,6,73
329391602,111,20,2,1,134
329394633,69,3,2,6,80
329398902,133,22,8,18,181
329402176,108,37,2,6,153
329402507,14,7,2,1,24
329405603,97,3,2,2,104
329409835,263,4,2,1,270
329413605,106,3,2,5,116
329418809,20,31,2,1,54
329423352,70,48,23,4,145
329431397,185,3,2,1,191
329454610,17,3,2,1,23
329457107,13,5,3,2,23
329469537,43,47,7,5,102
329477380,58,9,2,1,70
329477859,11,9,2,2,24
329490986,70,68,32,38,208
329501578,11,6,2,5,24
329501718,80,25,2,12,119
329512152,36,3,2,5,46
329522242,23,3,2,1,29
329526098,76,61,21,7,165
329531288,187,33,2,4,226
329546370,75,7,23,2,107
329562833,16,3,2,1,22
329579902,77,3,2,3,85
329586946,61,44,49,2,156
329589710,73,54,2,1,130
329610385,102,30,2,1,135
329620298,109,38,24,13,184
329624213,108,20,24,6,158
329629917,33,3,2,3,41
329632056,165,3,2,1,171
329635961,14,3,2,1,20
329645900,41,34,2,5,82
329646269,83,13,8,1,105
329653719,196,23,10,13,242
329666475,41,6,2,4,53
329674560,108,6,2,1,117
329702033,78,28,7,4,117
329703640,114,3,2,2,121
329706994,76,28,16,4,124
329722988,10,9,2,1,22
329744791,46,94,35,19,194
329754288,71,38,2,2,113
329766654,52,37,20,14,123
329769096,106,9,2,2,119
329770895,12,3,2,1,18
329804182,62,9,2,25,98
329804553,12,19,2,1,34
329810843,89,21,24,6,140
329812320,96,3,2,1,102
329815657,13,29,8,4,54
329824641,122,34,2,1,159
329842349,67,3,2,1,73
329844522,103,12,2,10,127
329864622,15,19,2,1,37
329865052,45,47,50,3,145
329876686,11,3,2,1,17
329878648,47,15,4,2,68
329878831,138,41,10,1,190
329882251,46,20,27,20,113
329882846,10,10,2,1,23
329885392,17,26,2,1,46
329916349,81,11,2,1,95
329930754,13,25,34,2,74
329945553,131,21,6,7,165
329952980,218,21,5,5,249
329958071,135,80,6,15,236
329959282,23,3,2,7,35
330006838,31,44,37,2,114
330017376,52,12,2,1,67
330020239,24,64,2,1,91
330022810,53,12,5,1,71
330029009,374,28,2,9,413
330040740,83,22,2,20,127
330053456,34,3,2,1,40
330057189,132,35,75,9,251
330078365,62,41,13,20,136
330083308,18,7,2,2,29
330086180,91,13,3,11,118
330109502,13,3,4,1,21
330131153,200,3,2,12,217
330132346,34,7,18,1,60
330137162,19,3,2,3,27
330141205,255,3,2,40,300
330150926,40,29,2,1,72
330154537,57,27,25,11,120
330170210,219,35,2,7,263
330181305,118,71,93,8,290
330187616,33,27,11,1,72
330196959,49,18,2,17,86
330201085,73,3,2,1,79
330202345,87,3,2,1,93
330214888,17,3,2,1,23
330219118,398,43,19,8,468
330220713,69,5,10,1,85
330233794,38,24,2,1,65
330236265,49,24,24,7,104
330249200,70,17,5,1,93
330254184,10,3,2,4,19
330265163,16,39,116,4,175
330265949,74,51,2,9,136
330268159,12,19,2,1,34
330282442,67,10,46,1,124
330288474,648,3,2,6,659
330294276,20,31,2,2,55
330295197,42,28,2,3,75
330300897,58,3,2,3,66
330306813,257,23,5,20,305
330307568,16,25,2,4,47
330312450,49,12,2,1,64
330343482,45,3,2,1,51
330352032,17,3,2,1,23
330352157,39,46,17,63,165
330396520,11,3,2,1,17
330408162,57,3,2,3,65
330428660,120,30,2,3,155
330445503,43,3,2,2,50
330466130,109,42,27,16,194
330466976,27,25,15,4,71
330473578,12,15,2,1,30
330478039,56,24,105,32,217
330479460,109,12,25,1,147
330487923,173,35,7,45,260
330491170,52,38,68,11,169
330520273,108,54,48,16,226
330520641,34,3,2,1,40
330540753,144,6,3,1,154
330548858,60,7,28,5,100
330566919,36,19,28,22,105
330580958,18,24,2,3,47
330596744,55,3,2,1,61
330601831,90,8,2,5,105
330605510,34,3,2,1,40
330627760,52,18,18,1,89
330631200,68,3,2,1,74
330646267,168,23,5,28,224
330659466,107,14,2,1,124
330668600,84,117,38,43,282
330681313,42,3,2,2,49
330682201,12,3,2,1,18
330694955,38,22,4,15,79
330696011,57,18,29,6,110
330708630,24,5,2,26,57
330709013,55,3,2,4,64
330715650,60,21,17,4,102
330721819,80,16,3,12,111
330729520,49,50,38,4,141
330732406,222,3,2,6,233
330745230,110,29,2,4,145
330745244,37,24,2,1,64
330759591,18,51,16,6,91
330762952,40,28,31,1,100
330764249,16,3,2,1,22
330767646,20,4,2,1,27
330773291,11,48,8,9,76
330776100,52,38,8,1,99
330781527,76,3,2,4,85
330801108,160,37,38,3,238
330801117,24,11,3,1,39
330807405,29,8,7,4,48
330809781,63,17,3,7,90
330821177,70,3,2,12,87
330876584,21,12,2,1,36
330879215,19,5,2,1,27
330886109,29,3,2,2,36
330889429,40,23,36,1,100
330897934,23,3,2,10,38
330904060,17,16,2,1,36
330905345,10,10,2,1,23
330936401,25,14,2,3,44
330951707,100,3,2,3,108
330962867,44,71,2,2,119
330969845,27,24,2,4,57
330975164,92,3,2,1,98
330987070,16,3,2,1,22
330987282,104,3,2,1,110
331002771,148,39,80,14,281
331003477,13,3,2,1,19
331008819,71,3,2,2,78
331012023,23,7,35,9,74
331026106,23,3,2,1,29
331034935,11,32,2,1,46
331039105,139,21,2,2,164
331053940,26,67,3,1,97
331059627,48,11,18,7,84
331065469,28,15,2,2,47
331065911,55,3,5,6,69
331074635,36,53,8,13,110
331082523,156,3,2,1,162
331092019,17,6,5,1,29
331093608,15,3,2,1,21
331096792,88,20,15,1,124
331097492,11,3,2,1,17
331117978,39,3,2,6,50
331122067,92,28,78,2,200
331122842,22,4,2,3,31
331125737,100,11,2,1,114
331135875,58,39,3,1,101
331136435,20,3,2,2,27
331156728,59,50,22,27,158
331169198,31,42,3,1,77
331176443,154,3,2,3,162
331183131,68,80,43,9,200
331189969,185,80,6,3,274
331194305,86,4,2,1,93
331195991,10,17,2,1,30
331199536,72,3,2,1,78
331208353,61,15,18,3,97
331219889,83,53,2,18,156
331221339,12,3,2,1,18
331224540,44,14,4,6,68
331257785,115,32,19,2,168
331260284,17,24,2,14,57
331270595,17,34,4,5,60
331285423,91,3,2,1,97
331293962,20,7,4,4,35
331295886,30,3,2,1,36
331301201,84,14,45,5,148
331301323,44,23,2,1,70
331322483,44,17,11,13,85
331325962,18,3,2,2,25
331346049,69,17,13,1,100
331347500,68,3,2,2,75
331358378,146,26,64,3,239
331365807,74,29,75,16,194
331380757,77,35,19,53,184
331383714,34,24,6,1,65
331401098,101,56,10,29,196
331415828,59,6,3,4,72
331420301,34,3,2,1,40
331436868,498,3,2,14,517
331450696,101,25,104,43,273
331451730,151,13,66,14,244
331464032,28,17,18,1,64
331478763,80,3,2,14,99
331482985,64,57,25,5,151
331483491,25,11,2,19,57
331514470,68,3,2,4,77
331524528,30,11,2,10,53
331541964,10,3,2,3,18
331591395,19,3,2,9,33
331600070,113,3,2,1,119
331604682,61,32,60,2,155
331630501,134,3,2,1,140
331633599,10,8,2,1,21
331649034,183,25,61,2,271
331684978,25,41,2,13,81
331698377,78,40,16,24,158
331701562,72,11,2,1,86
331716255,41,16,13,3,73
331736162,228,67,48,2,345
331741702,50,55,33,31,169
331767262,84,4,3,2,93
331769888,107,15,64,43,229
331786337,62,23,2,7,94
331804163,108,6,59,12,185
331820846,88,28,35,1,152
331840279,45,3,2,1,51
331840584,32,71,6,9,118
331842456,19,4,2,2,27
331843757,179,73,2,20,274
331846919,66,22,2,1,91
331848283,46,3,2,1,52
331864439,54,53,22,31,160
331897938,28,7,2,14,51
331901728,52,8,2,3,65
331913603,66,24,2,2,94
331914213,61,31,29,18,139
331939577,166,26,3,2,197
331943068,22,3,2,6,33
331957008,77,11,2,2,92
331957820,26,7,2,5,40
331968943,12,3,2,1,18
331979522,111,22,8,10,151
331982874,114,33,69,1,217
331987405,146,43,2,1,192
332001104,19,5,2,1,27
332003654,17,5,2,7,31
332006873,51,13,2,1,67
332011345,38,33,12,3,86
332018624,95,3,2,1,101
332019970,40,15,2,62,119
332025640,122,28,5,1,156
332036230,20,24,15,1,60
332041806,10,25,2,1,38
332051887,26,3,2,1,32
332054977,88,46,23,13,170
332055464,74,22,4,15,115
332073846,20,3,2,1,26
332074486,31,3,2,1,37
332090555,98,23,8,10,139
332093622,48,23,15,1,87
332106743,20,3,2,1,26
332143581,23,38,2,1,64
332144027,102,32,5,2,141
332155561,184,68,3,14,269
332165777,38,124,47,1,210
332169085,72,33,85,19,209
332179818,79,7,34,3,123
332187011,11,6,2,1,20
332204399,10,6,2,1,19
332211388,72,3,2,7,84
332213027,16,7,2,2,27
332219214,14,3,2,1,20
332219682,17,3,5,5,30
332221188,41,15,14,8,78
332236482,23,4,2,2,31
332239796,77,28,39,4,148
332262838,74,3,2,10,89
332265568,60,26,2,1,89
332274547,99,17,75,35,226
332285038,31,18,2,1,52
332293202,20,16,2,1,39
332301972,37,24,44,1,106
332309655,11,16,2,1,30
332312096,51,3,2,1,57
332324941,17,6,20,1,44
332335990,58,3,2,1,64
332343258,116,3,2,7,128
332354907,17,72,6,4,99
332387982,42,30,29,11,112
332420705,20,6,2,1,29
332426270,123,3,2,34,162
332440724,14,26,2,1,43
332445871,22,3,2,3,30
332448070,20,3,2,1,26
332450774,166,26,31,41,264
332460073,96,30,5,8,139
332474622,58,30,18,36,142
332478107,837,7,2,10,856
332478914,11,4,2,2,19
332494377,134,29,21,2,186
332498062,56,42,85,8,191
332518317,71,33,2,1,107
332528704,89,3,2,1,95
332532530,46,17,2,1,66
332537940,29,3,2,1,35
332540719,85,6,2,1,94
332573231,127,9,2,1,139
332576707,57,3,2,1,63
332584626,90,51,42,2,185
332584947,76,3,2,1,82
332586385,16,59,2,1,78
332594726,115,19,2,4,140
332598873,119,37,65,4,225
332606119,130,7,14,1,152
332610625,27,8,2,1,38
332613014,11,3,2,1,17
332621963,18,29,3,1,51
332622753,28,3,2,1,34
332625051,47,11,6,19,83
332629117,11,3,2,2,18
332633756,53,16,2,4,75
332636019,57,5,3,15,80
332660916,44,31,2,4,81
332664455,10,8,2,1,21
332676365,97,158,54,7,316
332677462,40,5,2,1,48
332684200,127,19,2,1,149
332688966,54,19,2,1,76
332691453,16,3,2,3,24
332692130,145,33,2,3,183
332721960,61,28,25,10,124
332722959,187,51,24,18,280
332730051,73,44,12,12,141
332739158,73,9,2,1,85
332795014,112,13,14,13,152
332807879,71,31,35,15,152
332814787,100,63,8,6,177
332815736,11,3,2,1,17
332821627,20,7,9,1,37
332823291,10,3,2,10,25
332827299,37,36,43,1,117
332855176,18,3,2,1,24
332862015,171,48,68,6,293
332868900,85,39,24,3,151
332869394,33,20,65,13,131
332877183,78,15,17,1,111
332885239,106,40,7,16,169
332889405,214,13,2,1,230
332901781,57,23,2,3,85
332903227,24,24,24,1,73
332904334,48,3,2,6,59
332908661,87,3,2,7,99
332912319,11,4,16,1,32
332920826,27,106,59,1,193
332931220,183,14,2,12,211
332933215,35,3,2,2,42
332949588,1383,3,2,8,1396
333022014,16,18,2,9,45
333035426,16,3,2,1,22
333053164,40,21,2,4,67
333062045,10,3,2,4,19
333066134,65,10,5,23,103
333071128,93,3,2,1,99
333097394,92,7,6,1,106
333098205,171,18,5,2,196
333108372,14,3,2,1,20
333111052,179,4,2,3,188
333111430,97,3,2,9,111
333111572,34,3,2,2,41
333113536,151,3,2,4,160
333118965,43,3,2,1,49
333131763,16,5,2,1,24
333141869,125,9,11,18,163
333143619,54,13,17,47,131
333166494,43,18,2,3,66
333170990,97,30,30,3,160
333179457,39,38,3,10,90
333179821,19,28,2,1,50
333182471,70,3,2,3,78
333183566,105,7,4,6,122
333189834,62,47,4,47,160
333193953,73,28,38,5,144
333201308,21,3,2,5,31
333202409,617,3,2,7,629
333203708,78,20,49,1,148
333207987,29,9,3,1,42
333213759,112,3,2,14,131
333225842,289,13,63,18,383
333233474,310,18,8,15,351
333234292,28,12,2,1,43
333239578,36,35,18,1,90
333252644,26,57,8,9,100
333254301,21,26,45,13,105
333274217,12,3,2,1,18
333296996,11,3,2,1,17
333306519,20,15,31,3,69
333310733,25,40,2,1,68
333322193,28,71,11,27,137
333326385,33,9,9,2,53
333340044,70,40,21,15,146
333346025,98,51,52,1,202
333354210,205,24,27,4,260
333357158,145,3,2,1,151
333377353,14,3,2,1,20
333382080,13,5,2,1,21
333382637,161,8,2,82,253
333384593,42,13,21,17,93
333385260,21,24,2,1,48
333401499,107,28,4,2,141
333421329,14,12,2,1,29
333428117,126,7,2,2,137
333429033,82,44,10,15,151
333432777,138,20,27,10,195
333436927,14,16,2,2,34
333456204,45,3,2,1,51
333473777,77,3,2,5,87
333490526,18,3,2,1,24
333491170,90,18,2,1,111
333506974,154,8,2,1,165
333522420,39,3,2,1,45
333534614,19,28,2,1,50
333534675,53,3,2,1,59
333536738,13,3,2,1,19
333546051,63,5,39,1,108
333554854,64,55,6,11,136
333561605,16,4,2,1,23
333563433,18,29,80,7,134
333564562,22,32,4,1,59
333582541,106,16,5,6,133
333586631,84,20,2,7,113
333598592,13,3,2,1,19
333602143,63,38,2,10,113
333602941,202,3,2,4,211
333613507,20,3,2,1,26
333614740,29,3,2,13,47
333627624,46,17,11,1,75
333633238,11,3,2,1,17
333634416,53,32,2,1,88
333639654,58,14,44,6,122
333645042,34,11,2,2,49
333647794,29,3,6,1,39
333659524,51,3,2,1,57
333669012,33,5,2,3,43
333673797,12,12,2,1,27
333678717,71,26,55,23,175
333690242,52,76,18,53,199
333692855,120,40,39,9,208
333700767,14,16,2,1,33
333707141,28,26,4,1,59
333707835,85,13,3,1,102
333722231,205,30,4,2,241
333727471,27,42,14,1,84
333730001,24,14,2,3,43
333736346,75,15,2,4,96
333756347,83,18,6,2,109
333763621,66,25,10,9,110
333773834,18,33,2,2,55
333782127,184,7,2,4,197
333784241,65,3,2,20,90
333790921,205,29,2,8,244
333796539,76,26,2,6,110
333806876,55,16,3,1,75
333811940,102,27,2,2,133
333818031,91,30,76,73,270
333818922,16,35,2,1,54
333819113,15,13,5,1,34
333832387,13,6,2,2,23
333855282,90,3,2,1,96
333868647,164,39,112,1,316
333873479,124,68,2,3,197
333876534,42,43,52,30,167
333879118,45,34,31,34,144
333888663,93,3,2,2,100
333892984,68,31,13,1,113
333906130,28,19,2,4,53
333914043,249,3,2,1,255
333916378,24,46,3,1,74
333929967,40,11,21,6,78
333933869,206,54,21,29,310
333947754,80,3,2,3,88
333958691,190,13,30,9,242
333961758,22,9,2,1,34
333970764,14,3,2,2,21
333975176,81,3,3,6,93
333977004,60,3,2,1,66
333987918,58,36,46,1,141
333990239,12,3,2,6,23
333996071,75,3,2,1,81
333999078,41,3,42,12,98
334003921,271,55,12,16,354
334011930,20,3,2,1,26
334034110,94,23,14,12,143
334046435,24,3,2,5,34
334060352,12,3,2,2,19
334062267,21,3,2,5,31
334083097,11,3,2,1,17
334088539,107,8,2,8,125
334092307,81,60,2,17,160
334103124,142,19,3,6,170
334115395,36,5,2,3,46
334126864,27,80,16,10,133
334152495,202,3,2,10,217
334179703,18,24,57,3,102
334187035,11,3,2,1,17
334194564,105,3,2,3,113
334199054,50,27,2,2,81
334204056,55,19,2,1,77
334213754,61,9,33,2,105
334218572,202,62,3,1,268
334240846,73,126,103,95,397
334253511,18,32,6,1,57
334261289,18,3,2,1,24
334271555,52,23,25,2,102
334274858,28,3,2,1,34
334285979,116,31,33,6,186
334294028,145,3,2,15,165
334318511,111,3,2,1,117
334328289,77,34,31,24,166
334329446,75,7,3,17,102
334334782,32,3,2,2,39
334341025,22,7,2,1,32
334351306,46,3,2,1,52
334354371,126,6,2,2,136
334354547,71,15,4,1,91
334361253,136,19,2,31,188
334364034,45,3,2,1,51
334365242,25,14,2,3,44
334390704,170,3,2,21,196
334450525,26,14,14,1,55
334451326,58,88,73,1,220
334458328,108,11,3,4,126
334474323,42,15,11,1,69
334478513,63,34,45,6,148
334486592,88,79,2,1,170
334507000,44,16,9,20,89
334521844,37,10,13,14,74
334538631,235,3,2,5,245
334550179,64,81,39,4,188
334550690,64,36,70,30,200
334562862,44,54,2,1,101
334577550,78,7,15,2,102
334578695,153,3,2,1,159
334582237,57,10,2,2,71
334603790,41,3,2,2,48
334611938,17,3,2,1,23
334637596,33,58,5,16,112
334643020,47,32,19,4,102
334649663,248,14,6,10,278
334659727,42,3,5,1,51
334680013,14,3,2,1,20
334691201,82,30,6,5,123
334736739,15,15,4,1,35
334736911,101,26,39,11,177
334742559,16,3,2,1,22
334746793,184,32,148,58,422
334766619,100,3,2,5,110
334769554,77,32,32,3,144
334773547,57,4,8,12,81
334780010,42,20,2,7,71
334783199,27,3,2,1,33
334798192,41,3,2,1,47
334831229,37,12,3,1,53
334877332,93,37,115,2,247
334878277,54,3,2,15,74
334881023,13,3,2,1,19
334882216,111,3,2,1,117
334911576,53,17,51,1,122
334925477,20,13,3,1,37
334929540,94,56,58,1,209
334959787,59,3,2,1,65
334964533,34,3,2,1,40
334976233,96,19,44,1,160
334983014,113,23,2,1,139
334987241,180,11,3,2,196
334987408,12,8,2,3,25
334993208,94,42,10,21,167
335001839,13,5,2,1,21
335011264,10,19,2,1,32
335015865,66,60,6,2,134
335040353,20,3,2,1,26
335041993,117,43,145,1,306
335042613,14,3,2,1,20
335053531,77,22,3,12,114
335062951,81,11,41,1,134
335082947,65,10,3,8,86
335088325,37,4,2,1,44
335105451,88,21,2,3,114
335107647,33,18,15,16,82
335112521,106,19,16,6,147
335143025,146,19,5,10,180
335150477,15,3,2,1,21
335158273,75,40,11,2,128
335189566,37,28,7,4,76
335209232,35,43,6,6,90
335224700,145,26,10,29,210
335225832,37,61,21,7,126
335228083,11,3,2,1,17
335244487,12,9,2,1,24
335253638,21,3,2,2,28
335268584,34,9,43,2,88
335291545,17,14,2,2,35
335300499,12,3,2,1,18
335302067,30,29,8,1,68
335315772,21,15,16,7,59
335323897,33,10,21,4,68
335326652,103,59,31,64,257
335332229,55,3,2,1,61
335351180,127,37,28,19,211
335352197,53,24,2,4,83
335364304,63,3,2,1,69
335365157,75,3,28,1,107
335380266,32,6,2,1,41
335381407,405,8,4,2,419
335382254,10,6,2,1,19
335388328,81,3,2,3,89
335388835,12,3,2,1,18
335394870,84,21,14,18,137
335418360,78,27,2,1,108
335426312,44,11,2,2,59
335427604,47,10,17,1,75
335435176,146,4,16,1,167
335455379,60,41,14,5,120
335467067,11,3,2,1,17
335474006,11,3,2,1,17
335499484,39,46,19,14,118
335500122,135,23,93,1,252
335520637,80,22,47,3,152
335525698,71,3,2,3,79
335531388,89,3,2,1,95
335543191,70,8,66,3,147
335572380,104,15,34,1,154
335588783,89,3,2,12,106
335600821,165,28,55,5,253
335604220,96,10,2,1,109
335604881,24,55,14,1,94
335655212,105,19,12,10,146
335692109,32,29,19,17,97
335700996,53,15,2,1,71
335715880,103,5,56,22,186
335722783,69,3,2,12,86
335733269,15,3,2,1,21
335743405,52,10,4,10,76
335754434,102,20,2,17,141
335756269,97,20,34,1,152
335767214,56,7,19,11,93
335783448,32,49,35,8,124
335784862,52,22,2,1,77
335789846,51,33,4,265,353
335792506,15,3,2,1,21
335811455,35,11,2,7,55
335812378,17,3,2,1,23
335821591,163,56,2,13,234
335840854,64,12,60,3,139
335845127,22,3,2,1,28
335854720,125,15,85,6,231
335860817,161,3,2,2,168
335875653,49,3,2,3,57
335879109,14,22,2,1,39
335881617,36,13,3,1,53
335889350,109,41,9,4,163
335905212,58,67,2,1,128
335909486,60,66,20,2,148
335911726,144,16,3,1,164
335924880,65,24,2,1,92
335927561,40,3,2,2,47
335942173,35,23,20,14,92
335952629,100,50,16,12,178
335976896,136,17,2,1,156
335980520,24,35,9,12,80
335983959,131,4,8,5,148
335992810,65,59,19,5,148
336003931,46,3,4,1,54
336006354,48,51,94,2,195
336028582,80,12,2,6,100
336031676,107,32,28,69,236
336036961,91,3,2,1,97
336042708,39,35,37,9,120
336050434,69,35,28,49,181
336051832,71,39,2,1,113
336052119,11,3,2,2,18
336073821,23,66,14,13,116
336075080,11,26,2,1,40
336080135,67,40,31,10,148
336081346,13,8,2,7,30
336108106,48,44,48,2,142
336126986,31,14,2,7,54
336129376,106,63,16,35,220
336139938,199,40,2,12,253
336155575,23,5,2,1,31
336159990,162,9,105,34,310
336167576,12,3,2,1,18
336175011,11,3,2,1,17
336201879,118,3,21,4,146
336204220,172,5,2,9,188
336206650,10,19,8,4,41
336214265,62,4,2,1,69
336215485,52,23,2,12,89
336221380,30,64,51,7,152
336221924,20,27,2,4,53
336275684,73,51,54,4,182
336275905,39,39,6,8,92
336278516,17,3,2,1,23
336299345,13,4,2,2,21
336324863,38,13,2,1,54
336335046,61,13,10,5,89
336335793,10,3,11,1,25
336351166,228,15,6,13,262
336351761,43,30,13,2,88
336354850,33,46,2,2,83
336357550,81,3,2,1,87
336359414,100,3,2,6,111
336360790,134,43,2,6,185
336363298,108,25,18,10,161
336371425,52,15,2,16,85
336390552,77,32,80,13,202
336398981,95,7,20,4,126
336405727,18,6,2,2,28
336411739,24,13,2,7,46
336414091,72,7,2,2,83
336418116,77,53,2,1,133
336420274,20,32,2,1,55
336426091,10,6,2,1,19
336428413,23,9,9,4,45
336446195,76,3,2,1,82
336458857,86,3,90,1,180
336473547,68,92,16,6,182
336474831,49,63,2,1,115
336474972,62,3,2,1,68
336478850,61,4,9,20,94
336488749,69,24,2,3,98
336494268,32,14,17,1,64
336502323,64,21,14,1,100
336502403,22,3,2,1,28
336508235,21,36,59,1,117
336513782,76,3,2,1,82
336517214,526,3,2,7,538
336529776,46,5,22,27,100
336539329,10,9,2,1,22
336539659,92,37,7,1,137
336541510,29,3,2,1,35
336549175,79,17,2,9,107
336575654,16,13,3,1,33
336576362,53,28,85,7,173
336577082,18,9,7,1,35
336579664,94,44,5,5,148
336588474,70,19,21,1,111
336598247,41,28,32,1,102
336620493,10,7,2,1,20
336632970,22,3,2,1,28
336645838,18,3,2,1,24
336662946,249,33,23,38,343
336696907,53,35,19,24,131
336701482,99,10,2,17,128
336705090,32,9,5,1,47
336718892,37,100,4,1,142
336752624,95,3,2,1,101
336761673,62,17,29,3,111
336768285,23,3,2,6,34
336769544,88,8,2,1,99
336773545,146,62,20,15,243
336785086,59,76,80,8,223
336785580,98,3,2,16,119
336789138,281,3,2,1,287
336789460,11,3,2,1,17
336795839,31,35,5,2,73
336801668,121,3,2,1,127
336802823,67,37,4,7,115
336811022,63,15,2,7,87
336819990,73,10,2,14,99
336820799,13,5,2,5,25
336824032,114,3,2,24,143
336826439,58,9,43,37,147
336830833,176,28,24,47,275
336836057,160,34,2,10,206
336836440,46,71,2,1,120
336841582,67,3,2,1,73
336849465,85,3,2,1,91
336867042,58,7,2,9,76
336880632,647,3,2,12,664
336887731,115,19,114,3,251
336888260,58,42,4,2,106
336898960,142,40,51,23,256
336910787,11,3,2,6,22
336910891,24,14,2,1,41
336919851,51,27,4,11,93
336929670,251,22,3,1,277
336943435,95,11,2,4,112
336947990,113,14,45,7,179
336949007,33,34,42,4,113
336951845,34,24,4,17,79
336968311,61,76,12,27,176
336975906,11,3,2,1,17
336980581,141,12,2,4,159
336980627,23,51,2,1,77
336981392,80,7,2,1,90
336981745,124,3,2,1,130
336984435,122,33,7,19,181
337008043,28,3,2,1,34
337011007,98,20,18,20,156
337027969,67,3,2,1,73
337035778,68,17,2,1,88
337043513,76,8,63,2,149
337048503,39,46,28,29,142
337052305,94,16,2,1,113
337062951,93,3,2,48,146
337063627,178,3,6,4,191
337083328,185,3,2,3,193
337086520,75,13,2,11,101
337110150,127,13,2,2,144
337121422,27,16,2,1,46
337126761,60,14,2,2,78
337128517,39,3,2,15,59
337144739,27,7,8,4,46
337147488,16,20,2,1,39
337149484,43,28,55,1,127
337165981,190,99,3,6,298
337171722,106,3,2,1,112
337182319,57,13,2,20,92
337189409,13,3,2,1,19
337189516,203,11,2,14,230
337199139,34,6,2,7,49
337209495,84,3,2,1,90
337223044,10,3,2,2,17
337233226,188,23,69,7,287
337240883,23,39,8,23,93
337244472,21,3,2,1,27
337244757,165,29,91,2,287
337273674,50,178,35,122,385
337286057,114,34,21,1,170
337292169,108,61,40,16,225
337296390,123,19,2,28,172
337312769,128,19,69,48,264
337319270,61,3,2,2,68
337321248,46,3,2,1,52
337328088,227,3,2,1,233
337351115,49,3,2,1,55
337354409,45,3,11,1,60
337356744,68,3,44,10,125
337394200,11,8,2,1,22
337394586,71,32,41,81,225
337396544,108,3,2,1,114
337408663,98,7,7,24,136
337410338,91,20,17,2,130
337449674,45,16,15,4,80
337450836,54,68,8,33,163
337454152,213,14,2,13,242
337457927,163,13,2,1,179
337480334,23,8,2,1,34
337484798,39,9,2,17,67
337488064,98,18,2,7,125
337501034,132,8,2,4,146
337502827,35,3,2,6,46
337516737,43,24,35,1,103
337517566,15,3,2,1,21
337517839,70,12,4,1,87
337529495,13,3,2,1,19
337533283,33,39,9,1,82
337539196,144,40,42,15,241
337539843,66,34,2,1,103
337542456,10,3,2,2,17
337545443,87,5,2,2,96
337547113,62,4,2,12,80
337554938,111,18,16,20,165
337565410,79,3,2,3,87
337575490,20,9,2,1,32
337611597,33,19,12,8,72
337625643,43,56,14,15,128
337628202,56,47,47,9,159
337642024,31,3,2,7,43
337649552,31,24,8,10,73
337657037,107,3,2,3,115
337657626,130,27,2,1,160
337659741,39,38,5,1,83
337681353,14,9,2,1,26
337684275,39,22,2,10,73
337686131,12,3,2,1,18
337689878,41,52,13,1,107
337711456,11,87,2,1,101
337731406,32,17,2,1,52
337736638,206,5,2,32,245
337737600,10,3,2,3,18
337738687,49,18,32,11,110
337768664,136,3,2,1,142
337772866,16,27,4,2,49
337774544,32,7,2,6,47
337777466,11,3,2,1,17
337783916,22,42,2,1,67
337801134,10,13,2,1,26
337803413,47,9,2,17,75
337813404,11,4,3,1,19
337815808,41,53,2,73,169
337840891,136,3,15,6,160
337848892,153,16,2,1,172
337849152,76,3,2,13,94
337865305,44,3,2,1,50
337891773,63,21,37,4,125
337893138,31,57,97,1,186
337895338,14,3,2,2,21
337902787,116,15,21,12,164
337902913,44,5,16,3,68
337909078,67,35,26,21,149
337911657,76,13,4,2,95
337912047,74,25,25,1,125
337925475,359,38,17,5,419
337925590,81,37,34,30,182
337931152,14,59,39,2,114
337943269,115,9,39,14,177
337964241,18,9,5,1,33
337998866,156,26,2,16,200
337999487,61,10,38,2,111
338001126,33,11,2,1,47
338017145,302,3,2,2,309
338034951,23,38,19,1,81
338052808,57,9,3,23,92
338068345,88,7,2,5,102
338071995,15,3,2,3,23
338074509,61,48,2,9,120
338076560,45,24,15,10,94
338077765,11,28,8,1,48
338093597,38,32,44,11,125
338110728,40,3,2,12,57
338117828,49,14,7,1,71
338124809,78,9,2,1,90
338140377,14,5,2,3,24
338148877,42,24,27,23,116
338150566,19,3,2,1,25
338161288,18,13,2,2,35
338191707,32,35,5,1,73
338211189,150,5,44,1,200
338212610,87,13,15,3,118
338213680,118,23,16,2,159
338218893,34,101,9,4,148
338226834,16,3,2,1,22
338227384,50,15,2,13,80
338238662,116,3,2,2,123
338239247,71,24,2,9,106
338251779,85,33,2,8,128
338273253,45,20,2,6,73
338285809,25,3,2,1,31
338293379,71,9,2,3,85
338294678,11,3,2,1,17
338319365,43,3,2,1,49
338330134,79,17,2,4,102
338331799,55,15,2,6,78
338337640,10,7,2,2,21
338339666,134,3,2,3,142
338345022,252,33,70,1,356
338349931,17,3,2,1,23
338360692,168,25,7,1,201
338372152,149,9,28,3,189
338379781,171,3,2,4,180
338407892,178,28,23,17,246
338426146,13,3,2,1,19
338429683,17,3,2,1,23
338430125,18,3,2,1,24
338439347,54,59,5,6,124
338446048,39,29,10,1,79
338468769,73,6,15,2,96
338468905,13,3,2,1,19
338486935,28,3,2,1,34
338490999,11,9,2,1,23
338494955,32,20,2,2,56
338497281,16,3,2,1,22
338502415,11,3,2,1,17
338510920,35,22,17,10,84
338511546,56,19,4,22,101
338515371,118,6,4,1,129
338518076,75,26,4,1,106
338533970,98,61,44,12,215
338547160,34,19,3,4,60
338565004,109,3,2,1,115
338580830,73,26,32,4,135
338585175,57,17,10,25,109
338586796,294,68,6,1,369
338588095,10,13,2,1,26
338593872,16,3,2,1,22
338610112,14,6,2,1,23
338615475,60,22,11,5,98
338637738,46,34,29,1,110
338649058,21,17,6,2,46
338653352,122,35,27,29,213
338671701,19,37,6,21,83
338675006,99,4,2,4,109
338693748,25,26,2,24,77
338703623,31,97,11,3,142
338763121,123,16,9,30,178
338794479,65,18,45,4,132
338797926,13,3,2,1,19
338817654,33,4,27,9,73
338826723,32,3,2,1,38
338830154,53,3,12,1,69
338835732,29,40,15,4,88
338850225,91,37,17,15,160
338858781,22,3,2,1,28
338863969,136,15,5,2,158
338870242,41,11,2,1,55
338897110,50,36,8,1,95
338928821,78,73,9,10,170
338932386,30,9,2,2,43
338936675,56,19,128,2,205
338961295,74,6,2,2,84
338962974,143,3,2,1,149
338968266,87,12,51,10,160
338990114,47,5,2,1,55
338995052,48,16,2,6,72
339002219,34,3,2,5,44
339007568,59,43,2,1,105
339016616,40,33,56,1,130
339017613,97,4,2,1,104
339023815,113,51,95,49,308
339029521,101,37,13,6,157
339043494,23,24,18,6,71
339065560,11,3,2,1,17
339077419,100,41,19,20,180
339082115,48,17,2,1,68
339083769,98,3,2,1,104
339085167,156,3,2,1,162
339097455,284,3,2,9,298
339102796,38,6,2,14,60
339106889,22,3,2,1,28
339123085,20,18,11,2,51
339123573,50,15,2,1,68
339130046,44,3,2,1,50
339154659,29,18,2,3,52
339157709,88,5,2,1,96
339161088,20,3,2,1,26
339163610,12,19,7,1,39
339169574,34,20,2,11,67
339194948,31,30,13,33,107
339205286,112,36,2,2,152
339218917,31,23,8,5,67
339227494,53,17,32,25,127
339229300,208,27,53,25,313
339256766,78,10,26,1,115
339267505,34,17,39,2,92
339269610,36,22,9,13,80
339295189,37,55,19,13,124
339308459,130,25,11,6,172
339312443,19,24,2,1,46
339327942,132,53,3,3,191
339335476,53,50,10,1,114
339348518,74,66,22,49,211
339351569,73,19,5,33,130
339360420,22,71,13,11,117
339367125,45,43,14,16,118
339367248,187,3,2,4,196
339373356,15,26,2,1,44
339386485,46,15,7,5,73
339396814,86,3,2,1,92
339409956,42,28,7,1,78
339423767,126,24,2,16,168
339442501,33,29,10,1,73
339456864,30,3,2,6,41
339469729,30,14,2,1,47
339486692,46,19,12,1,78
339502411,35,12,15,7,69
339510416,67,14,2,1,84
339526141,45,3,2,9,59
339529934,12,3,2,1,18
339531789,19,19,2,2,42
339538360,13,3,2,1,19
339540176,66,37,4,1,108
339544453,110,3,2,26,141
339568993,111,18,2,1,132
339587548,61,5,3,1,70
339599939,16,3,2,1,22
339616400,72,17,2,9,100
339631051,50,45,2,1,98
339632115,52,5,2,4,63
339633395,71,3,2,2,78
339635737,53,16,2,2,73
339646313,45,12,4,6,67
339653533,32,3,2,1,38
339655881,110,20,46,7,183
339668944,24,8,3,3,38
339677598,17,3,2,1,23
339685127,13,14,4,8,39
339685413,17,3,2,1,23
339723448,12,7,2,1,22
339727071,51,3,2,1,57
339745844,21,16,29,6,72
339754274,11,3,2,1,17
339755376,210,9,2,1,222
339761323,102,14,2,23,141
339765903,164,43,76,17,300
339766876,17,26,8,1,52
339767213,55,3,2,1,61
339767846,11,3,2,2,18
339774231,95,20,94,2,211
339776071,88,13,40,1,142
339785658,78,22,89,29,218
339809913,52,3,2,1,58
339810147,30,12,4,5,51
339810752,60,7,16,37,120
339813746,77,3,2,1,83
339815015,56,3,2,1,62
339823018,108,26,2,1,137
339828624,56,36,20,4,116
339830502,57,17,15,13,102
339856692,27,17,7,1,52
339879017,10,5,2,1,18
339886623,11,3,2,1,17
339898314,54,11,2,3,70
339906796,117,14,36,22,189
339907277,82,20,2,1,105
339926392,96,18,32,16,162
339949819,42,3,2,1,48
339983635,11,3,2,1,17
339994818,35,3,2,2,42
340002059,55,3,2,11,71
340023553,73,7,44,7,131
340051747,114,3,2,1,120
340057663,10,3,2,3,18
340067431,70,3,5,1,79
340070275,31,3,2,1,37
340077175,10,5,2,1,18
340083130,17,3,2,1,23
340090733,10,18,2,3,33
340104574,32,109,2,3,146
340115682,11,6,5,4,26
340119570,50,14,4,1,69
340120469,126,60,20,8,214
340121990,12,3,3,3,21
340135156,81,3,2,8,94
340138567,236,21,20,18,295
340139028,66,13,23,21,123
340141727,121,37,2,3,163
340180860,105,3,2,2,112
340184343,11,3,2,1,17
340186788,86,25,93,1,205
340187880,67,38,59,26,190
340193006,24,3,2,1,30
340198250,19,29,2,1,51
340205863,118,3,2,9,132
340212268,112,43,11,2,168
340234285,16,3,2,1,22
340257472,16,3,2,2,23
340260139,51,4,2,1,58
340266305,140,91,13,44,288
340276095,29,14,3,5,51
340276634,127,3,2,1,133
340276979,50,21,34,17,122
340283794,10,40,2,2,54
340284246,12,7,2,1,22
340292198,16,10,2,1,29
340295994,101,17,2,9,129
340316014,113,3,2,3,121
340341886,118,62,74,8,262
340356500,186,63,46,3,298
340370529,13,3,2,1,19
340383283,13,9,2,2,26
340384160,42,50,4,1,97
340392662,40,50,45,2,137
340393916,71,3,2,1,77
340404003,41,17,2,1,61
340412251,23,18,2,11,54
340433348,14,4,2,17,37
340433903,16,36,2,1,55
340434594,90,14,2,1,107
340456848,17,48,26,1,92
340467954,12,3,2,1,18
340472822,98,6,2,1,107
340478433,29,8,2,1,40
340481052,186,17,2,7,212
340519319,10,3,2,4,19
340545974,25,3,2,6,36
340553886,43,29,2,4,78
340556411,32,57,31,1,121
340564560,12,3,2,1,18
340567866,91,104,2,16,213
340569949,37,80,17,14,148
340581556,71,37,29,16,153
340589911,13,3,2,3,21
340595765,25,3,2,11,41
340606629,41,4,2,8,55
340609722,24,3,2,7,36
340611526,311,11,46,5,373
340635969,158,55,102,7,322
340637122,108,19,59,28,214
340642770,29,23,33,1,86
340647936,111,3,2,1,117
340661943,23,3,2,10,38
340664021,55,13,5,7,80
340664569,61,3,2,3,69
340689677,86,23,68,1,178
340705834,33,34,23,1,91
340711977,71,20,68,2,161
340721167,44,20,2,1,67
340721471,15,16,12,1,44
340723274,283,3,2,1,289
340727589,95,9,52,4,160
340730508,49,23,3,10,85
340737889,81,52,4,2,139
340775612,57,20,4,2,83
340775912,166,37,2,15,220
340791453,10,5,2,1,18
340791858,76,38,37,12,163
340808841,89,3,2,2,96
340814265,19,14,2,1,36
340834998,35,29,2,6,72
340838474,112,23,49,8,192
340843644,47,26,42,3,118
340855546,43,3,3,2,51
340856253,90,3,2,1,96
340880161,65,35,3,5,108
340891008,36,39,11,1,87
340901296,54,53,6,14,127
340903815,84,3,2,1,90
340914274,58,31,34,1,124
340918179,58,15,11,4,88
340929201,29,31,3,1,64
340931905,42,24,2,2,70
340940551,71,31,27,2,131
340947853,108,3,2,2,115
340958075,43,54,2,1,100
340960749,20,3,2,1,26
340996142,46,29,43,16,134
340996749,34,21,29,17,101
341004229,11,3,2,1,17
341017781,12,3,2,1,18
341021015,20,3,2,1,26
341024620,32,3,2,15,52
341029748,40,12,18,1,71
341030821,116,5,2,7,130
341049881,48,3,19,16,86
341064062,86,4,31,5,126
341064660,14,3,2,1,20
341065433,22,6,4,1,33
341078217,67,32,2,8,109
341083839,16,3,2,1,22
341084880,23,40,2,1,66
341086622,96,55,44,9,204
341108347,20,8,4,1,33
341127279,57,22,5,5,89
341129366,24,3,2,1,30
341133941,65,15,5,9,94
341135759,161,88,50,3,302
341146612,66,50,2,3,121
341170799,15,16,2,1,34
341178096,72,9,5,35,121
341182018,12,4,3,1,20
341190782,83,4,2,7,96
341191023,66,34,2,7,109
341199995,93,8,2,1,104
341210762,12,26,2,1,41
341215116,15,3,2,1,21
341219801,37,4,2,27,70
341227498,59,3,2,33,97
341234702,47,3,2,1,53
341238332,149,39,115,46,349
341249358,114,38,3,11,166
341255143,116,64,29,3,212
341262076,97,13,6,15,131
341265826,11,3,2,1,17
341267333,76,35,33,1,145
341269959,15,3,2,1,21
341288904,19,60,2,1,82
341296864,51,12,23,1,87
341311546,129,27,44,1,201
341312657,47,3,2,1,53
341319135,10,3,2,2,17
341333871,43,39,16,36,134
341345600,46,55,10,29,140
341387768,34,29,42,6,111
341389840,86,14,18,3,121
341399337,97,29,4,13,143
341407442,78,3,2,1,84
341409115,86,12,2,1,101
341410786,35,13,2,13,63
341416330,60,41,11,36,148
341416988,74,20,28,1,123
341423868,20,10,2,3,35
341425094,195,28,4,11,238
341426383,55,5,58,15,133
341435724,189,3,2,13,207
341440508,16,3,2,2,23
341452752,109,25,2,3,139
341453792,95,82,4,3,184
341461352,133,10,7,7,157
341462095,39,74,34,1,148
341482020,127,19,2,7,155
341486192,48,19,60,1,128
341493054,144,68,94,25,331
341497568,76,3,2,7,88
341502799,104,21,2,1,128
341508732,124,83,36,3,246
341514937,70,19,2,13,104
341525849,51,18,24,15,108
341529682,35,34,39,35,143
341557109,42,13,2,9,66
341557364,11,3,2,1,17
341565473,53,66,9,11,139
341572410,25,14,4,2,45
341573975,50,3,19,1,73
341576525,102,80,14,14,210
341576570,702,3,2,5,712
341576898,103,3,2,3,111
341581802,74,3,2,1,80
341589718,16,3,2,1,22
341599747,31,24,2,1,58
341615043,52,27,43,2,124
341615912,64,36,20,27,147
341618458,75,100,64,1,240
341621204,85,19,3,1,108
341622522,180,28,40,24,272
341629248,67,3,2,1,73
341646713,150,24,19,15,208
341652844,39,23,19,1,82
341653177,28,41,2,1,72
341655197,23,24,2,4,53
341658146,20,3,2,1,26
341672431,56,3,2,1,62
341672432,61,7,5,17,90
341689775,38,18,2,1,59
341692206,10,22,2,1,35
341695858,10,4,2,1,17
341697114,66,3,2,14,85
341706527,87,30,2,15,134
341724438,10,5,2,1,18
341724559,16,7,2,2,27
341751521,16,3,2,1,22
341769278,15,3,2,1,21
341773171,60,24,18,6,108
341778089,118,3,2,1,124
341786530,78,15,2,4,99
341798232,104,11,11,6,132
341833178,119,12,2,1,134
341837852,137,7,37,1,182
341899455,30,47,11,2,90
341910105,11,32,3,1,47
341912912,34,5,2,9,50
341921965,28,34,2,2,66
341923593,25,7,2,3,37
341933332,57,74,55,5,191
341951494,73,44,52,63,232
341954086,95,19,2,5,121
341962623,15,3,2,1,21
341965080,41,3,2,5,51
341986542,10,19,2,1,32
341995509,11,3,2,1,17
342025592,11,3,2,1,17
342035682,113,43,2,4,162
342037516,21,3,2,2,28
342048904,10,57,2,1,70
342055751,80,19,2,5,106
342056162,53,37,2,1,93
342060288,58,10,2,6,76
342082158,22,15,14,4,55
342099833,52,33,11,39,135
342117585,68,20,12,13,113
342124857,33,4,2,2,41
342127985,20,3,2,1,26
342136857,62,3,2,1,68
342142817,65,18,2,2,87
342163070,98,30,3,10,141
342209304,29,17,3,1,50
342218208,199,3,2,1,205
342237936,112,31,2,1,146
342253935,73,3,2,2,80
342258854,27,21,13,27,88
342281033,17,9,2,1,29
342299835,17,3,2,3,25
342300878,72,71,17,37,197
342302263,11,3,2,2,18
342311409,84,24,18,2,128
342318773,15,5,2,2,24
342319342,36,26,2,1,65
342319698,92,8,2,1,103
342320191,72,21,53,1,147
342328733,13,19,2,1,35
342332062,23,6,2,1,32
342332596,71,3,2,1,77
342339717,122,12,16,2,152
342369785,26,27,50,4,107
342377591,48,10,2,3,63
342381548,122,39,21,6,188
342384039,49,42,31,7,129
342410294,89,5,2,2,98
342422932,24,16,6,1,47
342433507,127,6,2,1,136
342437291,48,22,36,1,107
342440170,76,30,5,63,174
342455658,195,12,4,2,213
342458019,38,58,11,10,117
342483404,13,3,2,1,19
342487187,150,29,2,2,183
342518675,41,3,2,1,47
342521761,168,52,23,11,254
342524144,13,23,2,1,39
342525712,20,49,16,4,89
342547079,73,3,2,1,79
342550048,74,14,2,19,109
342554967,10,6,2,1,19
342564965,150,4,2,4,160
342566129,50,8,2,3,63
342571459,471,3,2,1,477
342580658,16,39,2,1,58
342583191,63,26,50,9,148
342593382,17,38,11,19,85
342593735,18,10,2,1,31
342608130,21,47,8,5,81
342608703,56,10,4,4,74
342629116,159,17,15,17,208
342634931,91,4,2,16,113
342647460,130,3,2,1,136
342649839,74,3,2,29,108
342659419,55,16,2,1,74
342666072,110,10,2,1,123
342670518,128,3,2,1,134
342676840,26,3,2,1,32
342677174,30,30,14,7,81
342691438,66,27,61,1,155
342697484,14,30,2,1,47
342698283,56,15,5,7,83
342706524,45,27,2,1,75
342726305,26,36,2,5,69
342733598,100,3,2,9,114
342736954,14,17,3,3,37
342774515,98,14,2,1,115
342792445,13,3,2,1,19
342794497,67,28,51,71,217
342795041,105,3,2,3,113
342797849,12,28,2,1,43
342802482,57,28,23,2,110
342808773,53,30,17,3,103
342809957,35,3,2,1,41
342810741,58,20,2,5,85
342822059,10,49,26,3,88
342846494,12,3,2,1,18
342847028,162,50,4,2,218
342861886,15,3,2,1,21
342877787,20,3,2,1,26
342888520,73,94,39,14,220
342892490,23,5,2,5,35
342898476,217,56,2,38,313
342901947,50,27,31,56,164
342933399,196,5,6,21,228
342948026,11,3,2,3,19
342961616,407,8,2,2,419
342963312,125,34,33,13,205
342965851,37,41,58,9,145
342970647,65,16,36,15,132
342975663,75,37,12,15,139
342991541,10,38,3,2,53
342991582,122,99,16,7,244
343011793,24,14,3,1,42
343011857,72,20,22,1,115
343015583,18,9,2,1,30
343028080,24,4,2,24,54
343035858,65,21,59,1,146
343038715,27,3,2,1,33
343045196,56,16,18,18,108
343046556,43,8,8,1,60
343050575,32,8,3,10,53
343052189,51,3,2,1,57
343094873,112,20,2,1,135
343104435,73,33,5,9,120
343108714,53,7,63,3,126
343110300,94,49,132,50,325
343111044,46,16,11,2,75
343117379,48,14,4,4,70
343117722,148,32,45,29,254
343128626,39,3,2,6,50
343132876,17,10,2,1,30
343137398,100,8,2,1,111
343143197,55,69,7,1,132
343152216,128,31,18,12,189
343152844,25,25,17,31,98
343176169,62,3,2,1,68
343177702,130,93,102,92,417
343192989,14,7,2,2,25
343208835,112,71,5,16,204
343209035,49,3,2,1,55
343212432,90,3,2,18,113
343249010,37,3,2,1,43
343253335,71,11,7,8,97
343265616,81,29,26,17,153
343268538,15,55,2,6,78
343279207,24,13,2,8,47
343280845,70,3,2,1,76
343287273,71,8,2,1,82
343288727,22,41,2,1,66
343290243,151,3,2,10,166
343299326,86,3,2,5,96
343308715,41,37,20,6,104
343312354,99,29,2,1,131
343312830,50,26,74,6,156
343315006,79,16,28,14,137
343317697,61,32,3,8,104
343326914,232,3,2,13,250
343333430,40,26,2,2,70
343342781,104,3,2,1,110
343356133,11,3,2,1,17
343361930,30,12,2,1,45
343363389,87,10,38,4,139
343365310,237,13,2,3,255
343382300,64,102,2,9,177
343384493,68,19,34,13,134
343399447,34,3,4,1,42
343402017,75,12,51,1,139
343412637,56,3,2,2,63
343413995,78,22,24,5,129
343444016,31,14,2,2,49
343452939,25,8,13,1,47
343468376,12,3,2,1,18
343479571,63,3,2,1,69
343480773,520,3,2,1,526
343495096,18,3,2,1,24
343496235,60,46,37,1,144
343514621,54,28,2,2,86
343517460,11,8,2,1,22
343526286,144,6,2,2,154
343538224,13,3,2,1,19
343539654,78,32,4,10,124
343544158,80,3,2,1,86
343560679,24,25,2,1,52
343571686,37,6,2,10,55
343575154,22,6,2,1,31
343593466,21,3,2,1,27
343615560,27,3,2,1,33
343617068,29,9,3,5,46
343629040,22,4,2,6,34
343639287,95,19,11,12,137
343647345,49,20,15,25,109
343651885,63,41,2,4,110
343651906,15,14,4,4,37
343653532,61,16,2,8,87
343658677,69,9,9,7,94
343662794,11,5,2,1,19
343670517,12,4,2,2,20
343690476,92,3,2,15,112
343693005,12,3,2,1,18
343695443,24,8,3,1,36
343696647,13,3,2,1,19
343697093,29,3,2,14,48
343712775,45,3,2,1,51
343714970,220,8,2,4,234
343719393,53,22,65,1,141
343722415,138,29,23,8,198
343732311,121,3,2,1,127
343732484,45,3,2,5,55
343762037,50,3,2,1,56
343763618,106,3,2,1,112
343766998,179,3,2,1,185
343770330,51,26,22,5,104
343772288,11,3,2,1,17
343775077,124,43,34,15,216
343776246,161,3,2,14,180
343777398,11,5,2,1,19
343781665,62,17,7,1,87
343782501,97,32,2,1,132
343782797,10,4,2,1,17
343784512,10,3,2,2,17
343794107,35,42,12,28,117
343804094,65,22,21,4,112
343813081,272,65,2,1,340
343829730,162,3,2,2,169
343833197,33,54,28,20,135
343855520,42,86,11,9,148
343865067,86,31,2,41,160
343876440,152,50,27,7,236
343878040,64,23,2,15,104
343878093,97,3,2,1,103
343880198,49,55,4,55,163
343880951,102,27,20,7,156
343884851,80,20,21,7,128
343901910,98,34,7,21,160
343902039,22,3,2,1,28
343905391,52,30,20,88,190
343910839,27,8,21,1,57
343912596,235,3,2,4,244
343919445,79,29,26,26,160
343921876,34,59,11,18,122
343924713,41,86,2,4,133
343929954,162,3,2,1,168
343934211,43,17,2,1,63
343934740,80,3,2,1,86
343938934,17,34,2,6,59
343940079,10,3,2,2,17
343951854,129,3,36,2,170
343953768,33,14,2,11,60
343967714,218,16,2,3,239
343998036,187,4,7,25,223
344005458,34,39,6,1,80
344021089,29,10,31,2,72
344021212,57,3,2,3,65
344027637,58,10,2,4,74
344032549,11,3,2,1,17
344061169,156,52,2,1,211
344061636,122,3,2,4,131
344073176,34,37,2,8,81
344080359,99,47,13,58,217
344084031,10,16,2,1,29
344085055,58,70,68,5,201
344086292,12,16,2,1,31
344097126,30,18,2,1,51
344115198,46,18,37,1,102
344116619,10,11,2,1,24
344127169,13,49,29,2,93
344137818,52,42,55,39,188
344137944,30,51,4,1,86
344147002,16,3,2,1,22
344153535,85,13,106,13,217
344166197,78,9,2,4,93
344168116,30,10,2,2,44
344181796,79,19,22,4,124
344196298,23,31,42,4,100
344196340,15,5,2,1,23
344202873,41,20,9,1,71
344205260,88,19,6,1,114
344217275,81,3,2,1,87
344223991,51,25,2,1,79
344289111,13,3,2,1,19
344291443,298,3,2,9,312
344292427,88,10,2,1,101
344293713,22,8,2,1,33
344297068,10,3,2,2,17
344297902,117,16,22,22,177
344298548,93,23,2,1,119
344319344,44,49,21,9,123
344321997,11,3,2,1,17
344329668,10,3,2,2,17
344342781,143,3,11,26,183
344352721,11,42,2,1,56
344359747,30,7,2,3,42
344363611,94,17,105,1,217
344365183,56,14,14,1,85
344372054,13,3,2,5,23
344381913,529,3,2,1,535
344386874,71,42,4,1,118
344392753,41,16,2,1,60
344406699,71,14,2,1,88
344422719,36,12,2,2,52
344449577,59,6,2,1,68
344451172,70,79,32,23,204
344463186,42,11,2,1,56
344482781,96,4,2,2,104
344485762,13,3,2,1,19
344489086,44,34,2,1,81
344528814,73,7,3,16,99
344530754,41,53,31,3,128
344541838,64,8,67,5,144
344545999,54,16,13,1,84
344546025,43,3,7,2,55
344559140,331,35,2,63,431
344562541,15,31,10,8,64
344602321,95,3,2,35,135
344603047,82,4,13,62,161
344606427,43,40,9,2,94
344613300,25,10,2,9,46
344614412,35,3,2,1,41
344615157,84,26,4,21,135
344617162,95,3,2,1,101
344619672,28,17,2,3,50
344621147,84,3,2,2,91
344643383,121,31,9,5,166
344648622,135,3,2,7,147
344650042,18,3,2,1,24
344650616,10,4,2,1,17
344672106,31,20,2,2,55
344677329,81,3,2,3,89
344699255,73,3,2,2,80
344703315,79,21,7,4,111
344707579,46,11,2,10,69
344707809,43,30,2,1,76
344713728,103,3,2,5,113
344714713,34,3,2,1,40
344719363,111,31,32,29,203
344727585,14,8,3,2,27
344728199,187,3,2,1,193
344753599,64,48,59,28,199
344755981,233,15,2,8,258
344769126,25,8,2,2,37
344786376,134,3,2,1,140
344807131,27,8,21,10,66
344812806,69,11,7,5,92
344814592,57,41,81,10,189
344819848,58,42,19,8,127
344825169,23,3,2,2,30
344830404,68,37,3,12,120
344830991,129,27,2,5,163
344834451,59,50,13,2,124
344864847,214,54,3,10,281
344867665,65,59,12,10,146
344868136,65,3,2,17,87
344891490,111,3,2,1,117
344898311,30,32,2,1,65
344906174,54,3,15,1,73
344919758,88,47,116,125,376
344929150,30,31,42,15,118
344933191,23,3,2,1,29
344933767,90,3,2,1,96
344941776,25,20,5,2,52
344950273,57,44,46,13,160
344962481,94,68,2,7,171
344965006,31,40,4,1,76
344971873,79,3,17,3,102
344995161,90,29,15,9,143
344997735,22,24,3,44,93
345022053,19,11,2,1,33
345023164,102,10,2,1,115
345030583,130,49,31,4,214
345079997,35,3,2,1,41
345084892,24,46,17,1,88
345110009,42,48,2,20,112
345115875,43,3,2,6,54
345117338,101,70,45,73,289
345122215,44,10,13,1,68
345124504,40,14,4,4,62
345148190,66,3,2,4,75
345172268,88,35,4,1,128
345179705,85,3,2,2,92
345191867,72,32,37,4,145
345194734,118,3,2,5,128
345204984,68,29,35,1,133
345214061,75,41,9,3,128
345218248,48,40,2,1,91
345251398,31,6,12,1,50
345260485,51,3,3,2,59
345272670,134,3,2,1,140
345281935,39,3,2,1,45
345282875,42,16,2,2,62
345301699,18,60,9,2,89
345304521,50,44,6,2,102
345307777,30,3,2,2,37
345317112,10,3,2,2,17
345318923,114,3,2,2,121
345322008,18,3,2,1,24
345365637,45,13,6,4,68
345366046,20,3,2,1,26
345368098,11,3,2,1,17
345368202,36,3,2,1,42
345374352,49,10,2,2,63
345383790,48,30,10,1,89
345385567,19,19,3,2,43
345388416,11,3,2,1,17
345389227,65,17,2,1,85
345416527,17,3,2,1,23
345419495,11,6,2,1,20
345420963,174,3,2,2,181
345426093,13,3,2,1,19
345426302,42,3,3,11,59
345426892,10,7,2,2,21
345436824,96,3,2,3,104
345439984,58,17,14,12,101
345444952,106,3,2,1,112
345445104,116,10,4,2,132
345445221,74,3,2,1,80
345452071,55,28,2,1,86
345453487,91,3,2,1,97
345456593,26,3,2,1,32
345463757,81,12,2,18,113
345475393,13,16,2,3,34
345528409,30,31,3,1,65
345535119,88,24,23,3,138
345540667,39,33,37,1,110
345541224,156,42,2,5,205
345541518,43,3,2,1,49
345557609,56,41,86,54,237
345562140,20,3,2,2,27
345569502,113,3,2,3,121
345578097,158,22,4,14,198
345586053,16,3,2,1,22
345598673,75,3,2,1,81
345609054,39,38,8,1,86
345616313,53,31,31,9,124
345625023,12,3,2,1,18
345626553,68,16,49,3,136
345636209,27,3,2,1,33
345638037,75,50,45,52,222
345672053,26,25,2,3,56
345720692,234,3,2,1,240
345722787,76,3,2,1,82
345745056,13,3,2,8,26
345749696,115,53,52,38,258
345752871,101,3,2,16,122
345770714,70,37,40,28,175
345776044,34,25,2,2,63
345779675,13,3,2,2,20
345780229,48,32,10,6,96
345781647,49,14,2,1,66
345787234,53,10,5,11,79
345790188,10,4,2,1,17
345799283,144,16,2,6,168
345803383,46,3,2,8,59
345812490,33,9,5,2,49
345814385,17,3,2,1,23
345819133,64,67,15,8,154
345820030,11,5,2,1,19
345820056,91,3,2,1,97
345829592,37,20,15,42,114
345831527,61,3,2,1,67
345832383,17,3,2,2,24
345846937,145,3,2,3,153
345849333,25,3,2,1,31
345881465,46,22,2,7,77
345888163,18,34,43,12,107
345890991,13,3,2,1,19
345891413,96,14,2,3,115
345902414,37,76,11,1,125
345905230,144,22,2,4,172
345905314,103,63,5,51,222
345913133,112,21,2,1,136
345926267,105,35,20,53,213
345928215,40,35,2,6,83
345928289,22,3,2,1,28
345932701,119,46,56,60,281
345934884,96,3,2,27,128
345940271,162,28,16,4,210
345941101,13,9,2,1,25
345961547,78,10,2,3,93
345972412,158,3,2,3,166
345976377,58,31,69,8,166
345985287,18,3,2,2,25
345988385,34,3,2,4,43
345990644,119,20,49,2,190
346002158,39,58,8,1,106
346018925,170,52,75,20,317
346020003,78,3,2,1,84
346027790,58,25,2,2,87
346038608,41,18,2,2,63
346039805,61,27,45,1,134
346044671,41,76,29,5,151
346095980,12,10,2,1,25
346096290,25,24,4,1,54
346102394,72,8,2,3,85
346104433,11,3,2,1,17
346109751,77,8,2,1,88
346110165,115,17,4,9,145
346117799,15,11,16,1,43
346118456,11,25,8,1,45
346123487,79,3,2,18,102
346149271,42,28,6,1,77
346153258,55,29,34,9,127
346153725,69,3,2,1,75
346154562,105,3,2,5,115
346154574,33,9,2,1,45
346155286,160,29,10,2,201
346162025,66,21,62,8,157
346170988,140,3,16,8,167
346177421,87,63,2,15,167
346178288,143,3,2,9,157
346206264,19,80,2,1,102
346206543,59,97,37,56,249
346209704,43,24,2,1,70
346210793,53,30,40,24,147
346217241,25,4,2,6,37
346219729,12,3,2,1,18
346225191,234,3,2,3,242
346235908,71,33,27,1,132
346240887,31,9,7,8,55
346251102,23,41,35,20,119
346255664,26,38,15,15,94
346281689,54,30,3,1,88
346282933,100,3,2,1,106
346305742,111,58,34,1,204
346306079,48,3,2,1,54
346315213,58,17,3,3,81
346356043,46,3,2,1,52
346371317,11,6,2,1,20
346372666,15,3,2,1,21
346396320,28,24,2,1,55
346397167,148,10,2,1,161
346399240,71,38,2,11,122
346411757,13,3,2,1,19
346416335,29,48,18,3,98
346418890,56,24,2,2,84
346430718,47,45,29,1,122
346431625,20,3,45,2,70
346440065,46,55,3,3,107
346458155,124,3,2,4,133
346473268,182,3,2,27,214
346476371,39,5,2,2,48
346492153,81,9,2,1,93
346502367,122,3,2,1,128
346509427,65,3,2,2,72
346512264,61,27,17,41,146
346522688,121,23,3,1,148
346531678,69,13,18,2,102
346534753,74,16,3,11,104
346544887,86,3,2,7,98
346556079,16,3,2,5,26
346559249,61,6,2,4,73
346560999,104,3,2,1,110
346562259,16,3,2,1,22
346570010,33,30,24,25,112
346576507,103,19,11,4,137
346584865,193,3,2,2,200
346596158,42,3,2,5,52
346599832,60,40,40,9,149
346609032,124,27,18,12,181
346615914,89,35,86,2,212
346627823,70,3,2,18,93
346661545,134,32,2,1,169
346667061,117,3,2,1,123
346681348,34,3,2,3,42
346682497,130,67,76,1,274
346682789,91,7,2,1,101
346695428,64,22,15,4,105
346708486,35,33,12,21,101
346719793,93,11,3,17,124
346731821,62,34,5,1,102
346733844,47,6,2,3,58
346734581,15,21,20,2,58
346741254,14,3,2,2,21
346759209,76,39,39,21,175
346768210,67,3,2,6,78
346776382,43,22,2,2,69
346779887,54,32,58,20,164
346781919,95,21,89,1,206
346783362,60,19,2,1,82
346801304,72,47,20,29,168
346813406,95,38,23,2,158
346817753,42,28,11,5,86
346818726,91,30,9,28,158
346819971,53,11,5,8,77
346823301,88,21,4,62,175
346825900,16,3,2,2,23
346832923,12,78,2,1,93
346845542,22,3,2,1,28
346849465,49,80,31,73,233
346852573,90,3,2,6,101
346856050,136,3,2,1,142
346859352,45,20,2,5,72
346865369,42,41,11,1,95
346866142,57,59,7,9,132
346875020,37,7,27,1,72
346890477,53,25,2,1,81
346891221,83,46,54,15,198
346901405,68,54,120,8,250
346914827,18,5,2,1,26
346916133,39,35,2,2,78
346985086,60,24,8,3,95
346988694,52,28,22,2,104
346993928,230,7,2,2,241
347008440,32,3,2,3,40
347013026,23,14,2,10,49
347018465,68,3,2,66,139
347018518,55,45,3,2,105
347018813,125,15,43,2,185
347035953,70,20,2,8,100
347038523,189,5,23,1,218
347039520,13,3,2,1,19
347060962,14,3,2,1,20
347071422,20,24,21,1,66
347073969,10,3,2,5,20
347078936,34,19,3,7,63
347082073,17,15,2,1,35
347090142,50,23,6,56,135
347090464,119,6,2,14,141
347091383,69,14,28,5,116
347104556,22,3,2,1,28
347110108,40,3,2,1,46
347111942,103,9,2,9,123
347120824,130,3,2,1,136
347144068,41,23,2,6,72
347146874,97,60,60,8,225
347184949,10,4,2,1,17
347219665,36,9,2,1,48
347229022,47,33,45,12,137
347231758,66,3,2,1,72
347265959,41,21,4,16,82
347278472,23,18,6,3,50
347278819,88,47,11,4,150
347284943,77,42,2,19,140
347292218,38,3,2,5,48
347297098,61,4,2,15,82
347297606,88,14,12,10,124
347304263,54,26,20,16,116
347311540,17,19,2,1,39
347320888,47,9,2,4,62
347343712,28,129,22,30,209
347358279,73,3,2,1,79
347358518,11,3,2,1,17
347366406,53,24,5,4,86
347371633,213,38,21,3,275
347387641,34,14,2,1,51
347389431,35,19,3,1,58
347393354,22,3,2,1,28
347398158,56,3,2,1,62
347414912,14,11,2,1,28
347415536,85,43,2,6,136
347422095,88,3,2,1,94
347450752,111,3,2,1,117
347455279,17,9,2,1,29
347479355,174,3,2,1,180
347482209,118,24,48,14,204
347497990,149,10,19,4,182
347533486,164,25,2,11,202
347538985,65,17,18,11,111
347544077,14,10,7,2,33
347549531,35,27,7,2,71
347587738,60,11,12,6,89
347589627,59,47,29,14,149
347591482,40,3,2,1,46
347592612,190,30,103,2,325
347604778,59,9,2,9,79
347613964,36,10,9,1,56
347638235,38,13,2,1,54
347640265,14,10,2,3,29
347643084,104,20,46,9,179
347651173,52,30,51,12,145
347664477,69,3,2,1,75
347666248,193,46,29,39,307
347666351,11,3,2,2,18
347691618,101,25,2,12,140
347693384,77,33,2,1,113
347706503,39,31,2,2,74
347706617,68,3,2,4,77
347706630,57,25,42,2,126
347714108,12,24,2,1,39
347718807,10,8,2,1,21
347737379,45,8,5,2,60
347754057,53,29,2,1,85
347754702,45,57,16,5,123
347758235,51,3,14,1,69
347762840,32,37,31,5,105
347774556,17,24,2,1,44
347778499,12,34,2,1,49
347783326,59,56,24,34,173
347786293,99,4,2,1,106
347793748,197,22,59,12,290
347809133,99,7,7,6,119
347820214,64,6,19,1,90
347822656,82,3,2,5,92
347850871,11,3,2,1,17
347860403,14,3,2,1,20
347863749,83,30,2,1,116
347882807,38,32,2,1,73
347890313,33,24,13,4,74
347895728,61,31,52,1,145
347897944,27,5,5,15,52
347910321,26,3,2,1,32
347911198,39,3,2,1,45
347912659,94,17,25,3,139
347917007,112,67,53,26,258
347954717,73,20,14,4,111
347962217,29,3,2,2,36
347964172,102,7,2,3,114
347972725,19,3,2,1,25
347973525,43,4,2,11,60
347985147,119,35,5,9,168
348010793,31,9,2,2,44
348050744,27,6,3,1,37
348056053,126,3,2,1,132
348056962,22,3,2,2,29
348061910,81,3,2,1,87
348062321,13,7,2,1,23
348063813,79,3,2,1,85
348066197,99,46,24,15,184
348066711,19,7,2,1,29
348102857,50,3,2,1,56
348108448,43,3,2,7,55
348108704,81,21,15,16,133
348109664,13,3,2,1,19
348110804,135,21,22,2,180
348164154,74,28,2,2,106
348182111,47,38,48,5,138
348209272,20,3,2,1,26
348223640,14,6,2,1,23
348242915,52,11,57,31,151
348249323,36,11,2,2,51
348255783,61,3,2,1,67
348273243,16,8,2,1,27
348295590,20,3,2,3,28
348296346,12,11,2,1,26
348304752,68,11,2,1,82
348312268,35,3,2,15,55
348315640,225,3,2,1,231
348316323,72,49,18,2,141
348322365,16,3,2,5,26
348324321,19,37,2,15,73
348327284,41,27,10,5,83
348328901,77,35,13,1,126
348339746,33,9,2,2,46
348348629,40,28,2,1,71
348356886,86,48,2,6,142
348358338,85,4,2,2,93
348399671,10,9,2,1,22
348401838,116,19,2,3,140
348402719,67,59,2,21,149
348407552,80,26,61,7,174
348410221,13,24,2,1,40
348414494,68,3,2,2,75
348423594,49,22,5,3,79
348443689,76,13,66,1,156
348463613,41,7,2,6,56
348463758,29,69,13,6,117
348464543,45,6,2,8,61
348467319,11,4,2,1,18
348476598,39,30,4,3,76
348485215,130,3,2,1,136
348487592,94,27,2,12,135
348496553,14,8,2,1,25
348506423,195,3,2,1,201
348519734,93,33,34,1,161
348526247,107,3,2,1,113
348558701,58,8,20,3,89
348596625,59,3,2,1,65
348600271,163,23,3,8,197
348617041,51,28,5,2,86
348618650,70,28,22,1,121
348622241,28,11,2,1,42
348627153,83,10,8,8,109
348636277,14,3,2,1,20
348642231,45,14,11,8,78
348645608,40,20,60,1,121
348646062,10,4,2,1,17
348654942,11,3,2,1,17
348670980,32,22,2,9,65
348695101,24,11,22,9,66
348702050,62,38,18,31,149
348729092,422,3,2,13,440
348732719,38,38,45,13,134
348735757,19,3,2,1,25
348743932,100,23,21,27,171
348745443,24,10,2,3,39
348757652,34,31,2,2,69
348768986,55,3,2,2,62
348775109,96,25,10,1,132
348797462,100,32,15,1,148
348804433,72,3,2,6,83
348805427,10,7,2,1,20
348851734,81,45,59,32,217
348854585,21,14,10,1,46
348865141,41,4,2,1,48
348865633,13,3,2,1,19
348879687,86,72,35,29,222
348882956,37,13,21,11,82
348889452,52,13,22,13,100
348900435,21,28,86,2,137
348940487,92,39,26,4,161
348943223,111,54,10,1,176
348945237,114,23,26,5,168
348945303,16,3,2,2,23
348951760,47,9,17,3,76
348954723,36,11,7,34,88
348955163,29,27,2,9,67
348957864,11,9,2,1,23
348959192,30,10,2,3,45
348959920,43,11,2,15,71
348960821,143,69,12,1,225
348962293,107,3,2,1,113
348972651,51,16,43,5,115
348987914,108,14,2,5,129
348989360,36,37,34,18,125
348990597,129,37,30,6,202
348996771,57,6,2,4,69
349020313,10,4,2,1,17
349023898,51,7,2,4,64
349035469,49,15,11,1,76
349043518,49,44,2,2,97
349046105,74,35,17,23,149
349051835,107,28,2,13,150
349056459,82,25,5,50,162
349062519,81,4,2,1,88
349065825,57,59,4,11,131
349072538,150,3,2,7,162
349079481,11,3,2,1,17
349081902,26,64,18,9,117
349083958,33,19,2,1,55
349085109,12,4,2,4,22
349090520,73,18,88,16,195
349106195,40,3,2,2,47
349109183,57,3,2,7,69
349114507,72,49,49,15,185
349117336,26,34,2,1,63
349139104,60,30,39,18,147
349141791,148,3,2,1,154
349174798,158,3,2,9,172
349180059,121,41,12,3,177
349180445,28,3,2,5,38
349194665,35,3,2,1,41
349198431,33,16,2,3,54
349199133,30,24,2,1,57
349212902,25,21,18,1,65
349213426,15,3,2,1,21
349227321,119,16,15,17,167
349244382,15,14,2,1,32
349268870,21,9,2,1,33
349269969,10,5,2,1,18
349273979,99,5,4,2,110
349275049,15,5,2,1,23
349289157,74,3,2,2,81
349308099,75,18,34,39,166
349310829,77,14,37,38,166
349312292,53,41,13,7,114
349313552,149,47,40,60,296
349322436,225,3,2,7,237
349353779,50,32,2,1,85
349357819,111,43,2,17,173
349367164,79,17,29,29,154
349378715,91,39,3,1,134
349397244,29,25,10,1,65
349406451,175,3,2,4,184
349430240,10,4,2,3,19
349430405,151,28,26,3,208
349434430,96,28,34,55,213
349435001,71,3,2,1,77
349446986,92,25,2,4,123
349447729,184,21,41,4,250
349457695,100,3,15,1,119
349458108,66,11,2,3,82
349464850,46,3,2,1,52
349468788,242,82,2,9,335
349469723,51,21,2,5,79
349471872,44,4,2,1,51
349484992,49,40,11,3,103
349500044,156,3,2,14,175
349517445,10,9,2,1,22
349538120,174,46,2,1,223
349553049,109,47,50,6,212
349570954,47,9,2,1,59
349579544,64,3,2,9,78
349583791,130,6,2,22,160
349596427,76,31,3,25,135
349597793,161,19,56,1,237
349602961,18,3,2,2,25
349603750,28,17,20,1,66
349603893,68,3,2,1,74
349604261,59,60,81,2,202
349612035,53,3,2,1,59
349612791,171,36,20,2,229
349613735,160,22,4,10,196
349618909,123,5,34,1,163
349654885,70,37,38,10,155
349669831,211,3,2,9,225
349675195,14,3,2,2,21
349675757,57,50,2,74,183
349693882,92,15,2,23,132
349706759,23,15,5,6,49
349723972,19,50,13,12,94
349748718,17,3,2,1,23
349750400,165,3,2,12,182
349756307,16,3,2,1,22
349758761,136,10,12,1,159
349758996,33,6,6,3,48
349767903,96,24,52,1,173
349784374,19,3,2,1,25
349814044,69,5,2,1,77
349821199,70,22,14,3,109
349821748,65,33,2,2,102
349823345,87,15,13,10,125
349831812,336,3,2,2,343
349833587,28,43,9,12,92
349839403,13,13,2,1,29
349847829,142,29,2,1,174
349874336,96,14,2,4,116
349878187,76,34,36,70,216
349879604,82,19,36,9,146
349882258,231,28,75,5,339
349882710,60,9,2,1,72
349897123,123,3,2,4,132
349910163,21,8,2,2,33
349910200,29,65,26,7,127
349917906,10,7,2,1,20
349931047,18,3,3,1,25
349935630,96,3,2,1,102
349941462,329,43,2,15,389
349947537,50,13,26,6,95
349964802,121,3,2,5,131
349971556,14,3,2,1,20
349974971,10,11,2,1,24
349981860,31,65,20,10,126
349984024,28,11,2,2,43
349986741,66,3,2,1,72
349988970,147,45,67,41,300
349990799,24,27,2,1,54
350013699,126,15,47,1,189
350024843,135,43,30,1,209
350029426,104,26,8,8,146
350032850,11,3,2,1,17
350034909,173,3,2,3,181
350037421,17,29,2,1,49
350040759,67,18,2,1,88
350042246,120,25,14,20,179
350045621,77,3,2,1,83
350065262,94,3,2,3,102
350068980,27,24,40,10,101
350083244,18,21,2,6,47
350090167,87,61,2,12,162
350090661,43,57,2,2,104
350092883,21,11,6,31,69
350093577,41,73,30,1,145
350101609,24,5,2,1,32
350119404,11,3,2,1,17
350122024,48,3,2,1,54
350143221,122,3,2,4,131
350145988,84,5,3,1,93
350158280,144,31,3,1,179
350161547,230,5,2,38,275
350169128,78,3,2,1,84
350177144,41,23,36,8,108
350187973,40,3,2,10,55
350202966,22,33,5,1,61
350210569,42,59,29,1,131
350231386,63,23,2,5,93
350247688,30,33,13,1,77
350269974,38,3,2,12,55
350280686,18,5,2,7,32
350297234,151,43,33,52,279
350304965,15,6,2,1,24
350319096,50,23,53,53,179
350329382,55,3,2,1,61
350348841,17,32,2,1,52
350355102,12,8,2,2,24
350362453,21,44,4,1,70
350372700,22,3,2,4,31
350372757,41,21,2,1,65
350380927,72,14,20,1,107
350389894,18,24,141,2,185
350411098,38,61,140,55,294
350411170,10,5,2,1,18
350411817,502,3,2,94,601
350417990,25,18,3,3,49
350430533,46,3,2,1,52
350430767,82,23,2,1,108
350448068,31,21,6,11,69
350458357,75,39,14,3,131
350458801,202,14,7,19,242
350465140,42,60,8,8,118
350476721,13,10,2,1,26
350483863,51,18,40,23,132
350510734,63,39,21,7,130
350533624,181,3,2,6,192
350548517,110,35,15,54,214
350569990,186,9,2,11,208
350570399,34,10,2,8,54
350571743,27,25,25,3,80
350617408,66,32,73,78,249
350635221,33,6,2,1,42
350651020,53,73,18,1,145
350665021,21,7,2,1,31
350668074,15,63,2,1,81
350689397,72,85,51,9,217
350694629,162,3,2,5,172
350709001,31,3,2,10,46
350720740,103,3,2,1,109
350730352,114,22,24,32,192
350732670,88,10,2,10,110
350733796,18,3,2,1,24
350734352,82,101,15,1,199
350739381,37,47,2,1,87
350742621,96,33,2,5,136
350743441,93,6,3,1,103
350744516,39,3,2,1,45
350749538,51,17,2,2,72
350754471,52,32,70,1,155
350791783,71,56,3,4,134
350797311,203,6,16,1,226
350813570,16,4,2,5,27
350818547,24,15,4,11,54
350821306,87,8,5,2,102
350829492,29,3,2,7,41
350835806,75,28,35,55,193
350839187,28,18,2,1,49
350841867,117,28,31,3,179
350842477,62,25,5,1,93
350846192,485,64,34,7,590
350858991,29,25,7,11,72
350867080,88,3,2,3,96
350874141,12,3,2,1,18
350874962,34,5,2,1,42
350882157,15,73,2,3,93
350883683,31,29,2,3,65
350884818,20,27,5,6,58
350891075,286,3,2,4,295
350897211,88,108,12,3,211
350941298,45,3,2,1,51
350947083,30,5,5,2,42
350959161,62,3,2,1,68
350963791,67,33,45,27,172
350972667,25,3,2,3,33
350974273,56,11,48,5,120
350980931,19,3,2,3,27
350990817,18,8,16,1,43
351001455,63,46,2,45,156
351005496,50,9,2,7,68
351008789,13,27,2,1,43
351010202,25,14,2,1,42
351027006,46,5,5,2,58
351028123,63,5,6,3,77
351029368,31,150,18,2,201
351042184,12,3,2,1,18
351047793,65,35,25,7,132
351049817,37,3,2,1,43
351051734,49,80,22,1,152
351055376,41,37,73,2,153
351056000,126,41,4,4,175
351075867,89,8,2,1,100
351076292,12,3,2,3,20
351078587,22,4,2,1,29
351081777,38,21,52,107,218
351096513,11,3,2,1,17
351096904,16,3,2,1,22
351097767,39,13,25,1,78
351101238,11,8,4,1,24
351105426,38,3,2,2,45
351106814,15,20,2,4,41
351112388,274,3,2,1,280
351130362,228,29,14,1,272
351130653,10,3,8,1,22
351137931,108,5,6,6,125
351138015,101,3,2,6,112
351148502,71,13,2,1,87
351161328,41,7,35,7,90
351173093,88,3,4,2,97
351182293,58,16,2,1,77
351187883,32,49,15,3,99
351194322,12,3,2,1,18
351204350,170,3,2,11,186
351206199,113,44,44,89,290
351226682,311,3,2,2,318
351237108,40,3,2,1,46
351259582,32,3,2,6,43
351266862,106,10,85,28,229
351268133,13,3,2,3,21
351282749,71,4,2,1,78
351285105,103,16,5,2,126
351306716,11,3,2,1,17
351312836,78,14,2,4,98
351322824,242,34,20,4,300
351327942,15,6,2,1,24
351348868,42,4,2,3,51
351363040,94,24,10,21,149
351365256,15,3,2,1,21
351371138,44,3,2,6,55
351378999,110,3,2,1,116
351379660,96,3,2,1,102
351391176,61,3,2,1,67
351396812,121,5,2,1,129
351397075,45,12,4,3,64
351404361,81,17,9,2,109
351419484,28,57,2,1,88
351468456,36,37,2,1,76
351468676,27,75,2,1,105
351474951,111,15,49,2,177
351477168,57,12,11,9,89
351477214,62,3,2,1,68
351477378,65,27,3,42,137
351490474,22,4,5,8,39
351501052,92,104,13,19,228
351504842,11,4,2,1,18
351506096,141,3,2,2,148
351506658,87,3,2,2,94
351510814,224,26,2,36,288
351514320,135,68,7,4,214
351518785,185,3,2,1,191
351523815,12,4,2,1,19
351536355,43,39,12,1,95
351550415,63,68,81,3,215
351554376,53,4,2,12,71
351566897,81,3,2,6,92
351566927,100,9,4,1,114
351567665,60,11,11,5,87
351568221,138,25,9,1,173
351568903,304,3,2,20,329
351575271,19,3,2,1,25
351578998,77,38,33,6,154
351599201,69,15,2,1,87
351620601,19,3,2,1,25
351627046,79,70,2,3,154
351630321,16,3,2,1,22
351650703,13,3,3,1,20
351655095,13,3,2,1,19
351672885,113,11,64,1,189
351677932,11,6,2,1,20
351681814,74,3,2,1,80
351691101,90,37,15,14,156
351691226,58,25,2,1,86
351695876,225,33,2,2,262
351697160,63,14,2,7,86
351711618,107,60,41,45,253
351718582,40,3,2,8,53
351721824,94,35,53,6,188
351756328,42,3,2,1,48
351774381,100,33,4,8,145
351775346,103,5,108,1,217
351792205,71,3,2,1,77
351826657,12,3,2,1,18
351831164,178,18,2,2,200
351834938,96,7,10,1,114
351838868,11,3,2,1,17
351844111,63,3,2,1,69
351857293,185,8,13,2,208
351876929,10,9,2,1,22
351888998,64,3,3,2,72
351897916,42,3,2,3,50
351903394,84,18,2,2,106
351903595,147,3,2,1,153
351906911,134,3,2,1,140
351917336,32,49,9,7,97
351923797,12,3,2,1,18
351925982,125,97,127,3,352
351936686,111,50,27,30,218
351938513,89,21,4,1,115
351942222,53,3,2,4,62
351944941,32,13,3,1,49
351948994,13,3,2,4,22
351962360,12,3,2,1,18
351965629,61,22,2,3,88
351969567,19,6,2,1,28
351985837,27,10,2,6,45
351986825,39,25,2,1,67
351989635,40,3,2,1,46
351995161,47,62,32,1,142
352001473,41,25,53,18,137
352033486,14,24,2,1,41
352036013,74,7,3,9,93
352047157,10,3,2,2,17
352052053,93,3,2,1,99
352072611,37,41,8,2,88
352073490,39,3,2,2,46
352082503,79,3,2,4,88
352093483,14,11,2,1,28
352097394,84,3,2,2,91
352107719,23,46,2,2,73
352109395,103,12,12,2,129
352109933,52,5,2,1,60
352116944,29,5,7,6,47
352121792,90,6,6,3,105
352123751,10,3,2,6,21
352124563,75,16,14,20,125
352126665,61,11,4,12,88
352142553,54,11,2,22,89
352147311,10,3,2,2,17
352150150,11,8,2,4,25
352151477,25,22,39,3,89
352183146,135,42,29,7,213
352183455,91,36,27,16,170
352187123,11,5,2,1,19
352192326,72,3,2,2,79
352204282,104,38,42,17,201
352234723,54,32,8,1,95
352241532,49,3,2,1,55
352252416,51,62,12,37,162
352258749,13,3,2,1,19
352261167,28,3,2,1,34
352272557,15,7,2,2,26
352280734,399,53,2,19,473
352291536,128,3,2,1,134
352292402,13,3,2,1,19
352298276,27,17,2,2,48
352323243,22,8,2,14,46
352330822,55,15,14,1,85
352334546,125,24,63,1,213
352335832,18,52,4,1,75
352358617,43,3,12,1,59
352359273,12,4,2,2,20
352362746,474,3,2,1,480
352394071,47,3,2,1,53
352429153,40,71,29,16,156
352429433,117,3,2,1,123
352437637,85,19,12,14,130
352437779,63,79,72,21,235
352447246,84,3,2,3,92
352459264,37,3,2,3,45
352461073,70,3,2,1,76
352462120,18,18,2,1,39
352475829,22,18,2,1,43
352480444,71,57,44,17,189
352491148,11,3,2,2,18
352493610,85,30,7,7,129
352495106,47,77,2,18,144
352504816,83,14,31,2,130
352511330,105,54,106,15,280
352512844,100,3,2,3,108
352530695,12,5,2,1,20
352530738,35,19,2,2,58
352537314,165,3,2,1,171
352539492,11,3,2,1,17
352554131,35,32,2,2,71
352557480,61,31,5,7,104
352566499,13,20,2,1,36
352568680,149,6,9,11,175
352588050,26,55,7,37,125
352595777,89,11,2,5,107
352601435,35,18,53,9,115
352630055,129,54,83,68,334
352669043,81,10,2,3,96
352673889,12,12,2,1,27
352678545,54,4,4,1,63
352687162,37,3,2,2,44
352692955,45,3,2,3,53
352706737,10,3,2,2,17
352718199,43,21,2,3,69
352719508,14,3,2,1,20
352721795,142,12,2,3,159
352723376,166,40,59,10,275
352728415,36,36,15,3,90
352744014,91,9,38,1,139
352745656,16,3,2,1,22
352746658,64,33,2,4,103
352759163,50,3,2,11,66
352761674,41,3,2,1,47
352762778,22,3,2,1,28
352766182,11,3,2,1,17
352769134,77,3,2,16,98
352771618,166,8,2,4,180
352784760,93,14,46,8,161
352784787,49,3,2,1,55
352800352,28,40,15,32,115
352801537,51,3,2,1,57
352802800,152,7,21,4,184
352804546,10,16,2,1,29
352816676,171,3,2,3,179
352819723,109,24,11,6,150
352824319,188,43,2,3,236
352843148,15,3,2,1,21
352845807,50,11,10,3,74
352869757,10,3,2,7,22
352920458,92,5,2,1,100
352921540,74,3,2,1,80
352931041,43,37,13,9,102
352936678,80,221,6,3,310
352940462,65,3,2,7,77
352948093,72,39,15,18,144
352954790,13,23,2,3,41
352956759,35,26,2,1,64
352959318,17,3,2,1,23
352965872,43,12,2,2,59
352967749,211,33,7,1,252
352987983,45,116,37,2,200
352989855,47,3,2,9,61
353006054,102,3,2,1,108
353028625,39,19,4,15,77
353031811,44,3,2,1,50
353033921,18,3,2,1,24
353040517,18,53,2,1,74
353043358,44,46,6,4,100
353048083,220,3,2,7,232
353049430,78,31,2,1,112
353055638,68,3,2,4,77
353059435,197,23,11,1,232
353065763,25,28,12,11,76
353084666,120,168,32,28,348
353087465,41,21,49,8,119
353093965,88,37,50,2,177
353096925,18,3,2,1,24
353098262,16,6,2,1,25
353104655,29,25,2,1,57
353110350,13,26,2,1,42
353115589,127,3,2,12,144
353121570,60,21,2,1,84
353156507,53,3,2,1,59
353170678,93,19,23,8,143
353179627,48,25,34,19,126
353179924,157,3,2,1,163
353185515,41,3,2,1,47
353186857,85,5,10,13,113
353192136,10,8,2,3,23
353207768,135,20,10,13,178
353208199,80,41,2,3,126
353219556,13,3,2,1,19
353222745,73,15,2,11,101
353228182,47,49,12,1,109
353242269,10,3,2,3,18
353243224,44,32,3,21,100
353244832,10,4,3,4,21
353245560,98,9,2,7,116
353246671,12,3,2,1,18
353248591,84,30,3,1,118
353268847,112,26,15,6,159
353283001,28,57,11,26,122
353284130,29,18,2,1,50
353304299,47,19,17,5,88
353307929,74,47,8,25,154
353316815,110,3,2,6,121
353366406,92,53,22,9,176
353367577,16,3,2,1,22
353372067,17,3,2,1,23
353384765,31,8,2,1,42
353392398,34,42,2,2,80
353396666,58,12,2,2,74
353411152,75,4,55,4,138
353435220,36,47,18,11,112
353441400,75,3,2,2,82
353444926,217,28,7,10,262
353449761,31,14,2,3,50
353457227,12,3,2,1,18
353457410,30,14,2,1,47
353459552,53,35,14,13,115
353484938,10,4,2,1,17
353485305,59,3,2,1,65
353489532,139,3,2,3,147
353498233,28,7,7,1,43
353500565,90,3,2,74,169
353512654,40,41,32,16,129
353513665,77,65,7,2,151
353517505,42,3,2,9,56
353530281,184,23,32,16,255
353538992,15,14,2,3,34
353539725,173,3,2,36,214
353551594,149,4,2,7,162
353554339,243,22,21,28,314
353557752,26,3,2,1,32
353561019,12,16,2,1,31
353581742,11,21,2,1,35
353591718,61,20,8,10,99
353595182,23,3,2,1,29
353612789,83,12,4,1,100
353635068,160,16,10,20,206
353639865,56,3,2,1,62
353681841,14,4,9,1,28
353698745,24,50,33,15,122
353701702,97,11,14,35,157
353707797,65,3,2,1,71
353710569,69,34,35,11,149
353711622,281,18,2,1,302
353716524,625,7,9,39,680
353716750,37,10,2,1,50
353721718,107,11,2,3,123
353735487,91,59,28,16,194
353750494,27,3,2,1,33
353775721,146,3,2,10,161
353784762,14,15,2,1,32
353785509,131,4,2,1,138
353789128,130,3,2,1,136
353794802,160,39,23,2,224
353796243,45,26,47,2,120
353806598,118,3,2,5,128
353823645,13,3,2,2,20
353840120,95,33,10,9,147
353850495,18,3,2,2,25
353853591,57,14,42,9,122
353859519,22,28,2,1,53
353861966,44,3,2,1,50
353867799,14,3,2,1,20
353868651,13,3,2,1,19
353880073,36,3,2,1,42
353890027,17,19,2,1,39
353890423,73,23,3,2,101
353893580,14,3,2,1,20
353903297,49,6,26,1,82
353918725,91,3,2,7,103
353944360,90,13,3,6,112
353946199,18,18,2,2,40
353956692,50,21,3,7,81
353973097,10,31,2,1,44
353977433,103,18,8,1,130
353980533,76,37,23,15,151
353986885,146,3,2,2,153
353989107,98,3,2,1,104
353996167,174,3,2,1,180
354020892,39,3,2,1,45
354038126,60,14,2,2,78
354056277,24,7,2,1,34
354063737,66,20,54,1,141
354065721,49,33,7,1,90
354069922,10,5,2,1,18
354085689,22,3,2,1,28
354095494,13,20,2,1,36
354100247,71,16,46,5,138
354101493,120,3,2,2,127
354106092,11,3,2,1,17
354112465,49,20,3,1,73
354120386,41,3,2,1,47
354127639,51,11,2,1,65
354138141,56,7,2,10,75
354144178,25,3,2,1,31
354144928,78,3,2,1,84
354155180,39,16,2,1,58
354156495,101,3,2,1,107
354171581,121,5,2,1,129
354184894,46,35,10,9,100
354187104,67,18,28,26,139
354188063,24,32,5,16,77
354192392,94,6,19,1,120
354192820,50,43,3,1,97
354195516,31,18,2,1,52
354210249,31,20,2,3,56
354211711,156,8,9,2,175
354212308,25,3,2,3,33
354217121,54,3,2,4,63
354224323,37,37,55,15,144
354236423,58,40,2,2,102
354242136,12,3,2,1,18
354258739,84,37,2,1,124
354265796,58,3,2,27,90
354266118,73,29,2,8,112
354278384,212,30,3,91,336
354290505,25,7,3,1,36
354295444,85,3,2,1,91
354320083,22,4,2,1,29
354326633,89,8,48,5,150
354345275,103,43,3,49,198
354350501,54,11,16,1,82
354354285,116,3,2,2,123
354361094,27,3,2,1,33
354362233,180,38,21,1,240
354386832,59,3,2,14,78
354397391,56,29,10,13,108
354404336,16,3,2,1,22
354404913,12,4,2,1,19
354418548,43,53,17,9,122
354443612,72,3,2,3,80
354450010,39,11,4,1,55
354458654,57,7,15,1,80
354459517,32,16,3,15,66
354463410,89,24,2,7,122
354466764,85,38,2,2,127
354469221,10,5,2,1,18
354470487,198,3,2,1,204
354483131,11,3,2,1,17
354489953,18,23,7,2,50
354490889,200,22,2,12,236
354491144,43,9,2,1,55
354497804,73,5,5,15,98
354498536,83,15,2,5,105
354500589,31,26,25,7,89
354528395,101,4,69,1,175
354531892,104,12,50,1,167
354545785,12,3,2,1,18
354554279,98,26,14,13,151
354555969,13,23,2,1,39
354577722,154,41,33,21,249
354583679,46,26,18,24,114
354589459,78,28,3,22,131
354589769,72,26,7,1,106
354630880,155,3,2,10,170
354633599,10,4,2,1,17
354639112,125,3,2,1,131
354640124,20,40,6,5,71
354664050,29,22,5,1,57
354675213,48,7,2,9,66
354683975,11,3,2,1,17
354686264,12,3,2,1,18
354692785,98,19,2,19,138
354693482,11,3,2,1,17
354697617,28,19,2,1,50
354698510,104,12,2,37,155
354712418,13,39,2,1,55
354713791,108,14,53,24,199
354714456,81,4,3,1,89
354716830,170,38,5,3,216
354736139,145,3,5,1,154
354739713,152,3,2,7,164
354742682,59,10,2,4,75
354752967,24,22,2,3,51
354753921,249,3,2,10,264
354759652,154,3,2,19,178
354771487,92,3,2,1,98
354792280,65,29,46,1,141
354805097,64,23,189,14,290
354813400,15,3,2,1,21
354829389,202,38,5,1,246
354862419,141,58,6,4,209
354867803,114,3,2,3,122
354874393,112,46,111,6,275
354877588,16,3,2,1,22
354882356,124,60,7,109,300
354886704,24,25,2,1,52
354888391,27,17,7,21,72
354889118,107,17,2,1,127
354889257,72,19,2,12,105
354890648,12,3,2,2,19
354890908,39,3,2,1,45
354891289,17,9,2,5,33
354897415,86,53,19,2,160
354902027,65,13,2,2,82
354902337,11,8,2,1,22
354909497,80,13,2,7,102
354909760,41,6,2,2,51
354917529,17,39,4,3,63
354940489,135,28,20,40,223
354952717,144,4,33,3,184
354957804,112,14,3,8,137
354958852,152,13,25,55,245
354973481,53,5,25,1,84
354981749,43,31,2,2,78
354983739,18,3,2,1,24
354992664,117,3,2,1,123
355004305,47,36,8,8,99
355014355,71,38,41,3,153
355044760,87,17,3,9,116
355046475,52,20,30,8,110
355057094,102,72,32,15,221
355058775,52,19,2,12,85
355061060,96,10,2,2,110
355105349,208,3,2,2,215
355113339,28,30,4,2,64
355113354,48,23,2,1,74
355124170,13,3,2,1,19
355129023,10,3,2,2,17
355139538,71,8,80,1,160
355140275,87,16,2,1,106
355146744,108,16,33,18,175
355170122,32,41,2,3,78
355191000,11,3,2,1,17
355193442,121,29,31,6,187
355197610,53,38,10,12,113
355202480,61,12,2,1,76
355202519,39,22,2,21,84
355207670,173,3,2,3,181
355218580,19,3,2,1,25
355233404,13,3,2,1,19
355245942,10,4,2,1,17
355248083,21,10,2,1,34
355252597,141,64,4,2,211
355255325,108,30,11,17,166
355257333,93,3,2,1,99
355278935,83,15,2,1,101
355286605,72,6,15,1,94
355317582,62,118,52,57,289
355326339,20,4,2,2,28
355328948,131,22,2,1,156
355331943,11,3,2,1,17
355338609,51,3,2,6,62
355339504,232,3,2,10,247
355340982,91,44,30,4,169
355355203,80,61,5,55,201
355356267,14,21,5,3,43
355358107,80,32,2,1,115
355361450,15,3,2,1,21
355363325,72,37,7,27,143
355373280,86,21,2,8,117
355374641,67,3,2,2,74
355389329,12,3,2,1,18
355392525,121,3,2,2,128
355393784,48,4,13,5,70
355403641,70,23,17,9,119
355408707,63,18,24,6,111
355409246,60,12,19,9,100
355410607,42,3,2,1,48
355422412,34,31,16,9,90
355442699,121,27,78,22,248
355444938,17,15,2,1,35
355450826,91,21,2,45,159
355456277,179,42,34,54,309
355493852,14,12,2,1,29
355534942,11,17,44,5,77
355548437,10,28,12,1,51
355550777,128,44,24,1,197
355566969,11,3,2,1,17
355566985,58,11,2,4,75
355591040,39,3,2,1,45
355593786,61,3,2,1,67
355597244,108,3,2,1,114
355619807,40,25,3,2,70
355629236,38,17,2,13,70
355633947,89,3,2,5,99
355634971,20,18,22,4,64
355636943,93,55,3,3,154
355641099,45,3,2,16,66
355641529,20,20,61,3,104
355646928,21,19,14,4,58
355653485,63,3,2,6,74
355661696,13,3,2,3,21
355662855,44,75,6,1,126
355670332,11,3,2,1,17
355677537,327,3,2,37,369
355681236,33,13,20,1,67
355682926,108,29,18,2,157
355690976,31,54,2,1,88
355698231,18,47,58,1,124
355700120,52,29,2,2,85
355701096,34,5,2,1,42
355702637,172,17,2,1,192
355706001,88,3,2,3,96
355710771,86,18,2,4,110
355718834,19,3,2,2,26
355719445,22,3,2,1,28
355722414,43,32,8,47,130
355728769,74,28,3,9,114
355729541,39,26,13,21,99
355746394,14,28,2,1,45
355765252,61,7,3,2,73
355765273,97,3,2,1,103
355778641,119,23,3,6,151
355789706,199,3,2,1,205
355790945,59,27,36,11,133
355799855,10,6,2,1,19
355823206,75,3,2,3,83
355843378,57,3,2,3,65
355865382,84,30,50,10,174
355874553,56,20,4,1,81
355890063,126,13,33,42,214
355892379,73,3,2,1,79
355895925,11,3,2,1,17
355896201,116,12,47,3,178
355900228,20,47,10,2,79
355918892,69,59,25,7,160
355920502,19,8,2,1,30
355924023,97,18,2,1,118
355926645,69,9,2,2,82
355934957,35,28,7,1,71
355940929,75,22,2,16,115
355947062,45,53,63,11,172
355962030,12,5,2,1,20
355977613,67,12,2,50,131
355991745,128,32,25,1,186
355995615,16,5,2,1,24
356004336,115,19,18,1,153
356011090,28,57,12,1,98
356015857,73,3,2,1,79
356016317,97,6,2,1,106
356026226,80,3,2,33,118
356060873,27,3,2,1,33
356067013,37,3,2,1,43
356069818,88,72,103,4,267
356070629,17,3,2,1,23
356076770,52,46,44,14,156
356077606,26,33,10,1,70
356085851,12,3,2,1,18
356111191,11,3,2,1,17
356113590,40,24,9,15,88
356139043,387,3,2,2,394
356139860,18,3,2,3,26
356148539,14,5,2,1,22
356158415,17,3,2,1,23
356164148,14,3,2,2,21
356164193,22,3,2,1,28
356173475,11,3,2,1,17
356202449,40,11,2,2,55
356209182,116,3,2,2,123
356212432,95,35,2,48,180
356238018,14,44,2,3,63
356244816,52,28,24,29,133
356245907,22,14,2,1,39
356256771,54,4,2,1,61
356256987,76,54,21,5,156
356264838,36,23,5,1,65
356265571,44,15,2,6,67
356275780,11,10,2,1,24
356297123,172,3,2,19,196
356313649,13,18,2,1,34
356315774,36,5,9,8,58
356316038,15,13,2,1,31
356321572,75,55,81,9,220
356322062,121,91,35,2,249
356335366,98,18,2,1,119
356336523,14,3,2,1,20
356340228,27,15,2,1,45
356352829,22,5,2,1,30
356358424,15,3,2,4,24
356372182,29,8,2,6,45
356398057,15,36,2,1,54
356401116,73,35,11,1,120
356410542,61,26,17,56,160
356413778,50,4,8,11,73
356416767,61,14,2,16,93
356418523,63,22,2,3,90
356429925,58,48,98,6,210
356444829,26,16,36,2,80
356454370,60,22,2,5,89
356456367,102,40,80,9,231
356459709,12,3,2,3,20
356461436,82,24,19,72,197
356463456,132,48,19,17,216
356476922,130,8,2,3,143
356478867,17,3,5,1,26
356498744,121,37,22,18,198
356502885,67,16,30,3,116
356508190,35,6,3,3,47
356532340,11,5,4,1,21
356537131,16,10,4,1,31
356538124,40,59,9,12,120
356543517,72,3,2,2,79
356544935,29,27,35,2,93
356581085,32,19,23,2,76
356590724,140,7,33,1,181
356600668,16,22,2,1,41
356600708,51,60,16,48,175
356603608,232,3,2,59,296
356634231,125,25,2,4,156
356640645,17,3,2,1,23
356661452,16,3,2,1,22
356663955,12,3,2,3,20
356694689,15,3,2,3,23
356715353,74,37,69,10,190
356716747,105,23,7,1,136
356717229,17,32,2,1,52
356735993,29,27,5,1,62
356751453,30,32,19,31,112
356754272,18,3,2,1,24
356768035,180,3,2,1,186
356783852,57,19,2,9,87
356785284,21,43,2,2,68
356798588,48,3,2,1,54
356805731,133,3,17,1,154
356816376,22,3,2,1,28
356819411,398,3,2,12,415
356821895,20,36,2,1,59
356824434,73,3,2,1,79
356833004,96,54,8,3,161
356857414,44,101,80,29,254
356859059,31,83,6,2,122
356859798,10,11,2,1,24
356891353,50,10,3,4,67
356901315,33,11,2,1,47
356909824,61,3,2,2,68
356927260,33,15,3,6,57
356931938,58,6,2,5,71
356932616,71,16,43,17,147
356958847,62,3,2,1,68
356963398,396,3,2,1,402
356964820,52,5,3,4,64
356965781,10,3,2,3,18
356977835,136,35,2,5,178
356986202,155,73,36,19,283
356998030,47,3,2,10,62
357002282,30,21,3,8,62
357041791,33,48,19,12,112
357051574,11,3,2,1,17
357054727,6940,3,2,25,6970
357066523,19,3,2,1,25
357078209,67,13,31,1,112
357078383,41,31,2,1,75
357085951,163,5,10,4,182
357104442,25,17,12,6,60
357107169,17,13,30,1,61
357111303,27,21,89,1,138
357116701,47,3,2,17,69
357121660,99,17,90,1,207
357129267,67,30,3,1,101
357189299,34,20,2,5,61
357189357,119,12,13,12,156
357198261,78,3,2,4,87
357201155,27,9,2,1,39
357202104,37,35,5,1,78
357231678,18,8,2,8,36
357254625,55,27,5,3,90
357272898,71,36,17,1,125
357273692,36,76,6,9,127
357279510,615,3,2,1,621
357282899,76,3,2,1,82
357289295,12,3,2,1,18
357304595,115,16,48,28,207
357307533,102,42,9,23,176
357308954,61,31,57,1,150
357314278,72,3,2,5,82
357314598,26,5,2,1,34
357320031,59,7,2,6,74
357342723,93,11,10,14,128
357348847,13,30,6,1,50
357364629,12,3,2,1,18
357380820,89,31,2,4,126
357380950,44,21,9,1,75
357386870,62,3,2,1,68
357388888,31,46,9,2,88
357390450,53,3,2,1,59
357392037,244,27,2,12,285
357395194,194,22,95,33,344
357404269,102,88,36,31,257
357412799,15,3,2,1,21
357438644,143,5,2,6,156
357450907,44,14,6,1,65
357456042,13,4,2,1,20
357474409,129,19,2,2,152
357492904,23,19,2,31,75
357500692,11,3,2,1,17
357516003,27,25,41,15,108
357519135,181,3,2,13,199
357522655,35,12,6,1,54
357530775,42,17,35,12,106
357588731,19,30,2,3,54
357599855,12,9,2,1,24
357623631,18,12,2,3,35
357649349,22,7,5,9,43
357652876,106,21,42,1,170
357656716,46,16,9,12,83
357664905,55,26,3,7,91
357671004,53,7,2,4,66
357685867,130,3,2,2,137
357689478,81,44,14,2,141
357695935,22,5,2,2,31
357699320,19,5,2,2,28
357710518,241,5,41,7,294
357711856,54,102,6,1,163
357714635,15,10,2,2,29
357722215,72,38,35,8,153
357725330,39,24,26,13,102
357731907,28,4,2,4,38
357735634,158,22,2,4,186
357736487,44,3,2,4,53
357738709,17,3,2,2,24
357740449,117,24,4,84,229
357743225,79,65,17,34,195
357744546,65,4,2,1,72
357755954,79,16,2,7,104
357765050,51,32,36,3,122
357767384,12,3,2,1,18
357772904,40,15,5,32,92
357776777,14,3,2,1,20
357805853,44,52,2,1,99
357811242,93,6,2,3,104
357824501,103,12,2,6,123
357838347,28,13,79,5,125
357844816,23,6,2,1,32
357875523,217,3,2,1,223
357880606,105,17,6,10,138
357885623,108,10,2,1,121
357886749,16,3,2,4,25
357892759,371,3,2,13,389
357901115,106,43,8,3,160
357905839,69,10,3,8,90
357916118,27,7,2,1,37
357924021,57,15,9,10,91
357926877,91,9,79,8,187
357927489,15,4,2,4,25
357930552,10,21,2,3,36
357942856,15,3,2,1,21
357942963,54,11,2,1,68
357953375,101,47,97,15,260
357959683,44,3,2,1,50
357965416,33,21,2,2,58
357965452,41,5,2,7,55
357965820,107,19,4,8,138
357968647,16,6,3,3,28
357971679,104,7,23,2,136
357987756,109,4,37,1,151
357988803,45,39,2,1,87
357992372,54,3,3,5,65
357995153,28,11,8,7,54
358006334,22,8,22,1,53
358018265,71,5,2,1,79
358035521,122,18,2,12,154
358061845,105,3,2,2,112
358068552,57,5,3,1,66
358071404,61,5,2,9,77
358086707,60,3,2,1,66
358101506,33,48,3,11,95
358110348,185,32,26,30,273
358111310,13,3,2,2,20
358124296,62,13,11,26,112
358125790,24,3,2,1,30
358130667,10,5,2,1,18
358138966,112,8,3,11,134
358139666,36,47,3,8,94
358145878,18,14,6,3,41
358153031,44,13,38,1,96
358159693,51,9,4,55,119
358162030,279,26,2,4,311
358171202,178,38,3,1,220
358179688,172,21,2,2,197
358193651,19,3,2,1,25
358203189,15,3,2,4,24
358239930,27,14,25,5,71
358254355,91,27,2,1,121
358275186,146,29,3,63,241
358297835,11,3,2,1,17
358299315,62,16,5,13,96
358310593,378,108,5,9,500
358320665,13,29,2,1,45
358334688,38,34,8,3,83
358336993,35,29,32,9,105
358341869,10,5,2,1,18
358347491,176,10,20,54,260
358374647,23,20,2,3,48
358386223,46,22,11,17,96
358394581,107,19,7,1,134
358395277,23,15,3,1,42
358397850,20,3,2,4,29
358403608,20,16,2,1,39
358417281,43,37,7,14,101
358435240,56,56,2,6,120
358435736,36,47,2,33,118
358452264,33,3,2,1,39
358458748,59,14,21,13,107
358459287,131,3,2,1,137
358462360,123,18,2,13,156
358479081,10,30,2,1,43
358482143,39,5,2,4,50
358493834,39,46,14,1,100
358496013,12,3,2,1,18
358502379,34,31,2,3,70
358537866,88,28,5,4,125
358545197,59,3,2,16,80
358547823,73,36,28,10,147
358549172,227,3,2,3,235
358552898,12,3,2,1,18
358556026,39,39,22,23,123
358563573,79,85,2,8,174
358565427,24,3,2,1,30
358568071,16,10,2,1,29
358592032,39,35,2,1,77
358613254,130,14,117,1,262
358630308,84,109,83,7,283
358632742,181,3,2,7,193
358655669,87,25,2,27,141
358663400,72,39,17,3,131
358676057,64,28,2,9,103
358680205,50,38,22,1,111
358707853,45,31,6,6,88
358714469,233,3,2,1,239
358738109,270,37,97,14,418
358740167,14,3,2,1,20
358748305,51,59,45,1,156
358748421,39,17,2,5,63
358755088,83,4,9,3,99
358772516,14,3,2,1,20
358781280,22,31,2,1,56
358783997,47,3,2,3,55
358784624,99,3,2,2,106
358799585,111,3,2,3,119
358808205,53,47,2,11,113
358809205,72,34,2,3,111
358809490,55,25,19,6,105
358821294,11,3,2,1,17
358833333,60,7,2,1,70
358833580,52,20,2,1,75
358834082,67,10,2,1,80
358837686,62,7,8,1,78
358872078,94,23,6,11,134
358875384,131,12,11,1,155
358883133,204,3,2,2,211
358895555,13,6,2,3,24
358896426,52,4,2,10,68
358903099,61,25,2,14,102
358905447,108,37,6,1,152
358914070,36,3,2,2,43
358944521,24,35,2,4,65
358949906,60,3,2,1,66
358956468,24,34,19,1,78
358965785,31,23,29,4,87
358970503,62,16,12,13,103
358989326,94,43,2,1,140
358990351,77,53,54,7,191
359000896,90,18,2,1,111
359008311,292,3,2,1,298
359012938,77,26,15,11,129
359017947,46,8,52,1,107
359023089,60,61,16,39,176
359024508,32,3,2,1,38
359038748,19,75,2,9,105
359045360,74,11,2,2,89
359052623,126,9,3,3,141
359053390,128,3,2,5,138
359071660,58,53,7,3,121
359081334,84,47,5,28,164
359088701,11,21,2,3,37
359097248,58,28,10,3,99
359098497,68,10,2,1,81
359102721,41,3,2,1,47
359102919,99,48,3,18,168
359103925,125,3,2,4,134
359130236,76,3,2,4,85
359131222,23,65,51,1,140
359143574,90,12,19,2,123
359146849,47,3,2,1,53
359175050,89,3,2,4,98
359175070,83,18,34,11,146
359175237,10,3,2,8,23
359177117,16,41,2,1,60
359180423,197,22,27,8,254
359181360,69,29,64,1,163
359183832,89,62,14,16,181
359194861,11,8,2,1,22
359201330,85,34,2,2,123
359202159,92,21,54,5,172
359224423,18,34,2,4,58
359250579,64,5,13,7,89
359251712,54,3,2,1,60
359254252,187,114,45,8,354
359267939,67,24,59,7,157
359270808,52,42,15,4,113
359289060,32,3,2,4,41
359298138,94,24,2,6,126
359298272,54,47,51,3,155
359304422,18,9,2,1,30
359305888,10,6,2,1,19
359310300,33,7,2,5,47
359324002,150,91,2,1,244
359328333,44,41,15,20,120
359336967,16,14,2,1,33
359353201,35,76,7,1,119
359353624,14,8,17,9,48
359359292,32,42,63,2,139
359367820,196,25,2,5,228
359385663,25,3,2,9,39
359387826,150,25,74,21,270
359416794,31,3,2,1,37
359424479,39,20,5,2,66
359436494,26,15,11,6,58
359479012,12,3,2,1,18
359512375,155,3,2,1,161
359517276,114,34,4,9,161
359525423,19,10,2,5,36
359527532,11,3,2,1,17
359539246,108,3,2,39,152
359565699,106,3,2,1,112
359572920,49,27,14,1,91
359586278,11,3,2,1,17
359591103,217,36,106,22,381
359600099,49,12,2,2,65
359600734,29,61,14,19,123
359601556,72,17,34,1,124
359604967,35,38,90,3,166
359612897,54,3,2,2,61
359620342,18,3,2,1,24
359630741,36,44,51,1,132
359638472,69,3,33,1,106
359639750,126,43,73,12,254
359648938,126,36,7,2,171
359654315,120,17,104,14,255
359657472,48,3,2,2,55
359657669,14,7,2,1,24
359658421,13,15,11,3,42
359662307,75,16,27,2,120
359707249,81,3,2,15,101
359708918,55,20,75,11,161
359711458,12,3,2,1,18
359718126,159,42,41,6,248
359722026,130,3,2,1,136
359728486,71,3,2,8,84
359737130,35,78,32,20,165
359756209,11,3,2,1,17
359765139,133,63,16,8,220
359768782,11,3,2,1,17
359777607,11,3,8,4,26
359793935,41,27,28,1,97
359805382,35,12,65,8,120
359814568,17,5,2,1,25
359815790,45,10,7,5,67
359817007,47,7,27,1,82
359819487,38,22,4,3,67
359822217,106,24,2,6,138
359823570,10,23,2,3,38
359830049,57,3,2,2,64
359830844,16,3,2,1,22
359841008,20,3,2,1,26
359843175,45,3,2,5,55
359852836,20,14,2,1,37
359866783,81,21,2,5,109
359875563,84,14,12,19,129
359890245,148,9,34,1,192
359892210,35,3,2,1,41
359894456,15,3,2,1,21
359906441,17,26,2,1,46
359912273,98,7,2,2,109
359917355,11,12,2,1,26
359924566,11,3,2,1,17
359934276,91,20,2,6,119
359936140,242,52,2,71,367
359944071,77,39,2,8,126
359968138,78,42,14,1,135
359975313,120,12,6,1,139
359975804,86,5,2,2,95
359976409,79,32,2,1,114
359987144,104,25,31,2,162
359993729,45,77,45,3,170
360016784,224,20,67,12,323
360035469,189,65,21,3,278
360057539,11,6,2,1,20
360057652,21,16,34,1,72
360063701,172,3,2,1,178
360099077,31,11,5,6,53
360100463,54,6,89,3,152
360102818,22,38,2,1,63
360138937,14,3,2,1,20
360144401,56,16,78,24,174
360162120,65,3,2,1,71
360181812,20,3,2,2,27
360188411,28,59,6,2,95
360208358,106,3,2,1,112
360214793,55,3,2,1,61
360220805,19,3,2,1,25
360223852,24,51,9,1,85
360241701,11,3,2,1,17
360260835,19,20,3,1,43
360263669,17,3,2,1,23
360265210,50,34,26,11,121
360266453,47,29,3,1,80
360277576,11,3,2,1,17
360282831,10,3,2,3,18
360291418,15,12,10,1,38
360292493,160,10,58,4,232
360294180,63,3,2,1,69
360304421,36,58,2,2,98
360305196,83,24,89,1,197
360306202,41,3,2,1,47
360306489,12,24,2,1,39
360313683,92,23,5,10,130
360317471,20,51,2,1,74
360336535,125,13,3,1,142
360352690,227,3,2,1,233
360356331,125,34,10,4,173
360365923,25,23,2,1,51
360365988,70,17,2,12,101
360379735,43,7,46,10,106
360400241,35,3,2,1,41
360408710,11,7,2,1,21
360432085,105,31,3,3,142
360432408,131,18,28,31,208
360465918,16,3,2,1,22
360473677,66,13,6,1,86
360475704,72,12,2,1,87
360482853,10,18,3,1,32
360485054,55,25,3,2,85
360489727,42,3,2,1,48
360498180,135,3,2,3,143
360502688,30,3,2,1,36
360505644,134,20,56,27,237
360506930,76,70,3,11,160
360515161,160,3,2,3,168
360540025,41,42,2,23,108
360543455,84,3,2,1,90
360567282,80,24,2,91,197
360567946,65,58,37,9,169
360570133,15,3,2,1,21
360577129,54,24,63,7,148
360579154,48,3,2,1,54
360593671,114,35,72,1,222
360595258,141,3,2,18,164
360596029,91,40,2,1,134
360609275,41,18,28,3,90
360609949,48,10,5,1,64
360615221,32,12,2,6,52
360618536,16,27,18,4,65
360625660,89,5,8,1,103
360646991,72,3,2,2,79
360650664,20,6,8,8,42
360666444,30,3,2,1,36
360675865,29,3,2,1,35
360683928,43,3,2,1,49
360687872,11,6,4,1,22
360695022,26,4,2,1,33
360707998,157,53,3,2,215
360711355,62,15,7,4,88
360716360,159,54,69,4,286
360730752,25,5,2,6,38
360745952,45,15,17,1,78
360755401,47,14,41,7,109
360756177,72,3,18,1,94
360771049,134,7,2,1,144
360779452,219,3,2,2,226
360782121,133,3,2,1,139
360785071,52,16,2,4,74
360789788,10,6,3,1,20
360820551,14,3,2,3,22
360827672,27,3,2,1,33
360828612,16,9,2,2,29
360830315,88,59,9,16,172
360834100,136,3,2,2,143
360844875,16,3,2,1,22
360852845,117,13,2,1,133
360871702,63,18,2,2,85
360882512,33,36,4,21,94
360898394,83,3,2,4,92
360898453,54,11,28,9,102
360900687,69,3,2,14,88
360914933,124,3,2,1,130
360924152,10,8,2,1,21
360925809,32,10,5,2,49
360940036,66,3,2,2,73
360940838,48,30,17,10,105
360941248,38,6,6,1,51
360973378,109,31,25,7,172
360982828,11,3,2,1,17
361006084,30,3,2,15,50
361009507,130,19,2,1,152
361017421,17,49,16,49,131
361022642,38,28,2,3,71
361023572,106,19,2,1,128
361053994,190,15,62,1,268
361066989,12,9,2,5,28
361067349,47,13,17,7,84
361088588,15,3,2,3,23
361100714,34,45,2,8,89
361104931,84,19,3,1,107
361107841,23,51,2,3,79
361124195,52,4,2,1,59
361135107,32,11,2,1,46
361135327,11,3,2,1,17
361140897,13,15,3,1,32
361145585,139,34,4,3,180
361163507,54,17,2,2,75
361172397,37,72,79,19,207
361181795,32,13,9,3,57
361194708,27,4,2,61,94
361200878,25,3,2,1,31
361203111,91,5,77,6,179
361204168,55,20,23,1,99
361225665,145,3,2,1,151
361229350,118,5,19,25,167
361230693,94,19,10,7,130
361237756,112,25,64,3,204
361243337,52,26,22,1,101
361247716,12,3,2,1,18
361248469,11,3,2,1,17
361255661,39,9,2,3,53
361270607,11,3,2,1,17
361273182,21,17,2,4,44
361294015,13,3,2,1,19
361303580,88,34,20,52,194
361304111,32,113,27,20,192
361318986,37,19,13,2,71
361328304,14,4,2,2,22
361333019,171,30,8,2,211
361334078,53,31,3,4,91
361339447,15,14,2,3,34
361354488,96,3,2,3,104
361359004,31,5,8,6,50
361367442,51,105,35,4,195
361367932,66,30,9,3,108
361370279,87,3,2,5,97
361370285,191,3,2,1,197
361375592,16,3,2,1,22
361379394,21,7,2,4,34
361386107,133,25,80,26,264
361435814,31,43,35,3,112
361442553,117,27,14,1,159
361465196,72,98,69,75,314
361479681,102,3,2,1,108
361483156,115,94,20,9,238
361506631,103,26,7,1,137
361514446,48,3,2,3,56
361514804,73,3,2,1,79
361526321,38,20,9,5,72
361528647,14,3,2,1,20
361536781,88,3,2,1,94
361549386,65,34,11,16,126
361550388,51,5,2,1,59
361558844,55,8,14,8,85
361571887,126,36,7,5,174
361573082,56,4,2,1,63
361581466,17,74,41,1,133
361588667,11,5,2,2,20
361596993,13,3,2,1,19
361608959,42,47,24,29,142
361614570,100,39,78,24,241
361617464,56,35,9,3,103
361635864,24,27,2,3,56
361675875,78,6,7,1,92
361684894,114,5,2,9,130
361717578,50,165,7,22,244
361741027,125,4,2,1,132
361742327,68,3,2,2,75
361760304,29,13,4,3,49
361772724,10,3,2,2,17
361774046,120,40,11,5,176
361777676,152,21,16,5,194
361784552,15,8,2,1,26
361784788,86,43,2,5,136
361785362,103,16,2,1,122
361789364,229,4,3,6,242
361807157,23,12,2,20,57
361808881,19,68,2,2,91
361810774,106,12,4,13,135
361818348,78,3,3,1,85
361858273,101,34,19,9,163
361871527,137,13,2,3,155
361880019,57,18,2,1,78
361903916,28,19,4,43,94
361903965,12,3,2,2,19
361921878,116,48,6,14,184
361930845,52,15,2,1,70
361942249,115,40,4,2,161
361943679,27,26,5,14,72
361953807,34,3,2,1,40
361956259,35,4,2,1,42
361959054,134,43,2,6,185
361969992,96,40,85,37,258
361974389,83,3,2,1,89
361977423,104,53,10,2,169
361981236,67,41,41,1,150
361989895,90,9,74,1,174
361992784,10,15,2,2,29
362024120,52,64,3,1,120
362038966,44,21,3,1,69
362040686,11,3,2,1,17
362043274,61,3,2,2,68
362044679,38,32,2,1,73
362049118,153,3,2,6,164
362056482,56,12,4,1,73
362137311,14,49,2,1,66
362150513,76,3,2,2,83
362155518,177,14,2,2,195
362171055,21,47,4,2,74
362182215,88,36,7,30,161
362183381,69,22,9,1,101
362184715,43,26,2,2,73
362186886,86,9,2,6,103
362195871,10,10,2,1,23
362199015,71,38,2,3,114
362200561,53,44,2,15,114
362204311,104,3,2,14,123
362204981,207,108,2,3,320
362206252,137,70,92,63,362
362208944,139,3,2,1,145
362210621,12,3,2,1,18
362212294,111,45,16,2,174
362213857,36,18,20,6,80
362215960,68,11,3,1,83
362216737,21,74,3,1,99
362272325,64,19,10,2,95
362285183,37,56,7,25,125
362286528,102,55,7,30,194
362290517,89,23,43,1,156
362294725,46,24,124,40,234
362298720,24,3,2,1,30
362303544,112,38,37,1,188
362305952,44,42,20,17,123
362311625,32,34,19,1,86
362314956,40,3,2,3,48
362315862,30,3,2,1,36
362319810,48,3,4,4,59
362325438,50,3,2,1,56
362339405,36,8,2,4,50
362345110,18,13,8,1,40
362345511,96,3,2,1,102
362370213,58,63,26,4,151
362418918,194,16,14,13,237
362418941,85,5,4,1,95
362422025,17,3,2,5,27
362435937,44,18,4,12,78
362440202,31,3,2,1,37
362444421,86,10,28,21,145
362487164,19,26,13,2,60
362488094,25,29,56,23,133
362497365,138,3,2,16,159
362501757,17,30,49,1,97
362516618,16,3,2,1,22
362524454,19,7,2,59,87
362530129,30,3,2,1,36
362531276,205,21,2,32,260
362542417,96,32,2,29,159
362558345,84,23,2,4,113
362571697,54,69,18,10,151
362580271,75,52,12,6,145
362590159,72,18,28,1,119
362598822,48,57,62,2,169
362599589,27,28,2,2,59
362600988,29,6,6,7,48
362602971,41,38,2,1,82
362603292,87,40,7,1,135
362635336,20,102,16,2,140
362651612,78,25,38,1,142
362665456,35,52,39,1,127
362666354,52,3,2,1,58
362667923,164,3,2,6,175
362676460,22,3,2,1,28
362677824,70,91,2,1,164
362687558,72,32,14,1,119
362702669,70,3,2,1,76
362704011,109,5,125,7,246
362715386,54,36,13,6,109
362718413,10,3,2,2,17
362720970,152,25,3,37,217
362726709,12,3,2,1,18
362750749,75,59,22,1,157
362759797,181,13,2,7,203
362765818,19,32,8,1,60
362782551,11,3,2,1,17
362783162,16,14,2,1,33
362796857,16,3,2,1,22
362801418,57,63,45,1,166
362813194,154,15,20,17,206
362822009,68,19,13,11,111
362829342,11,3,3,1,18
362837078,21,3,2,2,28
362853328,13,3,2,1,19
362853683,30,54,8,5,97
362857683,23,48,2,5,78
362861488,132,17,2,1,152
362864987,51,15,2,1,69
362872743,14,26,2,1,43
362873684,214,56,40,3,313
362874964,110,33,4,3,150
362880998,15,3,2,1,21
362886255,29,12,2,1,44
362894921,88,38,4,8,138
362908509,18,3,2,6,29
362911368,51,3,2,1,57
362912544,81,5,2,1,89
362918031,79,3,2,1,85
362921905,74,12,7,19,112
362938475,59,3,2,2,66
362942483,51,19,10,12,92
362950271,473,3,2,5,483
362963978,38,19,53,6,116
362974524,194,49,16,14,273
362978175,145,21,2,2,170
362990757,17,3,2,1,23
362990761,64,3,8,1,76
363005090,23,11,2,2,38
363009287,158,3,2,5,168
363020183,25,23,9,2,59
363031097,11,3,2,1,17
363033324,92,3,2,26,123
363034244,76,3,2,1,82
363066296,15,3,2,2,22
363080172,191,10,2,10,213
363092958,35,18,2,2,57
363097985,13,11,2,5,31
363111811,15,14,2,2,33
363125012,12,3,2,1,18
363127498,81,25,19,3,128
363134582,20,6,2,3,31
363164675,115,3,2,1,121
363193498,31,26,58,1,116
363208062,49,28,20,2,99
363217862,62,5,26,2,95
363222778,28,44,14,12,98
363224111,55,72,2,5,134
363233700,43,29,2,2,76
363240487,79,3,2,1,85
363253715,43,3,2,1,49
363267213,36,29,6,7,78
363279276,114,33,14,1,162
363289718,84,14,2,3,103
363291652,73,26,25,1,125
363294279,13,3,2,1,19
363308535,40,51,35,1,127
363321515,87,7,2,2,98
363341587,112,15,9,20,156
363342580,209,3,2,3,217
363344706,36,24,74,3,137
363348349,71,3,2,4,80
363354582,76,21,11,1,109
363361279,44,34,2,10,90
363368054,23,19,3,1,46
363377639,23,7,2,7,39
363390646,77,3,2,1,83
363402534,132,68,23,1,224
363403816,103,39,58,81,281
363409481,10,4,2,1,17
363423959,142,69,31,19,261
363435932,74,3,2,1,80
363442228,28,52,7,5,92
363451644,11,10,2,1,24
363451678,60,3,2,1,66
363453523,57,3,4,1,65
363455926,11,3,2,1,17
363459972,131,22,2,3,158
363475487,18,7,2,2,29
363497420,12,3,2,1,18
363497629,19,18,10,9,56
363503132,55,17,2,2,76
363511392,130,3,2,16,151
363521162,78,3,2,2,85
363552885,56,20,39,7,122
363576595,26,3,4,1,34
363594996,17,22,4,5,48
363596096,138,4,2,9,153
363602086,113,3,2,1,119
363607385,30,3,7,12,52
363610254,155,3,2,1,161
363615374,46,28,2,4,80
363618014,15,14,2,1,32
363621107,95,35,2,1,133
363635557,78,29,2,45,154
363643361,49,10,2,7,68
363643671,73,3,2,1,79
363653958,36,18,7,1,62
363671079,12,3,2,1,18
363684769,128,7,14,1,150
363688244,98,74,23,61,256
363732793,55,6,3,1,65
363734779,93,3,3,1,100
363737570,66,9,3,4,82
363738158,76,5,2,5,88
363757662,133,18,2,1,154
363757671,55,49,15,52,171
363757803,37,23,53,3,116
363762604,39,34,9,1,83
363765064,34,10,2,1,47
363767220,88,3,2,1,94
363771946,15,3,2,5,25
363788393,65,25,33,3,126
363793986,100,19,16,55,190
363799749,24,3,2,7,36
363818153,28,3,2,1,34
363827321,10,7,2,1,20
363851783,88,48,65,77,278
363859461,16,3,2,1,22
363861712,221,11,5,1,238
363869544,48,34,30,2,114
363870940,45,24,17,66,152
363871168,19,3,2,1,25
363878869,43,28,7,4,82
363891291,13,7,2,1,23
363905093,21,31,7,9,68
363905545,74,4,2,33,113
363910915,30,3,2,6,41
363913071,64,3,2,1,70
363953949,99,26,3,25,153
363956191,107,41,35,36,219
363963489,23,17,2,1,43
363970992,11,7,2,1,21
363994849,166,23,111,16,316
364001868,55,7,2,3,67
364019256,183,28,17,38,266
364028574,54,12,2,1,69
364029273,15,3,2,1,21
364043614,55,42,2,18,117
364064161,122,39,20,9,190
364064848,117,22,3,1,143
364069647,37,7,4,8,56
364084253,111,3,3,1,118
364088449,49,28,2,1,80
364100650,44,3,2,1,50
364101498,56,25,51,9,141
364114450,87,61,39,4,191
364136751,158,19,16,5,198
364140013,49,17,2,1,69
364151588,241,20,18,1,280
364164387,79,21,9,9,118
364173941,24,6,2,2,34
364181882,120,37,63,19,239
364203342,63,23,2,3,91
364237793,27,7,2,5,41
364238926,12,11,2,1,26
364241683,18,3,2,1,24
364251893,52,21,29,26,128
364253980,53,18,2,2,75
364267855,108,55,13,13,189
364275991,80,10,24,3,117
364278172,94,28,6,1,129
364282198,38,6,5,1,50
364282699,20,3,2,5,30
364298050,125,3,9,1,138
364298839,135,44,46,2,227
364306275,13,3,2,1,19
364322744,216,49,19,2,286
364323582,31,3,2,1,37
364325490,57,3,2,1,63
364388176,13,3,2,8,26
364396580,55,8,36,6,105
364398022,178,3,2,1,184
364398326,66,5,44,1,116
364406833,89,14,2,11,116
364414617,71,19,2,7,99
364422024,28,17,52,5,102
364424262,109,47,31,4,191
364425213,108,18,2,7,135
364425374,23,10,2,1,36
364441185,73,3,2,3,81
364456068,68,3,2,2,75
364474005,49,93,34,2,178
364485997,50,31,3,1,85
364521524,15,3,2,1,21
364547148,216,40,2,6,264
364558375,122,46,28,12,208
364561064,19,3,2,3,27
364563472,118,24,2,5,149
364575147,47,4,8,11,70
364594655,28,15,48,11,102
364595399,244,43,2,10,299
364597590,49,8,5,1,63
364604597,13,3,2,1,19
364618903,109,3,2,1,115
364631105,29,24,39,17,109
364637571,131,25,60,76,292
364638369,168,61,73,24,326
364648206,73,28,2,3,106
364662999,44,3,2,1,50
364675320,117,15,18,1,151
364677515,67,7,19,1,94
364680825,15,3,2,1,21
364700552,13,3,2,1,19
364728958,26,52,13,1,92
364736024,62,56,39,16,173
364741531,58,20,7,13,98
364744511,38,36,2,2,78
364768136,18,3,2,4,27
364768702,138,3,43,1,185
364778578,10,4,2,1,17
364785825,43,3,2,5,53
364794401,641,10,18,14,683
364796131,133,5,2,1,141
364806145,110,3,2,3,118
364815115,149,5,12,6,172
364821115,30,35,19,13,97
364829988,10,3,2,2,17
364831194,89,3,2,2,96
364840851,41,42,9,14,106
364857301,123,35,39,35,232
364861009,122,25,32,47,226
364868465,87,10,17,1,115
364873299,125,3,2,5,135
364876130,36,15,18,8,77
364881281,21,75,34,1,131
364883563,110,41,2,1,154
364894539,17,51,12,3,83
364913681,20,81,2,1,104
364915715,348,21,2,5,376
364935933,29,11,4,8,52
364938889,27,62,2,1,92
364940700,92,20,86,7,205
364943946,103,15,56,1,175
364963237,50,9,21,2,82
364966498,49,3,2,1,55
364968411,68,19,2,1,90
364970003,110,12,2,5,129
364980320,33,44,49,1,127
364981554,15,14,2,4,35
365005871,167,4,2,7,180
365012646,24,8,2,6,40
365017640,28,29,2,1,60
365017661,21,3,2,1,27
365030169,43,21,2,3,69
365031688,58,3,2,1,64
365054340,202,3,2,1,208
365070933,11,3,2,1,17
365072958,24,35,2,3,64
365085811,29,21,13,12,75
365088740,104,44,24,7,179
365100948,74,128,46,6,254
365105176,79,57,3,3,142
365132407,26,70,16,4,116
365146902,17,3,2,1,23
365169929,100,42,18,19,179
365170669,149,72,12,2,235
365171889,70,27,12,1,110
365178615,20,3,2,1,26
365195295,56,3,2,1,62
365211754,71,3,2,10,86
365216394,49,17,2,1,69
365216812,11,7,5,1,24
365217387,41,59,5,1,106
365249140,36,37,4,5,82
365250914,13,42,2,1,58
365257225,10,4,2,3,19
365271290,10,5,2,1,18
365285258,79,39,8,8,134
365306569,116,3,2,2,123
365314566,36,60,3,24,123
365319627,198,3,2,1,204
365328220,58,4,2,1,65
365329495,48,84,21,17,170
365330318,36,43,7,1,87
365334646,179,19,57,9,264
365334736,137,32,37,4,210
365336752,187,8,2,1,198
365338966,51,3,2,23,79
365345158,55,3,2,8,68
365357070,90,28,2,1,121
365382057,102,3,2,1,108
365392746,13,3,2,1,19
365393622,27,3,2,1,33
365413069,34,3,2,3,42
365426217,116,28,9,7,160
365426287,169,3,2,4,178
365447828,39,9,4,7,59
365457183,65,42,23,2,132
365459954,52,18,2,1,73
365476809,89,43,79,2,213
365510091,114,53,3,1,171
365512356,116,46,5,1,168
365514032,37,33,62,1,133
365516520,15,6,2,1,24
365525771,72,44,20,2,138
365528386,36,13,23,3,75
365532914,12,3,2,1,18
365534868,20,7,2,1,30
365543383,56,13,3,3,75
365549526,75,36,101,10,222
365552345,74,3,2,1,80
365556847,55,3,2,4,64
365564200,111,7,47,11,176
365568713,94,3,2,1,100
365601586,37,22,15,7,81
365602332,12,12,2,1,27
365605649,119,41,38,2,200
365606913,36,21,17,14,88
365610170,58,10,13,38,119
365615113,45,39,60,2,146
365626576,33,32,29,18,112
365632345,23,50,7,9,89
365638269,407,3,2,16,428
365671726,21,6,2,2,31
365688018,66,10,2,1,79
365691348,60,17,43,5,125
365700211,156,63,126,7,352
365748731,91,22,12,37,162
365760016,96,3,2,1,102
365763894,30,7,2,2,41
365782110,257,20,4,3,284
365790300,25,3,2,2,32
365797891,41,3,2,3,49
365798579,41,40,16,4,101
365804829,34,3,2,2,41
365812821,209,3,2,8,222
365813957,58,3,2,1,64
365814908,34,11,2,1,48
365822189,88,31,79,17,215
365822666,11,3,2,1,17
365850350,43,45,2,47,137
365860229,30,3,2,3,38
365869790,13,36,2,4,55
365870036,99,44,39,6,188
365870797,144,11,2,9,166
365871686,47,5,2,3,57
365873251,124,18,4,1,147
365875826,69,65,9,1,144
365880097,37,13,2,6,58
365888620,46,3,2,4,55
365899621,109,21,38,19,187
365900689,97,3,2,5,107
365910520,26,3,2,21,52
365920226,43,8,3,1,55
365931122,160,3,2,1,166
365931776,35,3,2,1,41
365938044,97,30,33,2,162
365951998,22,3,2,1,28
365958272,78,7,46,8,139
365964368,110,11,12,1,134
365984994,65,7,2,4,78
365986598,41,3,2,1,47
365992924,207,17,2,2,228
365999037,12,21,2,11,46
366000612,10,4,2,1,17
366001220,14,18,2,1,35
366004165,306,3,18,12,339
366011651,124,111,5,11,251
366020027,79,3,2,7,91
366026778,77,3,2,1,83
366030320,55,4,24,1,84
366033035,97,5,2,18,122
366039614,81,57,3,15,156
366057061,140,45,24,4,213
366058748,110,13,45,3,171
366066390,99,6,11,1,117
366067090,39,3,2,2,46
366079358,181,48,2,1,232
366097846,10,3,2,2,17
366104088,10,3,2,2,17
366114936,16,3,2,3,24
366127581,114,16,2,1,133
366131075,10,35,6,2,53
366156843,39,43,4,2,88
366160663,115,3,2,3,123
366163320,116,3,2,1,122
366172287,51,30,44,1,126
366175353,120,36,22,2,180
366177174,20,3,2,1,26
366192792,108,3,2,20,133
366198951,91,9,3,2,105
366212250,20,4,2,3,29
366220188,64,19,3,23,109
366227501,19,51,33,2,105
366233287,32,3,2,1,38
366245921,330,3,2,1,336
366264974,97,35,3,1,136
366269967,58,3,2,5,68
366271089,53,7,41,5,106
366271400,269,23,2,2,296
366292438,127,46,22,36,231
366292772,123,3,2,5,133
366300794,35,3,2,1,41
366301836,18,3,2,1,24
366312393,50,34,74,4,162
366315582,10,7,2,1,20
366315902,119,59,47,13,238
366323928,53,20,21,4,98
366326554,30,12,27,10,79
366329213,111,17,2,1,131
366333201,60,35,6,7,108
366335619,14,17,2,1,34
366346140,164,29,2,2,197
366362552,65,3,2,1,71
366367905,17,3,2,1,23
366373575,13,60,5,1,79
366374268,82,3,2,1,88
366377247,65,34,5,10,114
366389448,46,55,31,17,149
366397849,41,32,29,13,115
366400907,136,3,2,1,142
366409794,158,32,30,15,235
366428648,74,3,2,1,80
366431016,10,3,2,2,17
366437671,61,6,2,1,70
366441942,50,36,3,16,105
366452173,37,44,7,22,110
366461449,94,14,46,6,160
366467375,28,3,2,1,34
366471843,39,10,2,1,52
366480834,26,9,5,3,43
366487308,35,50,9,3,97
366516066,55,3,2,1,61
366525165,12,3,2,2,19
366527515,13,3,2,1,19
366527716,54,28,35,17,134
366532482,80,3,2,1,86
366550658,19,11,7,1,38
366565796,44,26,31,1,102
366570838,260,29,2,36,327
366577538,67,44,2,8,121
366579850,40,37,2,9,88
366612008,221,22,4,44,291
366622865,61,6,2,5,74
366639219,148,39,2,4,193
366654741,69,3,2,1,75
366657090,68,3,2,1,74
366657791,122,3,2,1,128
366664236,43,19,2,3,67
366672444,21,28,4,58,111
366709340,68,5,37,2,112
366714290,11,3,2,1,17
366715829,85,16,3,1,105
366717696,19,39,44,2,104
366717935,50,9,3,7,69
366731920,115,3,2,2,122
366751922,66,52,2,2,122
366763548,134,12,3,7,156
366767170,38,15,33,1,87
366769913,165,33,14,4,216
366785084,167,20,2,2,191
366803525,106,9,7,1,123
366813247,132,50,55,1,238
366815414,27,6,2,1,36
366831163,271,25,2,7,305
366838689,150,6,69,1,226
366858078,12,15,2,2,31
366863713,28,35,2,3,68
366866262,41,26,7,1,75
366867215,55,15,26,3,99
366894935,147,7,2,24,180
366906115,31,3,5,1,40
366910435,39,3,2,19,63
366931364,96,7,2,2,107
366934197,87,6,2,1,96
366938266,35,20,5,15,75
366957959,73,3,2,14,92
366958357,10,13,2,1,26
366975082,16,28,2,2,48
366979595,12,3,2,1,18
366985059,94,22,39,5,160
366985215,45,9,2,7,63
367011642,104,20,2,1,127
367011815,52,8,2,1,63
367020117,169,3,2,4,178
367023642,54,14,2,1,71
367026229,205,28,28,26,287
367034491,72,8,37,1,118
367046857,91,3,2,1,97
367050400,84,43,2,52,181
367076722,13,3,2,1,19
367076951,124,5,2,4,135
367078361,93,3,11,1,108
367127026,30,3,2,5,40
367128436,51,38,13,1,103
367131597,90,11,8,1,110
367139038,60,11,2,7,80
367143627,25,34,12,7,78
367145307,35,22,2,7,66
367148341,31,3,2,1,37
367149496,48,39,2,1,90
367173963,91,31,36,6,164
367173977,158,58,60,69,345
367188132,53,3,2,1,59
367188868,19,3,2,1,25
367194017,10,13,2,1,26
367206139,14,3,2,1,20
367210498,568,3,2,14,587
367213059,41,20,2,2,65
367214711,24,3,2,1,30
367221889,111,3,2,1,117
367237033,59,3,2,1,65
367240184,121,29,24,2,176
367246560,31,6,2,1,40
367261463,16,26,2,2,46
367274499,85,37,2,16,140
367279248,164,19,11,7,201
367282141,54,11,2,1,68
367286544,40,35,15,6,96
367293853,252,9,2,1,264
367297860,11,3,2,2,18
367306430,10,4,2,1,17
367317341,46,3,2,3,54
367323931,40,57,26,3,126
367325594,61,19,2,2,84
367337358,77,30,2,2,111
367348548,179,16,2,4,201
367354630,39,57,10,5,111
367355901,35,3,2,1,41
367359040,178,26,3,12,219
367368073,92,18,2,1,113
367380116,47,3,2,1,53
367385968,21,3,2,1,27
367387922,63,3,2,1,69
367402985,10,21,5,10,46
367422573,61,40,51,23,175
367431604,12,22,3,1,38
367438778,106,23,2,2,133
367449511,24,3,2,7,36
367460631,39,30,2,25,96
367461921,36,3,2,1,42
367474830,80,60,6,1,147
367492413,156,42,17,1,216
367494418,44,8,2,1,55
367495227,47,8,7,17,79
367500498,30,6,2,1,39
367506710,425,41,3,2,471
367517120,95,9,10,4,118
367537787,23,28,2,9,62
367538082,12,4,2,1,19
367548135,47,23,4,48,122
367551890,28,3,2,1,34
367557609,233,3,3,1,240
367561705,131,42,22,1,196
367576783,71,3,2,1,77
367582764,101,67,25,1,194
367588815,184,25,63,3,275
367604813,11,9,2,1,23
367642478,153,3,2,3,161
367642781,93,3,2,2,100
367644218,12,21,2,1,36
367650050,148,13,6,3,170
367666036,12,3,2,1,18
367666891,75,10,2,4,91
367667158,21,3,2,1,27
367671806,25,3,2,1,31
367679550,114,43,28,4,189
367715038,90,34,124,2,250
367725432,108,14,12,14,148
367730363,16,3,2,8,29
367735285,72,3,2,4,81
367745717,61,13,19,2,95
367778839,80,21,13,17,131
367781245,47,10,26,20,103
367782050,16,13,2,2,33
367799087,11,6,2,2,21
367805320,976,3,2,4,985
367809316,17,9,2,2,30
367824791,14,3,2,1,20
367829654,83,49,25,16,173
367830103,148,3,13,3,167
367834116,11,4,2,2,19
367846971,27,103,45,1,176
367847407,40,12,2,12,66
367871598,75,38,15,10,138
367875911,10,6,2,1,19
367883797,176,3,2,3,184
367887567,25,25,9,1,60
367890403,34,6,2,13,55
367903054,60,14,2,3,79
367907180,10,6,2,4,22
367943057,109,38,2,8,157
367956666,21,14,2,1,38
367962448,39,24,6,1,70
367972754,45,56,14,16,131
367974690,126,51,2,14,193
367986887,191,27,2,5,225
367988935,47,22,13,14,96
367995630,13,7,2,3,25
367998329,125,22,2,1,150
368000513,65,36,23,33,157
368006506,168,14,18,1,201
368013253,95,63,2,1,161
368017421,48,77,30,11,166
368024850,153,20,32,1,206
368046193,50,9,2,1,62
368051663,65,17,7,1,90
368060351,40,12,13,44,109
368063247,58,23,2,1,84
368064444,37,23,2,4,66
368064478,33,57,5,1,96
368084297,40,28,20,1,89
368089150,21,4,2,2,29
368090417,12,3,2,7,24
368108676,154,41,22,58,275
368112568,88,25,6,1,120
368112715,14,4,2,1,21
368125525,223,20,20,1,264
368126248,57,30,2,1,90
368131782,31,23,2,4,60
368137583,62,9,2,2,75
368163351,25,22,31,1,79
368181351,84,29,24,9,146
368182295,64,66,34,1,165
368182668,49,4,14,22,89
368204499,46,9,3,1,59
368213067,83,33,4,2,122
368233136,43,3,2,1,49
368233588,22,11,2,1,36
368241189,10,7,3,1,21
368244649,76,16,19,1,112
368245278,52,47,2,2,103
368254144,51,15,16,1,83
368255541,11,5,3,1,20
368256471,23,11,2,1,37
368258407,300,61,5,13,379
368283168,18,6,2,4,30
368300615,54,5,2,1,62
368301227,138,15,19,12,184
368345421,162,41,39,3,245
368350501,36,64,28,1,129
368350956,86,3,2,1,92
368353468,149,26,5,2,182
368389779,134,50,27,5,216
368391641,96,11,2,1,110
368399046,137,21,8,22,188
368401396,27,27,2,1,57
368412875,29,10,3,1,43
368431788,65,24,2,13,104
368477911,35,17,9,7,68
368484706,16,20,3,4,43
368506984,80,65,42,19,206
368514454,22,24,2,1,49
368516440,94,31,42,1,168
368518621,13,3,2,1,19
368569398,83,3,2,2,90
368571367,94,39,2,34,169
368579272,17,62,2,1,82
368584418,144,39,16,2,201
368630057,38,18,23,17,96
368636132,64,25,18,1,108
368643384,99,52,36,4,191
368672466,89,8,27,18,142
368676815,45,62,38,2,147
368680945,60,66,16,1,143
368689268,56,3,2,1,62
368695253,54,42,11,4,111
368699525,83,3,43,2,131
368700916,51,35,3,4,93
368748065,17,89,2,1,109
368757371,10,19,2,2,33
368760085,23,3,2,1,29
368766050,38,4,62,3,107
368775020,51,3,2,1,57
368779313,13,3,2,1,19
368779359,11,3,2,1,17
368785782,10,13,2,1,26
368789389,179,47,51,11,288
368792785,110,18,4,12,144
368807865,20,10,2,1,33
368818255,13,5,2,1,21
368820469,26,3,2,1,32
368840720,121,28,2,7,158
368847407,155,11,26,1,193
368862464,34,19,2,3,58
368869360,12,4,2,1,19
368886023,13,11,2,1,27
368886284,109,3,2,2,116
368892535,13,23,2,1,39
368902384,24,7,2,1,34
368933567,72,3,8,43,126
368934550,162,22,39,37,260
368936171,86,45,4,4,139
368937986,162,42,43,30,277
368939281,102,3,2,1,108
368945438,61,32,34,13,140
368951214,74,37,2,1,114
368955517,83,3,2,1,89
368968389,94,15,14,17,140
368983686,38,43,2,4,87
368991075,74,35,49,29,187
369012888,40,21,11,8,80
369023899,57,33,2,1,93
369047173,149,21,2,3,175
369066200,107,3,2,2,114
369068601,21,9,2,1,33
369068850,91,14,37,4,146
369080188,47,21,3,3,74
369081436,16,13,2,1,32
369083340,89,3,2,1,95
369084377,52,3,2,1,58
369087931,72,3,2,3,80
369089971,104,102,112,5,323
369093769,83,30,2,22,137
369102488,64,12,2,15,93
369107564,84,16,2,1,103
369111490,103,3,2,46,154
369137063,34,3,2,2,41
369140858,31,35,42,31,139
369142971,34,3,2,1,40
369156413,20,3,2,1,26
369158145,74,29,10,62,175
369181517,116,5,34,7,162
369185671,82,3,2,1,88
369198763,49,73,71,2,195
369215813,116,23,26,17,182
369216609,127,3,2,3,135
369239327,161,34,6,4,205
369268513,54,3,2,5,64
369270082,319,21,9,1,350
369271510,49,11,2,2,64
369285829,136,23,27,34,220
369299349,107,3,2,1,113
369317098,95,38,57,1,191
369319174,125,43,118,6,292
369327626,30,3,2,2,37
369342289,84,42,27,3,156
369347283,124,43,76,9,252
369362872,129,47,11,12,199
369366065,85,3,2,4,94
369367710,19,24,2,9,54
369368039,182,10,3,1,196
369376401,53,3,2,9,67
369382220,70,29,2,1,102
369393574,15,8,2,3,28
369402516,16,3,2,1,22
369419771,14,3,2,1,20
369426583,88,3,2,9,102
369426890,16,11,2,1,30
369441512,56,14,7,1,78
369446042,86,3,2,1,92
369457107,71,44,2,6,123
369471953,65,22,12,1,100
369473206,58,41,2,1,102
369475491,18,3,2,1,24
369480169,93,40,57,7,197
369494381,125,3,2,5,135
369500664,114,3,2,63,182
369508994,37,39,15,65,156
369509696,42,3,2,1,48
369510653,23,3,2,1,29
369531558,10,12,2,1,25
369539183,50,27,10,3,90
369542230,59,24,5,20,108
369548222,18,42,7,1,68
369562341,97,3,2,1,103
369573032,11,3,2,1,17
369578585,76,16,18,1,111
369579547,91,21,11,17,140
369592689,94,3,2,2,101
369594648,12,3,2,1,18
369646969,63,56,39,24,182
369648328,148,9,57,5,219
369693102,10,15,10,1,36
369704840,21,6,2,2,31
369704924,71,3,2,2,78
369709761,29,6,2,2,39
369711915,36,3,2,1,42
369736956,54,3,25,14,96
369740764,123,16,9,75,223
369745013,41,21,5,3,70
369788285,16,12,3,1,32
369791615,123,7,66,9,205
369796028,135,11,56,46,248
369816849,12,25,2,4,43
369824632,10,6,2,2,20
369825294,58,30,9,3,100
369851135,29,60,2,3,94
369856418,33,3,2,1,39
369873875,67,38,81,4,190
369887416,33,17,3,9,62
369888602,23,3,2,1,29
369892761,12,3,2,1,18
369893334,13,3,2,1,19
369902583,16,3,2,1,22
369905765,27,19,9,23,78
369908288,27,8,2,1,38
369919747,89,37,3,4,133
369921156,47,3,2,1,53
369936986,33,26,13,1,73
369954147,115,3,2,1,121
369963398,13,3,2,2,20
369966374,19,3,2,1,25
369985382,66,19,62,2,149
370001413,137,3,2,1,143
370007784,28,47,16,2,93
370036232,16,22,6,1,45
370037600,123,62,163,2,350
370051393,28,4,2,1,35
370052024,197,15,2,7,221
370059950,52,3,2,1,58
370079951,103,10,2,1,116
370104178,28,32,3,5,68
370111619,64,18,10,3,95
370115138,70,15,2,2,89
370122309,148,3,2,1,154
370126261,10,6,2,1,19
370139518,518,3,2,3,526
370140026,24,12,2,1,39
370148509,120,3,2,6,131
370149424,10,4,2,1,17
370158417,63,6,20,34,123
370161925,66,3,2,1,72
370166908,66,27,5,3,101
370172750,121,3,2,1,127
370180803,41,36,2,1,80
370186714,67,54,2,1,124
370204169,74,3,2,2,81
370213299,111,17,36,67,231
370215459,43,3,2,1,49
370216068,79,3,2,2,86
370220078,99,4,2,10,115
370231561,74,69,24,24,191
370238733,37,86,23,16,162
370251005,35,3,2,3,43
370257583,64,3,2,1,70
370262578,24,3,2,1,30
370263357,129,27,2,10,168
370264350,72,3,2,1,78
370280603,73,29,2,5,109
370283035,525,3,2,1,531
370286916,87,13,13,36,149
370287590,119,31,22,8,180
370306639,22,3,2,1,28
370313698,11,3,2,1,17
370326494,121,70,2,32,225
370333139,13,31,2,1,47
370337339,64,36,6,1,107
370342526,19,23,2,1,45
370368607,107,21,32,13,173
370374992,33,29,14,1,77
370374999,118,61,71,23,273
370383808,66,13,6,6,91
370383915,121,18,2,7,148
370390975,213,43,3,4,263
370413330,148,3,2,2,155
370413838,28,14,2,1,45
370438589,27,15,2,1,45
370445627,109,31,2,4,146
370450610,85,3,2,20,110
370460486,59,29,6,20,114
370473579,39,3,2,1,45
370485861,77,32,39,20,168
370491876,82,15,22,2,121
370497843,70,3,2,1,76
370497885,67,47,2,19,135
370516429,105,12,6,90,213
370518967,26,3,2,1,32
370519813,76,35,2,6,119
370529673,11,25,2,2,40
370533234,50,7,2,27,86
370538284,62,24,60,3,149
370543771,16,9,3,1,29
370552491,174,45,54,29,302
370552907,24,9,26,7,66
370554866,83,6,2,16,107
370579095,50,14,3,1,68
370580626,23,3,2,5,33
370584952,77,107,10,18,212
370596300,93,4,3,2,102
370596746,45,13,2,1,61
370601440,11,14,2,1,28
370612112,85,3,2,1,91
370627551,41,15,2,1,59
370642168,22,3,2,1,28
370650623,20,3,2,1,26
370654363,24,3,2,1,30
370677825,88,3,5,5,101
370678785,66,79,58,39,242
370680916,11,9,2,1,23
370683915,122,3,2,2,129
370688748,120,111,112,1,344
370690626,12,3,2,1,18
370692605,148,45,37,4,234
370700797,44,3,2,1,50
370708592,12,12,2,1,27
370711007,113,3,2,2,120
370717044,20,17,2,1,40
370736831,41,15,8,6,70
370739384,10,5,2,1,18
370747667,90,31,27,3,151
370748745,14,3,2,1,20
370754455,11,3,2,1,17
370756047,149,18,23,22,212
370761827,15,59,4,1,79
370764213,16,20,3,1,40
370766821,14,3,2,1,20
370778863,17,3,2,1,23
370793017,42,44,12,5,103
370794038,77,3,2,1,83
370813606,55,30,13,9,107
370816303,10,13,2,1,26
370820734,186,11,2,1,200
370840636,27,14,9,17,67
370853021,52,6,2,12,72
370853072,10,3,2,2,17
370871294,64,12,2,1,79
370879461,121,3,2,5,131
370892346,312,3,2,9,326
370916555,271,96,44,2,413
370916924,79,20,2,13,114
370918384,67,75,147,11,300
370918964,16,5,27,3,51
370926931,10,3,2,2,17
370975701,79,56,53,17,205
370976177,61,34,69,9,173
371006344,27,10,6,10,53
371008396,10,6,2,1,19
371011602,11,3,2,1,17
371017613,48,81,5,1,135
371018551,73,22,2,2,99
371021032,47,17,3,9,76
371025170,18,23,4,1,46
371027910,179,69,2,2,252
371058345,283,3,2,11,299
371060994,59,105,24,6,194
371063812,46,3,2,3,54
371083664,84,11,3,1,99
371087463,11,3,2,1,17
371120186,60,32,8,34,134
371144483,44,29,2,1,76
371144970,33,24,40,26,123
371164306,96,3,2,10,111
371168503,32,3,2,3,40
371182972,160,3,2,9,174
371200478,46,18,2,2,68
371206762,65,25,9,4,103
371226526,56,37,28,1,122
371230147,157,66,47,4,274
371234813,222,3,2,1,228
371235327,60,22,2,1,85
371241924,53,3,2,5,63
371265998,70,12,2,1,85
371299014,16,3,2,1,22
371318776,24,14,2,1,41
371322635,184,44,14,1,243
371327282,59,78,3,1,141
371334604,66,35,14,4,119
371341112,68,24,42,16,150
371346164,44,20,2,1,67
371358160,10,3,2,2,17
371383007,139,3,11,1,154
371389365,96,3,3,9,111
371390090,77,8,2,19,106
371390669,80,16,2,1,99
371391614,12,3,2,3,20
371398101,75,3,2,1,81
371420228,212,3,2,12,229
371423612,84,9,6,2,101
371424624,82,28,45,20,175
371432387,84,15,85,3,187
371453423,124,3,2,4,133
371453704,14,11,2,20,47
371463394,59,44,8,2,113
371475743,119,3,2,1,125
371480156,192,3,2,34,231
371502379,68,25,39,8,140
371518298,22,3,2,1,28
371522625,53,31,2,1,87
371531076,103,19,31,15,168
371544253,21,3,2,1,27
371547814,72,3,2,5,82
371548625,152,51,2,7,212
371552950,88,8,2,13,111
371585588,131,41,92,31,295
371604621,61,15,3,1,80
371628956,11,10,2,2,25
371629180,11,3,2,1,17
371647325,97,47,40,45,229
371654642,55,32,2,1,90
371662903,39,27,15,2,83
371666723,33,3,2,1,39
371671800,262,12,2,4,280
371688174,22,5,2,1,30
371696852,15,3,2,1,21
371711523,12,8,2,1,23
371727991,48,12,3,1,64
371733025,114,3,24,5,146
371733183,10,18,2,1,31
371737188,65,21,17,33,136
371749003,10,5,2,1,18
371753553,11,18,2,3,34
371756723,80,25,13,7,125
371766831,13,3,2,1,19
371773405,12,3,2,1,18
371779490,75,3,2,1,81
371791603,98,46,12,30,186
371809394,112,41,2,22,177
371810031,74,38,2,1,115
371811585,52,24,15,8,99
371813745,11,5,2,1,19
371826056,19,6,2,3,30
371827545,174,41,16,3,234
371831699,30,3,2,2,37
371845256,76,19,2,6,103
371853151,67,28,11,17,123
371857936,60,41,18,13,132
371870518,65,7,54,1,127
371877455,78,49,66,14,207
371884409,85,60,21,24,190
371885042,20,56,2,31,109
371900732,109,36,19,6,170
371915899,77,52,2,6,137
371922636,10,3,2,2,17
371923747,49,3,2,3,57
371933110,50,32,26,1,109
371938133,23,10,2,3,38
371939759,65,3,2,10,80
371940711,60,22,8,1,91
371975784,72,24,11,3,110
371976413,16,3,2,1,22
371979239,136,26,28,20,210
371985569,46,28,2,3,79
372004775,108,17,6,21,152
372005307,55,18,83,1,157
372010931,207,57,2,21,287
372011173,66,7,10,17,100
372018715,84,14,79,2,179
372018972,82,19,21,2,124
372025785,31,10,23,1,65
372042576,283,10,2,1,296
372047984,44,64,25,18,151
372062323,110,46,13,1,170
372064275,100,36,2,70,208
372070164,115,9,2,1,127
372104576,39,39,25,45,148
372111619,47,38,2,7,94
372128960,136,48,16,12,212
372129284,118,31,2,9,160
372150812,29,3,7,1,40
372160328,67,3,2,5,77
372172643,32,8,2,1,43
372182784,64,26,16,20,126
372194714,49,3,2,5,59
372198702,18,3,2,1,24
372221981,25,8,15,3,51
372223220,15,47,5,20,87
372226352,71,3,2,1,77
372228061,52,92,22,65,231
372229567,64,31,2,4,101
372234648,236,136,3,7,382
372245410,102,22,9,19,152
372252196,158,3,2,28,191
372258355,44,4,28,1,77
372260355,30,18,24,1,73
372267773,104,3,2,4,113
372268156,24,66,30,2,122
372271874,35,44,7,5,91
372273586,14,3,2,1,20
372274196,12,3,2,1,18
372293611,41,19,3,2,65
372296927,58,46,26,34,164
372311111,91,3,2,55,151
372316125,146,5,2,2,155
372324154,45,3,2,1,51
372326523,116,21,10,3,150
372328205,44,3,2,4,53
372331379,22,23,2,2,49
372333714,20,18,2,1,41
372343613,58,8,4,2,72
372344389,65,3,2,1,71
372347803,15,6,2,1,24
372364728,45,3,2,2,52
372366341,19,3,2,14,38
372380258,173,3,2,1,179
372381317,89,3,2,3,97
372400947,104,3,2,2,111
372408755,58,66,3,1,128
372426958,32,9,2,3,46
372434550,39,59,18,2,118
372444122,14,3,2,1,20
372456163,100,3,2,6,111
372460457,25,3,2,4,34
372462375,16,3,2,1,22
372473570,45,110,10,5,170
372475766,112,33,2,7,154
372476828,52,6,2,1,61
372478316,10,28,2,1,41
372486790,27,19,79,48,173
372488408,137,3,2,1,143
372494891,67,20,34,13,134
372514326,11,3,2,1,17
372530882,109,19,114,1,243
372531966,55,8,12,1,76
372541671,12,3,2,1,18
372569010,72,3,2,1,78
372573319,36,3,2,1,42
372584525,64,21,2,5,92
372597396,29,3,2,1,35
372604473,98,35,41,4,178
372606679,171,3,2,1,177
372613213,18,3,2,1,24
372615093,10,3,2,3,18
372615573,129,66,29,19,243
372621705,132,35,36,2,205
372624422,93,26,2,65,186
372629919,17,3,2,1,23
372639395,26,3,2,1,32
372639824,37,25,23,36,121
372647533,67,21,2,2,92
372667095,97,14,22,4,137
372672624,60,19,10,2,91
372678949,137,3,2,1,143
372712251,17,3,2,1,23
372715342,55,3,2,2,62
372719778,17,19,27,1,64
372727355,71,3,2,2,78
372745275,69,10,2,1,82
372753993,45,26,2,1,74
372754046,14,14,2,3,33
372767338,77,57,3,28,165
372771895,48,3,2,2,55
372782124,55,3,2,1,61
372792902,21,55,6,1,83
372804189,65,19,22,19,125
372812221,95,19,2,6,122
372837850,46,51,63,3,163
372847096,12,3,2,3,20
372853096,67,6,33,7,113
372855957,39,49,56,5,149
372862862,55,5,4,1,65
372865604,18,32,2,1,53
372872069,11,3,2,5,21
372873745,41,34,17,10,102
372877459,11,3,2,1,17
372884458,13,21,3,1,38
372898773,56,57,27,11,151
372904358,75,11,2,3,91
372906665,19,3,2,10,34
372907260,10,23,2,1,36
372927815,19,3,2,1,25
372937275,32,29,26,1,88
372944466,17,3,2,1,23
372944749,44,23,2,1,70
372948365,110,42,74,13,239
372950695,11,3,2,1,17
372956112,84,28,36,1,149
372964949,25,3,2,1,31
372966081,129,31,25,8,193
372969012,16,3,2,1,22
372969671,33,3,2,3,41
372976365,34,3,2,1,40
372976881,27,22,8,1,58
372985428,134,3,2,1,140
372986258,36,43,26,4,109
372995983,26,24,2,5,57
372999680,15,3,2,1,21
373001433,11,3,2,1,17
373013908,11,3,2,1,17
373030922,78,3,2,2,85
373049859,22,26,9,1,58
373052692,255,9,2,4,270
373054403,80,27,9,32,148
373055262,73,3,2,1,79
373055962,41,32,79,10,162
373067198,10,6,2,1,19
373070286,16,3,2,1,22
373073033,10,3,2,2,17
373089621,10,14,2,3,29
373096228,86,3,2,1,92
373096417,15,8,3,9,35
373100634,43,35,17,1,96
373100727,93,12,2,7,114
373110373,38,16,5,1,60
373111924,54,52,18,1,125
373114187,123,19,8,60,210
373121451,76,36,127,1,240
373124787,19,3,2,2,26
373125169,121,44,40,4,209
373131009,11,10,2,1,24
373148997,12,3,2,1,18
373151609,232,142,3,13,390
373153194,132,76,28,1,237
373154549,151,16,21,11,199
373172942,167,30,16,7,220
373174739,17,30,3,3,53
373177480,19,10,2,2,33
373178641,16,3,2,1,22
373187964,68,29,11,9,117
373189357,41,45,12,1,99
373203076,11,18,2,1,32
373212016,157,3,2,2,164
373230792,25,23,10,1,59
373231174,11,28,11,13,63
373237013,154,88,48,27,317
373263703,104,3,2,5,114
373267094,72,58,14,16,160
373277189,10,8,2,1,21
373279176,101,36,6,11,154
373279280,53,20,2,4,79
373301712,33,92,2,3,130
373303071,104,10,2,12,128
373328122,51,11,2,1,65
373328227,68,26,68,52,214
373368805,79,75,31,15,200
373370664,44,7,114,1,166
373378906,27,3,2,1,33
373386433,123,19,2,22,166
373415740,51,3,2,8,64
373438550,129,67,16,1,213
373455487,118,3,9,1,131
373468270,75,17,8,12,112
373471445,69,21,2,4,96
373475262,21,3,2,1,27
373479320,15,3,2,1,21
373498876,135,56,104,7,302
373504426,204,47,2,4,257
373504455,26,8,2,1,37
373512040,11,3,2,1,17
373512682,35,3,2,6,46
373515750,41,17,36,7,101
373533148,15,3,2,1,21
373534762,16,7,2,2,27
373536507,82,57,2,4,145
373542181,53,45,2,1,101
373543115,271,8,2,3,284
373554568,94,11,2,3,110
373587594,11,3,2,1,17
373593392,197,39,8,5,249
373622724,97,9,6,4,116
373630405,91,33,3,3,130
373637439,21,55,10,2,88
373641851,109,40,7,5,161
373654455,13,14,2,1,30
373675021,27,10,2,1,40
373679943,24,3,2,4,33
373690939,29,22,32,1,84
373693908,29,19,2,1,51
373711287,18,9,2,2,31
373713238,59,30,61,1,151
373719509,114,29,12,5,160
373725384,90,13,66,2,171
373732004,86,13,5,11,115
373733626,60,3,2,1,66
373734135,57,13,65,4,139
373739019,30,35,45,3,113
373744600,44,3,2,3,52
373767549,114,50,47,3,214
373768765,94,3,2,1,100
373770756,30,3,2,2,37
373773235,20,14,3,3,40
373797484,70,4,4,2,80
373807777,58,19,41,8,126
373821543,123,10,24,2,159
373845329,72,3,2,3,80
373852524,103,26,2,4,135
373857739,15,10,3,1,29
373857826,11,3,2,10,26
373862891,81,3,2,31,117
373865787,75,3,2,8,88
373873392,33,10,19,5,67
373876190,212,10,3,9,234
373884496,30,13,4,10,57
373901434,49,8,15,1,73
373919147,16,26,8,4,54
373931223,112,30,32,2,176
373944748,146,41,28,15,230
373944914,55,6,7,13,81
373947133,15,3,2,1,21
373950519,108,25,53,30,216
373956547,39,3,2,1,45
373970532,27,7,4,2,40
373979848,42,5,2,1,50
373981196,156,17,2,1,176
373992391,37,36,32,2,107
373992578,71,22,6,2,101
373997327,102,23,2,6,133
374015802,46,21,4,6,77
374023034,12,3,2,1,18
374024230,86,3,2,10,101
374025995,22,12,2,1,37
374026659,83,3,2,1,89
374068811,58,26,2,8,94
374072889,65,37,41,14,157
374074028,69,18,14,14,115
374083813,50,30,50,26,156
374086939,143,39,7,17,206
374088024,34,70,2,4,110
374103200,41,11,10,1,63
374115573,102,3,2,1,108
374119903,58,21,9,8,96
374127529,252,24,4,1,281
374130348,71,20,16,4,111
374135674,64,21,2,2,89
374140718,501,3,2,1,507
374149920,21,4,2,7,34
374161608,65,23,54,17,159
374174689,20,3,2,1,26
374191058,43,8,2,1,54
374194538,146,3,2,5,156
374206063,207,97,4,18,326
374228076,20,20,2,95,137
374228856,15,18,2,1,36
374237627,40,36,30,1,107
374260049,36,13,2,3,54
374260309,31,15,2,8,56
374272330,34,3,2,15,54
374276203,69,3,2,8,82
374294839,48,13,2,28,91
374309483,51,11,4,1,67
374322039,24,18,2,8,52
374322951,97,3,2,9,111
374342071,36,10,19,10,75
374350007,162,23,47,4,236
374355583,48,29,2,1,80
374359596,150,48,36,71,305
374366405,48,25,10,9,92
374376888,100,20,28,19,167
374393694,50,21,11,11,93
374393904,236,3,2,1,242
374458735,37,48,40,43,168
374463991,45,13,9,1,68
374515652,47,33,27,5,112
374525159,60,26,27,3,116
374538101,14,3,2,1,20
374546636,43,19,3,5,70
374548032,133,41,7,6,187
374553399,20,11,2,1,34
374554283,11,3,2,1,17
374558293,10,4,2,1,17
374558804,12,3,2,1,18
374558905,77,8,2,10,97
374599795,54,27,11,24,116
374614415,154,32,42,34,262
374631863,14,12,3,4,33
374638546,69,49,83,2,203
374659625,93,18,7,2,120
374676401,77,50,11,7,145
374676495,69,3,2,1,75
374677327,168,14,2,3,187
374684739,54,29,19,46,148
374687162,99,46,4,9,158
374694369,90,11,2,1,104
374697010,20,3,2,1,26
374698619,67,35,2,8,112
374705111,35,3,2,1,41
374708580,88,45,2,4,139
374718835,119,56,37,15,227
374726314,90,31,73,1,195
374735682,10,3,2,6,21
374737065,84,3,4,2,93
374768339,39,44,2,13,98
374781569,38,17,25,1,81
374787715,16,3,2,1,22
374788578,113,13,11,16,153
374809338,33,65,2,1,101
374848228,13,36,7,1,57
374850022,54,13,14,1,82
374858973,95,3,2,13,113
374859448,59,11,2,5,77
374871620,11,3,2,2,18
374879524,71,3,2,1,77
374879698,114,59,62,37,272
374890008,34,13,4,14,65
374890601,65,10,2,14,91
374902837,21,3,2,1,27
374922340,17,20,9,15,61
374923986,63,67,16,14,160
374926758,12,3,2,1,18
374933870,46,7,2,1,56
374937550,12,3,2,1,18
374945777,31,29,2,7,69
374966165,66,20,13,30,129
374969637,201,18,3,6,228
374985933,84,3,2,1,90
375002900,75,19,25,102,221
375003325,31,13,15,8,67
375026378,13,6,2,4,25
375039783,72,17,22,41,152
375074263,153,33,45,1,232
375084966,75,21,2,1,99
375085186,126,3,2,3,134
375089739,63,59,45,6,173
375098414,11,3,2,1,17
375105761,19,51,2,1,73
375112560,17,32,57,16,122
375119060,25,52,8,65,150
375119072,185,3,2,23,213
375123031,98,24,13,4,139
375128153,46,25,2,2,75
375132549,109,32,36,3,180
375140384,141,22,19,16,198
375142805,11,3,2,1,17
375146745,194,11,70,13,288
375148628,13,11,2,1,27
375155496,81,21,4,23,129
375165384,35,3,2,1,41
375167410,126,5,3,1,135
375173520,59,22,94,3,178
375177282,58,3,3,5,69
375191346,71,24,2,4,101
375197796,142,44,5,3,194
375204534,116,12,2,9,139
375204545,77,40,5,1,123
375209666,55,3,2,1,61
375210145,11,5,2,1,19
375214833,99,3,14,6,122
375216535,63,42,5,13,123
375217921,13,3,2,1,19
375227755,27,38,20,2,87
375236070,10,5,2,1,18
375238884,89,19,2,4,114
375243087,78,32,4,5,119
375244027,24,24,2,2,52
375247673,13,8,2,4,27
375255485,18,3,2,1,24
375258632,24,23,5,6,58
375270444,17,3,2,1,23
375276124,32,42,2,1,77
375279054,31,3,2,3,39
375287116,13,3,2,1,19
375294914,35,15,16,2,68
375300067,66,3,2,2,73
375306065,38,21,3,5,67
375313705,195,3,2,3,203
375314095,12,7,2,1,22
375330301,110,8,2,1,121
375354295,35,42,5,2,84
375363107,15,3,2,1,21
375367383,93,9,2,1,105
375373896,19,3,2,1,25
375375073,52,3,6,1,62
375377504,84,3,2,2,91
375382358,59,15,2,6,82
375383092,75,4,2,1,82
375385818,26,8,2,20,56
375394742,12,4,2,1,19
375406159,50,3,2,1,56
375407769,33,5,2,6,46
375408448,246,3,2,4,255
375428862,39,20,2,4,65
375434294,102,3,2,2,109
375452567,22,3,2,1,28
375461855,54,19,13,1,87
375474487,48,22,2,1,73
375479740,10,6,2,1,19
375483330,146,3,2,4,155
375489938,34,36,9,48,127
375498145,93,26,42,6,167
375508390,32,16,2,1,51
375513079,80,13,56,4,153
375518820,109,22,14,1,146
375522221,105,18,3,29,155
375526190,12,4,2,1,19
375527377,91,16,2,3,112
375541196,115,14,2,5,136
375544668,112,30,2,2,146
375546291,126,3,3,6,138
375547410,15,3,2,3,23
375559524,161,33,15,17,226
375559823,99,31,2,1,133
375559836,35,3,2,1,41
375561166,34,37,2,1,74
375564169,152,3,4,20,179
375567617,21,3,2,1,27
375571024,21,3,2,1,27
375577913,17,3,2,1,23
375592125,28,10,2,1,41
375607399,190,25,3,2,220
375619205,26,21,2,2,51
375627278,20,3,2,11,36
375646037,30,13,7,11,61
375651378,23,3,2,1,29
375655463,26,36,3,11,76
375658186,27,3,2,3,35
375659669,101,3,2,1,107
375680177,10,9,2,1,22
375688431,90,35,21,19,165
375693254,109,6,18,10,143
375694931,163,39,53,2,257
375697610,131,119,2,17,269
375698381,27,13,2,1,43
375698845,43,3,2,3,51
375713555,32,40,50,40,162
375728088,23,41,12,7,83
375739802,67,50,25,25,167
375749379,82,20,5,18,125
375749581,54,39,2,1,96
375756404,99,22,2,1,124
375766629,13,13,2,1,29
375772887,79,5,62,16,162
375775660,39,43,2,15,99
375776504,12,3,2,1,18
375782822,116,16,3,1,136
375795938,12,3,2,2,19
375800619,66,42,13,2,123
375801890,141,14,16,1,172
375803340,53,28,2,1,84
375812053,51,3,2,1,57
375812162,65,3,2,2,72
375813090,40,15,2,10,67
375819490,57,3,2,1,63
375829921,71,22,31,18,142
375855343,17,6,3,2,28
375879310,99,86,74,8,267
375889860,40,21,2,1,64
375907820,49,3,2,1,55
375910709,50,13,2,2,67
375921389,58,4,2,1,65
375933615,48,26,4,1,79
375935480,183,18,8,2,211
375944826,134,12,38,3,187
375953705,17,24,2,1,44
375968015,11,4,2,4,21
375968266,46,6,2,1,55
375984223,88,7,2,14,111
375988744,35,14,3,5,57
375992449,15,86,8,2,111
375992553,63,3,3,1,70
375994348,13,3,2,1,19
375998060,327,3,2,3,335
375998884,14,10,2,1,27
376002678,182,3,2,4,191
376008559,18,3,2,1,24
376021626,56,13,64,1,134
376028909,72,19,2,1,94
376028985,73,33,114,16,236
376033317,50,34,35,1,120
376037389,60,3,2,4,69
376041273,33,3,2,1,39
376045677,67,11,47,7,132
376058365,10,14,4,1,29
376070962,85,10,2,1,98
376077095,10,7,2,1,20
376078192,23,3,2,1,29
376080962,106,34,31,5,176
376105959,61,20,5,9,95
376131182,33,5,2,1,41
376176769,51,3,2,1,57
376183492,69,16,122,1,208
376191405,45,3,2,1,51
376201374,118,58,4,44,224
376210904,31,52,2,7,92
376238413,134,15,24,5,178
376245034,98,13,2,4,117
376253065,151,3,2,7,163
376260631,21,72,3,5,101
376274049,11,3,2,1,17
376274817,47,17,9,4,77
376276341,41,53,2,2,98
376285337,32,34,6,2,74
376290067,61,25,17,1,104
376291186,59,47,7,2,115
376294651,63,10,2,3,78
376295432,13,35,2,1,51
376296034,63,34,15,1,113
376309266,22,34,2,1,59
376318983,13,3,2,4,22
376344088,220,10,15,1,246
376347470,66,34,18,1,119
376353231,197,3,7,4,211
376387970,126,45,2,1,174
376405609,61,3,2,3,69
376432271,107,3,2,1,113
376446826,111,34,28,16,189
376455444,118,10,2,2,132
376472614,41,3,2,5,51
376474985,29,3,2,34,68
376484532,858,3,2,128,991
376488913,86,22,36,9,153
376502706,44,9,4,1,58
376505122,39,44,3,1,87
376506511,48,3,2,1,54
376522035,31,29,67,12,139
376526220,106,81,54,8,249
376533724,66,22,2,4,94
376534491,47,36,41,8,132
376536776,89,33,2,1,125
376566355,83,21,6,78,188
376569186,100,26,25,2,153
376576455,100,3,2,1,106
376587101,55,18,2,1,76
376600092,69,3,2,3,77
376630670,17,4,2,5,28
376637029,32,18,51,5,106
376646058,54,3,2,1,60
376666712,13,3,2,1,19
376669144,16,6,2,1,25
376671070,10,3,2,2,17
376692017,120,32,15,5,172
376698062,42,5,2,1,50
376722723,105,29,103,21,258
376729937,60,31,15,15,121
376730412,71,20,21,28,140
376731876,127,13,2,1,143
376734887,30,13,11,1,55
376757320,36,3,2,1,42
376765794,159,3,2,1,165
376790598,25,21,2,1,49
376798973,36,7,2,1,46
376812705,72,5,5,1,83
376815165,22,3,2,1,28
376831711,30,3,2,1,36
376835869,46,13,60,16,135
376838095,103,26,37,25,191
376863965,13,3,2,1,19
376874502,157,3,2,5,167
376875664,75,12,2,5,94
376885028,78,23,60,16,177
376885272,41,14,2,9,66
376889442,54,76,55,34,219
376889907,117,21,2,5,145
376892324,18,31,2,2,53
376911422,63,3,2,1,69
376920758,38,8,2,5,53
376930901,61,30,2,11,104
376936695,628,3,2,5,638
376974642,14,20,5,3,42
376978193,138,26,13,1,178
376996135,17,15,2,1,35
377007195,33,37,52,9,131
377013369,42,28,2,4,76
377027796,60,10,34,33,137
377049179,73,3,2,4,82
377050213,30,3,2,1,36
377056137,99,104,11,11,225
377061126,11,5,2,1,19
377065674,111,3,2,3,119
377066457,57,3,2,1,63
377076475,66,3,2,3,74
377084744,77,10,15,12,114
377097835,15,20,3,2,40
377136554,61,23,13,1,98
377138514,55,3,2,3,63
377143246,70,11,21,5,107
377146789,80,3,6,1,90
377160808,88,3,2,3,96
377164202,40,3,2,2,47
377168211,52,37,11,9,109
377175021,13,3,2,1,19
377196321,40,3,2,1,46
377209251,55,54,21,6,136
377210358,43,21,12,7,83
377212335,119,50,50,1,220
377232405,200,3,2,1,206
377243567,120,3,2,1,126
377265066,10,3,2,2,17
377287084,71,75,26,1,173
377288255,69,3,2,13,87
377291636,24,3,2,3,32
377317520,74,3,2,1,80
377319300,98,21,5,3,127
377360124,57,37,3,5,102
377378089,16,16,35,1,68
377378732,16,3,2,2,23
377379972,16,37,2,39,94
377384192,64,3,2,1,70
377386576,149,13,10,26,198
377387166,60,26,63,29,178
377389551,47,3,2,1,53
377410158,121,14,2,6,143
377411677,100,3,2,3,108
377418110,40,3,2,1,46
377422869,43,9,4,1,57
377433284,52,20,2,6,80
377434237,25,3,2,5,35
377451643,86,39,53,1,179
377454042,19,3,2,2,26
377465380,54,3,2,1,60
377485044,71,3,2,1,77
377490920,21,3,2,10,36
377501690,68,9,2,5,84
377504692,56,3,2,8,69
377509429,48,3,2,1,54
377513071,13,60,3,1,77
377553230,21,29,43,1,94
377561847,100,80,18,36,234
377563607,21,13,4,1,39
377568284,31,3,2,1,37
377582790,90,25,3,8,126
377588190,107,40,11,28,186
377589555,98,33,81,1,213
377589571,107,21,2,37,167
377591352,81,3,2,1,87
377597189,43,56,4,2,105
377609325,46,18,46,4,114
377616009,107,3,2,14,126
377617920,99,9,2,1,111
377624165,102,15,3,3,123
377644846,53,26,22,7,108
377648937,16,3,2,1,22
377660566,11,3,2,1,17
377665971,39,17,11,29,96
377667589,61,17,8,1,87
377669338,564,13,58,165,800
377673064,90,11,3,3,107
377673442,18,6,3,2,29
377684568,32,29,29,1,91
377686620,37,3,2,1,43
377698817,15,3,2,2,22
377705027,78,3,2,8,91
377708758,18,3,2,2,25
377724594,78,15,80,1,174
377731489,24,3,2,4,33
377746813,56,31,19,3,109
377748033,73,7,2,3,85
377752440,41,17,38,1,97
377766400,40,3,2,3,48
377766421,80,25,35,14,154
377775167,47,35,8,2,92
377778240,144,24,3,3,174
377780425,17,15,2,1,35
377810503,44,3,2,1,50
377814255,27,38,27,1,93
377817804,18,16,2,1,37
377820639,64,20,15,51,150
377821497,32,54,2,4,92
377824923,39,28,88,1,156
377853150,41,3,2,1,47
377855114,79,7,2,5,93
377864453,20,35,3,10,68
377873806,67,3,2,4,76
377877189,12,3,2,1,18
377880278,139,3,2,6,150
377882430,154,3,2,9,168
377888810,10,8,2,1,21
377907969,89,19,129,123,360
377912822,14,3,2,1,20
377918501,20,21,2,3,46
377923822,91,3,125,1,220
377929334,37,54,25,7,123
377929850,90,23,9,1,123
377935809,97,16,2,1,116
377935935,81,12,2,1,96
377938230,12,3,2,1,18
377940213,112,26,5,4,147
377962306,25,44,2,1,72
377964121,181,3,48,14,246
377965011,25,49,15,1,90
377975201,99,54,33,25,211
377989316,201,20,4,27,252
378001332,29,16,4,1,50
378002397,52,13,9,1,75
378002938,75,3,2,1,81
378017693,470,6,19,31,526
378041386,193,23,2,19,237
378041874,39,8,2,1,50
378049940,50,23,8,3,84
378057161,59,35,32,2,128
378077155,14,10,2,2,28
378097255,43,22,7,7,79
378111263,48,7,10,2,67
378121094,173,14,3,2,192
378124815,36,37,11,7,91
378141509,118,31,5,54,208
378149766,136,40,2,1,179
378158298,116,10,2,3,131
378166941,55,59,48,4,166
378168717,11,3,2,1,17
378172425,48,61,4,13,126
378182933,29,39,39,1,108
378183865,37,51,24,9,121
378187692,118,28,2,7,155
378188620,40,40,2,1,83
378198817,48,33,20,1,102
378204855,12,3,2,1,18
378209812,42,9,2,4,57
378216260,67,16,20,7,110
378223160,33,64,2,1,100
378225632,61,11,2,1,75
378229225,76,13,2,1,92
378232116,93,21,20,27,161
378232201,93,12,2,1,108
378238195,34,3,2,1,40
378243125,72,30,2,1,105
378254976,12,4,5,3,24
378257051,34,3,2,2,41
378262462,161,3,2,1,167
378279477,189,72,13,31,305
378280759,10,5,2,3,20
378281899,42,3,2,1,48
378288927,126,82,95,26,329
378300451,12,3,2,1,18
378316304,44,9,6,12,71
378320337,16,3,2,1,22
378326806,14,33,13,4,64
378360236,163,3,2,5,173
378363155,54,3,2,3,62
378373299,46,35,32,1,114
378374924,73,33,61,11,178
378375731,27,29,3,7,66
378379903,83,9,2,9,103
378407194,55,43,32,7,137
378408236,11,9,2,1,23
378423532,138,28,2,4,172
378428910,38,5,26,5,74
378443797,51,70,34,10,165
378452442,20,14,10,6,50
378462852,39,49,9,2,99
378472849,143,3,2,1,149
378498602,45,63,23,12,143
378498755,125,120,31,7,283
378500907,33,22,2,1,58
378504380,63,3,29,1,96
378517084,10,3,2,3,18
378517632,41,13,2,1,57
378523302,131,3,2,1,137
378525562,103,10,2,1,116
378530717,139,39,2,3,183
378566507,266,48,2,5,321
378568005,116,48,104,1,269
378580791,70,7,2,3,82
378587974,15,11,2,1,29
378591026,57,45,41,14,157
378615819,22,15,2,1,40
378629163,25,5,2,1,33
378632930,88,5,24,6,123
378645100,28,3,2,1,34
378660290,196,9,3,1,209
378668189,59,31,33,66,189
378668344,42,31,42,30,145
378720528,328,3,2,6,339
378730067,91,30,2,4,127
378755038,214,9,2,9,234
378768383,21,34,2,1,58
378790408,87,53,2,8,150
378794182,18,5,2,1,26
378814947,44,3,2,1,50
378817060,10,6,2,2,20
378826221,89,3,2,2,96
378828465,12,3,2,1,18
378842024,647,3,2,6,658
378850603,78,3,2,1,84
378855946,14,3,13,3,33
378860746,85,65,18,8,176
378869177,107,23,2,33,165
378872716,44,15,2,1,62
378879139,68,3,2,1,74
378880466,67,14,26,1,108
378892057,56,53,2,3,114
378894488,30,29,34,5,98
378899515,70,3,2,8,83
378917725,62,3,2,1,68
378918720,46,66,9,4,125
378922242,31,14,2,1,48
378931977,115,29,2,9,155
378937258,56,45,4,8,113
378947017,154,37,7,24,222
378957991,47,20,9,21,97
378964083,29,12,2,4,47
378973797,24,26,2,6,58
378982585,10,3,9,1,23
378985256,38,3,2,1,44
378986560,79,20,22,6,127
378995769,260,18,2,7,287
378997210,73,16,4,14,107
379014559,36,13,66,17,132
379027557,32,21,4,1,58
379110775,38,3,2,5,48
379113939,92,26,2,13,133
379119708,66,7,2,9,84
379127249,28,54,2,5,89
379130105,32,3,2,1,38
379134493,90,10,2,1,103
379138420,80,22,15,7,124
379153742,95,3,2,11,111
379165498,16,8,2,1,27
379168320,75,3,69,1,148
379169141,87,17,2,4,110
379170376,59,36,13,15,123
379174237,144,39,32,2,217
379175294,26,3,2,1,32
379177199,162,3,2,3,170
379196859,90,3,2,1,96
379203540,94,3,2,1,100
379223282,47,3,2,3,55
379225830,27,3,2,1,33
379238546,31,14,4,3,52
379245802,46,37,2,10,95
379254954,184,16,53,15,268
379255028,10,34,2,1,47
379264140,15,25,2,1,43
379265260,10,60,3,1,74
379273800,41,40,113,23,217
379277245,49,26,23,8,106
379284477,147,3,2,10,162
379285403,12,3,2,2,19
379305951,59,96,11,4,170
379309707,39,3,2,1,45
379310096,21,3,2,4,30
379320538,223,35,2,37,297
379332646,52,34,8,1,95
379342543,35,44,47,1,127
379353400,11,44,2,2,59
379358882,70,14,36,18,138
379361406,56,3,2,4,65
379374959,43,3,2,1,49
379380034,148,3,2,2,155
379389505,25,6,2,1,34
379403822,46,3,2,1,52
379409202,11,3,2,1,17
379417982,18,6,2,29,55
379420979,74,18,89,1,182
379429002,190,4,2,3,199
379468141,31,23,3,16,73
379470428,162,23,6,35,226
379472498,13,3,2,5,23
379474369,106,39,28,16,189
379491081,18,7,2,1,28
379501358,249,3,2,15,269
379505103,63,5,38,1,107
379521238,11,3,2,1,17
379533588,88,27,2,27,144
379533600,36,19,2,14,71
379547201,14,10,2,1,27
379564781,46,3,2,1,52
379621949,59,83,6,64,212
379683137,17,6,2,10,35
379685788,64,16,2,2,84
379687752,79,5,3,1,88
379701053,132,12,2,1,147
379713346,45,33,90,13,181
379725458,11,4,23,1,39
379732841,26,24,2,2,54
379733934,19,7,4,2,32
379737340,102,58,24,12,196
379749743,33,10,2,1,46
379759895,139,3,2,8,152
379760350,58,3,10,6,77
379788530,47,40,12,42,141
379802388,144,18,2,10,174
379811731,80,32,11,11,134
379825994,54,6,2,7,69
379836541,30,37,33,7,107
379837572,27,3,2,1,33
379857723,67,10,15,5,97
379859626,47,35,14,1,97
379867682,32,4,2,1,39
379868179,95,26,2,1,124
379872530,24,20,3,20,67
379872811,18,10,2,1,31
379888321,106,35,5,1,147
379890687,86,41,124,2,253
379893849,73,10,2,2,87
379895303,167,18,5,6,196
379896186,62,17,28,7,114
379897587,102,59,17,53,231
379899698,102,3,2,1,108
379903549,78,8,6,22,114
379903890,107,50,5,43,205
379912891,68,3,2,15,88
379920535,42,39,2,3,86
379928389,83,6,2,1,92
379939413,61,7,2,7,77
379944735,11,3,2,1,17
379946531,67,50,12,8,137
379954009,177,3,2,1,183
379969149,36,17,23,8,84
379970007,27,3,2,1,33
379981176,71,79,42,5,197
379982214,16,3,2,1,22
379995124,42,3,2,1,48
380008296,117,8,2,1,128
380009518,11,3,2,1,17
380034964,55,3,2,6,66
380045876,12,3,2,1,18
380053274,456,3,2,5,466
380057789,37,8,2,6,53
380068591,14,3,2,2,21
380075991,69,37,31,74,211
380085933,16,3,2,1,22
380092341,11,7,2,1,21
380094511,47,12,24,1,84
380096148,25,3,2,1,31
380107120,124,51,15,1,191
380108191,42,20,21,1,84
380111494,95,19,2,8,124
380129573,14,3,2,1,20
380139823,114,18,47,4,183
380140516,61,117,26,6,210
380172305,478,3,2,55,538
380174039,42,3,2,3,50
380178434,54,29,8,19,110
380179858,95,8,2,4,109
380183311,85,23,20,5,133
380189583,10,3,2,2,17
380200909,41,3,2,1,47
380206522,15,3,2,1,21
380212458,18,22,2,3,45
380216499,15,3,2,2,22
380217552,82,31,22,13,148
380218892,54,31,3,2,90
380220248,68,24,21,3,116
380224589,101,50,15,3,169
380232236,37,3,2,1,43
380241522,127,33,177,1,338
380261139,22,33,2,1,58
380267740,11,3,2,1,17
380279922,67,5,2,2,76
380284936,14,3,3,4,24
380292033,179,3,2,9,193
380294815,26,3,2,1,32
380299921,44,13,6,1,64
380313711,62,3,2,4,71
380325070,86,57,18,11,172
380346062,63,3,2,4,72
380352677,13,3,2,1,19
380354850,17,22,9,5,53
380368537,26,27,2,1,56
380376619,59,28,8,4,99
380381905,43,7,30,3,83
380393102,13,32,2,1,48
380398846,67,15,2,1,85
380444378,99,80,106,87,372
380454097,18,3,2,1,24
380470036,16,27,2,3,48
380481387,88,15,9,6,118
380488700,89,17,2,1,109
380501617,127,48,71,7,253
380506269,85,16,2,3,106
380512005,24,16,2,1,43
380525591,50,22,11,12,95
380525932,19,76,2,1,98
380549087,31,26,15,9,81
380553482,16,6,2,2,26
380558109,56,86,54,18,214
380558634,11,3,3,6,23
380574831,12,3,2,1,18
380583191,24,3,2,4,33
380590304,27,35,2,5,69
380595367,35,3,2,1,41
380601040,131,3,2,4,140
380620856,114,3,2,1,120
380642543,77,50,6,63,196
380645867,69,15,2,5,91
380656778,43,25,30,1,99
380678784,116,27,12,1,156
380686124,12,49,2,9,72
380736598,201,18,12,27,258
380741718,121,38,2,5,166
380742450,63,18,6,6,93
380754372,44,52,50,11,157
380773020,47,36,2,8,93
380776752,106,6,2,4,118
380788686,66,44,32,1,143
380795940,89,3,2,20,114
380811866,240,3,2,25,270
380817480,143,21,3,1,168
380821923,60,38,2,15,115
380831101,43,3,2,1,49
380844209,10,3,2,2,17
380849623,25,12,21,8,66
380858963,10,3,2,2,17
380862004,30,8,4,1,43
380866429,28,3,2,1,34
380867173,11,4,2,1,18
380872070,47,15,2,2,66
380889239,109,20,147,1,277
380890257,58,35,7,10,110
380895166,75,47,2,1,125
380895379,26,3,2,1,32
380904236,46,3,2,3,54
380912558,59,29,82,2,172
380927853,78,87,2,116,283
380935749,217,41,3,26,287
380938127,28,3,7,10,48
380951189,197,57,41,1,296
380952500,13,12,2,1,28
380974005,17,3,2,1,23
381018383,168,10,65,10,253
381022704,130,3,2,1,136
381026779,17,3,2,1,23
381039506,75,91,3,1,170
381045513,99,3,2,1,105
381048098,72,19,66,2,159
381051208,108,47,37,29,221
381054577,11,3,2,1,17
381054930,446,3,2,8,459
381063662,57,3,2,9,71
381078561,83,14,68,8,173
381080544,165,40,16,20,241
381081911,73,27,8,10,118
381090499,41,26,8,7,82
381097343,84,19,2,2,107
381099111,20,3,2,1,26
381101290,48,39,10,10,107
381102036,80,129,7,11,227
381110836,40,27,32,1,100
381117042,53,28,38,1,120
381125780,117,28,2,9,156
381130648,11,3,2,1,17
381138318,81,7,45,1,134
381144028,16,3,2,1,22
381145092,31,18,5,1,55
381148958,20,29,5,3,57
381156061,12,3,2,1,18
381157819,135,35,69,1,240
381171880,62,54,21,1,138
381189489,39,3,2,1,45
381200046,67,19,33,1,120
381207458,41,9,4,3,57
381211843,63,26,15,8,112
381219529,31,25,41,19,116
381260120,19,4,2,6,31
381260681,10,7,2,1,20
381262373,12,7,4,1,24
381264426,21,16,2,1,40
381267913,84,60,67,38,249
381281338,142,8,2,10,162
381297226,122,20,4,9,155
381298666,81,49,3,1,134
381305011,72,51,5,2,130
381330031,36,12,2,1,51
381337206,22,3,2,2,29
381368975,41,115,48,6,210
381370180,12,3,2,1,18
381374532,79,18,18,9,124
381379401,12,3,2,1,18
381390910,22,3,2,12,39
381392882,85,26,2,2,115
381402659,98,16,2,13,129
381410212,434,3,59,1,497
381411007,107,19,2,1,129
381428510,55,29,2,11,97
381429557,104,50,60,38,252
381448093,50,16,4,4,74
381454373,13,12,2,1,28
381461562,26,43,26,4,99
381468490,46,38,67,10,161
381481522,16,3,2,3,24
381487481,104,3,2,1,110
381492957,34,3,2,1,40
381502340,11,3,2,1,17
381524110,22,3,2,1,28
381524651,106,3,2,1,112
381528799,51,33,54,34,172
381533771,45,35,2,5,87
381554441,141,96,3,2,242
381573239,113,16,2,16,147
381579168,11,3,2,1,17
381581743,17,34,2,2,55
381587562,110,7,63,5,185
381606514,190,25,11,1,227
381622076,46,3,2,2,53
381627079,72,6,10,13,101
381638911,124,24,9,5,162
381643103,34,18,72,17,141
381645352,29,4,2,1,36
381649750,72,3,2,1,78
381666016,101,3,2,1,107
381685577,37,20,49,1,107
381705653,217,3,2,11,233
381721780,55,3,2,1,61
381724940,38,23,26,3,90
381728762,75,18,32,1,126
381731233,37,3,2,1,43
381737190,46,29,64,3,142
381737919,41,98,2,4,145
381746039,171,15,4,2,192
381762536,16,20,13,1,50
381766151,27,7,21,1,56
381769616,105,3,2,1,111
381771640,22,61,2,1,86
381774347,15,3,2,1,21
381802126,152,19,2,22,195
381802406,11,3,2,1,17
381803448,29,11,7,9,56
381804662,97,26,39,5,167
381807328,125,18,5,8,156
381850057,11,3,2,1,17
381857715,89,12,45,2,148
381884188,55,63,14,3,135
381890579,80,21,4,5,110
381902409,31,39,54,4,128
381905284,171,52,45,12,280
381913530,44,6,2,2,54
381916408,134,4,2,4,144
381920645,95,3,2,1,101
381930294,24,13,6,2,45
381936751,83,9,2,7,101
381950102,175,70,40,2,287
381970406,61,36,49,28,174
381981680,317,3,2,6,328
381982800,127,6,19,3,155
381985993,37,15,24,1,77
381991005,41,34,64,1,140
381994917,22,5,2,1,30
382019168,55,3,2,89,149
382024129,11,3,2,1,17
382040452,47,32,40,12,131
382064993,75,3,2,1,81
382077248,89,8,2,2,101
382088939,40,34,3,1,78
382089321,12,3,2,4,21
382104387,71,27,2,5,105
382112189,69,27,10,7,113
382116857,48,3,36,9,96
382118467,32,3,2,1,38
382122583,137,23,19,2,181
382131921,46,32,2,1,81
382136304,91,15,22,8,136
382166781,112,11,13,3,139
382168611,24,3,2,1,30
382176181,11,3,2,1,17
382191410,116,3,2,1,122
382206572,43,3,6,2,54
382207420,102,7,2,1,112
382218468,68,37,23,1,129
382219716,66,3,2,3,74
382235846,12,3,2,1,18
382239310,78,6,24,3,111
382248694,86,3,2,1,92
382252742,50,14,24,1,89
382266564,57,7,21,6,91
382267757,134,36,3,41,214
382269226,34,3,2,2,41
382285432,47,12,12,5,76
382292686,16,19,2,1,38
382300755,124,113,14,15,266
382305478,12,3,2,1,18
382308508,38,21,2,1,62
382311576,98,28,82,31,239
382322573,17,8,2,1,28
382322636,13,3,2,1,19
382330080,22,15,3,1,41
382336972,119,3,2,3,127
382347930,43,34,7,13,97
382367509,105,15,140,9,269
382369707,44,23,2,1,70
382375420,26,3,2,4,35
382388361,86,13,12,10,121
382393138,41,3,2,4,50
382398191,37,10,14,1,62
382406461,161,3,2,1,167
382406859,14,12,4,2,32
382420504,60,48,2,2,112
382457474,46,39,2,1,88
382470561,13,3,2,7,25
382476852,59,12,27,1,99
382488774,100,50,10,10,170
382491585,33,40,12,1,86
382496286,107,33,2,2,144
382497838,97,17,41,11,166
382498895,17,13,2,16,48
382502328,41,33,48,7,129
382517753,175,19,7,18,219
382522586,42,3,2,1,48
382524801,157,3,2,1,163
382534404,64,15,41,1,121
382536641,913,73,2,13,1001
382550972,12,3,2,1,18
382558358,46,10,2,1,59
382573999,23,3,2,1,29
382589064,72,24,7,2,105
382599209,15,29,2,2,48
382601054,133,3,2,9,147
382601774,120,41,3,12,176
382602663,13,7,2,1,23
382602911,38,108,87,8,241
382614816,26,42,2,7,77
382637717,51,3,2,5,61
382640744,20,3,2,5,30
382649040,28,22,20,4,74
382650844,153,36,2,13,204
382652598,44,13,15,1,73
382679452,15,32,9,12,68
382695240,77,32,36,16,161
382711659,28,3,2,3,36
382711763,12,4,2,1,19
382712233,135,32,35,7,209
382730450,77,76,95,1,249
382731039,16,3,2,2,23
382735852,44,30,41,47,162
382737043,90,14,7,5,116
382757039,47,8,2,13,70
382762763,24,50,22,1,97
382763522,173,42,34,29,278
382768862,17,3,2,3,25
382777770,86,3,2,3,94
382812622,26,13,13,1,53
382816576,63,17,2,5,87
382827233,29,3,2,1,35
382838270,52,3,2,14,71
382876798,70,3,2,2,77
382879326,16,6,2,1,25
382882439,11,3,2,1,17
382885102,98,27,55,3,183
382899785,32,45,13,4,94
382910784,37,3,2,1,43
382911890,58,3,2,1,64
382912533,89,3,2,2,96
382926904,21,14,2,1,38
382932052,75,7,3,13,98
382947872,105,21,2,10,138
382956351,10,6,2,1,19
382964472,53,3,2,1,59
382991665,40,5,2,2,49
382997880,18,3,2,1,24
383002874,11,3,2,1,17
383011681,16,3,2,1,22
383011992,11,7,2,1,21
383013241,54,33,5,19,111
383031821,40,3,2,2,47
383032370,44,34,12,30,120
383048803,10,17,2,1,30
383071466,124,17,51,1,193
383074526,76,8,2,28,114
383106381,134,4,4,2,144
383116334,35,3,3,1,42
383119201,131,87,41,51,310
383121388,38,14,2,1,55
383133970,63,11,16,1,91
383143067,63,17,15,8,103
383150255,72,27,2,2,103
383168632,87,8,3,1,99
383171858,49,10,2,4,65
383177253,59,54,101,8,222
383192434,35,58,26,10,129
383195574,50,20,24,4,98
383196908,37,6,7,11,61
383198890,41,3,2,5,51
383211881,52,3,2,8,65
383212461,154,34,12,31,231
383218149,232,58,26,3,319
383230843,11,3,2,1,17
383231211,11,33,2,3,49
383234919,31,11,11,13,66
383242049,10,31,2,2,45
383257759,597,3,2,4,606
383260010,112,13,2,5,132
383268199,46,61,6,1,114
383273846,75,75,57,1,208
383274588,23,6,2,2,33
383299506,39,7,2,11,59
383300777,146,32,3,10,191
383300884,46,6,17,40,109
383302062,33,6,2,1,42
383319198,104,6,25,8,143
383320490,124,3,2,1,130
383324535,99,3,2,1,105
383328370,188,49,15,1,253
383346006,81,57,76,63,277
383377764,19,28,2,1,50
383387295,138,3,2,4,147
383387482,51,17,3,1,72
383406295,29,3,2,1,35
383407501,63,25,71,16,175
383413139,11,3,2,1,17
383449246,62,3,2,1,68
383454067,18,3,2,1,24
383465856,52,3,2,2,59
383468731,22,25,2,1,50
383470697,130,43,4,11,188
383486277,19,48,3,2,72
383489454,76,18,16,3,113
383507634,76,43,29,90,238
383507786,11,3,2,1,17
383510955,10,9,2,1,22
383513339,43,3,2,1,49
383518804,11,3,2,3,19
383525335,11,3,2,1,17
383532039,49,41,3,2,95
383540477,77,23,53,33,186
383542612,21,34,2,1,58
383546446,49,21,5,4,79
383546840,49,37,22,4,112
383548025,96,33,12,5,146
383555682,23,34,8,4,69
383556633,120,3,2,8,133
383584348,218,3,2,41,264
383590110,80,3,2,1,86
383595961,217,3,2,13,235
383597286,56,42,33,7,138
383601413,135,30,76,31,272
383611108,115,16,21,1,153
383625731,112,23,5,48,188
383655478,29,31,15,26,101
383657303,28,17,2,7,54
383663859,73,55,75,22,225
383668661,81,13,2,3,99
383674282,60,3,2,1,66
383686539,50,3,2,2,57
383702655,69,26,4,24,123
383703296,47,36,10,1,94
383705486,19,9,2,1,31
383724007,65,32,2,2,101
383735456,20,3,2,1,26
383740811,159,17,38,23,237
383769430,130,13,2,36,181
383781291,12,3,2,1,18
383788048,19,5,5,2,31
383789016,67,36,10,1,114
383792940,11,3,2,2,18
383801217,51,3,2,1,57
383818051,198,17,56,9,280
383821620,147,11,62,1,221
383837664,23,3,2,1,29
383842883,30,53,59,47,189
383845752,164,37,10,19,230
383858659,12,5,2,1,20
383861283,37,3,2,6,48
383875943,22,4,2,1,29
383883102,94,21,4,1,120
383888425,13,3,2,1,19
383914500,31,58,2,4,95
383931143,24,40,2,2,68
383933385,148,53,32,20,253
383942831,22,3,3,3,31
383945829,138,12,7,4,161
383946825,38,30,17,4,89
383947476,45,3,2,1,51
383950608,144,72,28,6,250
383950744,11,13,2,1,27
383955201,34,3,2,1,40
383972708,56,54,4,14,128
383975873,21,3,6,12,42
383980444,69,37,24,11,141
383982913,89,24,2,1,116
383998139,74,10,2,5,91
383998217,94,30,19,10,153
383999999,87,3,2,1,93
384000942,41,7,2,1,51
384009765,135,30,95,1,261
384010130,155,11,102,6,274
384012771,121,3,2,1,127
384026373,33,11,22,1,67
384032969,53,60,3,1,117
384034709,83,31,4,10,128
384039905,36,32,24,5,97
384043758,24,11,2,1,38
384091777,15,41,2,2,60
384092173,10,11,2,1,24
384096446,11,3,2,1,17
384097713,80,17,4,1,102
384098845,11,9,2,1,23
384110836,13,3,2,1,19
384120039,72,35,12,11,130
384120129,162,30,13,3,208
384123131,19,26,12,10,67
384134051,53,32,14,15,114
384142545,10,5,2,1,18
384143719,124,3,2,6,135
384146555,71,27,3,3,104
384169541,62,16,24,5,107
384171699,20,3,2,1,26
384182900,58,17,26,3,104
384185370,19,3,2,1,25
384191208,154,17,6,4,181
384194577,33,3,2,1,39
384198243,31,27,2,1,61
384201174,14,15,3,1,33
384206474,20,13,2,1,36
384210922,81,3,2,1,87
384220300,11,3,2,1,17
384225534,19,3,2,1,25
384226222,138,12,42,1,193
384228162,14,19,2,2,37
384243946,156,33,19,9,217
384259507,11,3,2,1,17
384259973,27,3,2,1,33
384278444,128,13,4,1,146
384292089,12,8,2,2,24
384294911,10,42,2,1,55
384306356,12,8,2,2,24
384307579,24,19,2,2,47
384308041,240,6,3,3,252
384313669,146,3,39,1,189
384318082,17,3,2,1,23
384319680,90,21,2,1,114
384347674,61,22,2,2,87
384357459,67,3,2,1,73
384359221,195,47,7,3,252
384364498,19,3,2,1,25
384365043,16,18,2,4,40
384365899,23,3,2,1,29
384380831,58,3,2,1,64
384388025,145,3,2,4,154
384392535,12,38,4,1,55
384412456,21,3,2,6,32
384418735,74,30,5,23,132
384425791,52,20,3,12,87
384437593,10,5,2,1,18
384438455,97,30,12,8,147
384441181,27,3,2,4,36
384453392,119,19,25,1,164
384459109,83,17,27,3,130
384463308,52,3,3,1,59
384464084,338,3,2,1,344
384467380,209,4,2,7,222
384487910,41,95,23,3,162
384492406,201,8,19,15,243
384493030,60,9,64,4,137
384498794,22,8,2,2,34
384534825,72,36,9,2,119
384557938,127,19,31,19,196
384585212,19,9,2,1,31
384586446,31,17,2,1,51
384587648,34,14,2,16,66
384589743,141,30,13,14,198
384590205,60,3,2,6,71
384593159,72,30,118,1,221
384593341,10,3,2,2,17
384604849,44,8,29,8,89
384608105,117,4,29,1,151
384610543,146,51,69,52,318
384610684,69,17,114,8,208
384619557,17,10,2,1,30
384622163,70,6,6,3,85
384644732,101,3,14,3,121
384650911,15,4,4,1,24
384653595,70,6,2,7,85
384654096,160,10,2,4,176
384658212,33,17,5,1,56
384669496,61,18,14,19,112
384669720,122,3,2,1,128
384673590,53,108,51,22,234
384690965,62,7,5,4,78
384697068,79,10,16,2,107
384708820,52,21,4,4,81
384723341,16,3,2,1,22
384731961,59,3,2,1,65
384732373,11,8,2,1,22
384732689,56,3,2,1,62
384738131,10,12,2,2,26
384755332,47,3,2,1,53
384755888,27,14,5,7,53
384759652,10,12,2,1,25
384759948,40,3,2,1,46
384765218,15,3,2,1,21
384772119,33,3,2,1,39
384789217,174,40,17,24,255
384797385,206,3,2,1,212
384809791,47,27,28,3,105
384813914,162,23,26,2,213
384815391,105,8,32,1,146
384820356,17,25,2,5,49
384827792,108,30,2,2,142
384829787,38,3,2,1,44
384834553,20,29,55,1,105
384849649,47,9,3,8,67
384857561,112,3,2,1,118
384868380,39,3,2,4,48
384881380,191,3,2,3,199
384891198,12,4,2,4,22
384894707,11,3,2,1,17
384902852,53,3,2,41,99
384903906,12,5,2,1,20
384929684,90,24,2,1,117
384930642,63,11,2,5,81
384942304,199,36,2,2,239
384942909,54,54,2,5,115
384958095,85,3,2,1,91
384961992,79,21,77,62,239
384965040,37,26,2,1,66
384965758,51,15,37,4,107
384970816,94,3,2,1,100
384970915,125,3,2,1,131
384987436,28,7,2,1,38
384996738,28,4,2,3,37
385003224,13,53,2,1,69
385003713,36,3,2,1,42
385014269,46,23,8,15,92
385024091,61,3,2,5,71
385029107,107,70,16,6,199
385030126,46,50,2,2,100
385034844,64,3,2,3,72
385055144,24,3,2,1,30
385072508,63,10,2,2,77
385076645,38,28,5,1,72
385093650,77,3,2,3,85
385095203,101,69,45,12,227
385099332,69,91,2,31,193
385101529,22,21,17,59,119
385111554,50,31,37,1,119
385114879,68,36,29,28,161
385118695,94,3,2,3,102
385119250,53,29,34,42,158
385124447,30,53,8,6,97
385134194,164,3,2,3,172
385136584,12,3,2,1,18
385146551,26,21,2,4,53
385150654,58,6,42,24,130
385155128,109,3,2,14,128
385160035,106,27,7,59,199
385171570,20,6,2,1,29
385176535,180,33,66,16,295
385179769,53,49,19,26,147
385184060,51,39,16,9,115
385187268,27,83,3,3,116
385190285,134,3,59,27,223
385190856,83,13,2,1,99
385199410,32,37,2,7,78
385202087,62,3,2,3,70
385229497,40,15,8,1,64
385230574,82,34,2,3,121
385232341,100,37,12,24,173
385240921,19,3,2,1,25
385246022,57,26,59,24,166
385256290,56,3,2,6,67
385269932,132,3,2,1,138
385274075,31,77,11,22,141
385275754,88,10,2,2,102
385303315,96,4,2,1,103
385304315,32,3,2,4,41
385307487,63,3,2,1,69
385325714,14,6,2,1,23
385326451,11,3,2,1,17
385332374,35,53,14,6,108
385375917,30,4,2,1,37
385379118,20,23,13,1,57
385393229,10,5,2,1,18
385395090,145,12,9,36,202
385399617,82,14,2,1,99
385412407,68,37,3,3,111
385414458,63,21,15,7,106
385430891,22,27,2,1,52
385432289,14,31,2,1,48
385433637,56,4,4,3,67
385474554,73,16,28,1,118
385485757,56,3,2,1,62
385496798,54,7,19,3,83
385502372,42,3,2,1,48
385512275,78,49,2,1,130
385528806,16,16,2,1,35
385545300,55,19,12,5,91
385553312,43,55,2,1,101
385597232,80,13,2,1,96
385611980,16,11,16,8,51
385621330,25,3,2,1,31
385630510,60,11,23,9,103
385638092,52,3,2,5,62
385650936,62,12,2,2,78
385656587,14,21,2,1,38
385659407,68,10,24,114,216
385659876,83,40,2,6,131
385679981,47,18,23,3,91
385715939,18,42,2,3,65
385724972,50,57,23,7,137
385727872,118,9,2,1,130
385729402,23,3,2,1,29
385730201,39,19,2,58,118
385739503,15,3,2,1,21
385742290,172,40,22,32,266
385744857,102,36,2,2,142
385746118,76,30,5,13,124
385750506,10,7,2,1,20
385764912,11,3,2,2,18
385769611,43,32,2,1,78
385771705,38,3,3,2,46
385772394,186,11,2,80,279
385777564,75,29,66,3,173
385795586,32,50,44,2,128
385795900,38,3,2,1,44
385805472,33,3,2,2,40
385807279,108,92,32,29,261
385818381,81,38,41,11,171
385823284,44,57,46,13,160
385828258,56,75,13,5,149
385829195,77,25,31,11,144
385841041,84,6,27,1,118
385841948,24,80,3,1,108
385885864,99,16,14,60,189
385892922,13,28,2,1,44
385895275,41,25,5,1,72
385913829,108,45,2,17,172
385915170,46,21,20,2,89
385921227,25,7,2,1,35
385933116,47,5,2,1,55
385938668,69,16,2,1,88
385957829,27,3,2,1,33
385979753,38,41,14,1,94
385990067,65,26,21,5,117
385995251,58,3,2,1,64
386000196,127,5,2,2,136
386000715,12,19,2,2,35
386005537,89,11,2,6,108
386025374,134,46,2,6,188
386025505,174,3,2,2,181
386044521,38,11,87,3,139
386049800,175,3,2,1,181
386058157,14,6,3,1,24
386063133,36,22,27,3,88
386076842,25,48,38,11,122
386086994,32,70,7,18,127
386092609,70,4,15,4,93
386105584,82,46,14,3,145
386110513,58,20,4,2,84
386119951,68,36,4,26,134
386134125,69,6,2,5,82
386134946,10,16,2,1,29
386135068,16,16,2,1,35
386137326,88,17,184,17,306
386174238,16,3,2,1,22
386177492,163,62,65,1,291
386179609,10,39,2,1,52
386181431,45,3,2,2,52
386187019,89,33,72,45,239
386193981,67,33,53,93,246
386194324,12,3,2,1,18
386210279,15,13,5,1,34
386215984,41,9,2,14,66
386218726,11,4,2,1,18
386228099,33,3,2,1,39
386229476,87,21,65,9,182
386235453,21,24,2,8,55
386235894,89,3,2,4,98
386238639,23,10,2,1,36
386240048,179,48,33,33,293
386262419,17,3,2,8,30
386268621,21,3,2,1,27
386293514,83,8,72,1,164
386303104,91,3,2,1,97
386311512,178,5,3,1,187
386318461,13,3,2,1,19
386323364,105,21,50,3,179
386328937,12,3,2,1,18
386330210,22,37,2,1,62
386334376,18,16,2,1,37
386339273,73,3,2,31,109
386343085,56,238,34,1,329
386346387,28,3,2,5,38
386355632,55,3,2,1,61
386359304,54,9,2,10,75
386365869,18,5,2,1,26
386366006,76,3,2,13,94
386371366,337,3,2,2,344
386395080,11,3,2,14,30
386395783,12,3,2,1,18
386397326,68,12,49,3,132
386399071,33,3,2,1,39
386400412,36,3,2,1,42
386405230,74,31,54,33,192
386410195,12,4,2,1,19
386423194,67,96,3,5,171
386423556,39,70,3,1,113
386461192,52,24,3,75,154
386464372,30,9,15,8,62
386464584,51,20,2,3,76
386485777,48,42,2,1,93
386500825,86,25,10,5,126
386501197,57,51,2,21,131
386519677,15,3,2,1,21
386520931,59,3,2,1,65
386543762,55,18,16,9,98
386548005,179,32,2,9,222
386549205,14,5,2,1,22
386557447,69,16,15,1,101
386570493,46,48,2,4,100
386574499,83,32,2,4,121
386582921,60,31,2,1,94
386583488,30,3,2,3,38
386588831,100,31,6,30,167
386605955,28,3,2,1,34
386620017,124,25,19,1,169
386623575,59,3,2,12,76
386629339,69,65,34,20,188
386631018,61,62,27,3,153
386651806,67,49,2,10,128
386654895,28,12,2,4,46
386661415,13,3,2,1,19
386670463,70,15,25,5,115
386672203,15,8,2,1,26
386688862,12,3,2,1,18
386704427,11,3,2,3,19
386734957,11,18,2,1,32
386737695,110,32,49,22,213
386742150,40,3,2,2,47
386759335,97,23,4,29,153
386769335,15,37,2,1,55
386772376,16,20,2,1,39
386783841,107,11,4,2,124
386791125,75,3,6,1,85
386800747,13,3,2,1,19
386808989,105,24,2,2,133
386815975,381,28,2,23,434
386828847,77,3,2,1,83
386844485,229,3,2,2,236
386850495,29,3,2,1,35
386873229,156,3,2,2,163
386877286,13,3,2,1,19
386879736,51,32,14,2,99
386881796,56,3,2,5,66
386910671,54,14,8,13,89
386914919,105,3,4,2,114
386915649,128,33,7,16,184
386931780,136,16,49,1,202
386936256,31,12,2,1,46
386937839,112,3,2,6,123
386939616,29,5,2,1,37
386940758,110,54,9,13,186
386943336,184,5,2,2,193
386948523,66,3,2,1,72
386985182,36,36,2,3,77
386990115,51,17,21,1,90
387002107,83,23,25,18,149
387020160,65,55,13,1,134
387022530,53,78,3,18,152
387024590,81,4,3,1,89
387032373,99,3,2,1,105
387043893,44,52,17,44,157
387045765,12,6,2,2,22
387075653,37,24,18,11,90
387111729,300,15,4,9,328
387113489,67,23,52,1,143
387116450,61,4,18,2,85
387119246,71,25,3,1,100
387154012,53,46,27,1,127
387154015,40,7,3,6,56
387161329,16,28,8,1,53
387163799,105,43,12,16,176
387166937,16,13,2,2,33
387171820,167,8,2,5,182
387176580,81,26,6,1,114
387212864,150,6,2,3,161
387213785,68,21,5,4,98
387214038,115,3,2,1,121
387226698,168,17,39,4,228
387230458,88,74,2,16,180
387253896,231,62,2,50,345
387260667,16,3,2,1,22
387269622,148,24,2,8,182
387275383,15,6,2,7,30
387278752,73,47,4,2,126
387307537,10,5,2,1,18
387308175,55,5,14,1,75
387311936,114,3,2,1,120
387321365,35,3,2,3,43
387322807,19,43,3,3,68
387324018,125,29,3,52,209
387331298,11,3,2,1,17
387337547,19,59,8,3,89
387344572,94,10,9,3,116
387352858,49,7,3,2,61
387354390,101,3,2,2,108
387362709,112,41,50,17,220
387363326,25,36,2,1,64
387366345,57,30,14,3,104
387374404,29,3,2,1,35
387378534,15,4,2,1,22
387378857,43,13,2,1,59
387391004,99,3,2,6,110
387395594,17,3,2,1,23
387407665,129,27,13,1,170
387412346,68,10,3,1,82
387418164,40,14,3,2,59
387429674,118,3,2,2,125
387434148,42,14,4,2,62
387434681,10,27,2,1,40
387447468,130,29,96,6,261
387461084,128,41,2,2,173
387461487,65,22,43,2,132
387479165,57,3,2,1,63
387480634,94,15,2,4,115
387481521,165,3,2,10,180
387488103,49,3,2,3,57
387491550,62,21,3,38,124
387491978,67,90,5,94,256
387498740,42,105,75,7,229
387501359,63,26,15,13,117
387510751,52,14,9,1,76
387511602,178,40,9,9,236
387532944,38,12,2,4,56
387534890,10,36,2,1,49
387546895,217,42,155,32,446
387554893,67,5,2,4,78
387566626,13,3,2,1,19
387571875,10,4,2,1,17
387582998,44,32,13,1,90
387610145,16,3,2,1,22
387611706,71,20,13,1,105
387612183,35,26,27,8,96
387626195,32,3,20,13,68
387627269,114,3,2,2,121
387632698,13,3,2,1,19
387657114,83,32,4,3,122
387664238,71,25,3,22,121
387666723,66,5,19,6,96
387683368,33,6,3,1,43
387685306,92,3,2,1,98
387686192,33,38,11,6,88
387687021,35,6,3,1,45
387693634,11,6,2,1,20
387699853,56,14,2,7,79
387712284,50,22,14,2,88
387719650,57,28,28,30,143
387730489,10,6,2,1,19
387737227,10,9,2,1,22
387739980,127,3,2,1,133
387743272,35,81,6,1,123
387747054,53,11,2,1,67
387777236,136,21,16,3,176
387781546,45,17,2,4,68
387782610,40,77,40,4,161
387795570,118,3,22,4,147
387797970,72,3,2,1,78
387798033,134,3,2,3,142
387808948,65,25,44,24,158
387821968,150,9,2,3,164
387823783,53,24,8,3,88
387827242,80,3,2,4,89
387835454,47,33,4,5,89
387846010,14,3,2,1,20
387854818,20,28,10,44,102
387860432,113,13,2,1,129
387870918,22,17,24,18,81
387889543,66,21,15,6,108
387889616,33,62,22,4,121
387894334,110,22,7,1,140
387925434,11,3,2,1,17
387934900,53,9,2,10,74
387942248,96,34,4,9,143
387948171,152,3,2,9,166
387948195,132,12,12,5,161
387996746,59,12,5,12,88
387996969,11,3,2,1,17
388012108,68,3,3,1,75
388022637,115,22,52,5,194
388036138,46,5,8,1,60
388036919,67,49,116,9,241
388057125,70,4,2,4,80
388062383,42,6,25,1,74
388068265,13,3,2,1,19
388069621,207,49,41,1,298
388077483,33,17,2,1,53
388081896,82,27,38,26,173
388083127,11,5,6,2,24
388101764,144,15,2,4,165
388150088,12,3,2,1,18
388152627,11,11,2,1,25
388154073,76,8,39,2,125
388155708,10,12,2,5,29
388164446,132,27,3,53,215
388184119,347,3,2,1,353
388197476,137,3,2,16,158
388201150,23,3,2,1,29
388202058,20,4,2,1,27
388203679,133,48,24,9,214
388206606,159,41,46,13,259
388224897,49,22,2,6,79
388226215,208,28,8,6,250
388240629,47,22,28,10,107
388246459,11,3,2,1,17
388263325,86,52,44,1,183
388268686,52,3,2,1,58
388287638,33,27,2,11,73
388290217,43,3,2,1,49
388298391,10,8,2,7,27
388299375,22,3,2,1,28
388312074,48,37,2,24,111
388313836,42,3,2,1,48
388326835,12,3,2,1,18
388341329,52,11,41,3,107
388351357,188,44,7,5,244
388351711,14,3,2,1,20
388353436,71,11,11,6,99
388361858,60,3,2,1,66
388367329,26,3,2,1,32
388378047,187,3,2,11,203
388382678,54,16,30,13,113
388398782,30,36,2,10,78
388405706,93,21,2,5,121
388418592,10,4,2,1,17
388437369,31,24,2,1,58
388446661,44,24,76,1,145
388472044,115,22,2,23,162
388476279,110,3,2,1,116
388480693,12,3,2,4,21
388483345,10,6,2,1,19
388483810,10,4,2,1,17
388488703,104,51,5,3,163
388500368,37,6,12,4,59
388535656,11,3,2,1,17
388573805,134,8,2,5,149
388576626,105,10,2,6,123
388578746,72,50,2,6,130
388588958,91,38,23,3,155
388602740,56,3,2,8,69
388618063,10,4,2,1,17
388630939,31,8,2,2,43
388638400,84,32,46,1,163
388639367,95,31,21,7,154
388640797,10,3,2,2,17
388641761,60,95,14,13,182
388642688,11,3,2,1,17
388649813,16,3,2,1,22
388666240,116,72,2,7,197
388671852,89,47,33,7,176
388678082,42,40,2,8,92
388679624,20,14,2,3,39
388689897,28,3,2,1,34
388695254,151,63,8,4,226
388705084,29,16,4,4,53
388705706,29,10,27,1,67
388719349,113,21,15,5,154
388720590,90,21,103,41,255
388745621,11,3,2,3,19
388752273,115,26,88,18,247
388758143,22,3,2,1,28
388763300,17,106,2,3,128
388783197,11,3,2,1,17
388788057,67,3,2,1,73
388804003,10,3,2,3,18
388819015,74,3,2,38,117
388820954,86,31,2,3,122
388827788,231,33,3,1,268
388842266,46,76,34,7,163
388850507,13,3,2,1,19
388856264,12,3,3,1,19
388881034,51,5,4,1,61
388884071,46,4,2,1,53
388885004,246,39,4,2,291
388888166,48,9,40,15,112
388907798,116,21,2,4,143
388908251,89,3,2,23,117
388915396,58,6,2,10,76
388923673,21,11,7,1,40
388928431,143,3,2,2,150
388946261,15,3,2,1,21
388949360,74,28,2,1,105
388967352,25,3,2,1,31
388975293,80,10,2,1,93
389004307,22,3,2,5,32
389008590,10,46,2,1,59
389021136,74,18,20,9,121
389022572,153,3,2,4,162
389022615,117,20,2,1,140
389027706,106,24,40,44,214
389027806,89,18,62,1,170
389044461,36,3,2,1,42
389050405,56,3,2,1,62
389061869,44,35,59,1,139
389088622,133,56,86,7,282
389102466,94,6,2,14,116
389104787,105,37,52,1,195
389113696,19,14,5,3,41
389120217,93,3,2,1,99
389122788,49,59,20,13,141
389153875,90,3,2,1,96
389175961,181,12,2,9,204
389187958,394,3,2,17,416
389192574,110,3,2,8,123
389197588,31,24,24,6,85
389206766,77,28,28,3,136
389207902,28,9,2,4,43
389215180,43,42,8,2,95
389215698,35,3,2,40,80
389227240,85,26,47,10,168
389235055,53,10,2,7,72
389236415,103,3,2,2,110
389239989,11,27,2,1,41
389249481,97,16,4,3,120
389254891,15,3,2,1,21
389260502,42,17,2,1,62
389263548,118,46,3,1,168
389272664,27,3,2,1,33
389273499,60,40,2,1,103
389273613,39,22,4,3,68
389277195,15,3,2,1,21
389286065,50,3,2,3,58
389314552,41,77,2,2,122
389325421,15,3,2,1,21
389338246,171,30,49,3,253
389340265,13,3,2,1,19
389340344,19,3,2,1,25
389342411,101,20,2,1,124
389343181,109,7,2,6,124
389349465,63,3,2,1,69
389372327,75,42,13,56,186
389384369,31,15,30,1,77
389436219,10,3,2,5,20
389451764,151,50,42,17,260
389454262,70,3,3,20,96
389463416,48,3,2,1,54
389470227,84,26,11,33,154
389473908,59,3,2,5,69
389474402,50,3,2,7,62
389479151,83,35,62,2,182
389479946,55,29,32,1,117
389481264,27,20,35,2,84
389497280,66,14,2,1,83
389497867,93,21,6,14,134
389504205,138,3,2,1,144
389508166,70,25,7,4,106
389509833,71,22,3,25,121
389516793,19,65,2,1,87
389534080,181,3,2,7,193
389543445,23,9,6,1,39
389544641,150,32,5,41,228
389550410,35,18,2,7,62
389570265,35,3,2,1,41
389585523,30,27,8,6,71
389590736,59,4,5,7,75
389606754,13,3,2,1,19
389610144,32,33,3,4,72
389611589,52,10,2,4,68
389620958,34,15,2,1,52
389666390,21,8,2,1,32
389673618,190,29,2,2,223
389686578,16,4,37,7,64
389688113,73,23,26,18,140
389698184,358,67,65,11,501
389704227,44,5,2,1,52
389705311,17,3,2,6,28
389712051,115,53,2,62,232
389724732,44,72,30,1,147
389737038,101,20,2,3,126
389739304,60,11,2,2,75
389742864,146,51,2,4,203
389768165,98,12,8,17,135
389772558,13,5,2,8,28
389781288,45,47,36,15,143
389781551,33,12,4,1,50
389782395,58,30,7,1,96
389800741,33,8,7,10,58
389809027,46,3,2,4,55
389812849,37,14,19,1,71
389818473,119,35,8,2,164
389820161,80,32,2,17,131
389840776,53,3,2,3,61
389842950,13,3,2,1,19
389857690,72,12,2,4,90
389864188,103,20,17,14,154
389864783,12,4,3,1,20
389873580,140,3,2,16,161
389873985,170,3,2,2,177
389877080,95,36,47,15,193
389912111,49,9,2,7,67
389912448,138,4,2,4,148
389940479,40,23,7,1,71
389942788,76,41,50,8,175
389958035,44,23,2,1,70
389997725,66,17,12,4,99
389999388,93,3,2,4,102
390006564,12,19,8,1,40
390007175,36,92,4,5,137
390011913,117,3,2,1,123
390019764,36,4,2,1,43
390021104,100,23,132,1,256
390047560,44,11,10,1,66
390047641,28,13,2,6,49
390054142,16,23,2,1,42
390059048,126,3,2,1,132
390064106,52,74,27,8,161
390078176,162,18,4,2,186
390080628,11,24,2,2,39
390082319,123,30,31,6,190
390086122,108,10,2,2,122
390090667,112,3,2,2,119
390101862,200,65,19,15,299
390108926,58,17,8,6,89
390114419,47,24,9,11,91
390115875,58,63,30,1,152
390116860,73,27,19,10,129
390126041,67,7,53,2,129
390134378,28,21,2,20,71
390153607,189,18,2,4,213
390196812,26,3,2,1,32
390198457,47,11,8,2,68
390203876,46,22,2,1,71
390211826,71,15,21,1,108
390215877,112,3,2,1,118
390231622,31,17,2,1,51
390238424,127,73,24,78,302
390249518,78,16,2,6,102
390259321,12,3,2,1,18
390269749,51,3,2,1,57
390271463,46,42,2,13,103
390277090,70,8,3,57,138
390291418,76,12,14,7,109
390296738,51,27,8,8,94
390303368,33,10,2,1,46
390306937,70,29,18,5,122
390349176,78,23,20,1,122
390351527,168,3,2,20,193
390366485,169,45,16,38,268
390378086,83,9,2,3,97
390392025,113,12,29,1,155
390394892,30,50,10,1,91
390417046,23,7,24,2,56
390426423,11,9,2,1,23
390428468,95,21,2,5,123
390444397,84,37,2,2,125
390444464,155,25,17,9,206
390453963,36,83,35,7,161
390457716,57,23,5,13,98
390489929,10,4,2,3,19
390505003,117,29,2,4,152
390530049,64,3,2,1,70
390545500,62,12,2,1,77
390557311,169,3,2,5,179
390558531,12,3,2,1,18
390577652,121,15,2,25,163
390599862,31,3,2,1,37
390615811,66,25,63,97,251
390624495,126,17,69,7,219
390631295,102,21,94,1,218
390631661,56,24,2,1,83
390634224,16,11,2,1,30
390645045,210,34,9,11,264
390646794,11,4,2,1,18
390662609,50,14,7,6,77
390670818,78,24,10,1,113
390675946,144,8,5,1,158
390678668,165,21,44,2,232
390680989,14,3,2,2,21
390683389,44,103,61,1,209
390684402,259,3,2,32,296
390691190,181,45,30,5,261
390730293,13,3,2,1,19
390732865,78,21,2,4,105
390737328,39,3,2,1,45
390742336,68,13,2,1,84
390746673,32,20,2,1,55
390755035,49,23,9,3,84
390755898,82,6,2,2,92
390759939,27,11,2,2,42
390762908,57,26,2,5,90
390770267,229,3,2,1,235
390781162,67,37,2,1,107
390786986,96,7,2,1,106
390795333,42,27,22,4,95
390797780,104,3,2,2,111
390800523,109,18,17,5,149
390801395,168,30,20,30,248
390802724,38,3,2,1,44
390811984,172,18,54,4,248
390831105,75,7,4,10,96
390835716,19,3,2,1,25
390847043,111,3,2,5,121
390868509,308,3,2,30,343
390883201,34,11,22,141,208
390907833,51,20,3,1,75
390911684,16,88,2,5,111
390931126,55,47,22,31,155
390942419,16,3,2,1,22
390945886,59,13,42,10,124
390961630,56,3,2,1,62
390963581,150,10,5,9,174
390974065,251,19,57,26,353
390977710,86,31,61,7,185
391035621,157,3,10,8,178
391042433,48,41,2,12,103
391051180,18,17,2,1,38
391062264,39,81,6,9,135
391067052,46,19,21,1,87
391068882,15,3,2,1,21
391100470,120,15,7,17,159
391107023,21,20,2,2,45
391108087,200,31,2,5,238
391112990,103,10,4,4,121
391114204,24,65,7,1,97
391135164,21,20,9,6,56
391146146,62,5,2,1,70
391155817,79,46,20,21,166
391155972,50,3,2,1,56
391157076,94,26,17,6,143
391166701,101,53,2,5,161
391166737,174,44,21,3,242
391167265,21,3,2,1,27
391176697,81,7,3,9,100
391195175,38,52,42,34,166
391197324,79,3,2,1,85
391208602,121,28,4,2,155
391228422,34,34,23,3,94
391233031,84,42,2,1,129
391234198,150,27,16,33,226
391239781,22,14,2,5,43
391248049,92,54,37,2,185
391254366,99,23,51,1,174
391256638,116,24,131,1,272
391279190,86,25,2,5,118
391290171,25,27,16,20,88
391296079,60,18,34,10,122
391309956,57,3,2,1,63
391322985,95,3,13,17,128
391323673,172,11,13,60,256
391329828,110,3,2,2,117
391335993,42,14,2,3,61
391339032,12,3,2,1,18
391350534,37,26,5,1,69
391364281,319,24,19,47,409
391371239,199,37,22,2,260
391371519,31,5,2,2,40
391393554,103,3,2,1,109
391399922,63,19,2,2,86
391423603,28,16,2,1,47
391430534,63,10,2,9,84
391431783,137,39,43,1,220
391436188,182,20,2,19,223
391437679,70,3,2,1,76
391441421,12,3,2,1,18
391449119,14,3,2,1,20
391456910,13,10,4,1,28
391465369,18,3,2,1,24
391475595,43,16,13,1,73
391482744,231,32,2,1,266
391502586,17,8,2,1,28
391506877,13,3,2,1,19
391516765,60,3,10,1,74
391527671,51,22,13,1,87
391533380,57,3,2,7,69
391535185,86,56,20,45,207
391550058,40,47,54,32,173
391562068,23,3,2,1,29
391580457,41,40,11,12,104
391580914,175,30,29,16,250
391592551,71,54,120,5,250
391600614,76,3,2,1,82
391605235,11,6,2,1,20
391612392,11,3,2,2,18
391622438,96,48,18,4,166
391625923,12,3,2,1,18
391629924,103,29,3,8,143
391642535,124,19,5,2,150
391644905,129,3,2,1,135
391654795,165,3,2,5,175
391674998,21,14,2,1,38
391675608,22,59,40,6,127
391687797,11,3,2,1,17
391690268,125,8,2,1,136
391692101,80,3,2,13,98
391692181,50,9,2,1,62
391716218,12,8,2,4,26
391725805,271,3,2,6,282
391739072,26,16,2,14,58
391740102,73,27,50,3,153
391742147,52,20,35,5,112
391744553,133,14,2,2,151
391747232,36,3,2,1,42
391747666,48,3,2,5,58
391773311,36,27,17,8,88
391775126,30,20,41,6,97
391788774,152,8,2,3,165
391793507,42,6,2,2,52
391801759,125,36,54,59,274
391814807,162,14,4,7,187
391822685,36,16,17,1,70
391825957,12,15,2,1,30
391832571,192,8,3,3,206
391834214,11,9,2,1,23
391840361,35,9,36,16,96
391844424,12,3,2,6,23
391855234,15,11,2,1,29
391863906,48,52,2,1,103
391910226,35,70,52,4,161
391912485,11,3,2,1,17
391916068,72,3,2,1,78
391918078,56,3,2,1,62
391925762,45,3,2,13,63
391928119,208,21,26,4,259
391938004,99,3,38,1,141
391941791,177,3,2,1,183
391974318,18,14,2,1,35
391982632,110,36,36,13,195
392029680,98,29,3,6,136
392034452,26,3,2,1,32
392059494,226,9,11,1,247
392060748,108,41,49,1,199
392079846,73,45,2,3,123
392081077,45,3,2,1,51
392085950,13,3,2,1,19
392115142,22,7,2,6,37
392135483,104,16,16,18,154
392137231,104,3,2,1,110
392137965,37,13,2,1,53
392140535,36,20,5,8,69
392148755,194,19,9,5,227
392149308,32,47,2,13,94
392167258,114,30,13,9,166
392170421,54,17,3,3,77
392175286,61,47,52,3,163
392176874,128,27,21,5,181
392188380,23,3,2,5,33
392193379,65,3,2,6,76
392196004,58,13,2,3,76
392197463,72,8,2,1,83
392210139,59,21,20,3,103
392217612,31,6,2,1,40
392218014,12,7,2,1,22
392248328,120,11,55,3,189
392248661,13,3,2,1,19
392257403,46,53,2,1,102
392257536,88,3,2,1,94
392265395,13,3,2,1,19
392273570,80,27,3,2,112
392294209,56,3,2,1,62
392303623,46,28,12,12,98
392320046,16,80,8,14,118
392338083,100,35,2,3,140
392348444,166,3,2,5,176
392351432,201,16,2,1,220
392352648,82,17,38,10,147
392360524,75,14,81,17,187
392363476,55,21,58,11,145
392371362,85,26,2,3,116
392373546,60,7,5,2,74
392396257,12,12,2,1,27
392402434,29,26,11,39,105
392414982,30,32,26,1,89
392429264,45,10,3,15,73
392448669,67,53,8,6,134
392451407,87,3,2,1,93
392454263,31,4,2,4,41
392461949,41,4,2,1,48
392468195,54,55,11,1,121
392505193,21,75,25,1,122
392507940,25,3,2,1,31
392513489,80,10,59,3,152
392540985,17,24,2,1,44
392569385,95,70,72,27,264
392598775,150,72,44,41,307
392607391,74,3,2,3,82
392607994,110,3,2,1,116
392610868,17,3,2,9,31
392634161,128,21,2,4,155
392635484,41,5,2,2,50
392640455,63,9,2,1,75
392666727,144,42,12,10,208
392683577,80,26,2,1,109
392696935,38,52,31,9,130
392703695,18,5,2,1,26
392711209,11,3,2,1,17
392715878,85,39,28,1,153
392721417,91,3,2,17,113
392722034,60,3,2,5,70
392752352,19,3,2,1,25
392768721,106,3,2,1,112
392788854,59,41,3,7,110
392797619,115,56,18,2,191
392799855,105,24,10,19,158
392801251,15,24,7,4,50
392805286,67,3,2,8,80
392810637,113,9,7,2,131
392825480,31,11,8,1,51
392825563,13,3,2,1,19
392837682,60,53,2,1,116
392841396,32,38,10,1,81
392844403,44,44,9,8,105
392850484,181,34,30,10,255
392855573,122,3,2,1,128
392885280,26,10,23,11,70
392900164,63,80,8,27,178
392902897,36,3,2,1,42
392905302,20,10,2,1,33
392938886,545,52,20,14,631
392939977,77,10,2,27,116
392951135,52,3,2,4,61
392964895,13,4,2,2,21
392977876,245,3,2,13,263
392984608,114,35,12,1,162
392987789,151,50,6,4,211
392995627,88,16,2,3,109
393005245,94,22,76,3,195
393015670,121,32,17,1,171
393016928,11,7,2,1,21
393022721,37,124,38,1,200
393027324,90,84,9,40,223
393063983,242,3,2,7,254
393072458,19,10,2,1,32
393073412,28,3,2,3,36
393074014,32,6,53,1,92
393074035,223,3,2,11,239
393082439,34,32,17,1,84
393095757,30,5,2,1,38
393109331,150,6,2,2,160
393131389,45,11,2,1,59
393150598,70,17,8,2,97
393155448,10,3,2,3,18
393157639,183,24,4,7,218
393158373,112,21,2,11,146
393186697,11,3,2,1,17
393199649,205,14,10,1,230
393201593,66,3,2,4,75
393204981,10,6,2,2,20
393207280,82,31,48,35,196
393212229,91,36,68,7,202
393233882,138,21,27,2,188
393241799,56,50,40,7,153
393251003,13,3,2,1,19
393253579,16,3,2,1,22
393269116,170,3,2,1,176
393272987,20,11,3,14,48
393278906,92,3,2,1,98
393285204,77,13,19,38,147
393287026,44,3,5,1,53
393296464,85,37,66,40,228
393297018,91,3,14,65,173
393300068,92,3,2,1,98
393301229,47,3,2,1,53
393316005,158,3,3,5,169
393319449,92,53,27,2,174
393321331,56,18,2,1,77
393336268,13,4,2,1,20
393346527,111,39,28,1,179
393348130,91,37,54,27,209
393364528,27,7,22,5,61
393369046,24,3,2,16,45
393390811,63,32,8,1,104
393391575,47,3,2,11,63
393414069,26,23,9,1,59
393417256,31,3,2,1,37
393418904,22,3,2,1,28
393423638,139,46,8,4,197
393433289,78,19,61,26,184
393435485,28,40,39,11,118
393440155,137,21,36,4,198
393454608,28,53,3,21,105
393458335,56,10,33,5,104
393488468,121,3,2,5,131
393495908,50,4,4,9,67
393497322,78,7,2,7,94
393500683,13,9,2,5,29
393511114,38,16,2,1,57
393535387,33,3,5,2,43
393541029,71,36,7,3,117
393551616,11,4,2,1,18
393555303,32,11,2,4,49
393556191,46,14,2,3,65
393562138,150,48,3,3,204
393570882,65,3,2,1,71
393574329,83,5,2,24,114
393576899,30,6,2,2,40
393577445,56,3,2,8,69
393582083,27,3,2,1,33
393587998,38,51,20,39,148
393590084,61,6,2,1,70
393594463,160,3,6,2,171
393599744,21,7,2,1,31
393604648,13,20,2,1,36
393606129,17,3,2,4,26
393609055,23,28,17,1,69
393611381,29,12,24,1,66
393618468,25,12,2,3,42
393666612,86,24,11,7,128
393670108,75,25,2,23,125
393688822,92,17,94,7,210
393697348,59,30,8,10,107
393705802,14,18,2,1,35
393747388,60,12,28,2,102
393761933,45,224,52,4,325
393763110,29,5,2,6,42
393764674,17,45,2,36,100
393766674,72,18,4,3,97
393770306,85,3,2,1,91
393770545,93,11,2,1,107
393785887,17,12,2,25,56
393791724,10,21,2,1,34
393801695,12,3,2,1,18
393807510,28,62,2,1,93
393810244,18,12,2,1,33
393810514,74,3,2,6,85
393817672,52,3,2,1,58
393818149,10,12,3,1,26
393835649,60,20,7,1,88
393846544,126,18,21,3,168
393848448,28,12,4,2,46
393848599,43,7,2,1,53
393850559,36,3,2,1,42
393851979,16,3,2,2,23
393853150,115,37,15,31,198
393854962,76,46,2,1,125
393858280,78,18,2,3,101
393862942,122,6,2,7,137
393864646,22,3,2,1,28
393864964,151,31,15,1,198
393879365,55,36,3,7,101
393887461,29,71,2,1,103
393891346,73,10,3,1,87
393923451,11,3,2,1,17
393969214,172,53,24,32,281
393978486,15,11,2,2,30
393992243,41,3,2,1,47
393996001,12,3,2,1,18
394000955,48,3,2,6,59
394009478,39,11,2,1,53
394013681,68,23,15,2,108
394016736,76,3,2,3,84
394027775,34,30,60,1,125
394041001,144,3,2,6,155
394042302,11,3,2,2,18
394062323,217,3,2,5,227
394070897,24,3,2,1,30
394071290,47,50,6,4,107
394072770,56,78,2,9,145
394101514,38,40,2,3,83
394103668,138,3,2,1,144
394105270,17,15,2,1,35
394113642,64,13,5,13,95
394117732,48,3,67,1,119
394117955,11,3,2,1,17
394124177,24,15,46,1,86
394138492,38,3,6,1,48
394139374,27,55,10,1,93
394141664,110,25,104,1,240
394142222,49,3,2,2,56
394159235,124,31,42,5,202
394166826,45,27,26,12,110
394173493,80,3,2,10,95
394175750,47,18,25,4,94
394198869,163,52,139,10,364
394212667,87,63,2,46,198
394212805,77,29,2,15,123
394213733,46,18,12,1,77
394227663,124,3,2,6,135
394233348,135,27,2,19,183
394245235,34,13,6,1,54
394245533,59,56,2,1,118
394245955,10,5,3,1,19
394247789,84,4,2,4,94
394263401,160,13,2,1,176
394266918,61,32,2,4,99
394271425,29,3,2,1,35
394287936,98,15,3,38,154
394297635,10,4,2,1,17
394301868,79,63,26,5,173
394311551,71,22,51,101,245
394324922,50,52,16,26,144
394332405,58,109,78,16,261
394334565,171,3,2,2,178
394335758,47,3,2,8,60
394336348,59,31,17,1,108
394340703,56,5,2,8,71
394345178,205,26,39,10,280
394376678,22,9,21,16,68
394380356,77,3,2,1,83
394386983,87,37,2,6,132
394388396,83,39,18,28,168
394390815,85,13,2,3,103
394401474,114,20,2,2,138
394414607,11,3,2,1,17
394415068,89,3,2,1,95
394417429,126,3,2,3,134
394417766,130,7,2,1,140
394421025,130,18,8,9,165
394458204,11,3,2,1,17
394459237,53,7,67,4,131
394461413,37,18,12,1,68
394466895,72,23,7,15,117
394478242,43,36,23,17,119
394487590,67,3,2,1,73
394490766,76,3,2,1,82
394497276,12,3,2,1,18
394497859,14,3,2,1,20
394499518,45,9,17,13,84
394501342,13,3,2,1,19
394505888,27,17,2,1,47
394506649,46,55,29,2,132
394522285,19,7,2,1,29
394524551,78,23,35,4,140
394525996,38,8,2,3,51
394574749,40,30,2,1,73
394577819,50,15,9,3,77
394585190,14,34,4,5,57
394602023,52,4,44,14,114
394613828,12,3,2,1,18
394615972,204,3,2,1,210
394655594,74,56,6,11,147
394658870,63,12,2,1,78
394659986,43,11,4,10,68
394660911,16,3,2,1,22
394686547,95,3,2,3,103
394689199,95,30,103,6,234
394707331,10,15,2,1,28
394714123,32,9,4,7,52
394729349,24,3,2,6,35
394736823,23,21,2,4,50
394737708,70,39,14,47,170
394738359,51,20,39,17,127
394739967,146,3,2,1,152
394756449,66,71,50,1,188
394767694,119,14,2,2,137
394771497,17,25,19,1,62
394782064,17,3,2,1,23
394791758,147,27,16,5,195
394797123,85,21,2,10,118
394832481,19,11,5,4,39
394844067,91,9,2,1,103
394851986,124,21,66,4,215
394855305,25,12,8,13,58
394882681,52,59,3,2,116
394887904,30,38,25,1,94
394897082,75,3,2,4,84
394905489,207,12,16,1,236
394907539,39,9,5,1,54
394908383,69,15,2,5,91
394911369,47,27,19,41,134
394915252,30,30,2,1,63
394920193,73,3,2,1,79
394933726,111,3,2,1,117
394937923,44,10,14,1,69
394944043,13,3,2,1,19
394957345,72,29,24,3,128
394968521,64,8,2,7,81
394974273,115,41,68,4,228
394986525,23,29,2,1,55
394997181,69,10,6,4,89
395008817,184,3,2,7,196
395015190,73,55,4,4,136
395030653,165,3,8,19,195
395032257,36,93,4,5,138
395034463,88,107,10,78,283
395054764,11,3,2,1,17
395056923,181,33,153,2,369
395057071,42,3,2,9,56
395057200,222,47,2,30,301
395060424,36,42,32,3,113
395061386,61,26,2,1,90
395073864,57,3,2,8,70
395077188,30,12,2,1,45
395082817,155,62,2,12,231
395095034,56,9,41,26,132
395096103,54,57,108,4,223
395117239,50,4,2,1,57
395118407,136,24,8,1,169
395120613,57,47,2,9,115
395134366,60,10,2,3,75
395149833,15,3,2,1,21
395158824,37,37,17,5,96
395173846,10,3,2,2,17
395173873,101,57,86,18,262
395176262,46,10,2,2,60
395180624,17,3,2,1,23
395181663,247,16,2,25,290
395197420,58,30,40,54,182
395207886,59,27,2,2,90
395212126,29,9,2,1,41
395224050,19,3,2,1,25
395227255,43,53,79,1,176
395232227,10,3,2,2,17
395232303,87,27,8,1,123
395233928,124,38,123,11,296
395236735,74,20,2,6,102
395237353,139,3,2,1,145
395247277,51,3,2,1,57
395253430,26,145,2,45,218
395254980,10,4,2,1,17
395282990,26,3,2,1,32
395291848,52,4,2,1,59
395299541,52,28,48,3,131
395300568,21,3,2,4,30
395301459,84,3,2,1,90
395304449,131,36,2,2,171
395321139,17,6,2,1,26
395321371,12,3,2,1,18
395332329,72,26,38,57,193
395333267,22,3,2,1,28
395339639,98,3,2,5,108
395344020,21,17,2,1,41
395346332,47,51,2,10,110
395354556,17,23,2,7,49
395358978,73,5,2,8,88
395360782,13,36,2,1,52
395367865,12,3,2,4,21
395401167,103,3,2,12,120
395403825,31,7,22,2,62
395404202,37,10,2,1,50
395404624,267,9,42,3,321
395408551,242,53,2,1,298
395410594,112,21,3,16,152
395410971,75,6,2,2,85
395411056,196,3,2,8,209
395412110,48,8,3,1,60
395425236,117,26,2,2,147
395432347,142,13,2,2,159
395432509,22,3,2,18,45
395433424,179,21,16,2,218
395436311,10,4,2,1,17
395463266,125,73,4,2,204
395485336,47,20,74,1,142
395487929,76,3,26,4,109
395488794,318,3,2,15,338
395490482,216,7,8,8,239
395496192,117,3,2,1,123
395506239,118,22,37,4,181
395506376,10,14,2,1,27
395514367,57,3,9,1,70
395517789,81,6,2,1,90
395518056,133,43,2,3,181
395528085,36,12,2,1,51
395528177,169,3,2,1,175
395544811,58,28,6,1,93
395546185,133,71,13,5,222
395570079,97,105,69,9,280
395581097,139,66,91,43,339
395581630,108,11,21,16,156
395591935,34,3,2,5,44
395597172,51,4,2,12,69
395602266,13,13,2,1,29
395619426,110,41,52,9,212
395626022,70,32,7,1,110
395629348,101,7,2,9,119
395630601,12,3,2,1,18
395633492,68,50,41,28,187
395639545,84,33,4,4,125
395642609,67,3,2,1,73
395658863,33,3,2,1,39
395686101,187,14,5,24,230
395695854,121,35,28,13,197
395708461,126,39,2,4,171
395714659,27,14,19,4,64
395717554,26,17,2,3,48
395724600,230,18,3,6,257
395724869,36,26,2,6,70
395725950,110,24,2,4,140
395731251,100,37,35,30,202
395733037,72,39,15,1,127
395750206,25,5,5,1,36
395760473,103,29,2,7,141
395770590,30,52,14,22,118
395776816,179,3,2,1,185
395778457,191,14,2,34,241
395801460,59,24,2,4,89
395802783,52,35,40,1,128
395802797,66,27,11,5,109
395806135,33,29,2,14,78
395807019,29,6,2,8,45
395807054,115,30,87,2,234
395817225,19,3,2,1,25
395817260,11,3,2,1,17
395818078,19,3,2,5,29
395825413,101,3,2,1,107
395826374,19,58,31,16,124
395826617,63,3,2,7,75
395826794,36,21,34,4,95
395845476,46,24,2,4,76
395846267,11,3,2,1,17
395859927,41,44,9,1,95
395861335,139,125,58,25,347
395871856,38,8,2,1,49
395887943,61,15,24,1,101
395892189,148,60,121,34,363
395897932,52,11,6,5,74
395914618,77,92,53,4,226
395924707,32,4,10,2,48
395925658,43,3,2,2,50
395930645,143,3,2,9,157
395937343,75,3,2,2,82
395940871,41,23,11,1,76
395941283,112,3,21,8,144
395941507,114,68,33,3,218
395944369,11,3,2,1,17
395951593,21,3,2,1,27
395962211,66,3,5,1,75
395989287,43,11,46,2,102
395989753,22,3,2,1,28
396019959,83,14,2,1,100
396023376,24,146,4,1,175
396028855,15,3,2,4,24
396033314,15,56,2,1,74
396033846,13,25,4,9,51
396038077,13,3,2,1,19
396050209,23,9,2,2,36
396056771,211,13,2,5,231
396068736,10,8,2,1,21
396088324,73,97,4,9,183
396095691,12,3,2,4,21
396099737,13,3,2,1,19
396102008,39,13,2,13,67
396106206,49,3,2,1,55
396115245,71,24,17,11,123
396128828,175,47,9,15,246
396143743,52,71,6,2,131
396151304,65,24,40,4,133
396162944,32,64,4,2,102
396168862,33,17,14,1,65
396171434,83,23,66,6,178
396192790,115,36,91,14,256
396202542,84,29,22,1,136
396204162,10,5,2,4,21
396209673,50,3,2,1,56
396217341,35,3,2,1,41
396218255,69,9,41,1,120
396227611,44,3,2,1,50
396229133,66,31,36,25,158
396246626,95,50,10,3,158
396252218,48,3,2,4,57
396262135,92,3,22,29,146
396271482,16,35,2,1,54
396279836,129,32,3,7,171
396283672,47,3,2,1,53
396299431,33,33,10,6,82
396303107,41,16,3,2,62
396312782,39,10,28,8,85
396313172,18,7,2,1,28
396314956,12,3,2,12,29
396317595,54,5,3,1,63
396366569,96,3,2,4,105
396367438,171,74,53,6,304
396373666,97,17,25,17,156
396374542,22,20,2,1,45
396375709,10,9,2,1,22
396383007,194,3,2,11,210
396392182,23,3,2,1,29
396401981,17,3,2,3,25
396407554,24,3,2,13,42
396421822,28,10,2,1,41
396423700,107,3,2,1,113
396428674,13,9,2,1,25
396433982,21,11,2,1,35
396480242,64,33,23,40,160
396513948,202,3,2,6,213
396515692,12,19,2,1,34
396523681,75,45,2,5,127
396526564,66,15,2,5,88
396533373,50,119,27,6,202
396562904,98,3,2,19,122
396596587,66,12,22,10,110
396615170,57,23,2,23,105
396616719,49,3,2,1,55
396625073,78,3,2,1,84
396626658,38,3,2,1,44
396630369,13,3,2,1,19
396650430,10,9,2,1,22
396652529,88,3,2,3,96
396653384,46,51,26,4,127
396653633,13,4,2,1,20
396656095,36,3,2,1,42
396666485,15,23,2,1,41
396669759,75,12,48,2,137
396674025,13,3,2,1,19
396686723,43,72,13,32,160
396707182,10,5,2,1,18
396737278,82,10,2,1,95
396746468,75,12,32,2,121
396752357,52,12,19,1,84
396752518,24,3,2,1,30
396789446,115,33,70,3,221
396790275,91,15,16,23,145
396805559,54,37,26,3,120
396839502,54,32,2,4,92
396840917,104,16,12,4,136
396863714,11,6,2,3,22
396877097,89,6,5,1,101
396877351,15,3,2,5,25
396891092,136,53,57,3,249
396908242,24,48,2,5,79
396919778,93,27,76,43,239
396921379,67,55,72,1,195
396941404,31,39,2,2,74
396947436,59,3,2,3,67
396952217,37,3,2,1,43
396959021,103,7,2,1,113
396959315,29,12,6,2,49
396980217,146,3,2,7,158
396992946,45,21,24,2,92
396994002,72,3,2,1,78
396996922,137,28,27,3,195
397001995,23,37,2,1,63
397002939,65,12,17,7,101
397014005,152,11,2,1,166
397025043,30,16,2,1,49
397034420,44,45,2,1,92
397035374,24,12,2,1,39
397045432,12,3,2,1,18
397046649,159,14,122,1,296
397048333,20,28,2,1,51
397053575,56,10,9,52,127
397059618,73,10,2,7,92
397061063,34,3,2,1,40
397068378,54,12,23,3,92
397072321,15,40,6,9,70
397079679,28,3,2,11,44
397085388,58,3,2,1,64
397096258,34,3,2,5,44
397096918,58,27,6,1,92
397109111,34,6,2,2,44
397111386,24,3,2,5,34
397118290,13,3,2,1,19
397119518,136,3,2,4,145
397122389,136,51,10,1,198
397122654,296,30,12,4,342
397122989,46,29,36,5,116
397138910,24,7,2,2,35
397179858,280,49,2,1,332
397193428,96,38,43,1,178
397200770,155,57,5,35,252
397214499,56,3,2,7,68
397220774,75,10,2,1,88
397269462,113,44,2,6,165
397274741,14,22,3,1,40
397281124,71,7,21,7,106
397281985,22,3,2,1,28
397282618,45,19,2,21,87
397291735,90,3,2,1,96
397294429,42,11,2,1,56
397297337,126,8,2,1,137
397313759,18,32,2,1,53
397317700,116,3,2,8,129
397319369,52,21,13,6,92
397338663,10,4,2,1,17
397341307,13,4,2,1,20
397363144,68,21,8,5,102
397390040,43,6,2,1,52
397390615,77,23,2,2,104
397390982,40,19,2,4,65
397393947,13,9,2,1,25
397409693,58,3,2,5,68
397409995,26,3,58,7,94
397414488,44,36,63,5,148
397415035,42,3,2,1,48
397417399,138,3,2,1,144
397417775,18,14,2,1,35
397418462,18,14,2,1,35
397429239,102,17,35,9,163
397434829,44,11,9,15,79
397449120,135,61,119,76,391
397475798,234,103,78,25,440
397477444,18,9,2,2,31
397480942,11,23,2,1,37
397495482,11,3,2,5,21
397495608,41,25,32,13,111
397504097,13,52,4,1,70
397505513,76,102,46,3,227
397512132,95,4,2,2,103
397513653,47,3,2,5,57
397514453,125,31,27,8,191
397519184,115,27,26,24,192
397527598,166,8,2,6,182
397528156,67,41,18,17,143
397529179,19,3,2,7,31
397535483,23,3,2,5,33
397536936,64,18,42,1,125
397545576,17,3,2,1,23
397559774,36,47,5,12,100
397584394,89,47,19,2,157
397594329,74,4,7,9,94
397599722,140,28,54,34,256
397600919,57,18,13,1,89
397609799,65,3,2,1,71
397619375,63,148,37,13,261
397628517,33,51,26,2,112
397653077,47,14,89,4,154
397666808,89,19,27,3,138
397676431,88,11,2,1,102
397686307,39,18,3,5,65
397687011,59,49,27,49,184
397694578,39,14,4,7,64
397697065,15,3,2,1,21
397726400,48,34,13,3,98
397750388,17,3,2,1,23
397750752,73,46,15,13,147
397759365,86,4,41,1,132
397781199,45,6,2,1,54
397787573,56,3,2,1,62
397788758,67,30,18,1,116
397795002,12,3,2,1,18
397808259,42,46,46,11,145
397811745,43,13,5,8,69
397840361,74,3,2,11,90
397852881,208,60,43,36,347
397863678,28,3,2,3,36
397867375,25,3,2,1,31
397874523,78,32,17,9,136
397875659,39,10,2,1,52
397879723,114,31,5,7,157
397882526,72,5,12,25,114
397893272,152,53,2,5,212
397898498,130,63,37,8,238
397899365,16,16,2,1,35
397906418,92,52,48,3,195
397910334,15,6,2,2,25
397913045,120,3,2,1,126
397919816,182,58,7,6,253
397921190,19,18,5,1,43
397924084,16,29,2,1,48
397930580,31,17,2,1,51
397957111,27,19,2,1,49
397971298,64,3,17,6,90
397973933,41,16,2,10,69
397976794,12,7,2,1,22
398008757,69,9,75,8,161
398022947,57,3,2,1,63
398045725,18,30,2,1,51
398046156,10,3,2,3,18
398051580,70,3,2,2,77
398055388,29,3,2,5,39
398071352,81,3,2,1,87
398096602,120,4,2,1,127
398114420,12,29,2,1,44
398116421,31,3,2,6,42
398131771,113,3,2,1,119
398132015,54,3,2,1,60
398142169,85,24,2,3,114
398144724,73,52,23,3,151
398149262,16,3,2,1,22
398151738,11,5,2,1,19
398156050,110,31,2,7,150
398158884,129,3,2,6,140
398160112,11,3,2,2,18
398184480,59,16,4,9,88
398192079,57,40,9,16,122
398213444,32,124,64,1,221
398226902,13,3,2,2,20
398239204,25,30,6,3,64
398241247,23,12,2,1,38
398260222,81,59,33,40,213
398263028,99,22,4,4,129
398273263,21,7,2,1,31
398282749,86,3,2,1,92
398286910,21,3,2,1,27
398297245,27,85,2,4,118
398312849,34,7,2,2,45
398335292,15,3,2,1,21
398336234,14,49,2,5,70
398347767,38,37,30,30,135
398348642,91,3,2,1,97
398351848,115,3,2,3,123
398353198,51,27,5,1,84
398355994,166,29,2,1,198
398357761,10,9,2,3,24
398361109,56,34,2,1,93
398368461,47,3,2,1,53
398375657,81,20,92,1,194
398385159,43,23,2,1,69
398391092,37,7,2,1,47
398411851,36,3,2,1,42
398420432,104,3,2,1,110
398438590,126,10,63,2,201
398447090,43,3,2,1,49
398454910,29,3,22,5,59
398460919,189,97,44,1,331
398464880,19,3,2,1,25
398471929,32,4,2,38,76
398473249,76,80,38,9,203
398486552,62,25,22,5,114
398492117,153,12,2,1,168
398506877,39,21,2,1,63
398510486,10,30,2,3,45
398516825,18,7,2,1,28
398517804,12,3,2,1,18
398526541,47,38,9,1,95
398529173,49,3,2,2,56
398544575,68,42,50,15,175
398576536,13,3,2,2,20
398588081,58,3,2,3,66
398598631,20,3,2,1,26
398604414,86,11,3,2,102
398605223,152,3,2,2,159
398606047,56,3,2,1,62
398613331,76,19,45,1,141
398638726,11,10,2,4,27
398644850,51,20,47,8,126
398657738,10,23,2,1,36
398667614,55,3,2,1,61
398677326,64,3,2,2,71
398689111,11,3,2,1,17
398704457,43,17,32,50,142
398704732,101,32,93,1,227
398706676,52,3,2,7,64
398706822,31,9,2,1,43
398723850,106,3,2,1,112
398736164,25,3,2,4,34
398742740,14,10,2,1,27
398747700,40,3,2,3,48
398751772,35,13,17,2,67
398752309,11,3,2,3,19
398773900,17,3,2,2,24
398781410,55,22,12,2,91
398791578,13,3,2,1,19
398794169,10,11,2,2,25
398803160,41,3,2,4,50
398806131,43,18,6,1,68
398809809,27,12,2,1,42
398816784,11,3,2,1,17
398819245,27,12,5,1,45
398819638,14,3,2,2,21
398828720,21,13,53,2,89
398834231,84,31,25,12,152
398843314,57,16,31,2,106
398852716,25,15,2,2,44
398856547,35,6,2,2,45
398858825,29,18,6,1,54
398860814,42,14,19,1,76
398862791,25,21,37,1,84
398866870,34,39,2,1,76
398870308,83,31,3,7,124
398882425,12,44,2,1,59
398894556,56,16,6,10,88
398904058,44,19,8,1,72
398909677,39,42,8,1,90
398910975,42,3,2,1,48
398940803,48,3,2,1,54
398973069,49,15,2,24,90
398976161,29,3,2,1,35
398984250,84,3,2,1,90
398988825,127,50,33,12,222
398991105,19,3,2,1,25
398994113,45,12,2,1,60
399002891,66,3,2,5,76
399014187,101,31,57,1,190
399027954,48,3,2,1,54
399039961,64,46,17,17,144
399061443,17,46,25,1,89
399080232,15,4,9,9,37
399080563,47,12,11,1,71
399098635,51,3,2,1,57
399101957,105,39,29,13,186
399105708,15,22,2,1,40
399111794,17,10,3,3,33
399118114,100,16,2,23,141
399122282,14,3,2,2,21
399128603,30,7,2,7,46
399139764,57,35,6,15,113
399151602,83,9,2,4,98
399165223,71,10,2,2,85
399171725,122,3,2,1,128
399171907,52,22,29,6,109
399174079,17,14,8,1,40
399174781,13,10,2,1,26
399175111,56,3,2,1,62
399204421,51,31,44,5,131
399206428,120,9,3,1,133
399220772,67,12,22,1,102
399226194,63,25,2,1,91
399246196,57,5,31,41,134
399255871,23,12,28,1,64
399272785,85,7,2,1,95
399278680,18,4,2,2,26
399331307,169,3,2,8,182
399331559,92,23,12,20,147
399334795,12,46,2,3,63
399342150,25,3,2,1,31
399352009,21,48,2,1,72
399352191,65,42,2,1,110
399357033,82,11,5,1,99
399367855,13,15,2,2,32
399389966,186,3,2,1,192
399392251,40,79,2,1,122
399412472,21,3,8,1,33
399414447,11,10,2,2,25
399422296,127,71,14,22,234
399434767,80,79,57,4,220
399439450,21,9,2,1,33
399446096,81,34,4,4,123
399451430,51,32,29,1,113
399460013,89,54,68,1,212
399462500,47,8,3,14,72
399466514,39,38,41,45,163
399498662,12,3,2,1,18
399513498,21,3,2,10,36
399524325,79,19,15,2,115
399543111,81,14,54,2,151
399548554,21,7,8,5,41
399551914,60,9,18,1,88
399560089,97,37,55,10,199
399561096,98,3,2,6,109
399589971,11,7,2,5,25
399600449,108,3,2,1,114
399624513,12,8,2,1,23
399626170,131,14,7,42,194
399634384,37,15,2,8,62
399644071,68,69,84,8,229
399654905,155,32,8,29,224
399658397,107,3,2,1,113
399662359,116,29,17,72,234
399673850,10,4,2,5,21
399676063,11,3,2,1,17
399705950,14,3,2,1,20
399706133,79,159,13,2,253
399715730,74,18,8,5,105
399735298,73,23,7,34,137
399761562,18,3,2,1,24
399768122,42,3,2,1,48
399793222,41,3,2,3,49
399812730,13,10,2,1,26
399822645,99,9,13,3,124
399824306,97,13,2,2,114
399846555,65,3,2,3,73
399866473,21,6,2,14,43
399867020,44,3,2,1,50
399874192,10,3,2,2,17
399876544,13,5,2,1,21
399877282,106,9,3,2,120
399883858,114,31,68,4,217
399883948,15,23,2,1,41
399892365,159,3,2,25,189
399892724,83,19,58,2,162
399895081,131,45,48,4,228
399896789,63,3,21,1,88
399900847,12,3,2,1,18
399909546,121,6,3,2,132
399912156,64,71,2,4,141
399912310,129,67,24,1,221
399912425,45,3,4,1,53
399927237,47,25,49,1,122
399938061,49,3,2,1,55
399943473,105,3,2,2,112
399945155,145,139,47,4,335
399948719,18,3,2,1,24
399960994,248,41,14,16,319
400017113,13,3,2,1,19
400022006,11,3,2,1,17
400030702,195,20,39,8,262
400055706,10,19,4,1,34
400060464,52,14,19,1,86
400064331,62,5,2,13,82
400071471,112,40,150,5,307
400077358,23,33,12,1,69
400078712,46,18,3,1,68
400087000,13,11,2,1,27
400093945,17,3,2,1,23
400102588,23,13,16,1,53
400105295,79,46,54,6,185
400110026,46,13,2,1,62
400114272,43,13,3,9,68
400121857,48,3,2,1,54
400154004,187,18,12,2,219
400159094,33,29,3,1,66
400173675,360,116,2,26,504
400175708,239,23,30,9,301
400178404,52,12,6,4,74
400201243,11,3,2,1,17
400202242,12,40,2,5,59
400203541,24,41,2,1,68
400204982,42,37,5,1,85
400218041,27,25,2,14,68
400239139,65,13,60,2,140
400242101,11,8,2,1,22
400267766,19,18,2,1,40
400276331,10,11,2,2,25
400296387,46,4,7,10,67
400298821,77,3,2,5,87
400307037,54,43,72,2,171
400309659,36,8,2,1,47
400342995,123,38,5,5,171
400352711,31,9,2,1,43
400353375,82,3,2,2,89
400376108,36,15,2,2,55
400378085,147,13,60,8,228
400379008,165,17,2,1,185
400388117,48,29,63,1,141
400410414,105,3,2,2,112
400418454,50,12,48,2,112
400419283,92,3,2,1,98
400421986,18,6,5,4,33
400429410,50,3,2,1,56
400429762,53,3,2,1,59
400430601,182,19,5,6,212
400436017,28,33,3,3,67
400440338,144,43,3,1,191
400456998,26,3,2,1,32
400458921,62,10,4,2,78
400477609,118,10,77,3,208
400478603,57,22,19,13,111
400485195,154,67,95,5,321
400486673,45,3,2,1,51
400487469,53,23,32,2,110
400492157,36,60,40,1,137
400492204,31,62,95,2,190
400498260,41,38,12,6,97
400500230,30,14,3,8,55
400500723,80,36,2,3,121
400506187,59,26,14,12,111
400511339,12,3,2,2,19
400513992,46,7,16,1,70
400520562,84,35,2,1,122
400521373,29,3,2,1,35
400530331,27,30,3,8,68
400536827,20,3,2,1,26
400547187,11,3,2,1,17
400552739,22,21,29,1,73
400569210,108,55,84,67,314
400577865,21,82,20,1,124
400580469,32,25,16,1,74
400589850,36,12,2,1,51
400594318,32,4,2,3,41
400614346,78,11,16,48,153
400622998,52,30,14,15,111
400624369,173,5,2,3,183
400650681,10,3,2,2,17
400655452,154,30,2,1,187
400655634,55,35,3,2,95
400656372,17,13,2,3,35
400682495,102,68,2,39,211
400696194,11,3,2,1,17
400708477,15,22,17,3,57
400735984,10,3,2,2,17
400737150,80,27,2,1,110
400754404,92,3,2,2,99
400784783,64,27,11,2,104
400787130,11,4,2,1,18
400796723,51,35,35,12,133
400803009,53,32,44,38,167
400813180,17,30,2,28,77
400813652,75,3,5,1,84
400819159,76,21,2,1,100
400835567,26,8,9,1,44
400836139,116,39,85,4,244
400847296,99,10,14,1,124
400859139,33,13,69,2,117
400872569,18,3,2,1,24
400876913,55,15,6,4,80
400880668,173,17,14,26,230
400881650,22,7,2,1,32
400894891,71,41,12,51,175
400905241,16,12,2,5,35
400912472,21,3,2,1,27
400918396,10,8,2,3,23
400942036,127,12,78,11,228
400947652,24,3,2,1,30
400948946,11,6,2,3,22
400953282,31,6,7,1,45
400955486,14,3,2,1,20
400973487,14,13,2,1,30
400976612,24,17,2,5,48
400977185,21,3,2,1,27
400981894,58,3,2,8,71
400991036,25,3,2,1,31
401009508,152,68,60,89,369
401009533,43,48,77,38,206
401016535,99,14,26,7,146
401017356,12,3,2,1,18
401053415,10,4,2,1,17
401058353,162,62,114,20,358
401066302,160,30,6,4,200
401073355,15,10,2,1,28
401075014,87,29,2,1,119
401092505,22,3,2,1,28
401108113,63,11,78,1,153
401124994,85,3,2,3,93
401148111,10,4,2,3,19
401152944,90,86,2,3,181
401153744,88,3,2,5,98
401154851,46,10,2,2,60
401155675,137,19,2,10,168
401175341,179,3,2,14,198
401179594,77,52,64,21,214
401193293,111,3,2,1,117
401204802,43,20,3,18,84
401207194,44,37,3,34,118
401212021,10,3,2,3,18
401218197,71,23,2,5,101
401219853,22,3,2,1,28
401245041,33,43,2,1,79
401278438,54,17,2,3,76
401279909,12,3,2,1,18
401284251,21,3,2,1,27
401314104,55,14,6,9,84
401315445,91,69,13,34,207
401322132,13,3,2,1,19
401327034,69,30,59,13,171
401343229,17,3,2,14,36
401347524,158,37,72,83,350
401349924,33,3,2,1,39
401350114,140,34,51,13,238
401356458,50,19,10,6,85
401375310,24,3,2,1,30
401376935,54,8,2,14,78
401379469,128,20,29,68,245
401381870,83,3,2,1,89
401385555,137,3,2,1,143
401386038,82,3,2,2,89
401397844,148,3,2,1,154
401400561,46,3,2,1,52
401410198,37,3,2,5,47
401444720,10,53,2,1,66
401467609,22,47,5,22,96
401467866,39,3,2,1,45
401476623,80,73,36,3,192
401487247,128,22,2,1,153
401489563,20,24,2,1,47
401489780,140,58,40,20,258
401497239,106,3,2,22,133
401499746,85,5,25,7,122
401502036,172,62,23,6,263
401517806,50,61,20,3,134
401521923,72,20,2,1,95
401523123,170,3,9,1,183
401541195,129,3,2,6,140
401550007,88,41,3,5,137
401553745,19,15,4,3,41
401559882,69,26,13,32,140
401561208,162,3,2,1,168
401562394,93,3,2,3,101
401562885,11,3,3,1,18
401563963,145,23,9,10,187
401565859,30,14,41,4,89
401572589,86,31,8,3,128
401580168,126,75,2,6,209
401586573,127,3,2,4,136
401587375,16,3,2,2,23
401591544,88,3,2,3,96
401600106,10,21,2,1,34
401603109,142,16,50,8,216
401622240,118,3,2,2,125
401626930,21,3,2,1,27
401633612,97,3,2,1,103
401634966,61,6,93,1,161
401640807,52,10,46,14,122
401659396,45,16,2,1,64
401661072,235,56,38,9,338
401675393,161,48,78,7,294
401688872,21,8,2,2,33
401694193,61,22,23,3,109
401698081,113,3,2,2,120
401721910,111,49,4,7,171
401725484,68,3,2,1,74
401733989,47,3,2,1,53
401744486,29,33,17,7,86
401752730,11,11,7,2,31
401758928,14,11,2,7,34
401786301,62,45,2,4,113
401788065,87,27,2,4,120
401796092,109,30,27,5,171
401800171,124,67,29,28,248
401802190,40,18,2,3,63
401803439,135,8,3,3,149
401810945,45,24,8,4,81
401814513,14,3,2,1,20
401829399,89,7,2,1,99
401840397,13,5,2,1,21
401844355,109,21,2,13,145
401844993,70,3,2,1,76
401864161,28,5,2,18,53
401867211,90,3,2,1,96
401874108,73,21,2,4,100
401877889,73,29,4,8,114
401881382,49,6,10,1,66
401882936,88,14,21,2,125
401913707,20,17,2,2,41
401934085,87,32,2,1,122
401942652,60,7,10,1,78
401943715,51,22,2,1,76
401976519,23,3,2,1,29
401980855,74,39,2,6,121
401989731,59,27,2,3,91
401997145,108,36,2,1,147
401997567,14,4,2,1,21
401998840,60,26,17,25,128
402008648,29,37,6,1,73
402010380,31,19,2,9,61
402018033,14,19,71,1,105
402061360,11,3,2,1,17
402063122,22,6,7,7,42
402064341,90,22,40,37,189
402091424,28,14,2,1,45
402092430,18,9,2,2,31
402128789,139,24,2,1,166
402135566,187,25,2,24,238
402145648,21,28,2,4,55
402146323,34,70,2,2,108
402178933,32,10,2,1,45
402181656,25,3,2,9,39
402183676,18,40,2,3,63
402189024,11,3,2,1,17
402191479,65,3,2,1,71
402196351,35,14,2,8,59
402200500,58,14,2,10,84
402204288,95,3,2,1,101
402213453,45,3,2,1,51
402216269,136,5,5,4,150
402217704,128,17,2,3,150
402223997,331,3,2,32,368
402230099,40,15,31,1,87
402230217,20,3,2,1,26
402231279,127,10,2,2,141
402233633,10,4,2,1,17
402253912,13,5,2,1,21
402259212,76,67,19,34,196
402284936,37,38,12,1,88
402285292,131,3,2,1,137
402296385,101,3,2,1,107
402306098,119,18,2,5,144
402319398,47,18,9,1,75
402321744,10,17,2,1,30
402325073,168,24,18,1,211
402329366,205,74,13,35,327
402335040,44,33,7,3,87
402340365,23,28,3,11,65
402348920,11,9,2,12,34
402349195,30,24,25,1,80
402358277,19,3,2,1,25
402362724,125,18,33,7,183
402364922,63,5,10,11,89
402370458,164,25,3,1,193
402373640,80,59,63,50,252
402388266,58,5,2,6,71
402409829,14,3,2,1,20
402410936,13,4,2,1,20
402436803,88,4,10,27,129
402440357,598,16,2,139,755
402442892,28,35,18,1,82
402448944,18,82,27,2,129
402449552,85,47,84,3,219
402456320,53,14,2,4,73
402460950,22,3,2,4,31
402467176,86,16,37,11,150
402485116,130,28,6,4,168
402487913,40,12,7,24,83
402493891,107,39,14,12,172
402501128,85,3,2,1,91
402516647,16,15,2,3,36
402552475,125,36,61,75,297
402584093,25,48,5,2,80
402589278,21,3,2,1,27
402590723,147,14,2,1,164
402590776,54,3,5,1,63
402599076,88,7,2,1,98
402612113,114,13,23,8,158
402631324,70,6,2,2,80
402631423,26,40,25,1,92
402670154,71,29,27,5,132
402676398,42,18,36,2,98
402684372,17,9,2,1,29
402686097,79,5,11,7,102
402690599,50,20,2,53,125
402691343,21,3,2,1,27
402698164,102,44,23,10,179
402702209,32,37,2,1,72
402717068,15,55,20,2,92
402724122,113,3,2,7,125
402728161,84,12,2,1,99
402728896,48,12,15,4,79
402731772,44,40,79,2,165
402780161,51,3,2,1,57
402782661,11,3,2,1,17
402814051,85,15,38,10,148
402824406,10,4,2,1,17
402841239,69,12,23,7,111
402850507,16,4,14,2,36
402888196,15,3,2,2,22
402928026,11,3,2,1,17
402932205,119,72,4,43,238
402936519,30,3,2,1,36
402941851,11,3,2,1,17
402950499,194,16,2,10,222
402971724,194,18,13,4,229
402979842,31,3,2,2,38
402995537,123,13,39,5,180
403002195,73,7,2,6,88
403015516,29,4,2,4,39
403062032,10,11,2,1,24
403065055,24,3,2,1,30
403068746,31,59,3,1,94
403082675,11,30,22,2,65
403086646,32,6,2,1,41
403093891,91,4,7,1,103
403097100,57,3,2,1,63
403098240,117,26,9,8,160
403109760,11,3,2,1,17
403119521,16,20,2,2,40
403130719,121,12,3,3,139
403132702,30,20,2,4,56
403160028,16,8,2,1,27
403162371,42,65,69,9,185
403167555,21,21,2,61,105
403176966,25,10,16,1,52
403192432,11,3,2,1,17
403229799,100,45,73,24,242
403240704,60,14,2,5,81
403247548,77,3,2,1,83
403247626,15,19,55,10,99
403256205,44,10,2,5,61
403265163,14,3,2,7,26
403268323,14,4,2,1,21
403294078,73,47,2,1,123
403300073,38,65,33,4,140
403300702,69,36,40,19,164
403307244,112,3,2,3,120
403322684,19,3,2,1,25
403324016,10,8,2,2,22
403340595,10,33,2,3,48
403363331,14,24,2,1,41
403366186,56,3,2,9,70
403374454,174,3,2,3,182
403379011,60,3,2,1,66
403384149,118,3,2,1,124
403385556,76,3,2,1,82
403399207,105,22,40,6,173
403406004,144,3,2,1,150
403416335,14,5,2,1,22
403427800,18,50,2,1,71
403428743,23,16,4,8,51
403450909,27,3,33,1,64
403452591,41,39,93,1,174
403452808,46,5,8,1,60
403458254,70,3,2,1,76
403466535,40,53,90,5,188
403479323,27,3,2,1,33
403502380,78,12,15,4,109
403506620,72,23,18,59,172
403530700,21,3,2,1,27
403532299,16,3,3,1,23
403535558,91,33,44,1,169
403540967,20,3,2,1,26
403544849,16,18,2,1,37
403550559,47,38,25,10,120
403555350,58,54,36,20,168
403560281,69,16,42,1,128
403563842,154,25,2,2,183
403573382,90,24,13,1,128
403599060,63,41,16,1,121
403608898,47,13,2,1,63
403619287,71,8,2,10,91
403643073,60,16,44,3,123
403664820,47,3,2,1,53
403668939,300,3,2,8,313
403671435,21,15,6,5,47
403678043,42,18,2,4,66
403685319,37,26,2,1,66
403692465,79,16,2,13,110
403704983,73,3,2,4,82
403705090,57,3,2,7,69
403707175,17,28,5,1,51
403707212,42,10,2,1,55
403707695,14,3,2,5,24
403718175,61,4,21,1,87
403722890,39,43,16,16,114
403734947,109,15,90,5,219
403740009,87,13,3,1,104
403748809,56,15,3,1,75
403752289,13,3,2,1,19
403763600,95,23,2,1,121
403771493,34,19,62,1,116
403774126,96,34,48,1,179
403787802,45,3,2,1,51
403794151,129,3,2,1,135
403798990,100,23,2,1,126
403805130,90,3,2,3,98
403807843,165,3,2,1,171
403812795,87,3,2,3,95
403819839,10,3,2,2,17
403832630,10,23,2,1,36
403841081,30,3,2,1,36
403854496,31,3,2,1,37
403871657,13,5,2,1,21
403872363,64,25,3,12,104
403884150,114,39,2,3,158
403887066,59,37,7,25,128
403903154,26,3,2,3,34
403908021,10,3,2,2,17
403908731,11,3,2,1,17
403941092,304,3,2,4,313
403951343,29,3,2,1,35
403953861,97,3,2,2,104
403961576,171,7,2,1,181
403962788,105,3,2,3,113
403969852,16,7,8,1,32
403979800,68,3,2,1,74
403991991,83,40,10,5,138
403996413,19,25,2,4,50
404024200,12,7,2,1,22
404026077,92,12,8,1,113
404031148,220,3,2,1,226
404040551,56,6,2,1,65
404054393,24,3,2,1,30
404058208,29,8,8,2,47
404067083,24,9,2,1,36
404083040,28,33,37,7,105
404086622,10,5,2,1,18
404112261,51,3,2,3,59
404113314,102,27,35,9,173
404117949,62,3,2,2,69
404118053,51,4,24,2,81
404124187,20,28,18,1,67
404124732,39,53,12,1,105
404127160,70,3,2,1,76
404129002,14,3,2,1,20
404139429,32,7,24,4,67
404156214,24,49,36,1,110
404159309,37,10,11,2,60
404161887,60,49,48,76,233
404165151,67,4,19,13,103
404169489,43,36,10,4,93
404195505,126,55,26,9,216
404198189,47,16,3,5,71
404221114,42,13,3,3,61
404235298,126,16,2,6,150
404261399,22,9,2,1,34
404268948,60,18,93,1,172
404269309,17,6,2,10,35
404288887,53,4,2,1,60
404296739,35,8,2,1,46
404303488,12,18,5,11,46
404317638,120,21,3,1,145
404338725,72,36,9,5,122
404373602,31,14,2,1,48
404388125,100,29,18,11,158
404390235,32,12,5,1,50
404408681,11,10,2,1,24
404411618,138,4,3,1,146
404416364,11,6,2,1,20
404428187,55,5,2,2,64
404431499,11,3,2,1,17
404444134,46,41,2,1,90
404450761,201,3,2,1,207
404463784,21,3,2,1,27
404472907,16,3,2,1,22
404473871,15,3,9,2,29
404479995,55,18,19,3,95
404487241,252,3,2,1,258
404505198,87,3,2,2,94
404506796,31,42,2,3,78
404508276,99,28,41,2,170
404523416,13,3,2,3,21
404525482,25,22,2,2,51
404533690,86,11,3,5,105
404536870,10,4,2,1,17
404540058,67,8,3,5,83
404552762,14,12,2,1,29
404566001,16,3,2,1,22
404598916,59,3,2,1,65
404608516,11,4,2,1,18
404615028,16,8,9,1,34
404616949,28,3,2,2,35
404620692,56,37,18,2,113
404631739,22,5,2,1,30
404645120,45,106,6,4,161
404647644,107,24,69,4,204
404653922,64,16,14,2,96
404660331,77,33,14,13,137
404661826,293,3,2,1,299
404666047,57,14,5,4,80
404667953,28,26,64,1,119
404678038,51,27,15,23,116
404683385,31,3,2,1,37
404696685,105,62,2,3,172
404699247,13,8,2,1,24
404701048,92,25,8,34,159
404716147,66,3,2,1,72
404719441,24,12,2,1,39
404733072,24,55,26,16,121
404737060,75,19,47,21,162
404739582,148,3,2,2,155
404747826,18,14,2,2,36
404782132,18,3,2,1,24
404782694,145,7,2,4,158
404803806,60,6,10,20,96
404807003,63,34,2,1,100
404815089,40,3,2,1,46
404818663,31,21,14,1,67
404821467,13,4,2,2,21
404830562,11,3,2,1,17
404830919,65,83,81,72,301
404831113,62,11,2,15,90
404832374,20,50,2,8,80
404851149,112,4,4,3,123
404863993,30,3,2,7,42
404868897,21,17,2,1,41
404890668,51,22,47,24,144
404890827,29,3,2,1,35
404902775,31,13,2,1,47
404906105,40,3,2,1,46
404910702,150,23,3,11,187
404926890,13,3,2,1,19
404932382,13,12,2,5,32
404932797,68,57,17,1,143
404936704,13,36,2,2,53
404944292,59,3,2,1,65
404953681,121,3,2,1,127
404954854,99,3,2,1,105
404961380,34,62,2,21,119
404969303,21,13,2,2,38
404974844,24,13,31,1,69
404976079,45,3,2,1,51
404983254,146,41,52,61,300
404994413,20,3,2,7,32
405014061,51,21,35,13,120
405019781,182,12,2,1,197
405027648,24,3,2,1,30
405033483,30,10,11,1,52
405039119,21,9,11,2,43
405070056,23,5,2,1,31
405082286,125,18,30,3,176
405101214,55,20,2,4,81
405103742,24,3,2,1,30
405110916,185,26,2,1,214
405114246,56,22,33,2,113
405120329,87,28,5,13,133
405128039,98,28,29,1,156
405131331,53,44,44,1,142
405151822,10,9,4,1,24
405152631,132,5,2,1,140
405156166,41,22,2,1,66
405178190,95,34,5,7,141
405190295,14,11,2,1,28
405204447,56,34,31,20,141
405206316,14,3,2,1,20
405226397,125,28,40,1,194
405238788,37,8,2,1,48
405260083,32,3,7,3,45
405267258,56,3,9,26,94
405274358,40,4,2,2,48
405277038,80,3,2,1,86
405277831,186,32,3,1,222
405302721,13,3,2,1,19
405317430,67,3,2,1,73
405324183,23,4,2,16,45
405334898,15,5,2,5,27
405344249,119,51,12,3,185
405349736,86,23,3,2,114
405357323,105,9,2,12,128
405369499,93,3,2,3,101
405371080,40,22,3,2,67
405375641,29,15,9,12,65
405379384,23,3,2,1,29
405385939,32,117,28,17,194
405386107,11,3,2,1,17
405390720,25,3,2,2,32
405418523,120,3,2,3,128
405418933,262,3,2,4,271
405421515,50,3,2,1,56
405432762,17,3,2,1,23
405436937,18,3,2,4,27
405460143,13,3,2,1,19
405467445,168,27,306,2,503
405474138,74,31,44,1,150
405476651,67,4,2,2,75
405490265,65,47,112,8,232
405494757,53,46,24,1,124
405497013,13,3,2,1,19
405517728,199,62,23,29,313
405518754,121,3,2,1,127
405539864,121,5,114,1,241
405561606,139,3,3,1,146
405561832,120,12,4,5,141
405593838,51,44,26,3,124
405598025,12,50,2,1,65
405598161,165,18,6,9,198
405609905,82,60,2,2,146
405621218,15,22,2,6,45
405623105,10,7,2,1,20
405644232,43,34,2,65,144
405647125,262,20,52,35,369
405665036,16,26,2,4,48
405678023,58,4,44,1,107
405698045,138,20,5,9,172
405701934,61,18,2,23,104
405706827,30,12,3,1,46
405788265,10,4,2,2,18
405792193,10,3,2,6,21
405794446,41,39,35,2,117
405800797,28,3,2,1,34
405809719,109,4,7,1,121
405824837,22,23,2,4,51
405827774,85,3,2,11,101
405838937,10,8,2,1,21
405842333,37,8,37,5,87
405846022,23,3,2,1,29
405851957,22,28,9,6,65
405862492,113,3,2,4,122
405887998,13,12,2,1,28
405897003,12,3,2,1,18
405899168,194,12,3,1,210
405903179,44,33,2,19,98
405919643,89,4,2,4,99
405926170,12,3,2,1,18
405933879,26,41,2,4,73
405937478,51,3,2,1,57
405941253,86,30,25,3,144
405945997,191,50,4,20,265
405946820,14,12,15,1,42
405949903,118,3,2,2,125
405964957,64,3,2,1,70
405999066,19,3,2,1,25
405999200,157,3,2,1,163
406024634,96,21,2,4,123
406028816,53,42,10,21,126
406045055,71,16,2,2,91
406050034,32,3,2,11,48
406053079,13,3,2,3,21
406065935,17,3,2,1,23
406066915,16,3,2,1,22
406074593,11,3,2,1,17
406075659,17,7,2,1,27
406078236,26,3,2,1,32
406090698,99,17,4,5,125
406103675,83,44,51,6,184
406106918,155,6,14,5,180
406110040,55,18,2,29,104
406124200,117,29,81,18,245
406128411,75,3,2,2,82
406141651,11,17,2,1,31
406148515,110,4,41,1,156
406153237,21,3,2,1,27
406156508,82,3,2,2,89
406161985,18,3,2,7,30
406165384,66,25,27,7,125
406197000,84,8,2,4,98
406201146,24,12,2,1,39
406216786,10,3,2,2,17
406232255,110,3,2,6,121
406241058,56,21,6,1,84
406260801,84,6,2,3,95
406265787,56,43,50,13,162
406279553,27,21,2,37,87
406281745,58,3,2,1,64
406291010,31,46,2,1,80
406292178,48,46,2,1,97
406297903,69,60,24,2,155
406298069,36,74,13,19,142
406302540,70,16,3,2,91
406311059,208,3,2,1,214
406328719,38,30,27,5,100
406330289,24,19,2,8,53
406331277,54,55,3,1,113
406331838,58,46,10,7,121
406347944,10,3,2,2,17
406350185,29,15,13,10,67
406360074,80,46,3,9,138
406369267,55,3,2,3,63
406402339,65,74,28,22,189
406415446,122,29,13,1,165
406426469,90,3,2,2,97
406427161,75,3,2,1,81
406431439,68,23,19,3,113
406440164,21,25,8,3,57
406481546,35,35,2,1,73
406481790,11,3,2,1,17
406502648,22,33,2,7,64
406505918,54,34,18,1,107
406509164,64,15,2,7,88
406510610,17,3,2,1,23
406512566,22,3,2,2,29
406548513,63,44,39,13,159
406578026,66,33,6,20,125
406579254,137,50,2,4,193
406587947,131,3,111,2,247
406590498,10,3,2,2,17
406590829,17,3,2,7,29
406598588,55,28,2,3,88
406611470,83,3,2,1,89
406611485,15,3,4,2,24
406629162,49,51,2,2,104
406674117,48,51,2,7,108
406690940,37,23,2,4,66
406691662,60,28,10,12,110
406698968,15,50,2,1,68
406709767,102,26,48,5,181
406740975,165,9,51,3,228
406741746,38,28,5,1,72
406751531,74,3,2,1,80
406755602,11,3,2,1,17
406770569,10,5,4,1,20
406788781,44,10,2,3,59
406805318,84,42,36,13,175
406819951,33,7,2,1,43
406830033,72,12,3,4,91
406843411,43,3,2,4,52
406848978,52,4,2,1,59
406862686,186,3,2,2,193
406902396,119,77,3,25,224
406922686,159,17,39,2,217
406923379,65,3,2,1,71
406928421,10,3,2,19,34
406936556,51,18,5,2,76
406938299,103,15,54,56,228
406938730,39,21,2,1,63
406962582,82,28,94,7,211
406971728,245,21,2,67,335
406972837,27,48,14,25,114
406985709,60,9,12,79,160
407006594,59,12,53,13,137
407014320,524,3,2,1,530
407026923,458,3,2,2,465
407031864,31,3,4,1,39
407040063,16,15,3,3,37
407062095,52,39,7,4,102
407079412,67,60,18,15,160
407080931,17,7,2,1,27
407084361,79,3,2,1,85
407088791,33,31,23,1,88
407105331,15,3,2,1,21
407106622,101,13,4,3,121
407133265,75,3,2,1,81
407136712,101,3,2,1,107
407152699,160,43,5,8,216
407170284,65,11,2,2,80
407172987,104,17,15,1,137
407183208,85,40,6,13,144
407186821,28,3,2,9,42
407188279,167,35,5,25,232
407188553,50,10,53,10,123
407191225,32,10,103,1,146
407197715,45,16,2,8,71
407198781,32,13,25,1,71
407214707,78,28,2,1,109
407221215,11,6,2,1,20
407235258,27,102,15,19,163
407240597,10,6,2,1,19
407247170,62,35,20,10,127
407256405,65,95,25,1,186
407260434,46,16,19,3,84
407280375,85,71,9,13,178
407283022,151,3,2,16,172
407283182,12,3,2,1,18
407299783,47,17,40,5,109
407306817,65,10,2,1,78
407310519,153,22,2,1,178
407312138,19,3,2,3,27
407315818,26,14,2,2,44
407325437,59,50,28,65,202
407329288,74,16,2,1,93
407362311,131,26,69,2,228
407372807,98,23,2,3,126
407386819,42,43,2,1,88
407388073,67,29,56,57,209
407389278,28,3,2,1,34
407400802,21,8,2,1,32
407411364,17,3,2,1,23
407433756,110,3,2,1,116
407439860,11,8,2,4,25
407459556,33,3,2,1,39
407465656,30,3,2,1,36
407486212,56,3,2,20,81
407493064,70,41,42,47,200
407495106,72,3,2,1,78
407515321,33,45,2,6,86
407525920,11,3,2,3,19
407527825,12,3,2,1,18
407534381,46,18,3,2,69
407534497,26,83,10,1,120
407535957,69,7,15,1,92
407547897,118,29,2,1,150
407559151,68,27,2,1,98
407560575,105,16,2,3,126
407564413,82,18,3,2,105
407574863,56,3,2,4,65
407575153,118,3,2,31,154
407577755,13,3,2,1,19
407579887,37,11,4,1,53
407582411,174,8,11,3,196
407587273,33,28,2,5,68
407600140,79,25,11,1,116
407604083,120,46,79,20,265
407612384,70,25,2,16,113
407621535,87,29,2,1,119
407626980,82,4,2,2,90
407630617,26,46,59,5,136
407636845,238,34,2,33,307
407645114,59,5,2,3,69
407651902,45,29,13,9,96
407653606,15,5,2,1,23
407688146,12,3,2,1,18
407691715,18,15,3,1,37
407700373,17,3,2,1,23
407709832,24,34,2,3,63
407711259,185,132,2,2,321
407714783,11,3,2,1,17
407723698,10,6,2,1,19
407728553,31,34,3,1,69
407735073,48,13,14,2,77
407735074,79,14,96,1,190
407752535,30,3,2,1,36
407760953,121,33,2,1,157
407761002,43,3,2,1,49
407761463,93,7,2,2,104
407767846,39,3,2,10,54
407770278,16,3,2,3,24
407795234,32,20,7,6,65
407802239,48,3,2,1,54
407805911,55,38,17,4,114
407810093,44,3,2,1,50
407815283,11,9,2,1,23
407816306,32,7,2,3,44
407839676,29,4,2,13,48
407848194,14,42,2,1,59
407848496,35,28,2,1,66
407858205,101,13,61,1,176
407858451,72,6,2,1,81
407861450,26,45,11,6,88
407863147,10,3,2,5,20
407870110,37,33,38,1,109
407872422,31,24,2,8,65
407900339,130,31,29,3,193
407912134,81,28,32,3,144
407913468,66,12,4,1,83
407919354,38,7,28,1,74
407922585,71,20,37,14,142
407938562,165,47,56,2,270
407945477,120,20,2,4,146
407947584,70,38,58,7,173
407952028,95,111,20,3,229
407959439,12,3,2,1,18
407962104,21,15,2,1,39
407965878,16,6,2,1,25
407978818,106,12,14,5,137
407985024,32,53,52,3,140
407985420,46,24,2,2,74
408011211,170,31,21,7,229
408011668,12,3,2,2,19
408015274,122,42,66,19,249
408020835,10,9,2,1,22
408040809,133,36,76,13,258
408049200,158,3,2,3,166
408070156,38,18,25,17,98
408073667,183,20,4,3,210
408075760,19,6,7,1,33
408091194,20,12,2,1,35
408093797,87,3,2,1,93
408095148,172,3,2,2,179
408100410,27,19,21,1,68
408100967,21,31,43,7,102
408136213,60,51,21,23,155
408138334,60,9,2,1,72
408143883,81,18,63,1,163
408150526,19,8,2,14,43
408162088,12,40,10,1,63
408201503,95,59,3,3,160
408213160,16,3,2,1,22
408216348,73,15,2,1,91
408218095,57,58,58,47,220
408232421,77,5,29,2,113
408238776,25,28,14,1,68
408243887,180,21,15,25,241
408245489,12,3,2,1,18
408258448,11,3,2,1,17
408260572,62,15,9,13,99
408274062,82,8,2,1,93
408275603,25,26,7,1,59
408281618,36,31,4,6,77
408329341,93,3,3,5,104
408340151,11,3,2,1,17
408345055,116,3,2,4,125
408345311,11,3,2,1,17
408374181,59,17,2,8,86
408374848,56,19,26,1,102
408379036,97,28,45,1,171
408395454,35,44,3,6,88
408397476,78,27,20,40,165
408409713,40,13,10,2,65
408412258,38,28,16,6,88
408413097,39,27,8,1,75
408419866,19,5,2,1,27
408462333,17,7,2,1,27
408486362,66,33,4,6,109
408502623,36,4,2,7,49
408516817,12,3,2,1,18
408545741,51,19,2,12,84
408562337,95,26,2,1,124
408568694,66,58,11,29,164
408571155,28,33,6,4,71
408588666,90,3,2,2,97
408614977,43,3,2,1,49
408644270,153,16,131,27,327
408645814,13,13,40,4,70
408655111,12,3,2,2,19
408657916,10,3,2,2,17
408661895,10,4,2,1,17
408665010,64,6,21,8,99
408673328,105,28,32,40,205
408674186,36,18,4,14,72
408691684,79,3,2,2,86
408692434,155,29,33,16,233
408698743,29,56,11,20,116
408708350,157,54,9,25,245
408715002,10,28,2,1,41
408727212,123,3,2,3,131
408732030,51,42,34,14,141
408762527,11,32,2,1,46
408762641,50,13,2,6,71
408764648,126,58,67,2,253
408764743,1020,3,2,22,1047
408813904,16,12,2,1,31
408813976,10,25,6,3,44
408823760,31,52,2,30,115
408830665,58,28,21,10,117
408837047,84,19,3,6,112
408850922,19,3,2,2,26
408858751,199,69,48,100,416
408861000,35,31,5,32,103
408864406,15,3,2,1,21
408870928,36,17,3,1,57
408871122,38,25,2,4,69
408883850,11,11,2,1,25
408884337,120,59,5,5,189
408886861,52,8,24,16,100
408902392,14,3,2,26,45
408919115,324,3,2,8,337
408923563,23,3,2,1,29
408924736,10,17,2,1,30
408929358,70,3,2,1,76
408936847,170,15,11,9,205
408950032,17,20,10,8,55
408959163,79,30,3,2,114
408962311,96,33,2,11,142
408962969,23,9,12,1,45
408964443,12,3,2,3,20
408988176,47,10,19,4,80
408989906,47,3,2,2,54
408997150,25,27,2,1,55
409008112,40,13,4,2,59
409024794,25,3,2,1,31
409028242,52,3,2,1,58
409031983,49,24,2,1,76
409035739,10,13,2,1,26
409045693,45,27,2,1,75
409069279,38,18,56,28,140
409077472,13,3,2,1,19
409088162,66,3,2,1,72
409093107,79,23,45,27,174
409112008,25,29,17,5,76
409133753,50,97,3,20,170
409139493,35,41,17,13,106
409143768,14,3,2,4,23
409156632,15,3,2,1,21
409171744,46,14,2,1,63
409172408,116,39,2,3,160
409173616,185,52,4,13,254
409179185,82,24,132,4,242
409182226,102,33,4,2,141
409184735,137,45,33,2,217
409195663,33,17,50,1,101
409198786,17,24,2,1,44
409200660,85,19,3,9,116
409204089,12,66,2,7,87
409214331,85,3,2,1,91
409225329,34,30,2,1,67
409225538,114,11,5,8,138
409226416,44,30,2,1,77
409243321,52,9,2,1,64
409248309,19,34,2,4,59
409251231,83,5,2,1,91
409265681,20,14,2,1,37
409267697,37,7,2,3,49
409279005,27,12,2,1,42
409280552,19,4,8,1,32
409285467,43,14,2,5,64
409296756,18,37,2,1,58
409304675,60,27,50,21,158
409311791,32,7,2,1,42
409329979,52,3,2,2,59
409359470,254,100,2,11,367
409360629,70,22,50,2,144
409365054,79,9,4,8,100
409372266,24,11,2,1,38
409385616,10,5,2,1,18
409387446,68,3,2,9,82
409389212,18,8,2,5,33
409391205,22,25,8,1,56
409398373,31,7,10,8,56
409401999,98,79,45,1,223
409402494,34,56,28,13,131
409410167,68,18,2,2,90
409412213,11,3,2,1,17
409415237,88,14,2,44,148
409420056,13,29,2,2,46
409423237,11,6,2,3,22
409423891,12,11,2,16,41
409426934,38,26,9,1,74
409441933,48,12,2,1,63
409445740,95,18,2,23,138
409456216,12,3,2,1,18
409459966,933,3,2,9,947
409463911,73,3,2,1,79
409465021,90,17,7,15,129
409479287,11,9,2,1,23
409482816,58,33,2,10,103
409485019,22,15,8,3,48
409488633,37,3,2,10,52
409509501,46,15,26,10,97
409533608,10,8,2,1,21
409535093,42,3,2,14,61
409536229,144,18,42,16,220
409539719,55,23,2,3,83
409544570,63,16,2,1,82
409547837,82,3,2,2,89
409551986,45,19,2,4,70
409555804,49,33,2,1,85
409570940,10,9,2,1,22
409586748,10,48,2,1,61
409598756,11,3,2,1,17
409604886,63,21,4,8,96
409609474,22,38,2,1,63
409610884,13,3,2,1,19
409617306,66,26,13,5,110
409626791,24,42,2,2,70
409634039,13,3,2,3,21
409635677,98,32,2,5,137
409655047,118,7,114,1,240
409658728,23,37,13,1,74
409659218,18,3,2,2,25
409663120,18,30,5,3,56
409692504,102,21,2,1,126
409706385,10,3,2,2,17
409712197,195,3,2,6,206
409717864,13,15,2,4,34
409740857,105,3,18,1,127
409742159,64,22,2,2,90
409767060,21,3,2,3,29
409767248,20,3,2,5,30
409768397,114,3,2,8,127
409774119,36,32,5,6,79
409782006,109,22,2,1,134
409797599,100,3,2,2,107
409801015,110,3,2,1,116
409802447,36,101,5,1,143
409807607,12,3,2,1,18
409822116,17,11,8,1,37
409832845,333,3,2,6,344
409841727,19,50,9,24,102
409849714,104,37,2,1,144
409856837,121,12,2,1,136
409868112,12,3,2,1,18
409876953,67,15,6,3,91
409894311,95,47,29,2,173
409902467,71,3,2,1,77
409907426,119,10,9,22,160
409908836,117,35,29,35,216
409911397,40,11,3,15,69
409925211,13,40,2,1,56
409926817,67,15,27,2,111
409935836,23,5,3,8,39
409939129,56,3,2,4,65
409960713,92,10,2,2,106
409993692,66,99,49,53,267
409997279,147,53,39,41,280
409999167,11,21,4,1,37
410005818,131,33,15,7,186
410026045,27,23,4,6,60
410027659,26,44,24,10,104
410028118,10,21,2,1,34
410037406,119,3,2,1,125
410049211,13,25,29,2,69
410058384,134,3,2,5,144
410067851,18,7,6,2,33
410068645,62,13,4,5,84
410070392,50,44,6,60,160
410085733,40,11,3,9,63
410088930,122,46,3,3,174
410091827,37,3,2,6,48
410096279,131,155,5,69,360
410115917,14,3,2,1,20
410120589,98,21,35,11,165
410126009,16,3,2,1,22
410134712,137,3,2,2,144
410135075,93,9,6,6,114
410137225,160,3,2,1,166
410145218,103,38,24,17,182
410154692,10,3,2,2,17
410155291,202,38,7,31,278
410155687,55,17,5,3,80
410163476,58,25,3,9,95
410191422,35,3,2,1,41
410215763,64,3,2,1,70
410243175,54,3,2,1,60
410243845,19,18,2,1,40
410258718,27,29,19,2,77
410259335,103,23,5,33,164
410260233,34,3,2,1,40
410264549,27,32,5,1,65
410275003,75,23,15,1,114
410280764,108,31,2,1,142
410306253,10,14,2,1,27
410317469,76,20,2,7,105
410323048,48,23,15,21,107
410323432,91,10,8,1,110
410332975,29,36,20,16,101
410343538,15,30,58,2,105
410353231,80,36,55,41,212
410355775,33,24,87,31,175
410359133,31,59,2,17,109
410382496,14,48,2,9,73
410383351,27,3,2,1,33
410402836,186,3,2,6,197
410420771,156,40,2,2,200
410455610,23,23,2,3,51
410475074,70,15,2,1,88
410491278,15,14,3,4,36
410497913,16,20,2,1,39
410500287,115,16,2,1,134
410501460,49,22,17,5,93
410504339,417,19,7,6,449
410504751,42,74,8,4,128
410514624,53,19,3,3,78
410516384,84,40,7,12,143
410533155,173,30,3,15,221
410537776,103,13,2,1,119
410539421,59,12,2,1,74
410540373,196,50,2,28,276
410552138,211,29,2,15,257
410557157,53,79,2,1,135
410590833,84,4,2,12,102
410595405,113,3,2,1,119
410597039,86,39,2,9,136
410598926,25,3,2,1,31
410623928,28,8,2,1,39
410628368,98,64,19,7,188
410628836,15,7,2,1,25
410643195,11,18,2,1,32
410663706,21,6,3,17,47
410671839,14,3,2,1,20
410696942,148,29,10,4,191
410714430,36,12,9,1,58
410723582,68,10,40,13,131
410729368,18,5,6,3,32
410738688,154,47,2,9,212
410772170,89,3,2,1,95
410778744,149,3,2,1,155
410778991,183,19,2,10,214
410779479,162,29,2,6,199
410780871,104,29,2,7,142
410793204,53,36,2,22,113
410793704,145,21,2,3,171
410816350,84,17,2,7,110
410841459,195,39,51,10,295
410851780,135,21,3,8,167
410853083,62,12,62,10,146
410860666,17,3,2,4,26
410860858,31,3,2,1,37
410863210,47,57,33,10,147
410865719,135,48,23,20,226
410904344,12,3,2,2,19
410913147,17,21,9,1,48
410916387,119,3,2,6,130
410927082,72,18,2,20,112
410929216,115,23,5,1,144
410941345,177,48,2,6,233
410944750,66,73,7,1,147
410946986,50,44,2,3,99
410950331,16,3,2,1,22
410953770,59,13,2,12,86
410986819,73,3,2,1,79
411025750,39,3,2,7,51
411033564,94,3,2,1,100
411036585,77,3,2,1,83
411049274,14,3,2,1,20
411055264,85,16,68,1,170
411057435,70,58,18,8,154
411060837,40,14,2,1,57
411066566,75,7,72,6,160
411068051,47,3,2,3,55
411094261,17,34,17,1,69
411095209,37,56,16,1,110
411095836,51,48,2,1,102
411098164,90,20,67,4,181
411100227,163,5,23,2,193
411110469,28,50,2,18,98
411113383,65,17,30,17,129
411121919,25,27,5,1,58
411123551,118,3,2,4,127
411167183,84,21,13,3,121
411184949,50,73,12,16,151
411202832,37,21,11,3,72
411203996,194,84,2,14,294
411207437,18,3,2,1,24
411214526,27,28,5,2,62
411216685,235,14,2,9,260
411236835,42,58,2,6,108
411238751,53,51,69,36,209
411260403,70,3,2,16,91
411262057,17,15,3,1,36
411264831,48,18,19,1,86
411284152,33,20,24,2,79
411299987,32,23,2,1,58
411318241,12,46,2,1,61
411319582,19,3,2,1,25
411322325,13,35,2,1,51
411330349,131,3,2,4,140
411349491,52,8,3,1,64
411349517,72,3,2,1,78
411364167,65,9,24,11,109
411387220,66,3,2,2,73
411400077,22,12,2,1,37
411404801,53,11,4,1,69
411406555,152,3,2,1,158
411425171,97,102,7,3,209
411427606,46,23,2,1,72
411428251,10,12,2,1,25
411443670,54,35,41,4,134
411444791,112,27,69,1,209
411447762,31,10,2,3,46
411448908,61,7,2,1,71
411455417,32,71,7,1,111
411458245,45,3,2,1,51
411458294,29,3,2,1,35
411475404,159,3,2,1,165
411477255,16,5,2,3,26
411496843,60,14,2,5,81
411510105,12,3,2,5,22
411514506,108,8,2,4,122
411534774,75,47,18,22,162
411545143,16,8,2,6,32
411547062,60,14,5,4,83
411547430,22,34,2,1,59
411549792,20,3,2,1,26
411551143,18,5,2,9,34
411569873,16,3,2,1,22
411570484,50,50,69,3,172
411570756,49,36,26,1,112
411577842,23,3,2,1,29
411581212,14,26,2,1,43
411596647,50,43,12,2,107
411602383,50,28,7,1,86
411617997,78,25,2,2,107
411621832,40,36,30,11,117
411623948,12,3,2,1,18
411625875,94,24,2,1,121
411628746,69,19,74,2,164
411632006,17,47,2,1,67
411643685,10,9,2,1,22
411665147,107,3,2,2,114
411672920,89,20,2,11,122
411673388,37,32,3,4,76
411679579,11,4,2,1,18
411689845,20,12,2,4,38
411697475,10,3,2,2,17
411703625,63,3,2,1,69
411713527,34,29,31,4,98
411715029,22,37,11,1,71
411719204,23,13,4,1,41
411733606,65,26,19,4,114
411736325,44,41,51,67,203
411736814,23,4,3,1,31
411738822,38,3,2,1,44
411764493,11,3,2,1,17
411765632,169,6,2,2,179
411780448,12,6,2,1,21
411789303,36,51,22,4,113
411797156,25,10,2,1,38
411798249,46,38,51,11,146
411801770,50,3,2,3,58
411805354,139,3,2,2,146
411809406,22,14,2,1,39
411820266,62,103,2,41,208
411824556,20,3,2,2,27
411826797,265,37,17,31,350
411828626,22,23,3,10,58
411830788,92,45,12,9,158
411839240,26,8,2,1,37
411844511,21,3,2,2,28
411846840,11,3,2,2,18
411849100,12,3,2,1,18
411860649,79,5,12,4,100
411860955,52,23,77,4,156
411862217,43,5,2,13,63
411876192,54,25,4,1,84
411881773,71,17,18,4,110
411894601,52,11,2,2,67
411903675,20,12,10,1,43
411903756,46,51,5,1,103
411912201,26,9,15,9,59
411915139,10,3,2,3,18
411915171,11,34,2,5,52
411923352,62,3,2,1,68
411932999,15,7,2,1,25
411957013,14,5,2,1,22
411964541,30,12,4,5,51
411981445,60,3,2,2,67
411986096,136,3,2,3,144
411988469,19,3,2,1,25
411999737,71,15,2,2,90
412005342,30,3,2,6,41
412007939,87,3,2,5,97
412008076,39,3,27,1,70
412019105,25,9,2,2,38
412029415,39,28,2,3,72
412035625,10,4,2,5,21
412040975,122,13,2,2,139
412041218,22,3,2,1,28
412049839,32,33,23,20,108
412063583,32,53,2,9,96
412084369,168,56,2,60,286
412097921,24,3,2,1,30
412107572,67,35,6,2,110
412120224,53,30,3,13,99
412135568,67,42,5,7,121
412145002,27,3,3,27,60
412145500,50,14,2,1,67
412157742,106,37,46,10,199
412188735,107,27,3,6,143
412191475,27,31,6,10,74
412206357,21,4,4,6,35
412207152,20,15,20,1,56
412212906,76,3,2,1,82
412219200,133,3,2,1,139
412226251,32,3,2,1,38
412233737,72,3,2,2,79
412233924,12,5,4,1,22
412236046,40,41,2,1,84
412247542,19,3,2,1,25
412250186,30,28,77,1,136
412260160,19,8,4,4,35
412264663,35,3,2,1,41
412269477,85,8,9,3,105
412276937,128,62,2,15,207
412277098,44,53,18,2,117
412301217,16,3,2,1,22
412303790,10,30,2,4,46
412306125,81,3,2,2,88
412320233,31,23,30,2,86
412327780,39,3,2,6,50
412345384,16,27,46,38,127
412351269,123,17,2,4,146
412358694,105,7,15,1,128
412362873,11,3,2,1,17
412372032,135,29,67,12,243
412378167,57,29,2,47,135
412383972,33,5,8,3,49
412398556,75,19,70,1,165
412406391,88,3,2,1,94
412407463,26,19,2,2,49
412439890,30,3,2,1,36
412443678,13,23,2,1,39
412474362,81,3,2,1,87
412489818,52,30,15,1,98
412497478,55,3,5,1,64
412500186,65,20,2,3,90
412502247,64,3,2,2,71
412505164,22,3,2,1,28
412505434,295,3,2,4,304
412519818,23,3,2,1,29
412519986,11,3,2,1,17
412537370,68,28,40,7,143
412538236,39,15,2,6,62
412542543,66,3,2,9,80
412561217,55,16,13,1,85
412564981,22,14,23,1,60
412568483,46,7,8,16,77
412572273,25,47,18,1,91
412582320,126,8,2,27,163
412612785,66,22,2,11,101
412625252,11,3,2,1,17
412630380,161,5,17,2,185
412632485,70,40,28,46,184
412641183,45,3,2,6,56
412644224,109,3,2,3,117
412644875,110,22,94,5,231
412678737,72,34,22,1,129
412694060,91,29,5,2,127
412698940,11,3,2,1,17
412723289,95,3,2,4,104
412729007,103,3,2,1,109
412755366,51,3,2,1,57
412758324,11,3,2,4,20
412758701,33,38,15,3,89
412761938,130,20,2,3,155
412763866,33,38,22,4,97
412772045,22,3,2,1,28
412772278,33,16,4,11,64
412776642,32,13,2,2,49
412792284,16,3,2,1,22
412807501,47,15,5,1,68
412826200,19,18,17,2,56
412842083,14,7,2,1,24
412852874,79,23,26,1,129
412854718,79,3,2,4,88
412863877,22,3,2,1,28
412883851,113,11,48,1,173
412894007,52,3,2,1,58
412918211,50,15,2,3,70
412933318,102,3,5,1,111
412935137,77,3,2,1,83
412935433,11,3,2,1,17
412947318,155,3,2,1,161
412966500,66,3,2,1,72
412981129,43,78,6,1,128
412988015,26,4,2,2,34
412991021,73,3,2,2,80
412995754,197,22,13,4,236
412999819,67,119,11,39,236
413022861,95,75,59,17,246
413038207,16,18,41,35,110
413041569,138,4,2,9,153
413060354,56,18,80,2,156
413101001,100,3,4,5,112
413108790,134,47,48,69,298
413111416,22,29,2,1,54
413126496,26,27,2,2,57
413129059,107,13,46,26,192
413130816,47,35,2,1,85
413132382,99,17,12,7,135
413144778,91,48,80,4,223
413154596,61,63,8,1,133
413158409,81,6,2,20,109
413178040,59,19,2,12,92
413196829,85,22,45,5,157
413201839,40,45,13,65,163
413252727,81,15,36,2,134
413293148,58,74,2,6,140
413305619,15,14,2,4,35
413318820,56,22,2,5,85
413327750,110,21,24,5,160
413329229,21,3,13,3,40
413330283,235,51,81,9,376
413342237,43,3,2,1,49
413352010,19,3,2,1,25
413368561,67,29,114,1,211
413373726,69,12,2,6,89
413373958,17,3,2,5,27
413394837,42,49,2,1,94
413401181,90,38,25,2,155
413403294,63,6,60,12,141
413415807,64,3,2,1,70
413423062,112,7,2,3,124
413428310,228,3,2,9,242
413429005,131,6,2,1,140
413429485,71,41,5,3,120
413439577,90,25,45,18,178
413442054,93,3,2,1,99
413443766,25,17,27,2,71
413455885,13,7,2,1,23
413457601,20,3,2,1,26
413457742,23,62,33,1,119
413469091,63,3,2,3,71
413476480,41,46,12,41,140
413485207,11,3,2,3,19
413486556,138,21,3,15,177
413496516,13,3,2,1,19
413515813,10,30,2,1,43
413518094,22,13,2,1,38
413519966,60,11,2,1,74
413532470,182,57,3,10,252
413547034,23,12,2,10,47
413547769,14,11,2,1,28
413547992,333,50,3,3,389
413553307,11,3,2,2,18
413554133,14,3,2,1,20
413554541,17,7,2,1,27
413556755,89,25,2,4,120
413561697,93,39,121,2,255
413567979,48,34,6,32,120
413574178,42,3,2,4,51
413603607,46,3,2,29,80
413610332,16,6,3,3,28
413625045,38,4,2,1,45
413627213,10,4,2,1,17
413634772,159,17,2,6,184
413639013,69,5,2,1,77
413643827,22,16,2,2,42
413665773,56,3,2,1,62
413678598,42,3,2,1,48
413694374,45,16,11,2,74
413696882,14,4,2,1,21
413698042,49,9,13,20,91
413698189,56,51,11,12,130
413701407,67,14,12,6,99
413717807,112,22,121,1,256
413718775,24,4,2,1,31
413719149,20,3,2,1,26
413766672,36,3,2,1,42
413769556,94,18,2,3,117
413792091,17,3,5,1,26
413809197,55,3,2,1,61
413839624,60,4,2,1,67
413841907,90,39,13,2,144
413845990,59,38,3,3,103
413848796,41,32,77,34,184
413856814,38,3,2,3,46
413860431,75,3,2,1,81
413875290,57,39,28,5,129
413883351,78,20,13,2,113
413886084,19,3,2,4,28
413888246,16,3,2,2,23
413892115,29,135,3,1,168
413897039,11,5,2,1,19
413902609,10,5,2,1,18
413918252,145,13,3,3,164
413931432,40,21,2,8,71
413940209,119,3,2,3,127
413947418,36,30,62,4,132
413947833,434,3,2,5,444
413954200,10,9,2,1,22
413981393,140,11,8,2,161
413991303,13,3,2,1,19
414011513,118,20,2,18,158
414012127,150,13,2,2,167
414024522,61,17,2,1,81
414048064,49,3,2,2,56
414048542,13,3,2,1,19
414052398,17,61,2,1,81
414063917,16,3,2,1,22
414069237,421,15,37,81,554
414075189,80,3,2,18,103
414079735,20,76,23,3,122
414083237,128,3,2,1,134
414092359,37,17,2,3,59
414097178,34,34,3,31,102
414117007,11,3,2,2,18
414120035,92,41,8,3,144
414121712,184,3,2,2,191
414127452,113,49,2,2,166
414127736,169,14,30,5,218
414152360,386,3,2,1,392
414159217,47,34,2,1,84
414174099,133,52,25,17,227
414177965,10,8,2,1,21
414180503,14,3,2,1,20
414193391,10,9,2,1,22
414208602,103,33,15,6,157
414209495,113,20,2,9,144
414222079,98,3,2,1,104
414226382,164,3,2,1,170
414247197,87,3,2,1,93
414273268,57,18,2,15,92
414278735,399,8,2,50,459
414283304,86,52,72,1,211
414286229,29,27,10,1,67
414289591,235,3,2,9,249
414297528,69,15,15,4,103
414298594,60,16,2,1,79
414310799,67,26,10,6,109
414317258,24,3,2,1,30
414323658,38,44,4,1,87
414338857,14,22,2,9,47
414340804,12,3,2,1,18
414340860,11,4,2,1,18
414348004,24,22,2,2,50
414348562,122,11,3,2,138
414353107,87,33,2,1,123
414362319,39,28,47,21,135
414362708,27,24,15,2,68
414368061,89,3,2,3,97
414382916,33,58,52,2,145
414393090,158,11,2,2,173
414393154,358,84,8,8,458
414402642,118,30,31,2,181
414406555,11,3,2,2,18
414420276,144,19,2,1,166
414422896,20,3,2,1,26
414436227,46,37,20,13,116
414440439,103,66,41,8,218
414454988,224,3,2,4,233
414481100,15,4,2,3,24
414496686,13,3,2,1,19
414497676,43,3,2,3,51
414502112,66,21,29,3,119
414505026,65,85,74,4,228
414510241,23,41,2,1,67
414513217,63,48,46,16,173
414523166,73,77,19,3,172
414525008,11,3,2,2,18
414527758,59,9,35,1,104
414528073,85,19,2,5,111
414529651,88,68,24,18,198
414561793,20,46,2,1,69
414562800,25,3,2,2,32
414574077,146,10,13,3,172
414574298,48,32,2,1,83
414586839,57,3,2,1,63
414589121,80,39,4,6,129
414607677,84,26,2,1,113
414620513,52,25,46,12,135
414624233,120,3,2,1,126
414626616,108,5,17,20,150
414631665,194,3,2,1,200
414641436,79,47,114,60,300
414668111,110,71,115,80,376
414670882,160,6,34,45,245
414689142,19,28,3,1,51
414691792,110,58,24,2,194
414692220,12,13,2,1,28
414697578,162,35,55,18,270
414700948,107,51,3,1,162
414721023,10,24,23,2,59
414724433,68,12,2,1,83
414734393,43,3,2,5,53
414744373,27,3,2,1,33
414747166,46,3,2,7,58
414748136,44,24,10,9,87
414780548,58,3,2,1,64
414798515,59,33,3,8,103
414800631,12,8,2,1,23
414815447,10,14,2,1,27
414816923,172,41,7,26,246
414833946,40,8,44,3,95
414857161,11,3,2,1,17
414878667,50,29,2,3,84
414879019,49,3,2,2,56
414881875,54,3,2,4,63
414887415,355,3,2,1,361
414890764,14,3,2,1,20
414902643,57,15,2,2,76
414912461,76,3,2,1,82
414927609,112,22,2,13,149
414928565,21,3,2,2,28
414936640,11,5,2,1,19
414939200,12,5,2,1,20
414945187,13,16,2,2,33
414955585,12,3,2,1,18
414959785,129,20,2,8,159
414964880,148,12,9,5,174
414966540,80,3,2,1,86
415002739,109,87,33,6,235
415018907,106,9,11,1,127
415019042,92,30,2,1,125
415033708,12,4,2,1,19
415042537,23,9,2,1,35
415057088,93,15,60,74,242
415065314,305,3,2,7,317
415066598,121,21,43,11,196
415082836,30,3,2,1,36
415102840,64,54,9,1,128
415109392,79,40,4,3,126
415112672,10,3,2,3,18
415118270,95,73,37,8,213
415123697,118,62,89,23,292
415124318,38,3,2,1,44
415129107,11,3,2,1,17
415133953,13,11,2,1,27
415134488,38,51,2,1,92
415136496,17,30,3,2,52
415155410,10,4,2,1,17
415160842,69,3,2,1,75
415161094,50,55,2,21,128
415163662,11,3,2,1,17
415178238,10,6,2,1,19
415191676,72,32,29,19,152
415198758,118,34,51,1,204
415206757,102,3,2,9,116
415236443,51,29,35,2,117
415242139,25,3,2,3,33
415242255,11,7,2,2,22
415252096,12,3,2,1,18
415255526,13,3,2,1,19
415258148,59,28,18,2,107
415268874,104,3,2,1,110
415280441,18,35,31,2,86
415291596,48,25,18,7,98
415313760,54,7,2,1,64
415329596,16,3,2,2,23
415357467,10,14,2,1,27
415371343,135,48,7,30,220
415372872,103,3,2,2,110
415386125,12,3,2,1,18
415403117,39,26,2,1,68
415407272,13,3,2,1,19
415411118,10,6,2,1,19
415449175,22,3,2,1,28
415467487,17,3,2,1,23
415479305,99,34,7,22,162
415480227,110,5,2,14,131
415486634,24,3,2,1,30
415513030,100,10,2,3,115
415516819,87,25,33,3,148
415546107,64,54,14,8,140
415562279,96,16,5,3,120
415566145,94,13,2,1,110
415571110,78,13,4,1,96
415572568,46,59,10,6,121
415590246,44,4,2,23,73
415592346,121,3,2,11,137
415606027,13,4,2,2,21
415606428,103,3,2,2,110
415607344,11,3,2,1,17
415613394,84,14,2,1,101
415624186,43,3,2,1,49
415648656,34,10,11,1,56
415713530,72,10,8,11,101
415718498,12,3,2,1,18
415719664,46,39,2,3,90
415736143,66,25,10,1,102
415739631,72,31,2,10,115
415750495,63,32,46,4,145
415760092,83,147,37,22,289
415769972,10,3,2,2,17
415771594,98,29,2,2,131
415774939,66,21,30,26,143
415779541,57,3,2,3,65
415813325,79,5,2,24,110
415823035,67,39,4,1,111
415825058,33,10,12,21,76
415856287,87,23,2,1,113
415858627,138,15,35,2,190
415863860,17,13,2,1,33
415868325,193,8,72,98,371
415869772,68,3,2,4,77
415870910,12,3,2,1,18
415877339,71,9,25,10,115
415887926,137,19,73,2,231
415889922,85,135,32,2,254
415890677,61,7,2,1,71
415893567,11,51,2,1,65
415926306,44,3,2,1,50
415933547,17,24,3,2,46
415934062,18,3,2,1,24
415934399,32,14,7,3,56
415935907,25,68,11,7,111
415937945,28,3,2,1,34
415941637,166,3,2,1,172
415948163,49,30,12,26,117
415950189,49,49,9,3,110
415951161,34,7,2,1,44
415964092,151,16,6,9,182
415984933,93,3,2,1,99
415987394,41,31,47,1,120
415995918,24,33,2,1,60
415998243,11,5,2,1,19
416016605,48,3,2,11,64
416016991,51,3,2,1,57
416017435,13,5,2,1,21
416024040,136,27,39,13,215
416028463,54,9,35,2,100
416037112,122,7,6,61,196
416058131,10,14,2,1,27
416078434,102,8,2,4,116
416091003,260,46,15,69,390
416122591,14,3,2,1,20
416128178,20,3,2,4,29
416128333,111,27,31,3,172
416143991,11,4,2,3,20
416153180,92,47,14,12,165
416170237,113,16,36,1,166
416187630,63,13,6,3,85
416191962,18,3,2,1,24
416199109,87,65,5,22,179
416205547,13,3,2,1,19
416207289,98,3,2,1,104
416234954,87,3,2,1,93
416268916,113,39,15,6,173
416270110,158,82,29,61,330
416279095,99,3,2,2,106
416291524,12,3,2,1,18
416296309,150,53,26,1,230
416312240,94,23,2,1,120
416323418,108,3,2,1,114
416332924,19,16,2,1,38
416336774,37,3,2,17,59
416338871,73,3,2,4,82
416341058,25,3,2,2,32
416345253,13,8,2,1,24
416349416,35,22,2,1,60
416354554,24,21,2,1,48
416366512,137,3,2,1,143
416370550,59,41,7,3,110
416392942,316,26,2,7,351
416393615,119,26,2,1,148
416394638,20,3,2,1,26
416396797,148,3,2,2,155
416398300,44,12,2,36,94
416408736,58,3,2,1,64
416409744,246,39,15,42,342
416413391,120,3,30,2,155
416460594,73,3,2,4,82
416461069,55,6,29,1,91
416461861,10,5,2,1,18
416481796,71,3,17,9,100
416491878,18,39,2,7,66
416560237,208,28,3,1,240
416560354,52,16,10,15,93
416564122,11,3,2,1,17
416572623,44,30,2,3,79
416577716,14,12,2,1,29
416592809,10,4,2,1,17
416608105,151,12,4,1,168
416611858,67,3,2,12,84
416614981,72,57,23,1,153
416633051,198,34,4,5,241
416656939,155,88,43,31,317
416657473,21,3,2,1,27
416668240,27,23,19,1,70
416676819,12,3,2,1,18
416686062,36,24,19,10,89
416726693,88,3,2,1,94
416748355,123,68,5,8,204
416749437,49,4,7,1,61
416755960,32,42,2,1,77
416764637,39,4,5,3,51
416785042,286,47,30,2,365
416799741,13,4,2,4,23
416801044,54,60,38,8,160
416814116,53,3,22,1,79
416814158,31,12,2,9,54
416819082,16,13,2,1,32
416822369,41,15,2,3,61
416824506,11,5,2,1,19
416825999,79,55,42,3,179
416829073,71,46,63,2,182
416843571,195,18,2,2,217
416847388,17,3,2,1,23
416877703,51,38,21,1,111
416889312,14,3,2,1,20
416890392,138,3,2,1,144
416897190,11,10,2,1,24
416903032,40,5,31,37,113
416907709,106,25,43,8,182
416908058,131,3,2,2,138
416924153,555,3,2,3,563
416935243,116,9,59,2,186
416936616,107,32,23,9,171
416938368,26,3,2,1,32
416953453,34,40,16,2,92
416956617,70,3,2,3,78
416974901,19,7,2,1,29
416986649,14,15,2,1,32
416996144,42,6,2,2,52
417003663,18,3,2,1,24
417007729,209,5,2,1,217
417018245,41,16,46,18,121
417033526,30,37,9,15,91
417036263,155,72,30,3,260
417054779,166,4,9,1,180
417057173,56,26,33,5,120
417061493,89,20,2,3,114
417066932,14,3,2,1,20
417071650,44,3,2,1,50
417072236,80,34,3,36,153
417075974,103,16,5,5,129
417079002,63,40,43,5,151
417080481,49,22,2,5,78
417099175,23,25,7,1,56
417101258,13,3,2,1,19
417103603,55,28,6,1,90
417114414,56,17,49,2,124
417118903,91,3,2,2,98
417126737,18,15,2,4,39
417134623,122,3,2,16,143
417144891,29,23,4,1,57
417166039,252,3,2,1,258
417171360,214,73,46,11,344
417176708,159,3,2,4,168
417181310,131,3,2,6,142
417182470,12,3,2,3,20
417192139,34,83,14,5,136
417192866,73,3,2,1,79
417197242,78,32,3,11,124
417205082,14,3,2,1,20
417224226,141,3,2,5,151
417224397,30,3,2,1,36
417232208,370,3,2,1,376
417235152,70,23,61,2,156
417238733,67,24,34,29,154
417241491,74,35,2,11,122
417242512,18,3,2,1,24
417245363,16,3,2,1,22
417266227,17,9,2,1,29
417275627,30,58,4,14,106
417290256,51,3,2,1,57
417292773,111,31,20,2,164
417295321,15,3,2,2,22
417314926,100,13,17,8,138
417329603,43,39,13,21,116
417329610,197,3,2,3,205
417331465,109,10,10,2,131
417333652,723,3,2,19,747
417333864,179,53,3,6,241
417339287,56,8,27,1,92
417344489,178,3,2,1,184
417353314,56,3,2,4,65
417385731,37,24,13,3,77
417388506,24,3,2,1,30
417390029,63,43,27,20,153
417391597,20,13,5,1,39
417395516,46,9,20,17,92
417400044,113,3,2,1,119
417405647,59,47,2,7,115
417424121,80,39,61,33,213
417429207,70,56,6,33,165
417441155,103,20,2,5,130
417443705,92,38,42,54,226
417450464,13,3,2,1,19
417457208,114,35,75,5,229
417471641,10,9,2,1,22
417473517,98,24,60,4,186
417484652,74,3,2,1,80
417485176,86,25,28,6,145
417502867,92,9,25,16,142
417511231,50,3,2,1,56
417517854,24,21,16,1,62
417525374,11,3,2,1,17
417556038,101,56,2,4,163
417560293,36,27,23,19,105
417564972,27,3,2,1,33
417567374,30,24,4,12,70
417581739,11,5,2,1,19
417587823,52,3,2,2,59
417618913,25,3,2,1,31
417626738,21,12,4,10,47
417627034,56,3,2,1,62
417629756,47,3,2,5,57
417630444,173,3,42,36,254
417630985,96,9,74,7,186
417666523,77,25,6,1,109
417669060,16,12,3,1,32
417676008,80,69,111,2,262
417681388,79,13,2,1,95
417698424,11,3,2,2,18
417708589,77,3,2,1,83
417712205,45,10,2,1,58
417723206,71,9,2,12,94
417732676,27,17,2,3,49
417737852,65,28,128,1,222
417745913,74,5,6,18,103
417749370,103,6,28,1,138
417754076,119,16,23,7,165
417758819,58,12,152,1,223
417773700,16,3,2,1,22
417784723,58,3,2,1,64
417802312,260,3,2,28,293
417819319,34,33,3,27,97
417827580,38,12,8,2,60
417830435,75,19,2,1,97
417835857,103,37,90,1,231
417839447,14,3,2,1,20
417842293,86,3,2,6,97
417847141,211,9,3,5,228
417878719,31,24,10,3,68
417887380,54,15,3,5,77
417896576,29,3,2,1,35
417917164,20,3,2,1,26
417917537,22,3,2,7,34
417934345,14,3,2,1,20
417950358,56,62,2,10,130
417955398,24,3,2,1,30
417974157,34,7,20,1,62
417975036,11,3,2,1,17
417976035,73,9,26,2,110
417978078,17,3,2,1,23
417984453,42,35,3,1,81
417999445,118,3,2,16,139
418010414,14,3,2,1,20
418010553,53,4,18,1,76
418036372,28,46,2,3,79
418039435,27,3,2,1,33
418061016,79,37,30,14,160
418072597,45,25,11,8,89
418081763,12,13,2,1,28
418088392,20,51,2,1,74
418088603,20,4,2,1,27
418106872,15,31,2,1,49
418110147,80,38,2,2,122
418134839,41,56,14,9,120
418148175,27,5,2,1,35
418148291,36,59,17,12,124
418152239,107,19,2,41,169
418163538,11,3,2,1,17
418171831,58,3,2,5,68
418181766,137,34,24,1,196
418197823,10,7,2,1,20
418205848,64,24,11,5,104
418215022,92,3,2,5,102
418219609,30,19,2,30,81
418249496,48,54,75,6,183
418252700,60,12,66,5,143
418274123,104,67,2,60,233
418278306,78,11,2,1,92
418282458,37,82,62,29,210
418292831,21,3,2,1,27
418309219,80,9,2,1,92
418309870,56,34,61,38,189
418313113,14,3,2,2,21
418317291,124,48,2,1,175
418319348,11,8,2,3,24
418332616,13,5,2,1,21
418353740,16,12,4,8,40
418364738,230,44,23,19,316
418392572,250,34,4,26,314
418392893,53,172,16,4,245
418396193,185,28,32,9,254
418411935,11,3,2,1,17
418414385,101,43,46,47,237
418414684,68,21,2,3,94
418415008,108,21,2,1,132
418424596,179,3,2,1,185
418435054,82,3,2,1,88
418436480,96,12,2,2,112
418438613,106,35,51,1,193
418448346,25,20,2,1,48
418465170,77,15,25,3,120
418477437,30,3,2,9,44
418487284,93,3,2,1,99
418491163,18,3,2,2,25
418511845,146,3,2,1,152
418514748,80,35,51,7,173
418516339,33,39,7,1,80
418520799,86,3,2,2,93
418537962,37,23,2,1,63
418570477,221,8,2,2,233
418575670,47,3,2,17,69
418585220,94,3,2,80,179
418599002,35,9,19,1,64
418612859,11,3,2,1,17
418639335,61,25,2,1,89
418653007,51,29,39,56,175
418653764,142,20,4,10,176
418663865,56,20,2,3,81
418666750,50,3,2,4,59
418686354,270,23,35,9,337
418690881,85,20,31,4,140
418694699,22,36,17,5,80
418713348,97,18,2,1,118
418726078,24,61,2,1,88
418732003,32,37,2,1,72
418735260,68,37,45,1,151
418742095,54,12,2,1,69
418751097,43,46,2,1,92
418768179,56,19,9,4,88
418788531,98,26,4,30,158
418789548,62,83,47,15,207
418802307,10,6,2,1,19
418814940,93,111,84,6,294
418828358,42,19,2,2,65
418836118,10,4,2,1,17
418859808,104,21,40,1,166
418859859,94,36,11,1,142
418876915,25,97,2,3,127
418877035,72,24,4,10,110
418882463,116,15,35,27,193
418894552,60,7,2,4,73
418904051,195,71,2,1,269
418914383,43,32,2,1,78
418932741,222,3,2,16,243
418940881,220,3,2,3,228
418942100,72,20,13,8,113
418944612,100,10,2,1,113
418951632,56,12,3,1,72
418979125,78,3,2,1,84
418985084,150,55,12,5,222
418991666,18,12,2,3,35
418991997,40,31,2,3,76
418994296,16,3,2,1,22
418996406,12,3,2,21,38
418997241,103,15,18,1,137
419001802,10,3,2,12,27
419001816,90,3,2,1,96
419011182,17,3,2,1,23
419015595,27,13,2,24,66
419020856,54,13,43,2,112
419021806,75,3,2,4,84
419031831,10,4,2,1,17
419038848,34,34,51,2,121
419072029,183,4,2,9,198
419074390,38,5,31,3,77
419083927,30,32,2,10,74
419084762,63,59,83,17,222
419090304,34,17,48,3,102
419091544,69,31,17,5,122
419115713,17,3,2,1,23
419126580,88,3,3,1,95
419133677,33,21,2,3,59
419144605,82,13,3,3,101
419145363,42,3,2,1,48
419235428,12,5,2,1,20
419238242,105,5,106,8,224
419238847,135,4,8,24,171
419241303,82,26,35,5,148
419254493,18,9,2,1,30
419262060,12,3,2,5,22
419308299,74,18,8,24,124
419317926,67,37,37,36,177
419319494,30,3,2,1,36
419321568,58,18,2,4,82
419328700,121,14,8,3,146
419338622,62,48,18,32,160
419342334,52,3,2,1,58
419348594,69,42,56,11,178
419356244,14,111,2,2,129
419377258,31,3,2,1,37
419378022,35,3,2,1,41
419378028,67,3,2,1,73
419389522,157,8,2,7,174
419394965,68,3,2,2,75
419405905,182,43,37,58,320
419406927,127,29,70,1,227
419408338,20,7,2,1,30
419439434,28,33,3,7,71
419447865,66,87,33,3,189
419482626,78,3,9,1,91
419488064,33,15,24,1,73
419492332,31,31,30,2,94
419494491,23,20,4,5,52
419498502,158,34,20,16,228
419499025,41,30,14,1,86
419505840,113,3,2,6,124
419523332,14,3,2,1,20
419531522,80,105,42,17,244
419532144,43,46,66,8,163
419533887,144,25,65,3,237
419546670,406,3,2,8,419
419547259,57,40,34,12,143
419547579,46,22,2,1,71
419565098,83,45,42,32,202
419603529,21,36,9,1,67
419603724,10,39,2,1,52
419607938,11,3,2,1,17
419622515,32,43,4,2,81
419625590,15,11,2,2,30
419632691,45,12,5,1,63
419633145,82,3,2,8,95
419642010,38,3,2,1,44
419649560,43,11,13,29,96
419658971,12,5,4,5,26
419663836,12,3,2,1,18
419668297,43,3,2,1,49
419677560,101,33,42,4,180
419679865,28,45,4,15,92
419686340,44,7,58,28,137
419692555,112,3,2,1,118
419706803,58,77,15,8,158
419707411,159,28,2,9,198
419738826,60,28,2,1,91
419743073,36,35,3,1,75
419784892,105,26,19,5,155
419810729,118,36,39,2,195
419819774,55,3,2,1,61
419833753,11,3,2,1,17
419843841,75,54,5,20,154
419850445,129,18,38,5,190
419852926,98,9,2,10,119
419863477,52,22,2,1,77
419874514,66,19,4,8,97
419899329,81,28,31,3,143
419911516,107,200,2,1,310
419913240,59,18,7,4,88
419928099,97,3,2,2,104
419953600,12,12,12,7,43
419982777,21,32,3,7,63
419985042,80,13,29,34,156
420002062,84,3,2,5,94
420002483,26,34,4,3,67
420004344,60,15,2,2,79
420011867,11,31,2,1,45
420031730,15,3,2,6,26
420043015,47,17,3,3,70
420044552,159,3,3,3,168
420053499,28,3,2,1,34
420073945,91,3,2,1,97
420081600,11,3,2,1,17
420083965,48,10,21,3,82
420092803,46,3,3,2,54
420101354,308,52,5,1,366
420106983,53,8,2,1,64
420109585,46,26,128,27,227
420112848,110,20,28,1,159
420137382,16,3,2,1,22
420137569,71,3,2,2,78
420146131,704,3,2,8,717
420169369,16,3,2,5,26
420169710,67,23,3,1,94
420178980,89,40,5,30,164
420196339,13,3,2,1,19
420211129,139,29,2,9,179
420222696,200,24,14,12,250
420231321,18,3,2,1,24
420249185,75,22,5,23,125
420257698,38,21,2,1,62
420258387,80,29,21,3,133
420259500,102,19,49,13,183
420276353,23,3,2,8,36
420283308,96,5,54,3,158
420292371,80,8,2,6,96
420296452,10,3,2,3,18
420300266,63,3,4,1,71
420320580,90,3,2,1,96
420324461,34,9,27,1,71
420340709,10,3,2,3,18
420344112,47,20,24,1,92
420344642,49,8,36,7,100
420349485,24,3,2,1,30
420353340,38,40,8,5,91
420356955,160,64,2,6,232
420357749,63,24,24,7,118
420364198,158,3,2,2,165
420368294,87,3,2,2,94
420370402,13,5,2,1,21
420377912,40,8,4,2,54
420398107,31,12,5,2,50
420406790,12,3,2,1,18
420419185,119,14,2,1,136
420426733,45,24,31,13,113
420429526,56,60,2,5,123
420445793,100,40,2,9,151
420454226,74,16,2,1,93
420459388,19,3,2,3,27
420465213,23,28,9,8,68
420466426,22,41,3,8,74
420468853,101,54,28,12,195
420469844,124,8,9,1,142
420478970,118,41,87,45,291
420479340,154,29,2,5,190
420488679,84,24,54,2,164
420495950,17,3,2,1,23
420499047,11,3,2,1,17
420529099,45,32,26,4,107
420543020,60,11,13,9,93
420547632,827,3,2,19,851
420557588,100,16,18,4,138
420562054,19,5,2,1,27
420562299,209,11,64,15,299
420569099,74,15,41,17,147
420569391,39,47,2,3,91
420593280,138,26,42,12,218
420604478,73,3,2,1,79
420608958,10,3,2,2,17
420609655,11,3,2,1,17
420611613,35,25,2,1,63
420613007,101,77,3,2,183
420619669,17,11,2,1,31
420623346,79,3,2,1,85
420645532,72,5,2,4,83
420655738,39,3,2,1,45
420706810,11,8,9,2,30
420707587,104,12,33,4,153
420710978,135,9,2,1,147
420742572,124,19,6,1,150
420746111,146,16,14,28,204
420761104,30,3,2,5,40
420764698,32,3,2,1,38
420767059,34,32,14,15,95
420799295,70,22,5,1,98
420808140,13,5,2,1,21
420808545,107,40,2,30,179
420808586,12,3,2,1,18
420813519,16,10,2,13,41
420830263,156,3,2,5,166
420852555,87,37,3,2,129
420867150,76,26,5,5,112
420869094,64,13,3,1,81
420870908,61,14,2,1,78
420873245,28,3,2,9,42
420885210,13,3,2,1,19
420903782,13,3,2,1,19
420909791,168,31,34,61,294
420923609,11,10,4,3,28
420925904,15,32,11,1,59
420936539,110,33,2,1,146
420936880,53,25,2,2,82
420940150,151,19,2,3,175
420953437,58,70,28,7,163
420955160,54,38,35,20,147
420964372,86,3,2,6,97
420971089,16,3,2,1,22
420981638,90,3,2,8,103
420993249,46,26,2,11,85
420998520,64,12,2,7,85
421005109,12,3,2,2,19
421011410,53,14,40,50,157
421019314,88,3,2,1,94
421021234,37,15,3,2,57
421049358,152,3,2,2,159
421067964,75,33,15,15,138
421069855,11,4,2,2,19
421105170,68,40,3,3,114
421107803,55,15,5,12,87
421123098,82,7,13,1,103
421125298,12,3,2,1,18
421136453,20,5,2,1,28
421136782,68,24,64,9,165
421151049,220,31,10,76,337
421154690,81,47,94,6,228
421157391,112,8,2,5,127
421158819,30,25,26,1,82
421161220,40,3,2,1,46
421167636,81,3,2,1,87
421182030,84,3,2,1,90
421204853,132,33,42,1,208
421228689,70,38,2,2,112
421246023,120,17,10,9,156
421248271,69,13,2,8,92
421254746,79,23,75,3,180
421259229,16,3,2,1,22
421260739,36,4,2,3,45
421265904,10,4,2,1,17
421293347,254,3,2,52,311
421307032,45,9,8,18,80
421321706,35,9,10,1,55
421325811,78,40,2,1,121
421332128,25,3,2,1,31
421340720,76,54,3,2,135
421345225,22,3,2,1,28
421348997,123,28,2,22,175
421352897,28,8,2,5,43
421356586,74,3,2,6,85
421363407,71,31,2,1,105
421370746,57,6,14,5,82
421372533,52,28,2,4,86
421372643,61,77,3,7,148
421398856,123,7,4,2,136
421400144,28,14,2,1,45
421403765,10,9,2,5,26
421410327,74,15,32,65,186
421416670,64,5,2,2,73
421417682,12,3,2,1,18
421418179,57,16,13,3,89
421422712,24,4,2,1,31
421445866,14,68,8,1,91
421449755,142,46,28,20,236
421466257,66,18,19,12,115
421470996,101,13,2,10,126
421472760,50,16,2,1,69
421480708,84,30,8,50,172
421481949,65,31,5,7,108
421487797,55,3,2,1,61
421489266,61,37,3,2,103
421501468,12,3,2,1,18
421520866,13,3,2,1,19
421521544,12,28,2,1,43
421534560,48,27,2,17,94
421544454,26,55,4,2,87
421544623,13,4,2,1,20
421553835,36,53,7,3,99
421558036,23,3,2,1,29
421559604,26,3,2,1,32
421572822,14,4,2,1,21
421587405,58,39,43,6,146
421594941,196,14,2,52,264
421596418,45,21,3,3,72
421603017,128,50,4,6,188
421633319,37,17,2,12,68
421649860,72,3,2,1,78
421672291,20,31,2,4,57
421710204,76,24,58,4,162
421724354,48,16,24,24,112
421737800,145,3,2,1,151
421744260,140,67,2,1,210
421746367,83,5,2,3,93
421754732,56,25,9,34,124
421762376,133,35,41,4,213
421768216,23,29,32,34,118
421785708,97,14,61,1,173
421789549,18,39,2,4,63
421789970,18,49,3,1,71
421795762,32,11,2,1,46
421811452,183,3,2,1,189
421823255,69,3,2,8,82
421834774,47,46,21,85,199
421842927,99,61,2,1,163
421843171,71,14,6,12,103
421864622,76,28,44,1,149
421892494,156,3,2,1,162
421898576,11,3,2,1,17
421902865,158,10,2,16,186
421919156,12,34,12,2,60
421922335,97,47,68,3,215
421924095,56,38,5,3,102
421924936,154,8,29,1,192
421936688,173,3,73,1,250
421938109,86,16,3,1,106
421948258,22,11,2,1,36
421960725,272,3,2,2,279
421963452,57,3,2,1,63
421967234,45,3,2,33,83
421982695,12,3,2,1,18
422009624,146,13,19,1,179
422022476,43,19,44,16,122
422025153,180,3,2,6,191
422029339,11,3,2,1,17
422031298,95,18,12,4,129
422035795,87,14,48,7,156
422046021,16,9,3,3,31
422050115,70,37,25,1,133
422053073,48,17,2,2,69
422056178,48,11,2,8,69
422073777,105,14,17,4,140
422083210,67,24,114,50,255
422098705,55,43,3,5,106
422101865,59,3,2,5,69
422102194,96,4,2,1,103
422115237,15,3,2,1,21
422119672,136,77,48,12,273
422134858,100,3,2,2,107
422134936,20,3,2,6,31
422135277,11,3,2,1,17
422147063,27,3,2,1,33
422170065,112,18,2,13,145
422177348,39,68,34,6,147
422180660,12,9,2,1,24
422192328,41,15,2,12,70
422193278,64,8,2,2,76
422196884,13,3,2,1,19
422197543,11,3,2,1,17
422200456,46,3,2,1,52
422200774,70,10,2,1,83
422206612,23,13,2,1,39
422212742,118,3,2,4,127
422217447,146,3,2,2,153
422222420,59,31,14,1,105
422253195,223,18,24,7,272
422259445,151,3,2,1,157
422262124,12,12,2,1,27
422269609,47,16,2,1,66
422282428,62,3,2,1,68
422290754,55,15,63,2,135
422295292,40,22,2,17,81
422298426,185,3,2,1,191
422315625,15,57,2,3,77
422330446,14,5,2,3,24
422331948,66,63,52,1,182
422334607,128,14,109,1,252
422346429,96,3,2,6,107
422348692,11,3,2,1,17
422359066,20,27,2,5,54
422363510,92,19,28,5,144
422372127,33,3,2,1,39
422377362,93,22,2,5,122
422395354,84,3,2,1,90
422397602,45,55,14,19,133
422407029,29,3,2,1,35
422407846,14,3,2,1,20
422413474,163,17,2,3,185
422438575,23,41,2,1,67
422439682,83,3,2,1,89
422456928,41,25,2,1,69
422457995,11,3,2,1,17
422474439,33,23,12,1,69
422482999,85,62,6,1,154
422500803,28,16,2,1,47
422502365,46,6,5,20,77
422510408,57,27,3,3,90
422512248,68,16,2,8,94
422525776,196,3,2,8,209
422531896,108,5,13,1,127
422540390,46,10,2,4,62
422541443,61,20,2,4,87
422549695,68,16,7,1,92
422555741,12,3,2,1,18
422564003,106,3,2,11,122
422571094,222,52,4,21,299
422581027,11,5,2,1,19
422606051,51,11,2,1,65
422608894,55,28,22,2,107
422611081,10,3,2,2,17
422612732,56,13,38,30,137
422632040,84,3,2,1,90
422646909,95,13,121,6,235
422672000,127,65,7,2,201
422688053,108,3,2,1,114
422690785,589,3,2,6,600
422714965,39,18,40,11,108
422715656,19,7,2,1,29
422716733,48,6,2,3,59
422723786,16,10,2,3,31
422724909,60,3,2,3,68
422744072,142,14,5,6,167
422758103,99,32,12,28,171
422767824,44,36,20,1,101
422770773,53,3,2,41,99
422771001,76,14,45,2,137
422777226,79,3,2,1,85
422783716,190,39,8,55,292
422786896,70,10,26,6,112
422793969,53,63,39,7,162
422795133,38,14,6,22,80
422800449,58,16,3,13,90
422823492,36,6,2,1,45
422824754,33,3,2,3,41
422826695,19,11,2,1,33
422832305,70,21,126,3,220
422841737,43,3,2,1,49
422856396,58,8,13,1,80
422859736,20,10,2,1,33
422870278,146,3,2,67,218
422882354,15,3,2,1,21
422884064,43,3,2,1,49
422885777,87,3,2,11,103
422893299,14,45,9,1,69
422896802,52,9,2,1,64
422910035,17,17,2,10,46
422941923,165,33,44,28,270
422966718,15,84,2,2,103
422968568,12,27,3,1,43
422975450,191,3,2,30,226
422986113,182,3,2,14,201
423014547,25,8,2,5,40
423015368,22,13,2,1,38
423051899,39,24,65,7,135
423089300,18,4,2,1,25
423108077,63,44,2,2,111
423121124,11,3,2,1,17
423122762,185,3,2,7,197
423131459,32,26,4,4,66
423141356,55,33,17,7,112
423146654,12,12,2,1,27
423148942,153,3,2,9,167
423153670,36,3,2,1,42
423157938,19,6,2,1,28
423161159,21,17,2,1,41
423169537,31,3,2,1,37
423170457,38,23,4,7,72
423177090,130,80,3,6,219
423187320,137,53,40,19,249
423198623,37,3,2,1,43
423220893,29,51,35,4,119
423223817,127,48,68,8,251
423228485,119,16,2,11,148
423241550,34,42,2,1,79
423253468,19,3,2,6,30
423254961,25,4,2,3,34
423255154,138,12,2,18,170
423261065,121,38,27,4,190
423265725,82,14,2,4,102
423272933,67,29,6,1,103
423281328,62,35,18,1,116
423285348,27,25,31,5,88
423286569,17,3,2,1,23
423319898,29,5,4,8,46
423326608,31,19,6,7,63
423338412,150,18,29,7,204
423338617,46,22,5,9,82
423342302,158,33,3,4,198
423344042,22,3,2,1,28
423355591,120,25,3,18,166
423363042,45,22,35,2,104
423365050,66,22,7,9,104
423375522,64,22,2,2,90
423375800,25,3,2,1,31
423385098,66,7,2,5,80
423413551,17,3,2,1,23
423416185,71,50,45,5,171
423418887,52,37,2,1,92
423428890,170,21,142,1,334
423437262,22,10,30,4,66
423439230,106,17,2,14,139
423442695,38,47,15,4,104
423452633,210,20,2,1,233
423453562,16,3,2,1,22
423454127,64,27,4,17,112
423455981,67,19,2,14,102
423458872,128,4,53,1,186
423459838,89,3,2,1,95
423465610,56,42,10,12,120
423471619,144,10,2,3,159
423474371,17,29,2,1,49
423499053,18,3,2,1,24
423540268,171,49,2,8,230
423545700,127,20,41,23,211
423553785,12,3,2,1,18
423583043,110,12,2,1,125
423584406,29,3,2,14,48
423602865,60,25,24,2,111
423606031,11,3,2,1,17
423618091,67,15,6,41,129
423636223,77,59,54,15,205
423641821,11,7,2,1,21
423654644,17,25,3,1,46
423663992,12,24,2,2,40
423668670,20,8,16,1,45
423681262,91,23,20,34,168
423683779,37,51,26,1,115
423685661,89,11,2,1,103
423715272,103,50,17,11,181
423715958,102,16,2,1,121
423717324,41,23,30,1,95
423728802,40,28,39,1,108
423747077,11,3,2,2,18
423747151,35,3,2,2,42
423766515,132,54,31,2,219
423767732,150,26,19,10,205
423776715,72,70,22,2,166
423797034,17,11,2,1,31
423799596,63,15,8,1,87
423823583,81,5,2,9,97
423828476,207,15,53,1,276
423829044,11,3,2,1,17
423852530,84,5,17,65,171
423855593,20,17,7,1,45
423857257,68,11,2,1,82
423858722,130,56,38,22,246
423870697,10,3,2,2,17
423878520,45,3,2,2,52
423883287,37,15,34,2,88
423894582,12,3,2,1,18
423902430,21,9,2,2,34
423903685,127,9,96,8,240
423906005,82,3,2,4,91
423910302,91,26,30,13,160
423933578,25,13,2,1,41
423934210,89,3,2,4,98
423936985,108,51,9,5,173
423950533,24,11,4,4,43
423955430,77,3,2,1,83
423976392,45,38,3,1,87
423976985,60,50,15,9,134
423999488,131,4,4,1,140
424020930,33,30,6,1,70
424024180,79,3,2,2,86
424024277,133,3,2,1,139
424028490,124,48,10,46,228
424030286,16,5,4,3,28
424031309,112,35,98,8,253
424039593,37,22,13,4,76
424046880,64,3,2,1,70
424048439,47,3,2,1,53
424063685,198,3,2,11,214
424065740,18,3,33,1,55
424076622,20,3,2,2,27
424080795,53,32,2,1,88
424083681,69,8,9,1,87
424086957,30,3,2,1,36
424093805,10,3,2,2,17
424098074,95,17,2,2,116
424101110,161,3,2,4,170
424149945,40,33,24,44,141
424162078,33,39,3,2,77
424176864,37,28,2,1,68
424178150,15,6,2,1,24
424198883,88,20,40,5,153
424204269,51,3,2,2,58
424212686,34,66,3,9,112
424214686,107,3,2,1,113
424228136,158,40,2,1,201
424231869,99,28,9,5,141
424231908,40,3,2,1,46
424239020,113,7,2,4,126
424245245,474,3,2,7,486
424253273,83,14,14,30,141
424254448,49,42,2,4,97
424263451,98,28,13,15,154
424275166,15,3,2,2,22
424278926,73,11,15,4,103
424294604,14,9,3,1,27
424304108,12,3,2,1,18
424304579,58,3,2,2,65
424306893,40,21,2,18,81
424318407,46,29,19,5,99
424336492,19,3,2,1,25
424336712,153,3,2,3,161
424337281,28,59,4,10,101
424344279,78,11,2,7,98
424347261,77,20,15,27,139
424354167,110,18,3,1,132
424368973,105,144,2,10,261
424386568,21,40,17,1,79
424396957,97,17,2,2,118
424408075,65,145,27,26,263
424411251,23,3,2,1,29
424438008,38,12,9,2,61
424445282,67,3,2,1,73
424456034,34,3,2,1,40
424456934,55,50,43,30,178
424457119,147,45,10,3,205
424467586,16,3,2,1,22
424468035,68,25,2,2,97
424482604,37,85,2,1,125
424484128,14,8,2,1,25
424497095,40,13,2,1,56
424528255,69,60,2,2,133
424532102,16,21,2,4,43
424542222,71,9,2,11,93
424560369,16,3,2,1,22
424572287,217,140,2,3,362
424589405,16,38,7,3,64
424594911,19,7,2,1,29
424610705,42,60,20,6,128
424617364,15,5,2,1,23
424621584,75,6,23,1,105
424624452,74,3,2,2,81
424625911,10,4,2,1,17
424651161,121,3,2,3,129
424686864,70,24,2,6,102
424694591,85,8,32,82,207
424700249,34,36,2,1,73
424704828,92,41,92,3,228
424713219,85,14,21,1,121
424729582,129,3,2,7,141
424735616,70,8,2,2,82
424743200,268,129,14,120,531
424755875,71,14,14,1,100
424765826,83,27,37,1,148
424772063,17,3,2,1,23
424774345,100,28,13,1,142
424790029,11,3,2,1,17
424798119,80,15,44,5,144
424808216,19,15,10,11,55
424812009,55,17,10,1,83
424817920,145,3,2,4,154
424823098,12,23,2,1,38
424828442,13,3,2,1,19
424832013,23,13,3,1,40
424836070,29,3,2,5,39
424839797,39,4,2,8,53
424847233,27,66,2,1,96
424850207,16,3,2,1,22
424860942,82,3,2,10,97
424877342,10,5,2,1,18
424879316,105,3,2,1,111
424881637,34,19,8,1,62
424901196,47,48,20,1,116
424920081,75,3,2,1,81
424921104,54,23,34,1,112
424926982,54,27,15,3,99
424930052,21,13,2,1,37
424930490,17,7,2,1,27
424942394,177,3,2,4,186
424942785,29,33,2,1,65
424957571,12,3,2,1,18
424965912,28,3,2,1,34
424972939,177,14,16,4,211
424975322,79,34,22,10,145
424981157,45,26,32,7,110
424982763,64,3,2,1,70
424992829,11,3,2,1,17
424999776,85,3,2,1,91
425001599,95,46,3,24,168
425013992,24,3,2,1,30
425017944,63,3,2,1,69
425022491,21,3,2,1,27
425040209,83,3,2,1,89
425044633,14,3,2,1,20
425049047,38,3,2,1,44
425055245,17,7,3,1,28
425057173,73,42,9,1,125
425061188,90,3,2,1,96
425065094,60,3,51,20,134
425066097,25,13,2,1,41
425069334,121,15,2,4,142
425114934,31,31,2,1,65
425117434,63,3,2,1,69
425120702,61,10,2,1,74
425124053,77,24,28,1,130
425140868,76,15,76,3,170
425145468,142,25,58,14,239
425157356,59,7,2,17,85
425161156,73,15,2,1,91
425171427,13,3,2,1,19
425173723,104,43,41,58,246
425209035,55,3,2,2,62
425215628,46,13,10,4,73
425227322,90,35,10,1,136
425244320,173,3,2,4,182
425244998,10,27,2,1,40
425249391,44,12,2,2,60
425293174,106,7,2,1,116
425295788,15,3,2,5,25
425303793,38,3,2,2,45
425304955,15,3,2,1,21
425315740,19,38,2,1,60
425323621,10,3,2,4,19
425343974,17,13,6,1,37
425346355,162,15,2,4,183
425355552,40,3,2,2,47
425359474,34,8,2,8,52
425369451,209,26,2,13,250
425376576,55,45,5,4,109
425383653,23,46,13,4,86
425391811,22,3,2,1,28
425399341,18,7,2,1,28
425403585,58,18,14,1,91
425409778,115,3,2,1,121
425417256,107,32,22,1,162
425419187,103,12,2,5,122
425448093,53,24,9,4,90
425448366,124,36,2,20,182
425459218,25,3,2,1,31
425464773,231,56,20,50,357
425467724,78,33,40,23,174
425489362,85,26,2,4,117
425490827,53,35,2,7,97
425490924,97,33,58,14,202
425512648,36,3,2,1,42
425513204,88,73,2,4,167
425515749,37,25,11,12,85
425525842,145,67,20,2,234
425529334,115,59,10,32,216
425534332,19,46,2,3,70
425538556,62,56,72,8,198
425541566,31,44,2,17,94
425544278,64,50,62,8,184
425550319,30,27,10,1,68
425557820,24,89,36,1,150
425598731,12,3,2,2,19
425613137,25,34,51,1,111
425615348,114,12,2,5,133
425630427,92,20,60,12,184
425631872,99,37,3,5,144
425635548,60,3,2,32,97
425638392,17,4,2,21,44
425651382,15,3,3,1,22
425659451,36,24,10,4,74
425659626,95,11,51,64,221
425671899,30,23,2,1,56
425672181,79,41,2,2,124
425682366,80,7,2,5,94
425688524,37,3,2,6,48
425727388,15,3,2,1,21
425728687,15,3,2,1,21
425731367,122,12,38,1,173
425752411,65,14,2,1,82
425762640,108,13,16,4,141
425768838,27,3,2,1,33
425769218,11,3,2,1,17
425770901,209,22,101,14,346
425776376,13,20,2,5,40
425777288,78,32,89,17,216
425777368,147,67,15,4,233
425784379,110,6,2,7,125
425785785,94,3,14,1,112
425799860,106,3,2,1,112
425829950,75,3,4,2,84
425841151,74,3,2,1,80
425841389,47,28,2,1,78
425842717,101,3,2,1,107
425843282,62,3,2,2,69
425849095,51,5,2,2,60
425851913,77,29,28,2,136
425874486,158,4,9,1,172
425874776,50,67,12,7,136
425874930,69,7,2,5,83
425879211,39,121,30,1,191
425881599,50,4,2,14,70
425884037,72,11,2,2,87
425908371,124,47,2,2,175
425909902,62,4,14,1,81
425918285,88,3,2,1,94
425942294,70,30,29,16,145
425961390,37,34,21,10,102
425970163,39,45,15,7,106
425978734,103,51,27,2,183
426003745,39,3,2,1,45
426009530,29,82,21,5,137
426010085,15,25,2,1,43
426012241,29,8,2,4,43
426031061,93,22,19,7,141
426035475,42,6,36,1,85
426070248,16,3,2,1,22
426079086,11,3,2,1,17
426085580,187,3,2,2,194
426098009,57,3,2,1,63
426108785,117,3,2,1,123
426108918,141,3,2,2,148
426115222,14,3,2,1,20
426119180,36,83,2,1,122
426123139,18,15,2,1,36
426125435,116,3,2,2,123
426133244,41,27,14,28,110
426155442,23,70,16,2,111
426157574,73,20,19,15,127
426169509,99,68,9,1,177
426171349,13,12,2,1,28
426195410,35,3,2,2,42
426204147,56,8,2,1,67
426207673,59,32,26,1,118
426214069,112,19,31,8,170
426222669,56,47,32,13,148
426223487,268,3,2,6,279
426276400,119,3,2,1,125
426296504,38,3,2,1,44
426299681,91,32,65,37,225
426301220,74,8,2,7,91
426311864,21,14,2,1,38
426312401,98,37,45,38,218
426323347,48,3,2,32,85
426327300,30,25,2,1,58
426346122,45,3,4,2,54
426360153,100,3,2,1,106
426380488,68,28,53,1,150
426382146,33,3,2,2,40
426382616,15,3,2,1,21
426392901,52,25,25,1,103
426396123,207,23,39,3,272
426414185,35,16,2,2,55
426418876,107,35,23,1,166
426421015,142,65,23,3,233
426427144,69,57,4,2,132
426436148,116,27,30,10,183
426439111,16,33,28,2,79
426467430,33,27,3,1,64
426473616,52,4,2,1,59
426480529,52,27,23,10,112
426482409,159,3,2,1,165
426499295,42,4,2,2,50
426512573,22,22,2,4,50
426518968,98,22,2,20,142
426522289,90,48,8,2,148
426526820,25,3,2,1,31
426544022,11,5,2,2,20
426554261,10,9,3,1,23
426560973,69,3,2,1,75
426588262,92,27,9,8,136
426591785,20,3,2,1,26
426616435,47,3,2,6,58
426619185,79,55,49,19,202
426623113,139,31,22,5,197
426640582,55,3,2,1,61
426642799,13,3,2,1,19
426652346,96,36,43,26,201
426654642,22,22,9,2,55
426657605,74,3,2,1,80
426658476,62,41,19,3,125
426673469,82,13,32,59,186
426674964,60,44,56,1,161
426686120,14,3,2,1,20
426692871,17,3,2,3,25
426696776,10,3,2,3,18
426699143,27,3,2,42,74
426702905,11,3,2,1,17
426703123,12,12,2,3,29
426706898,13,5,2,1,21
426721503,15,9,2,1,27
426725864,52,3,2,1,58
426731687,58,10,2,1,71
426739695,109,10,2,8,129
426753729,49,20,2,5,76
426765755,95,13,2,5,115
426795381,18,18,2,4,42
426798682,22,3,2,1,28
426798697,43,8,17,1,69
426805995,58,3,2,5,68
426818349,11,4,2,1,18
426830995,62,17,13,13,105
426846211,43,3,2,10,58
426873157,107,8,8,33,156
426873249,56,10,2,14,82
426873853,62,3,2,21,88
426874185,10,3,2,4,19
426904034,16,67,17,36,136
426917914,51,18,2,1,72
426925590,78,3,14,1,96
426939969,20,17,4,1,42
426941514,22,7,2,3,34
426945866,64,3,14,1,82
426949794,53,16,3,10,82
426953898,64,3,15,1,83
426963389,184,61,42,5,292
426964498,26,6,18,1,51
426966279,21,32,11,1,65
426976377,42,3,2,1,48
426980794,58,22,28,1,109
426983767,71,3,2,50,126
426984509,47,3,2,1,53
427008584,57,18,19,10,104
427012917,62,20,2,8,92
427018814,77,28,71,15,191
427026182,10,3,2,6,21
427033797,19,3,2,1,25
427035701,128,22,63,11,224
427037389,15,15,3,3,36
427052005,15,3,2,1,21
427058218,28,42,2,1,73
427059507,69,3,2,2,76
427065056,205,7,39,3,254
427067779,14,6,2,2,24
427068201,11,8,6,1,26
427074070,11,9,2,1,23
427080521,86,31,138,1,256
427081013,16,7,2,8,33
427082065,24,25,2,5,56
427115512,24,64,2,34,124
427117598,18,38,2,1,59
427163752,62,42,2,14,120
427169873,48,3,2,2,55
427212218,85,37,13,12,147
427212650,74,8,3,2,87
427212804,10,3,2,3,18
427218180,17,21,2,1,41
427226433,11,3,2,1,17
427228733,74,15,15,45,149
427229368,94,52,2,3,151
427236454,66,3,2,5,76
427253341,119,5,2,4,130
427268054,92,3,2,2,99
427287637,18,3,2,2,25
427323690,112,17,46,1,176
427328850,14,22,2,4,42
427344076,105,3,2,7,117
427349626,50,51,3,7,111
427362392,29,34,36,1,100
427415023,48,30,2,1,81
427422981,13,3,2,1,19
427456793,114,3,3,1,121
427458388,12,17,2,1,32
427488845,117,21,30,3,171
427506251,139,37,2,1,179
427506466,15,3,2,2,22
427508955,20,3,2,4,29
427521128,73,26,17,8,124
427526435,209,19,2,9,239
427529555,18,13,5,2,38
427535044,18,3,2,1,24
427536241,21,6,3,1,31
427572201,10,30,2,1,43
427576297,31,3,3,4,41
427580211,19,3,2,10,34
427590120,89,28,40,1,158
427601039,63,50,50,11,174
427604153,26,5,2,2,35
427606986,125,51,4,31,211
427621737,19,3,9,2,33
427639873,77,16,27,19,139
427663070,67,30,2,3,102
427663655,51,3,2,2,58
427676450,81,3,2,14,100
427677905,70,3,2,1,76
427700031,67,3,2,1,73
427707442,21,3,2,1,27
427733922,117,47,9,1,174
427750662,111,11,60,58,240
427750756,73,3,2,2,80
427751392,76,3,2,3,84
427770046,24,12,3,3,42
427773169,100,41,2,2,145
427799609,24,3,2,36,65
427804877,99,24,3,8,134
427804987,33,14,18,7,72
427811987,121,102,59,5,287
427812015,95,25,3,22,145
427827591,20,3,2,2,27
427857757,23,12,2,2,39
427857996,77,20,42,2,141
427868328,41,23,30,12,106
427890962,11,31,2,1,45
427900780,10,16,3,1,30
427900996,124,60,14,7,205
427902390,14,3,2,3,22
427908811,10,10,2,1,23
427911355,11,3,2,1,17
427919559,33,54,12,9,108
427929078,85,33,15,7,140
427952395,50,3,2,1,56
427958372,19,26,2,18,65
427958997,58,44,16,20,138
427961141,235,13,2,6,256
427965324,123,42,14,18,197
427965732,74,3,2,1,80
427971347,65,11,2,1,79
427992742,11,3,2,1,17
427995205,47,39,26,1,113
427997583,75,15,4,1,95
428002743,35,40,5,1,81
428012411,49,3,2,1,55
428024978,37,151,2,3,193
428032271,16,3,2,1,22
428038119,93,4,2,9,108
428039520,10,24,2,1,37
428079854,92,4,5,1,102
428087070,73,36,2,14,125
428096435,59,3,2,1,65
428103036,144,3,2,8,157
428105017,85,53,7,20,165
428106389,14,16,2,1,33
428108717,83,3,2,1,89
428155721,45,11,2,15,73
428157970,40,34,3,2,79
428164755,114,3,2,1,120
428169119,36,44,89,28,197
428180327,63,16,2,10,91
428183154,161,45,35,3,244
428192878,151,37,3,1,192
428196038,49,10,2,10,71
428199209,52,20,2,5,79
428203059,108,31,5,4,148
428203632,166,3,2,13,184
428208558,69,3,2,14,88
428218727,20,3,2,1,26
428227942,121,12,2,8,143
428236157,29,32,19,3,83
428264943,150,18,50,3,221
428274162,35,15,2,1,53
428293657,178,13,5,3,199
428296530,61,31,48,7,147
428300957,25,3,2,1,31
428311549,37,13,13,2,65
428312628,57,50,7,7,121
428313771,75,92,46,14,227
428319235,38,7,2,1,48
428328514,201,79,2,8,290
428329857,129,3,2,47,181
428351596,42,3,2,10,57
428362288,68,3,2,1,74
428364156,101,4,6,7,118
428389230,10,3,2,3,18
428404195,89,3,2,1,95
428404983,12,3,2,1,18
428412904,115,3,2,1,121
428414311,91,12,2,1,106
428416527,12,3,2,1,18
428422197,57,7,3,2,69
428438347,67,3,2,8,80
428453949,125,3,5,1,134
428457603,67,3,2,1,73
428458895,65,3,2,1,71
428469408,11,5,2,1,19
428524730,72,70,50,10,202
428532129,268,153,71,46,538
428545800,34,3,11,4,52
428552481,87,5,19,1,112
428560182,25,3,2,1,31
428570136,99,37,11,3,150
428577222,122,49,69,22,262
428577422,23,23,2,1,49
428578306,20,36,2,1,59
428595490,189,16,31,9,245
428599425,30,3,2,7,42
428617133,60,3,2,6,71
428632293,71,89,4,2,166
428640683,120,70,75,31,296
428654332,79,38,24,29,170
428658134,147,6,5,1,159
428663708,81,3,2,1,87
428676469,15,3,2,1,21
428676919,68,5,2,22,97
428681546,121,3,2,1,127
428687428,40,3,2,1,46
428689135,90,51,25,17,183
428703980,125,4,25,16,170
428709373,93,44,16,6,159
428711770,11,3,2,1,17
428715810,110,4,35,12,161
428732271,69,57,3,6,135
428743354,12,3,2,1,18
428749264,19,38,2,1,60
428774807,29,23,2,1,55
428780205,12,17,29,7,65
428796022,39,7,2,6,54
428808851,116,3,2,1,122
428811216,11,3,2,1,17
428818468,96,76,35,4,211
428821185,100,3,2,6,111
428826544,23,23,2,2,50
428832733,87,54,35,8,184
428836228,13,3,2,2,20
428844623,12,5,2,7,26
428849794,10,15,5,1,31
428854285,51,41,3,6,101
428864638,48,24,6,13,91
428881709,117,51,2,10,180
428881754,36,3,2,4,45
428884148,43,8,7,1,59
428906048,13,3,2,4,22
428945650,43,43,9,3,98
428945719,13,3,2,1,19
428962992,72,9,22,14,117
428970584,75,21,3,1,100
428981208,17,3,2,1,23
428991524,69,3,2,1,75
428996464,24,11,2,1,38
429008333,13,3,2,1,19
429010651,59,18,107,1,185
429023870,28,26,2,2,58
429033410,12,3,2,1,18
429035985,80,75,9,7,171
429036219,36,44,32,29,141
429038568,52,10,39,6,107
429038749,26,4,2,9,41
429064268,14,9,10,1,34
429075225,44,38,112,1,195
429116250,113,16,2,12,143
429120905,92,36,11,7,146
429139104,136,10,23,28,197
429143072,90,41,17,7,155
429156797,10,6,2,1,19
429173478,12,24,2,1,39
429175234,82,32,49,2,165
429192215,46,3,2,1,52
429198706,34,80,8,2,124
429202996,134,3,2,8,147
429234629,192,17,2,1,212
429238401,64,25,29,1,119
429239270,178,37,26,1,242
429240858,18,10,2,1,31
429250519,10,11,13,1,35
429267369,49,37,33,1,120
429281804,38,16,68,4,126
429299007,14,13,11,4,42
429302076,61,5,2,2,70
429313677,10,18,2,1,31
429315439,54,27,22,2,105
429321671,138,9,9,16,172
429324325,25,7,2,1,35
429349169,58,3,2,3,66
429351113,107,13,2,4,126
429360715,99,3,2,1,105
429365962,49,10,16,1,76
429372245,81,5,2,3,91
429375836,50,3,2,1,56
429384712,77,21,43,5,146
429390699,18,43,19,1,81
429391653,43,12,3,1,59
429391811,70,8,2,4,84
429411557,51,3,2,1,57
429420570,83,22,78,2,185
429427292,154,35,55,104,348
429435483,67,44,15,13,139
429438834,55,74,2,5,136
429449085,202,19,17,19,257
429457776,70,12,15,2,99
429460588,154,3,2,1,160
429462074,10,4,2,1,17
429478438,196,3,2,15,216
429478996,13,3,2,1,19
429487448,43,13,2,18,76
429495616,14,3,2,1,20
429508412,68,3,2,1,74
429520675,49,21,3,4,77
429535753,28,3,2,1,34
429541719,36,16,10,2,64
429546589,75,3,2,1,81
429561112,10,35,2,1,48
429582785,19,3,2,1,25
429589691,20,10,9,5,44
429597190,107,3,34,13,157
429601862,20,7,7,4,38
429603415,11,25,2,1,39
429617341,61,25,3,1,90
429617482,62,24,5,13,104
429618893,23,8,13,1,45
429621304,37,20,2,1,60
429626913,27,38,72,1,138
429627778,38,35,26,29,128
429640833,43,45,16,25,129
429654614,75,3,2,1,81
429662592,21,35,34,12,102
429664723,30,39,22,8,99
429672927,18,7,3,1,29
429678269,12,3,2,1,18
429685719,61,8,18,9,96
429697913,45,46,10,21,122
429721750,20,3,2,3,28
429733220,31,3,2,1,37
429748208,23,3,2,1,29
429749389,157,69,2,5,233
429752567,141,20,6,13,180
429785291,35,58,23,2,118
429793774,48,42,8,42,140
429801682,118,26,2,8,154
429805947,10,4,2,1,17
429807369,265,10,71,8,354
429839868,63,3,2,2,70
429843842,61,30,3,2,96
429854674,68,17,2,3,90
429859305,17,25,2,1,45
429868861,90,3,2,2,97
429872852,19,10,4,3,36
429877065,53,12,2,9,76
429879522,42,4,2,1,49
429879605,31,3,2,1,37
429884304,52,3,2,2,59
429928854,11,3,2,1,17
429948648,12,3,2,1,18
429953593,13,12,3,1,29
429962733,306,40,2,7,355
429997008,10,5,2,5,22
430026295,50,3,2,24,79
430027531,22,10,2,1,35
430036379,136,32,4,4,176
430043885,28,31,19,11,89
430045979,13,3,2,1,19
430055398,23,13,2,1,39
430057289,161,30,30,4,225
430064110,51,18,8,10,87
430115253,39,8,2,1,50
430120923,125,43,2,18,188
430122416,44,59,4,6,113
430137893,18,18,4,3,43
430144366,105,59,2,1,167
430147540,28,65,11,6,110
430148269,88,24,15,28,155
430160437,40,23,2,2,67
430176817,43,25,56,1,125
430190011,77,33,8,7,125
430194663,128,64,19,4,215
430200614,82,52,4,2,140
430202802,47,4,2,3,56
430209404,105,3,3,53,164
430211995,32,40,6,12,90
430225763,143,3,2,11,159
430229748,87,3,2,1,93
430247503,10,9,2,2,23
430247604,10,4,2,2,18
430249464,111,17,15,1,144
430251495,127,3,2,1,133
430261927,44,63,60,16,183
430265820,18,29,2,1,50
430287798,71,10,2,3,86
430290887,53,3,2,1,59
430291770,143,3,2,4,152
430299160,28,53,5,2,88
430317401,38,10,2,6,56
430318070,76,24,35,1,136
430353698,50,26,7,3,86
430370031,10,9,2,2,23
430378784,61,21,2,38,122
430388977,72,8,2,1,83
430404871,19,6,2,4,31
430413671,139,27,23,12,201
430418785,117,13,2,10,142
430429682,143,9,2,10,164
430435372,135,31,33,5,204
430438743,44,29,16,4,93
430446479,17,3,2,1,23
430448471,16,3,4,1,24
430453702,31,18,6,4,59
430459401,71,20,2,1,94
430464736,86,25,2,3,116
430465949,146,25,26,2,199
430480390,13,3,2,1,19
430482811,18,3,2,1,24
430483972,19,32,2,1,54
430506511,58,74,13,13,158
430512306,126,59,22,5,212
430513071,155,3,2,7,167
430514350,160,47,2,16,225
430534839,329,3,2,1,335
430544133,103,3,15,1,122
430556797,82,36,45,5,168
430567695,56,4,4,1,65
430603658,40,7,14,3,64
430605817,35,3,2,2,42
430611017,247,3,2,49,301
430624298,35,3,2,1,41
430646602,87,8,41,1,137
430652423,22,3,2,1,28
430662628,36,24,5,1,66
430665632,56,57,19,4,136
430679309,39,68,10,3,120
430693141,65,16,8,4,93
430693354,48,16,2,12,78
430695305,132,20,2,1,155
430702861,42,34,2,8,86
430710682,13,3,2,1,19
430715866,13,24,26,2,65
430717624,122,59,2,3,186
430730135,55,64,18,1,138
430731604,12,3,2,1,18
430741431,47,29,4,3,83
430758500,56,65,12,2,135
430781206,36,3,4,2,45
430788859,278,3,2,3,286
430790027,174,3,2,3,182
430795925,19,7,2,3,31
430801328,57,3,2,1,63
430814923,10,3,2,2,17
430818647,67,80,2,2,151
430822518,33,48,18,3,102
430823585,101,3,2,7,113
430825282,43,24,22,13,102
430836226,61,14,20,1,96
430842068,114,19,16,1,150
430875270,12,15,2,1,30
430875705,54,6,2,4,66
430900537,35,16,2,1,54
430901015,104,3,2,6,115
430907949,95,3,2,1,101
430913291,67,3,2,9,81
430916812,86,3,2,1,92
430917031,45,3,2,1,51
430922218,40,27,3,1,71
430934656,105,3,2,26,136
430940220,40,45,21,1,107
430964685,54,36,6,1,97
430988705,15,11,2,7,35
430998920,20,54,2,1,77
431022939,16,3,2,16,37
431033164,44,23,36,6,109
431037748,12,3,2,3,20
431050968,49,53,13,7,122
431054719,89,53,4,2,148
431056200,15,3,2,1,21
431064010,16,3,2,4,25
431087215,67,28,2,1,98
431111890,28,55,2,1,86
431118731,138,34,9,1,182
431121065,12,12,2,1,27
431127584,115,25,17,9,166
431131392,51,3,2,3,59
431145614,69,17,71,1,158
431151858,11,3,2,1,17
431155139,21,15,2,1,39
431155412,23,3,2,1,29
431157401,111,43,3,2,159
431185573,12,5,4,3,24
431190730,53,13,2,1,69
431207638,28,3,2,1,34
431212616,32,10,2,1,45
431229640,49,24,2,3,78
431231534,56,14,2,6,78
431232503,16,3,2,1,22
431233403,194,53,11,15,273
431267341,95,3,2,2,102
431285455,45,25,2,4,76
431293450,143,23,3,4,173
431296144,32,48,20,1,101
431296240,83,15,2,2,102
431310503,70,3,13,8,94
431314360,90,3,2,1,96
431314710,27,9,2,1,39
431321812,23,3,2,1,29
431332413,95,3,2,1,101
431336745,66,3,2,2,73
431344147,20,3,2,6,31
431356282,103,7,2,1,113
431367940,98,8,5,9,120
431377868,170,27,40,28,265
431393480,18,9,2,1,30
431397589,134,33,38,1,206
431403864,17,3,2,1,23
431422482,11,3,2,1,17
431427560,99,13,8,3,123
431432438,209,18,2,8,237
431435185,102,22,40,1,165
431437012,40,30,5,3,78
431437969,20,13,2,1,36
431454162,311,3,2,31,347
431456807,14,3,2,1,20
431457166,39,3,2,4,48
431459667,47,19,20,1,87
431471548,54,28,34,2,118
431473503,11,64,2,1,78
431483736,61,20,3,4,88
431484865,94,3,2,3,102
431499440,103,44,15,20,182
431504220,31,25,2,1,59
431508575,87,16,7,1,111
431544408,11,3,2,1,17
431566491,186,8,3,6,203
431590382,35,29,48,8,120
431594731,35,27,2,27,91
431597396,11,3,2,1,17
431598314,10,16,2,1,29
431608863,153,40,8,1,202
431609086,18,20,14,4,56
431613057,36,18,2,4,60
431622915,145,22,4,62,233
431626682,30,75,2,2,109
431633543,233,3,2,12,250
431647745,76,58,73,2,209
431650605,23,13,13,2,51
431657095,95,19,2,4,120
431662634,28,3,2,3,36
431693531,102,3,2,16,123
431696856,71,3,2,1,77
431711023,53,55,28,17,153
431712378,134,3,2,3,142
431716861,34,3,2,1,40
431720669,27,11,8,5,51
431727207,25,16,3,6,50
431762628,50,31,11,1,93
431766913,108,16,54,26,204
431767595,25,7,2,2,36
431800032,68,37,30,41,176
431804184,115,31,2,4,152
431808486,59,14,25,1,99
431828043,47,3,64,3,117
431838635,11,6,2,1,20
431842551,18,3,2,1,24
431859638,23,12,3,2,40
431870344,55,31,2,1,89
431885998,14,3,2,1,20
431891830,38,3,2,2,45
431893280,21,10,2,1,34
431899935,40,3,2,1,46
431919680,15,3,2,1,21
431936285,72,21,2,1,96
431938221,79,14,68,7,168
431939836,276,148,78,6,508
431962767,88,3,2,16,109
431971193,125,36,2,8,171
431973898,155,5,2,4,166
431977164,106,20,2,6,134
431988497,30,14,2,4,50
431998441,15,3,2,1,21
431999152,38,3,2,1,44
432008483,43,3,2,1,49
432009637,409,3,2,8,422
432057715,19,3,2,1,25
432072002,76,23,3,3,105
432082696,175,3,2,16,196
432085041,123,3,2,2,130
432092793,22,20,2,1,45
432098793,128,4,2,3,137
432104307,13,12,2,1,28
432111697,83,46,6,4,139
432119969,11,3,2,1,17
432125129,220,37,2,14,273
432138339,82,27,3,8,120
432141473,10,10,2,1,23
432149454,224,3,2,16,245
432151504,15,3,2,1,21
432152891,33,64,3,3,103
432160895,70,3,2,1,76
432164385,40,29,8,1,78
432190441,22,3,2,1,28
432197432,31,44,86,2,163
432220887,140,3,2,20,165
432232423,32,35,5,17,89
432241634,88,50,32,11,181
432258894,82,13,3,9,107
432264576,11,11,2,1,25
432285985,27,17,2,3,49
432286625,116,82,54,9,261
432294995,12,3,2,1,18
432300971,63,3,39,1,106
432301998,40,42,27,7,116
432308550,85,3,2,5,95
432316900,37,8,52,13,110
432340203,42,20,23,1,86
432344946,71,73,58,7,209
432357596,13,21,2,4,40
432365248,25,3,2,1,31
432366739,23,3,2,1,29
432370941,17,11,6,4,38
432373659,137,3,2,3,145
432377014,262,25,2,9,298
432386054,42,7,2,1,52
432403022,11,3,2,2,18
432404931,67,21,3,7,98
432405393,36,15,45,3,99
432407706,21,22,2,9,54
432415117,26,3,2,5,36
432418671,69,13,68,1,151
432419126,10,4,2,1,17
432425469,34,3,2,1,40
432441173,29,28,2,1,60
432442890,29,3,2,1,35
432465144,146,3,2,1,152
432482661,34,26,2,2,64
432496538,25,3,2,2,32
432504333,211,37,35,9,292
432510202,58,5,3,6,72
432524597,285,13,66,16,380
432524753,148,13,2,3,166
432536875,102,12,36,7,157
432549617,19,7,11,10,47
432554475,142,28,2,3,175
432579222,20,24,2,2,48
432584283,33,3,2,1,39
432604993,61,3,2,1,67
432609364,68,7,2,1,78
432627916,124,3,2,8,137
432637825,42,3,2,1,48
432657728,83,23,24,11,141
432674273,208,3,2,1,214
432675448,39,32,26,1,98
432677192,195,51,12,24,282
432685885,29,3,2,1,35
432689968,69,20,31,3,123
432698017,108,61,100,10,279
432704656,144,22,5,6,177
432713762,23,18,3,1,45
432715256,19,12,2,3,36
432717087,75,20,81,4,180
432724340,10,5,2,1,18
432733976,35,27,3,4,69
432742481,93,24,12,1,130
432754903,43,56,47,6,152
432761765,145,29,2,9,185
432761824,39,23,2,10,74
432761900,112,32,29,1,174
432768766,11,3,2,1,17
432784405,42,10,2,1,55
432790383,29,10,2,1,42
432812020,101,50,22,11,184
432824972,35,8,2,8,53
432837171,39,27,26,21,113
432849933,16,3,2,1,22
432866402,11,3,2,1,17
432871675,75,38,30,17,160
432876178,14,3,2,1,20
432880050,98,37,14,1,150
432889975,56,43,9,19,127
432899034,54,51,28,20,153
432902640,10,4,2,1,17
432907344,213,4,7,4,228
432917925,70,109,6,1,186
432938634,143,19,52,2,216
432944358,87,16,5,3,111
432954479,58,6,2,1,67
432955795,73,26,29,4,132
432957082,59,6,2,3,70
432972057,39,54,44,9,146
432974235,119,12,3,3,137
432984732,65,13,20,27,125
432987476,14,15,2,2,33
432988445,143,70,8,3,224
432994504,69,19,12,1,101
432995185,75,14,17,9,115
433002554,64,26,2,26,118
433027410,101,14,4,6,125
433036608,112,31,2,17,162
433038207,49,3,2,3,57
433043745,102,55,21,35,213
433056784,24,3,2,2,31
433062070,81,34,41,8,164
433066288,43,3,2,1,49
433067436,146,19,63,15,243
433069511,89,34,19,1,143
433076833,75,8,2,10,95
433121905,35,39,13,10,97
433124152,22,3,2,8,35
433134161,609,3,2,5,619
433143440,49,31,6,6,92
433148823,112,13,4,3,132
433151779,31,23,9,4,67
433159363,63,15,2,6,86
433179004,159,23,4,1,187
433180751,101,3,2,4,110
433183733,52,18,2,5,77
433191289,180,25,70,1,276
433196391,26,81,2,1,110
433199060,57,33,84,2,176
433199341,128,3,2,1,134
433202159,216,35,22,8,281
433203955,60,45,6,9,120
433204564,12,3,3,1,19
433209351,84,29,4,1,118
433209620,94,10,2,3,109
433215383,28,3,2,1,34
433231656,113,10,148,13,284
433239938,32,32,2,39,105
433251282,30,3,2,1,36
433253483,43,3,2,1,49
433266320,25,92,22,1,140
433268437,13,10,4,8,35
433274763,164,12,2,9,187
433275255,44,5,2,3,54
433280981,261,19,73,59,412
433291977,98,3,2,5,108
433300333,10,20,11,1,42
433307762,58,27,17,5,107
433309621,54,3,2,4,63
433315558,13,3,2,5,23
433331657,20,42,10,23,95
433344379,25,96,37,4,162
433352243,144,16,7,5,172
433360020,54,32,12,2,100
433361682,97,59,132,23,311
433363601,151,3,2,1,157
433364359,45,31,5,6,87
433365253,13,3,2,1,19
433380246,95,3,2,4,104
433386645,20,3,2,1,26
433403396,44,3,2,2,51
433420956,59,3,2,2,66
433421449,129,44,21,2,196
433433515,86,3,2,1,92
433434027,61,8,23,8,100
433447702,162,43,2,30,237
433449689,63,3,2,1,69
433454519,74,23,13,1,111
433475254,19,3,2,1,25
433482146,24,24,76,2,126
433499977,195,71,2,5,273
433502276,131,3,2,1,137
433504519,134,38,2,12,186
433509539,82,41,2,2,127
433514531,89,3,2,1,95
433522434,78,38,15,16,147
433538868,11,3,2,1,17
433539232,15,3,2,1,21
433539301,93,50,12,68,223
433544171,40,25,17,2,84
433545431,69,27,11,21,128
433552307,16,3,2,2,23
433557342,14,3,2,3,22
433557543,186,4,2,13,205
433571316,19,44,39,17,119
433587391,91,35,2,4,132
433600702,75,3,2,1,81
433605036,36,43,4,1,84
433611582,160,3,2,91,256
433622042,297,3,2,9,311
433623064,115,59,8,26,208
433650879,64,15,2,6,87
433668391,99,42,26,17,184
433683042,133,3,2,16,154
433692787,57,40,3,19,119
433696638,128,41,2,2,173
433706498,16,6,2,6,30
433715128,17,23,2,33,75
433717657,91,8,14,1,114
433735171,118,3,30,2,153
433736269,19,30,18,1,68
433737562,24,16,2,1,43
433742116,12,3,2,4,21
433747773,148,20,2,2,172
433748906,56,44,2,18,120
433751024,52,9,2,2,65
433795481,16,12,2,12,42
433804623,10,4,2,1,17
433828025,80,15,2,1,98
433831801,30,3,2,11,46
433854115,46,3,2,1,52
433864135,15,8,2,2,27
433865627,12,4,2,1,19
433866701,93,13,2,11,119
433876865,31,3,2,1,37
433877499,11,3,2,1,17
433882094,24,3,2,1,30
433889509,131,54,14,7,206
433901128,91,17,8,2,118
433902329,56,23,51,1,131
433903058,24,3,2,3,32
433903992,81,3,2,3,89
433914762,21,3,2,1,27
433914917,47,3,2,1,53
433915675,122,11,2,4,139
433923688,111,51,90,40,292
433936706,23,11,2,5,41
433950728,48,3,2,1,54
433972419,138,15,5,1,159
433975329,11,3,2,1,17
433977068,102,60,38,145,345
433984803,90,5,2,1,98
433990479,81,3,2,1,87
433990903,27,3,2,1,33
434002770,15,3,2,1,21
434006610,103,3,3,2,111
434020977,133,15,45,47,240
434027442,39,4,11,2,56
434029209,93,10,5,5,113
434035692,49,49,62,8,168
434050766,53,3,2,1,59
434077751,21,10,2,1,34
434087628,142,56,84,20,302
434089088,84,24,33,1,142
434110121,155,27,21,23,226
434115812,72,3,2,5,82
434118635,157,42,61,13,273
434123368,80,3,39,2,124
434131300,10,8,2,1,21
434132223,13,3,2,1,19
434138140,97,8,13,11,129
434140507,42,37,61,2,142
434141130,15,7,2,1,25
434146718,11,5,2,1,19
434149607,76,19,4,1,100
434160376,23,3,2,1,29
434192295,15,11,4,20,50
434192538,65,8,55,8,136
434206071,38,20,2,1,61
434211517,84,45,6,14,149
434234538,107,34,15,13,169
434241397,147,27,24,1,199
434246257,16,9,2,1,28
434248413,29,23,95,66,213
434253980,49,27,2,2,80
434264262,25,3,2,1,31
434269890,21,12,2,13,48
434273044,67,22,29,29,147
434275047,83,3,2,2,90
434275755,48,3,2,3,56
434280694,50,12,11,4,77
434282062,11,18,4,5,38
434298562,307,3,2,65,377
434302021,46,12,2,5,65
434324472,109,3,2,6,120
434325655,30,23,3,4,60
434328716,130,26,50,28,234
434329097,29,150,3,1,183
434334249,18,17,2,2,39
434342227,17,31,10,9,67
434356350,44,41,44,21,150
434371276,49,25,2,1,77
434389292,28,22,3,2,55
434401022,32,23,28,5,88
434424104,85,48,66,18,217
434426369,68,77,25,50,220
434429117,10,3,2,2,17
434463058,43,30,21,20,114
434465088,165,48,67,1,281
434495159,30,48,7,2,87
434496226,144,3,2,1,150
434503133,26,16,2,1,45
434503611,21,32,4,1,58
434510498,57,44,17,1,119
434515499,245,22,2,1,270
434525567,81,10,7,1,99
434537297,54,4,2,3,63
434558181,179,35,21,2,237
434567354,68,54,2,17,141
434568516,92,35,66,24,217
434575108,43,5,2,1,51
434576971,35,21,6,2,64
434588822,312,32,20,6,370
434589550,59,125,89,1,274
434603496,110,42,6,1,159
434628475,145,9,31,1,186
434632997,43,14,2,3,62
434641123,38,3,2,5,48
434643881,56,3,2,1,62
434644163,11,3,2,1,17
434658119,46,9,2,5,62
434659579,12,3,2,3,20
434660118,16,15,2,1,34
434668369,86,3,2,3,94
434699948,35,27,2,2,66
434704478,36,3,2,1,42
434714994,98,3,2,1,104
434717112,29,7,66,1,103
434720750,26,4,2,2,34
434723521,123,3,2,5,133
434732044,21,34,3,1,59
434743158,86,19,2,1,108
434752227,57,3,2,3,65
434774076,90,3,2,1,96
434775075,16,7,2,1,26
434782981,170,8,12,17,207
434798234,163,3,2,1,169
434814210,18,11,4,1,34
434814643,173,4,2,8,187
434819796,19,3,2,8,32
434827213,39,18,4,9,70
434840170,90,6,5,14,115
434843727,51,20,2,1,74
434856529,25,44,2,1,72
434859965,34,10,2,4,50
434862099,26,17,22,4,69
434862801,65,3,2,1,71
434872491,68,7,22,9,106
434874458,35,15,2,1,53
434874601,78,28,21,31,158
434875496,29,23,11,1,64
434903895,34,54,23,29,140
434906244,33,3,2,1,39
434906500,15,19,2,1,37
434907311,19,3,2,3,27
434913014,54,5,2,1,62
434937217,11,3,2,1,17
434946137,38,3,2,5,48
434967070,198,16,2,22,238
434979867,78,47,28,2,155
434981425,139,3,2,1,145
434985146,15,3,2,3,23
434987229,22,3,2,1,28
434990561,10,5,2,7,24
435022356,145,62,218,42,467
435026585,36,3,2,5,46
435039450,133,3,2,1,139
435053881,121,21,5,2,149
435059723,86,14,63,5,168
435061192,35,3,2,1,41
435074407,40,65,58,1,164
435081278,62,16,7,1,86
435087249,114,20,33,8,175
435107148,73,3,2,1,79
435110850,118,28,2,2,150
435113102,44,16,5,2,67
435118824,36,20,7,1,64
435122474,18,28,12,1,59
435124251,10,3,2,3,18
435138296,30,3,2,1,36
435140896,75,3,2,1,81
435152773,38,55,66,7,166
435170365,164,32,3,5,204
435171065,95,13,6,6,120
435177688,11,3,2,1,17
435207161,14,3,2,1,20
435218189,184,3,2,3,192
435227401,71,15,2,1,89
435231903,19,18,4,22,63
435233727,148,27,4,9,188
435234781,72,42,4,1,119
435244277,29,14,2,11,56
435246236,26,4,5,1,36
435246906,97,13,2,2,114
435253639,89,44,17,1,151
435277327,66,12,5,1,84
435289918,96,4,2,10,112
435298660,103,16,22,17,158
435325983,62,19,2,16,99
435328094,75,3,2,1,81
435341709,78,51,6,1,136
435348876,10,15,2,1,28
435396673,37,27,3,18,85
435406259,13,8,2,5,28
435409493,41,3,2,3,49
435416457,10,29,2,4,45
435420127,201,37,72,14,324
435421385,16,4,4,2,26
435432370,88,48,44,5,185
435465480,81,11,2,1,95
435477777,114,31,11,6,162
435486246,152,3,2,17,174
435492752,114,35,12,20,181
435493905,17,32,2,1,52
435503528,19,3,2,1,25
435505975,80,20,33,61,194
435532728,148,28,2,1,179
435533377,73,3,2,1,79
435542507,68,12,2,1,83
435557077,15,3,2,1,21
435566727,20,6,2,10,38
435592337,58,44,16,1,119
435592480,34,18,3,4,59
435597533,53,17,2,5,77
435611333,57,50,3,1,111
435615361,60,3,2,11,76
435617722,94,7,3,1,105
435627204,88,28,6,7,129
435631580,11,4,2,1,18
435638354,72,17,39,1,129
435643273,56,3,2,1,62
435649452,106,10,37,58,211
435654993,52,3,2,1,58
435659424,25,25,2,5,57
435663365,37,31,2,1,71
435663609,65,49,60,3,177
435664179,29,3,2,1,35
435680965,28,3,2,3,36
435697207,99,3,2,1,105
435699991,35,24,41,23,123
435705838,11,3,2,2,18
435708292,53,4,2,2,61
435720799,15,3,2,1,21
435721341,39,4,2,29,74
435734904,138,3,2,1,144
435737276,10,22,4,1,37
435739517,40,40,3,3,86
435742630,93,3,2,1,99
435747861,43,3,2,3,51
435755679,158,60,105,20,343
435782384,26,3,2,1,32
435783666,223,7,47,4,281
435785643,20,5,2,1,28
435795686,53,32,76,4,165
435808093,61,20,23,9,113
435820716,157,43,8,1,209
435821365,45,22,7,3,77
435826773,10,3,2,2,17
435829837,31,45,2,6,84
435840492,136,3,2,3,144
435840652,119,31,28,66,244
435844751,12,3,2,1,18
435866940,27,41,3,16,87
435867925,61,34,2,6,103
435875854,27,14,29,13,83
435881030,47,5,2,2,56
435883638,83,12,19,37,151
435893816,27,41,72,1,141
435898964,68,3,10,1,82
435910345,21,25,2,6,54
435916644,11,3,2,1,17
435927100,10,4,2,1,17
435932750,81,45,22,16,164
435935981,81,15,32,4,132
435956780,10,4,2,1,17
435990581,11,3,2,4,20
436006599,125,3,2,1,131
436030516,120,20,35,1,176
436045522,147,11,18,3,179
436052982,78,9,2,2,91
436054437,119,103,39,14,275
436064040,21,3,2,4,30
436075901,183,3,2,13,201
436092074,74,3,2,1,80
436097611,137,50,69,6,262
436102709,35,59,31,19,144
436103268,137,37,24,17,215
436104755,285,3,2,11,301
436106876,21,34,14,2,71
436106946,95,41,3,26,165
436137218,10,20,2,1,33
436143588,25,39,17,19,100
436149150,52,43,4,2,101
436164597,114,26,2,1,143
436175603,33,18,3,18,72
436197614,27,3,2,1,33
436205907,81,33,28,29,171
436214894,41,41,2,5,89
436215289,76,20,10,53,159
436222709,38,18,9,1,66
436228989,31,9,2,6,48
436231675,111,38,20,3,172
436235282,87,14,66,3,170
436237232,18,3,2,1,24
436265647,152,23,60,7,242
436277838,66,8,2,1,77
436278373,10,4,2,6,22
436283345,92,52,3,4,151
436305250,10,10,2,2,24
436306211,60,23,2,1,86
436310909,47,3,2,1,53
436310938,16,3,2,1,22
436315910,35,73,21,5,134
436345927,55,3,2,1,61
436345960,122,8,108,4,242
436350341,11,8,2,1,22
436358056,74,20,2,2,98
436381199,131,3,2,1,137
436393245,11,3,2,1,17
436409944,51,84,7,1,143
436410333,79,3,2,1,85
436411358,35,3,2,1,41
436416004,23,62,20,7,112
436432161,112,18,3,1,134
436438116,64,35,3,4,106
436462770,30,3,2,1,36
436466482,60,10,12,20,102
436500220,98,3,2,4,107
436508288,11,3,2,1,17
436508352,24,3,2,1,30
436509981,17,3,2,2,24
436517074,14,11,3,1,29
436527266,24,44,2,1,71
436533194,14,3,2,5,24
436555105,68,23,3,1,95
436574184,80,3,2,1,86
436582347,17,3,2,1,23
436593478,53,38,20,1,112
436608833,123,10,5,9,147
436626716,73,23,2,3,101
436628140,207,3,2,5,217
436657811,102,3,2,1,108
436660835,24,68,8,4,104
436665572,19,12,3,6,40
436669225,63,79,8,29,179
436680563,101,15,11,3,130
436681351,121,56,35,21,233
436682152,41,28,2,3,74
436686395,28,67,38,1,134
436689772,12,3,2,1,18
436702191,174,11,2,59,246
436707013,250,3,2,10,265
436707623,11,60,15,1,87
436708105,185,30,21,15,251
436721710,13,20,2,1,36
436724943,87,17,2,1,107
436727068,64,7,2,6,79
436742637,56,10,2,1,69
436744560,180,3,2,2,187
436757039,96,21,2,47,166
436763062,38,15,2,11,66
436773497,42,21,2,8,73
436780168,56,3,2,1,62
436790722,30,3,2,1,36
436791853,32,4,2,1,39
436809784,90,61,9,18,178
436815874,79,55,20,36,190
436832478,129,9,43,5,186
436833511,54,22,40,9,125
436859543,10,5,4,2,21
436867476,18,3,2,1,24
436870942,41,29,2,10,82
436884197,21,3,2,1,27
436886252,23,13,13,3,52
436920457,19,11,2,3,35
436921304,53,7,2,5,67
436930950,13,3,2,6,24
436933189,61,27,3,5,96
436937780,176,3,2,3,184
436965896,52,3,2,1,58
436972679,47,3,2,1,53
436978269,92,10,11,7,120
436979044,121,9,10,2,142
436980842,57,21,2,1,81
436998634,16,3,2,13,34
437006255,34,9,2,5,50
437016542,10,4,2,1,17
437036668,42,4,2,1,49
437038342,22,3,2,1,28
437051673,127,19,9,2,157
437071874,13,3,2,1,19
437074734,13,16,3,1,33
437076230,17,3,2,1,23
437087671,22,8,2,1,33
437096556,41,23,2,1,67
437100661,80,23,10,8,121
437110331,88,3,2,2,95
437111660,91,25,21,5,142
437115658,37,56,40,1,134
437139659,123,4,101,9,237
437142622,99,40,91,25,255
437143138,67,6,2,8,83
437143597,67,3,2,3,75
437144349,59,7,2,5,73
437157963,13,11,2,3,29
437168352,34,31,2,3,70
437193366,177,20,3,4,204
437208329,52,3,2,1,58
437210201,95,3,2,1,101
437220613,74,7,2,2,85
437257077,21,12,2,1,36
437257465,12,3,2,4,21
437270482,54,13,51,1,119
437274022,34,31,8,6,79
437280124,39,18,2,1,60
437285416,19,3,2,2,26
437286759,16,3,2,1,22
437296845,10,14,2,3,29
437299677,68,3,2,1,74
437302616,94,14,2,1,111
437347107,15,3,2,1,21
437364079,49,18,26,7,100
437364152,50,36,24,1,111
437364877,35,8,2,3,48
437367634,89,35,2,4,130
437375162,11,63,2,1,77
437386511,26,30,4,6,66
437386572,172,3,2,1,178
437399845,109,19,5,2,135
437414388,48,4,3,5,60
437432704,62,3,2,1,68
437449717,13,3,2,1,19
437454415,41,15,14,6,76
437461486,80,44,13,5,142
437465346,60,11,2,4,77
437472895,112,15,2,13,142
437480945,58,49,22,53,182
437495071,11,3,2,1,17
437511610,71,16,8,1,96
437527803,33,9,2,7,51
437528982,24,3,2,1,30
437530185,125,18,42,1,186
437549581,130,3,37,1,171
437550857,34,42,4,4,84
437551102,177,31,2,15,225
437556102,14,8,6,2,30
437573851,289,6,22,45,362
437574276,38,38,2,2,80
437575110,223,29,2,3,257
437576201,20,10,2,1,33
437580147,122,3,2,5,132
437588501,37,27,13,10,87
437589832,26,17,11,19,73
437604773,42,16,16,7,81
437619808,79,3,2,1,85
437627139,82,3,2,6,93
437627305,43,10,20,23,96
437636515,57,28,12,1,98
437641654,135,59,14,47,255
437643524,61,52,2,1,116
437655044,47,8,33,16,104
437658862,41,56,52,23,172
437659374,30,29,32,2,93
437662293,110,3,2,3,118
437671061,18,12,2,1,33
437674252,92,3,2,2,99
437674307,45,14,2,1,62
437675327,148,3,3,2,156
437683304,141,4,2,1,148
437704439,11,3,2,1,17
437713511,85,14,24,11,134
437716780,103,24,4,18,149
437721856,10,3,2,2,17
437749837,52,3,2,1,58
437754437,61,21,7,3,92
437766659,133,7,7,5,152
437786671,71,3,2,2,78
437800557,45,60,12,3,120
437803589,86,14,2,1,103
437803833,27,6,2,1,36
437825769,24,3,2,1,30
437828613,37,3,2,1,43
437833753,239,12,7,16,274
437851658,89,41,10,10,150
437854321,85,131,12,7,235
437859209,135,47,32,29,243
437868408,10,14,2,2,28
437904228,27,13,2,1,43
437905763,92,3,2,1,98
437907989,20,3,2,1,26
437920470,86,3,2,1,92
437924952,13,3,2,1,19
437941353,77,3,2,34,116
437949376,12,3,2,1,18
437958222,263,3,2,2,270
437981335,12,3,2,1,18
437981580,46,91,135,46,318
437981682,113,36,28,2,179
437986922,13,9,2,1,25
438018006,18,18,2,2,40
438026429,96,10,2,4,112
438028313,23,3,2,1,29
438047818,11,3,2,1,17
438056239,55,22,2,15,94
438061818,83,21,4,4,112
438063658,48,55,34,14,151
438068631,68,12,3,11,94
438069460,23,3,2,1,29
438081074,36,43,45,1,125
438102932,32,15,2,5,54
438119780,54,17,2,13,86
438128666,127,51,26,3,207
438152923,11,36,2,1,50
438162149,34,142,49,3,228
438166266,39,18,2,1,60
438183533,82,35,19,26,162
438188846,19,3,2,1,25
438213675,28,82,29,25,164
438238088,10,23,2,1,36
438249732,50,10,4,8,72
438263849,79,3,2,1,85
438266685,80,16,2,5,103
438267528,154,58,73,7,292
438272566,76,12,16,18,122
438273278,11,3,2,1,17
438282829,107,9,2,1,119
438296181,94,39,2,11,146
438298841,83,21,4,3,111
438303034,19,4,2,1,26
438315016,59,30,2,1,92
438323494,12,9,9,1,31
438350981,46,5,11,1,63
438369841,39,5,2,1,47
438371003,40,4,2,3,49
438387275,95,41,16,2,154
438411697,72,3,2,1,78
438411977,129,19,13,42,203
438422946,39,46,3,7,95
438426230,21,3,2,1,27
438429594,94,24,3,1,122
438446959,119,7,62,46,234
438450905,14,21,5,1,41
438479694,31,40,2,1,74
438485042,18,78,7,2,105
438486925,48,38,14,2,102
438488209,136,3,2,5,146
438489166,16,5,2,1,24
438489616,13,12,2,1,28
438494908,10,6,2,1,19
438496767,96,3,2,2,103
438501696,135,3,2,3,143
438508233,12,8,2,1,23
438509769,60,3,2,2,67
438543928,23,145,10,1,179
438564546,21,24,2,5,52
438569775,44,26,10,2,82
438584951,18,3,2,3,26
438585341,50,25,11,1,87
438586338,21,7,22,2,52
438602047,40,17,2,1,60
438602095,106,9,4,2,121
438613212,32,18,42,1,93
438614150,44,16,13,1,74
438618758,184,13,68,1,266
438633508,84,22,4,13,123
438648344,49,7,2,2,60
438655193,38,13,21,7,79
438662939,25,3,2,2,32
438674719,29,36,20,19,104
438688496,34,33,2,2,71
438691309,56,3,2,1,62
438696420,11,3,2,1,17
438699644,54,5,2,21,82
438703511,43,25,2,3,73
438719507,41,30,116,1,188
438729781,81,22,2,7,112
438731209,135,7,4,1,147
438742217,10,5,2,1,18
438744277,22,52,2,9,85
438766136,27,26,2,9,64
438780588,11,5,2,1,19
438802222,11,3,2,1,17
438802576,34,20,2,1,57
438808298,50,20,2,2,74
438815332,149,10,2,1,162
438820592,25,24,2,1,52
438830008,100,23,2,3,128
438831644,15,3,2,1,21
438841851,20,3,2,1,26
438857528,68,3,2,6,79
438871058,10,3,2,3,18
438876296,34,80,7,2,123
438880477,224,13,35,16,288
438890886,103,8,13,15,139
438901812,11,3,2,1,17
438902023,161,54,2,1,218
438906772,27,110,2,2,141
438909812,26,8,4,5,43
438910180,42,4,2,1,49
438912989,62,12,14,7,95
438917479,10,5,2,1,18
438919628,146,20,18,5,189
438922373,27,3,2,1,33
438924293,10,6,2,1,19
438930261,270,3,2,30,305
438931088,10,3,2,4,19
438939123,15,3,2,1,21
438945275,10,4,2,1,17
438987847,49,86,19,3,157
438993795,162,24,52,22,260
438998025,70,21,67,51,209
439004452,120,24,2,5,151
439007690,44,3,2,11,60
439033701,67,27,2,1,97
439040557,11,3,2,1,17
439045408,74,30,19,44,167
439049042,53,42,37,36,168
439053067,99,3,2,5,109
439056160,10,3,2,2,17
439057714,48,45,2,12,107
439061206,13,3,2,1,19
439068279,13,85,2,1,101
439070506,276,3,2,8,289
439075675,72,8,76,10,166
439075718,81,48,18,11,158
439079117,11,8,2,1,22
439088114,46,38,5,43,132
439102861,25,26,35,31,117
439118496,26,3,2,1,32
439120940,45,3,2,1,51
439124893,11,3,2,1,17
439133311,102,13,7,1,123
439147349,13,7,2,1,23
439148528,125,84,48,7,264
439155316,36,60,3,28,127
439158716,70,25,15,26,136
439172656,56,4,24,9,93
439174723,23,25,7,1,56
439178296,37,29,22,1,89
439180118,54,3,2,1,60
439184209,62,32,2,18,114
439210591,18,16,5,6,45
439211580,11,3,2,1,17
439234622,24,3,2,2,31
439246489,80,3,2,6,91
439267907,13,3,2,1,19
439270504,168,59,23,12,262
439276864,79,33,58,66,236
439279077,71,4,2,1,78
439280526,10,34,2,5,51
439290079,128,46,85,30,289
439327006,28,3,2,1,34
439333573,64,34,35,10,143
439340507,46,3,2,2,53
439355757,103,3,2,16,124
439364698,68,26,9,1,104
439370896,10,3,2,4,19
439380990,54,8,2,5,69
439389124,12,12,3,4,31
439394583,55,56,68,23,202
439405631,122,27,26,2,177
439416686,22,34,5,2,63
439429546,15,3,2,1,21
439436561,66,18,9,9,102
439449402,177,20,20,35,252
439452908,64,56,30,7,157
439462935,46,36,50,7,139
439463727,120,44,34,7,205
439466328,36,50,6,7,99
439469293,35,17,2,1,55
439472667,46,4,12,1,63
439499529,43,17,8,10,78
439504753,11,33,2,6,52
439511437,101,41,2,3,147
439533524,273,3,2,6,284
439541361,98,35,28,17,178
439553807,15,8,7,2,32
439553827,96,3,2,3,104
439561696,92,12,56,2,162
439567595,52,45,9,2,108
439587823,161,23,5,3,192
439599225,175,61,14,8,258
439604640,42,12,2,1,57
439608102,53,11,2,5,71
439612423,128,3,2,1,134
439614467,43,22,4,1,70
439627726,68,44,7,74,193
439650931,86,14,2,2,104
439669214,228,60,5,2,295
439702463,100,3,2,2,107
439712551,77,6,2,2,87
439718395,23,26,9,9,67
439727617,13,24,2,8,47
439727670,15,3,2,1,21
439736510,60,15,2,14,91
439736518,49,40,3,1,93
439739788,38,50,13,14,115
439744259,114,28,43,8,193
439749736,43,24,4,1,72
439760751,13,41,2,1,57
439789957,107,57,121,12,297
439809895,14,3,2,1,20
439812204,36,19,2,2,59
439823411,140,11,8,1,160
439832826,17,11,8,3,39
439852117,95,17,55,37,204
439853346,59,17,5,2,83
439864042,98,3,2,28,131
439867585,23,43,15,26,107
439873573,10,3,2,5,20
439873812,64,11,2,1,78
439895237,19,16,2,11,48
439896940,16,30,2,1,49
439898165,29,3,2,6,40
439907088,44,6,16,1,67
439907965,144,33,2,1,180
439909595,48,7,3,1,59
439911881,90,3,2,4,99
439927663,58,3,2,1,64
439950139,33,26,12,1,72
439950766,37,3,2,1,43
439966422,31,17,7,31,86
439966912,151,3,2,1,157
439969639,85,31,19,1,136
439990788,93,3,2,1,99
439996534,29,24,2,2,57
440011111,176,26,76,16,294
440015162,43,22,12,12,89
440044806,173,26,19,33,251
440046236,32,5,5,7,49
440049722,38,37,4,12,91
440056050,304,46,2,75,427
440079111,26,59,3,2,90
440089384,132,53,19,24,228
440097724,55,20,7,1,83
440103069,29,8,14,1,52
440114968,27,8,2,1,38
440117627,115,34,3,33,185
440132607,14,15,2,5,36
440136540,11,3,2,1,17
440136946,91,34,45,1,171
440140784,69,3,2,1,75
440151341,11,3,2,1,17
440152407,19,4,2,1,26
440157128,27,44,4,2,77
440157406,16,6,48,1,71
440164638,26,48,10,1,85
440172431,154,17,57,43,271
440183995,94,3,2,1,100
440188887,70,47,11,1,129
440190828,127,10,2,6,145
440226424,107,15,2,4,128
440233456,49,47,2,2,100
440236358,12,6,2,1,21
440239621,233,14,3,1,251
440244739,35,44,35,1,115
440248748,14,34,3,2,53
440253703,65,13,2,1,81
440260763,69,10,2,1,82
440270028,11,3,2,1,17
440274298,460,3,2,13,478
440279040,68,5,4,3,80
440280743,12,3,2,1,18
440284314,10,5,2,1,18
440297694,59,3,5,4,71
440301245,87,3,2,1,93
440309515,61,60,46,8,175
440309651,34,20,2,1,57
440317703,13,4,2,2,21
440343593,64,3,2,1,70
440346267,63,3,2,3,71
440347783,54,3,4,19,80
440352794,40,3,2,4,49
440360879,17,3,2,1,23
440363439,24,63,3,2,92
440370797,53,8,32,1,94
440386051,12,3,2,1,18
440386941,11,4,2,1,18
440387976,38,4,2,1,45
440394291,15,14,2,1,32
440401538,95,90,10,1,196
440409626,97,22,27,2,148
440412852,72,26,28,4,130
440413148,46,8,2,1,57
440415535,164,19,99,16,298
440416926,26,44,2,1,73
440419455,43,59,34,1,137
440466018,91,5,2,1,99
440471714,84,3,2,1,90
440473423,43,3,2,5,53
440489882,64,3,2,3,72
440500566,51,76,11,18,156
440504647,18,3,2,1,24
440505591,11,3,2,1,17
440523357,11,3,2,2,18
440529241,85,22,68,2,177
440535621,11,8,2,1,22
440548480,13,3,2,4,22
440554683,78,24,2,7,111
440575104,79,3,2,2,86
440576345,19,8,2,3,32
440578131,54,10,2,1,67
440595820,178,70,36,7,291
440617835,53,13,2,3,71
440624600,24,32,3,30,89
440641504,55,10,2,2,69
440648984,144,3,2,2,151
440653682,89,32,14,11,146
440655394,13,3,2,1,19
440657334,40,6,3,1,50
440669475,82,25,22,45,174
440680975,16,6,2,8,32
440681593,41,3,2,1,47
440682478,87,13,2,1,103
440688627,11,3,2,1,17
440691241,19,17,2,1,39
440695710,12,23,2,1,38
440702234,107,13,24,29,173
440708098,56,30,2,8,96
440709291,85,10,11,10,116
440713887,42,37,45,6,130
440720973,24,3,2,1,30
440729273,70,24,9,19,122
440750097,100,36,9,2,147
440754696,26,6,39,2,73
440760525,51,30,27,23,131
440760775,76,43,152,11,282
440783349,31,23,4,12,70
440784727,10,4,2,1,17
440787488,17,3,2,1,23
440788216,45,25,5,47,122
440824431,34,31,4,7,76
440842275,38,3,2,1,44
440844269,156,25,34,1,216
440847828,20,51,22,1,94
440848965,26,17,2,1,46
440849452,29,8,2,1,40
440854475,100,35,42,7,184
440856297,27,3,2,1,33
440861247,68,3,2,4,77
440876043,25,32,13,1,71
440882681,18,25,21,2,66
440891180,46,3,2,4,55
440901597,73,14,2,1,90
440910427,10,12,2,1,25
440931549,156,41,85,5,287
440941285,89,26,25,10,150
440965463,69,9,2,1,81
440967455,13,9,2,1,25
440975019,42,5,7,1,55
440978145,158,7,45,2,212
440992168,93,3,7,9,112
441009169,14,11,2,7,34
441014960,39,3,2,1,45
441032067,60,3,2,1,66
441036392,18,3,2,3,26
441060450,49,3,2,1,55
441065481,31,4,17,4,56
441068196,17,3,2,1,23
441078546,185,6,3,1,195
441080924,32,64,5,4,105
441085573,30,21,5,2,58
441121451,51,41,13,3,108
441149272,24,3,2,1,30
441160078,30,3,2,7,42
441173626,74,28,60,9,171
441174762,74,10,2,7,93
441180277,55,23,8,11,97
441192246,59,28,2,17,106
441195792,11,3,2,1,17
441212151,24,3,2,1,30
441224819,91,24,65,13,193
441232204,70,3,2,1,76
441245557,189,34,93,11,327
441247174,109,3,2,17,131
441248153,10,3,2,4,19
441252080,10,4,2,2,18
441260908,77,24,42,3,146
441264147,61,28,42,29,160
441287019,63,14,7,7,91
441290503,96,23,2,12,133
441291777,66,22,13,8,109
441294708,49,75,69,1,194
441295560,47,6,3,2,58
441300770,18,48,15,1,82
441303813,43,3,2,4,52
441330872,78,20,87,21,206
441335624,85,23,89,8,205
441348460,44,50,34,1,129
441358604,72,24,9,5,110
441399193,44,9,3,16,72
441403378,37,21,2,1,61
441412111,106,24,2,1,133
441423909,107,29,13,21,170
441424937,13,17,2,1,33
441432093,57,61,104,5,227
441433727,142,3,2,3,150
441438530,78,23,13,23,137
441449402,34,63,4,1,102
441463502,121,78,89,1,289
441515538,23,27,8,1,59
441516224,42,21,2,12,77
441534319,54,3,2,3,62
441559759,115,19,106,30,270
441561000,59,3,2,1,65
441574461,22,26,35,1,84
441584045,148,69,48,4,269
441597821,148,25,95,4,272
441612058,31,7,2,1,41
441615000,83,13,2,1,99
441618591,55,3,10,10,78
441619684,17,3,2,1,23
441620314,13,3,2,1,19
441623877,11,4,2,1,18
441625520,11,6,2,1,20
441635436,44,3,2,5,54
441639389,33,5,5,23,66
441643414,142,3,2,1,148
441653394,49,39,2,1,91
441663807,66,11,42,6,125
441667239,92,20,3,10,125
441675401,24,7,2,5,38
441675866,44,3,2,1,50
441679004,128,30,12,54,224
441680978,179,9,53,73,314
441727013,61,14,3,1,79
441746811,119,25,57,1,202
441747637,19,25,2,1,47
441749179,37,8,2,1,48
441750756,43,11,54,10,118
441757049,192,22,71,12,297
441757720,78,15,2,1,96
441757910,12,3,2,1,18
441760653,30,3,2,3,38
441766683,18,4,2,1,25
441768632,17,7,2,1,27
441769601,135,29,3,9,176
441770874,10,15,2,1,28
441779075,102,17,30,3,152
441779988,42,45,2,1,90
441780485,117,22,42,3,184
441782771,106,12,39,1,158
441784976,91,3,2,8,104
441786487,26,28,4,1,59
441795538,110,7,2,26,145
441807693,21,8,2,8,39
441818864,46,68,2,8,124
441824050,10,31,2,3,46
441826203,38,18,40,9,105
441829581,85,19,6,2,112
441847986,97,3,2,1,103
441865126,107,3,2,1,113
441873179,93,17,2,3,115
441882868,92,3,2,1,98
441886977,99,44,2,3,148
441888333,10,5,2,1,18
441901535,15,3,2,1,21
441905238,54,26,32,8,120
441911980,39,3,2,2,46
441920219,18,3,2,1,24
441921170,82,59,17,3,161
441929592,106,11,2,1,120
441930211,49,24,21,24,118
441935717,62,3,2,2,69
441937054,13,15,2,1,31
441937895,17,5,2,1,25
441953998,209,37,4,8,258
441966291,43,3,2,3,51
441973275,41,36,29,3,109
442010273,40,34,40,1,115
442032333,38,59,2,1,100
442037001,42,3,2,1,48
442048058,16,3,2,4,25
442051385,79,4,10,6,99
442052177,64,48,3,21,136
442075726,25,3,2,1,31
442089682,10,5,2,1,18
442097852,72,85,2,3,162
442102175,342,5,12,5,364
442108733,11,3,2,1,17
442116171,13,3,2,1,19
442126767,75,26,31,5,137
442135781,130,12,3,1,146
442155128,42,71,3,4,120
442160460,17,8,3,1,29
442162046,95,18,57,7,177
442172082,64,16,12,7,99
442181173,15,3,2,1,21
442195020,17,4,2,1,24
442195050,79,10,3,5,97
442195398,24,3,2,1,30
442210352,21,5,2,5,33
442212192,73,21,28,2,124
442217601,67,49,17,2,135
442245668,72,39,48,20,179
442246408,141,25,4,3,173
442264862,118,36,13,13,180
442274797,106,21,23,3,153
442281427,103,3,2,1,109
442291421,57,5,2,9,73
442311202,65,7,26,1,99
442331660,62,14,2,3,81
442331808,12,30,3,1,46
442368786,47,35,31,37,150
442381016,23,3,2,1,29
442391677,44,3,2,1,50
442398718,40,51,12,4,107
442408122,24,7,2,1,34
442415010,196,3,2,14,215
442418845,10,3,2,2,17
442428793,129,10,61,4,204
442432303,22,3,2,1,28
442439487,59,33,16,7,115
442440146,43,53,4,16,116
442440151,60,49,31,8,148
442443984,52,3,2,1,58
442448326,31,8,2,4,45
442451306,49,14,6,6,75
442462873,79,3,2,13,97
442466883,17,33,2,1,53
442474550,99,14,2,1,116
442475395,170,31,20,13,234
442485929,72,3,2,1,78
442487099,50,25,8,4,87
442490574,122,40,29,61,252
442491362,15,3,2,16,36
442500442,36,3,2,13,54
442520614,54,51,12,15,132
442522742,51,3,2,8,64
442535146,22,33,2,1,58
442539938,31,3,2,1,37
442554603,37,41,24,5,107
442555077,511,3,2,4,520
442557052,27,3,2,6,38
442558667,22,3,2,1,28
442559418,39,3,2,7,51
442566611,42,33,2,38,115
442570652,90,3,2,1,96
442572670,73,25,3,15,116
442577005,112,84,2,14,212
442577113,42,10,2,2,56
442592995,60,31,6,1,98
442593152,14,50,2,1,67
442628271,18,7,2,1,28
442649684,97,63,2,9,171
442658324,69,9,2,1,81
442663994,57,36,36,26,155
442686968,122,64,59,18,263
442696512,40,72,33,3,148
442705450,35,7,4,2,48
442721103,12,3,2,1,18
442724639,15,3,2,2,22
442786188,144,51,25,3,223
442817854,54,21,66,31,172
442831470,37,73,22,5,137
442845644,106,29,9,6,150
442855139,85,25,27,69,206
442856504,162,17,2,1,182
442864246,58,3,3,9,73
442869427,108,10,41,3,162
442876638,66,21,26,5,118
442879995,160,32,2,2,196
442887080,32,52,16,1,101
442935626,71,24,38,16,149
442938306,133,27,6,3,169
442942078,95,53,78,10,236
442947229,21,18,2,4,45
442953498,96,11,15,2,124
442955486,40,71,2,9,122
442957332,29,6,2,1,38
442957411,111,44,76,4,235
442967699,21,3,2,3,29
442981695,11,3,2,1,17
442985567,35,3,2,4,44
443001565,245,19,2,146,412
443003615,17,3,2,1,23
443018166,10,36,2,1,49
443022655,25,3,2,4,34
443030390,18,14,2,1,35
443030620,59,3,11,1,74
443035565,15,16,2,1,34
443050888,117,39,2,1,159
443067957,49,3,2,1,55
443088619,12,37,2,1,52
443092098,32,18,61,2,113
443119853,80,3,2,1,86
443125011,68,3,2,1,74
443130975,53,51,19,1,124
443131648,34,3,2,2,41
443136708,219,3,2,30,254
443142594,56,7,17,4,84
443143422,48,11,7,2,68
443180869,19,3,2,1,25
443197068,46,25,42,19,132
443206015,63,3,2,1,69
443220525,10,3,2,2,17
443225205,74,63,21,3,161
443259966,10,8,2,3,23
443267600,82,36,66,1,185
443271967,45,27,2,10,84
443278332,147,3,2,1,153
443283107,86,34,27,23,170
443283294,149,50,14,6,219
443299545,42,16,2,1,61
443300387,63,3,2,1,69
443321176,97,3,2,6,108
443345634,10,6,2,1,19
443353502,132,29,13,15,189
443375712,96,73,28,13,210
443378017,19,4,2,1,26
443387372,45,22,38,2,107
443408781,86,3,2,1,92
443442016,94,4,12,7,117
443444571,85,14,45,14,158
443445050,48,28,2,22,100
443457394,102,6,2,1,111
443497705,33,41,2,1,77
443504479,1363,3,2,3,1371
443541966,45,53,2,2,102
443551163,44,6,2,1,53
443552972,102,64,2,9,177
443569649,43,41,55,60,199
443578242,28,18,2,1,49
443581463,111,35,68,3,217
443594478,19,10,5,1,35
443598327,144,25,3,1,173
443598810,91,3,2,8,104
443608740,44,40,9,7,100
443610775,117,37,2,9,165
443611464,22,5,2,4,33
443630959,75,3,4,1,83
443632511,18,17,31,3,69
443640505,144,20,3,19,186
443647018,150,30,2,6,188
443647638,106,65,23,3,197
443648744,89,16,17,1,123
443660733,95,21,2,5,123
443664065,109,3,2,1,115
443669488,15,19,2,1,37
443680554,66,4,2,5,77
443686641,27,3,2,3,35
443688313,96,36,13,1,146
443690161,113,3,2,1,119
443693884,134,44,113,18,309
443702323,70,36,34,24,164
443709475,171,3,2,6,182
443710722,81,51,38,18,188
443715077,44,25,27,1,97
443751584,56,10,8,8,82
443757907,10,29,2,2,43
443763531,75,39,2,2,118
443769293,20,3,2,5,30
443777082,26,53,5,4,88
443791314,42,26,10,1,79
443792433,21,3,2,2,28
443802904,59,29,5,23,116
443813035,12,16,2,2,32
443824997,51,7,26,43,127
443836041,53,6,8,1,68
443850225,151,17,3,17,188
443855196,115,13,2,2,132
443879562,57,34,48,3,142
443884335,16,3,2,2,23
443884370,18,3,2,1,24
443897899,55,3,2,6,66
443916633,236,64,32,8,340
443934338,38,3,2,1,44
443946455,66,29,6,1,102
443947849,142,3,11,1,157
443948014,48,99,51,21,219
443952775,56,3,2,1,62
443957362,52,3,2,1,58
443967362,32,3,2,1,38
443978626,15,3,2,43,63
443979362,55,13,52,1,121
444001923,102,8,2,7,119
444001953,73,13,10,10,106
444006548,14,3,2,1,20
444013039,100,3,2,3,108
444015237,106,15,2,11,134
444037040,16,6,2,8,32
444040579,120,19,2,6,147
444057773,26,51,65,1,143
444063132,87,25,2,24,138
444063305,46,3,2,1,52
444068656,11,3,2,1,17
444079804,11,9,2,1,23
444081115,100,32,21,3,156
444091519,36,28,17,4,85
444102835,166,33,2,4,205
444105347,19,15,2,1,37
444113486,33,3,2,8,46
444119721,16,3,2,1,22
444153425,65,22,2,8,97
444155722,39,46,14,22,121
444163167,112,58,95,2,267
444170026,152,15,2,1,170
444176534,50,72,3,11,136
444204496,92,26,26,3,147
444209879,18,25,2,1,46
444219679,36,3,2,1,42
444222959,16,3,2,1,22
444228438,164,3,2,1,170
444228797,23,3,2,2,30
444233097,55,46,32,2,135
444236214,37,53,2,49,141
444248336,79,21,2,1,103
444252335,40,11,2,1,54
444253134,11,13,5,1,30
444260085,50,3,2,1,56
444268708,11,5,2,1,19
444299977,72,3,2,14,91
444302189,121,45,33,9,208
444318291,23,3,2,1,29
444341703,39,22,17,19,97
444399514,213,38,76,51,378
444407717,18,32,2,7,59
444417210,41,36,17,3,97
444417714,105,3,2,2,112
444440073,59,7,2,1,69
444455253,10,3,2,5,20
444464015,24,12,13,2,51
444480537,34,31,11,18,94
444488863,127,33,5,1,166
444489366,269,3,2,3,277
444494709,61,13,10,22,106
444496353,122,45,55,53,275
444535665,18,18,2,1,39
444550295,132,20,73,15,240
444554875,57,67,9,5,138
444562976,75,3,2,1,81
444596184,17,7,2,2,28
444605095,16,3,2,1,22
444611504,129,13,122,1,265
444615003,10,7,2,1,20
444626737,14,3,2,1,20
444630003,76,3,2,3,84
444644917,82,33,12,12,139
444665366,119,3,2,1,125
444673653,71,23,2,2,98
444674611,42,3,2,1,48
444688877,74,11,12,40,137
444691334,84,29,32,24,169
444705827,39,37,2,2,80
444732598,11,3,2,1,17
444773831,43,31,2,1,77
444794675,94,38,118,3,253
444813475,32,43,2,17,94
444820085,11,25,2,1,39
444825186,27,5,2,5,39
444837965,14,15,38,3,70
444840803,20,35,21,2,78
444845477,164,10,2,6,182
444845715,32,71,21,4,128
444857634,29,16,29,8,82
444860185,151,22,2,1,176
444876114,14,3,2,1,20
444894422,29,3,2,8,42
444895566,19,55,2,4,80
444907200,41,12,8,1,62
444933836,36,3,2,2,43
444939245,16,25,5,2,48
444943606,16,25,4,1,46
444945140,112,47,2,13,174
444946227,14,43,40,1,98
444958111,57,17,88,40,202
444969955,74,51,18,1,144
444985312,183,15,3,5,206
445011462,68,6,9,6,89
445025568,19,45,2,1,67
445028776,17,3,2,1,23
445029943,25,21,2,1,49
445043829,47,78,33,2,160
445056874,51,11,4,5,71
445057024,72,11,2,1,86
445057670,38,106,41,8,193
445070920,126,3,2,3,134
445081521,50,3,2,1,56
445106174,120,20,5,5,150
445110059,54,3,2,1,60
445124299,75,25,16,13,129
445127418,50,22,2,6,80
445147832,21,19,5,4,49
445171403,47,3,2,7,59
445180659,147,3,2,18,170
445183078,34,28,3,20,85
445183401,46,55,49,11,161
445204619,146,38,50,6,240
445213722,11,4,2,1,18
445215509,13,17,2,1,33
445227527,83,51,30,1,165
445236779,72,43,9,3,127
445240409,24,30,18,1,73
445245341,82,21,2,5,110
445252856,75,17,2,3,97
445254354,22,3,2,1,28
445256733,26,44,12,6,88
445261880,111,3,2,9,125
445297804,48,14,12,17,91
445308428,66,29,33,18,146
445311169,14,23,5,1,43
445314886,113,66,2,3,184
445319262,39,19,36,19,113
445324732,14,3,2,2,21
445331185,55,3,3,5,66
445357073,111,3,2,1,117
445359946,13,3,2,1,19
445363223,40,3,2,1,46
445369129,15,3,2,2,22
445369618,46,53,26,3,128
445375333,16,3,2,1,22
445386622,31,3,2,4,40
445401246,22,66,28,1,117
445421130,46,10,2,1,59
445427083,37,13,3,2,55
445434689,87,3,2,1,93
445442626,143,3,2,7,155
445457114,68,26,18,11,123
445491408,19,3,2,1,25
445492105,182,3,2,4,191
445500428,144,51,44,59,298
445531020,21,6,10,1,38
445532670,22,48,6,13,89
445553012,50,20,3,9,82
445583532,218,36,62,2,318
445586208,14,3,2,5,24
445592541,79,10,3,1,93
445596919,12,7,2,1,22
445616700,28,7,2,1,38
445639888,36,43,42,28,149
445644108,139,33,6,23,201
445645331,17,13,3,1,34
445652229,47,10,2,1,60
445652655,49,43,70,3,165
445658472,126,29,4,5,164
445688290,18,3,2,1,24
445703137,94,30,11,9,144
445707430,72,8,19,3,102
445708097,101,25,46,14,186
445714253,31,60,3,64,158
445720822,12,3,2,3,20
445721566,53,38,26,8,125
445735611,24,3,2,1,30
445742309,44,3,2,1,50
445757013,25,3,2,1,31
445763877,46,16,2,1,65
445773542,66,53,16,3,138
445782701,111,20,93,22,246
445786723,149,25,2,2,178
445790640,35,13,19,1,68
445793258,20,3,2,1,26
445801756,51,49,30,1,131
445803507,50,19,9,3,81
445835364,32,3,2,1,38
445836744,32,42,3,1,78
445839143,71,9,13,1,94
445843575,134,3,2,9,148
445861488,13,3,2,1,19
445871320,25,5,6,3,39
445875531,43,78,2,7,130
445887764,162,3,2,1,168
445893562,10,3,2,2,17
445900179,102,48,34,3,187
445909232,99,23,5,2,129
445909880,14,3,2,13,32
445915556,130,61,2,9,202
445947085,14,3,2,1,20
445953766,10,3,2,2,17
445958018,11,9,2,1,23
445963437,13,3,2,2,20
445966818,172,3,2,1,178
445967962,52,3,2,1,58
445970623,53,5,2,1,61
445971968,41,9,18,12,80
445978197,91,18,77,53,239
445982578,273,3,2,1,279
445991738,16,32,5,1,54
445993072,55,3,2,1,61
445993711,67,63,2,5,137
446001495,33,23,6,5,67
446011016,143,15,2,6,166
446012439,84,47,25,2,158
446013662,20,8,3,5,36
446021782,29,3,2,1,35
446029403,16,21,2,1,40
446029768,69,10,2,1,82
446037986,58,16,44,11,129
446045448,144,6,41,4,195
446053729,47,4,2,1,54
446054481,29,3,2,1,35
446058541,748,3,2,6,759
446069433,130,3,2,27,162
446070212,62,27,3,10,102
446083634,79,10,2,2,93
446087223,76,20,2,1,99
446092199,137,3,2,8,150
446095373,21,84,2,1,108
446107348,150,12,39,1,202
446109398,94,3,2,1,100
446110249,41,78,3,15,137
446111444,11,9,6,3,29
446122184,14,51,2,2,69
446127844,38,29,16,1,84
446129878,216,48,17,3,284
446145130,19,3,2,1,25
446146895,92,3,2,1,98
446171982,186,28,21,7,242
446176169,91,3,2,19,115
446194849,15,25,2,1,43
446195518,95,3,2,61,161
446195594,85,6,2,11,104
446224349,94,5,33,26,158
446249292,11,19,2,1,33
446254236,15,3,2,1,21
446256465,77,21,2,1,101
446264512,42,54,24,11,131
446267556,58,34,33,1,126
446274488,73,7,11,2,93
446279740,89,20,4,1,114
446319298,155,38,48,1,242
446320865,175,55,93,79,402
446334396,164,76,2,8,250
446341611,94,3,3,1,101
446356226,164,11,7,6,188
446374431,48,30,53,11,142
446380320,49,23,2,1,75
446430344,95,21,4,1,121
446444263,78,3,2,4,87
446450385,139,3,2,1,145
446457211,58,4,15,12,89
446467024,42,20,16,9,87
446469072,77,30,16,1,124
446483750,59,50,22,5,136
446505496,22,22,2,4,50
446522330,25,21,23,5,74
446539918,75,9,4,1,89
446551338,62,18,2,1,83
446572547,21,3,2,1,27
446574005,40,51,31,25,147
446579448,51,3,2,1,57
446586241,21,33,4,1,59
446586396,11,12,2,1,26
446618683,33,3,2,1,39
446621446,63,52,25,6,146
446623966,17,92,5,1,115
446632750,86,3,2,4,95
446636684,133,3,2,5,143
446650542,34,32,5,3,74
446651702,64,59,77,2,202
446664620,127,37,2,36,202
446668884,24,3,2,1,30
446683921,20,19,2,2,43
446686847,25,3,2,1,31
446701043,73,14,132,10,229
446704208,14,6,3,3,26
446705151,23,67,4,14,108
446708424,21,3,2,1,27
446717248,23,50,5,8,86
446722662,34,29,14,1,78
446734564,138,28,72,5,243
446735787,312,6,2,1,321
446743931,15,50,2,1,68
446746579,84,21,2,7,114
446751255,111,5,18,3,137
446753178,46,33,3,2,84
446760547,200,12,22,1,235
446760802,91,27,38,8,164
446764270,12,3,2,1,18
446777506,11,3,2,1,17
446780253,96,23,2,1,122
446799882,11,3,2,1,17
446812852,21,20,38,12,91
446813377,98,3,2,16,119
446816815,104,13,2,1,120
446820121,26,38,24,4,92
446824768,58,3,2,1,64
446825872,89,49,2,1,141
446827957,171,3,2,4,180
446829700,10,3,2,3,18
446834901,21,3,2,4,30
446844878,43,70,34,3,150
446847794,53,6,2,5,66
446858421,43,17,2,4,66
446864568,10,3,2,2,17
446884433,97,3,2,3,105
446885735,32,24,5,3,64
446890192,44,7,2,45,98
446902149,15,32,2,2,51
446906550,108,34,35,35,212
446913310,85,3,2,1,91
446920047,57,39,2,3,101
446925806,27,28,2,1,58
446928130,22,48,2,1,73
446941248,34,51,2,8,95
446942553,78,23,33,1,135
446945375,68,53,2,6,129
446947557,33,25,3,1,62
446954867,106,37,68,2,213
446966315,77,38,41,11,167
446968364,51,54,12,2,119
446971145,17,7,2,1,27
446976697,52,11,3,1,67
446987084,13,4,2,1,20
446987497,41,6,2,1,50
446992262,83,69,30,5,187
447005285,135,3,2,5,145
447007464,15,18,2,1,36
447007773,39,8,2,1,50
447008729,40,26,15,25,106
447024286,73,3,2,17,95
447033965,36,44,3,1,84
447043685,43,21,2,9,75
447048985,19,7,2,1,29
447054506,68,3,2,1,74
447059325,20,3,2,1,26
447076217,83,27,2,4,116
447083181,73,3,2,7,85
447088471,54,3,2,4,63
447094213,58,7,2,2,69
447107997,38,13,2,1,54
447141151,49,35,2,4,90
447146548,128,32,12,8,180
447154252,19,14,2,1,36
447165658,375,3,2,3,383
447174071,68,14,2,2,86
447192082,55,3,2,2,62
447192207,42,36,18,5,101
447195275,32,17,103,6,158
447200057,83,36,13,1,133
447201628,79,25,2,1,107
447222091,108,40,2,24,174
447223020,13,7,2,1,23
447232230,19,34,7,20,80
447232872,16,19,2,1,38
447239719,10,6,2,2,20
447251082,14,16,2,3,35
447260430,53,3,13,1,70
447262261,38,29,21,4,92
447264725,79,11,2,1,93
447302428,34,9,2,63,108
447306867,40,9,2,1,52
447308566,20,25,22,57,124
447318924,61,60,2,2,125
447321099,25,6,3,9,43
447365020,70,18,17,12,117
447368200,101,46,6,4,157
447372301,125,3,2,1,131
447379746,15,3,2,1,21
447380975,206,3,2,53,264
447383176,23,3,2,1,29
447388543,82,20,13,10,125
447414363,17,3,2,1,23
447415659,67,3,2,1,73
447416322,85,3,2,3,93
447417131,21,15,7,8,51
447432203,188,5,2,2,197
447458683,13,3,2,1,19
447461800,50,5,37,3,95
447465409,117,12,2,1,132
447477664,39,3,2,1,45
447483593,371,3,2,2,378
447500242,117,46,7,51,221
447539860,11,10,2,1,24
447552693,10,3,3,1,17
447571754,20,40,11,1,72
447581595,83,15,2,1,101
447611675,11,3,2,1,17
447613255,109,6,61,13,189
447641690,26,3,2,1,32
447649874,17,15,2,4,38
447676558,134,3,2,15,154
447691234,65,3,2,1,71
447706258,153,237,59,19,468
447712300,22,41,50,1,114
447714464,50,3,2,4,59
447715383,92,23,9,2,126
447717192,69,3,2,1,75
447722306,186,3,2,1,192
447723310,93,11,2,2,108
447727561,31,88,7,2,128
447734283,10,6,2,1,19
447740927,85,25,2,5,117
447743660,49,3,16,7,75
447751707,44,3,2,1,50
447758305,12,3,2,1,18
447773120,95,23,33,26,177
447799200,71,24,2,1,98
447803521,14,3,2,1,20
447832688,57,7,2,1,67
447840483,59,9,3,1,72
447841558,54,144,22,14,234
447857579,66,9,2,9,86
447858304,39,31,31,15,116
447875887,15,3,2,1,21
447876076,50,25,2,2,79
447878035,11,11,2,1,25
447884790,80,30,33,8,151
447888535,40,3,2,6,51
447902581,14,3,2,5,24
447907144,22,3,2,1,28
447913564,13,7,2,1,23
447930422,31,44,3,35,113
447939960,56,39,36,9,140
447969363,53,11,28,2,94
447984755,30,30,29,2,91
447989009,50,14,5,6,75
448006418,45,3,2,10,60
448015146,71,30,19,8,128
448042097,10,13,2,1,26
448062368,180,3,2,7,192
448072864,131,63,13,52,259
448088517,89,9,8,4,110
448089056,13,17,2,1,33
448089178,36,95,32,14,177
448093048,27,3,2,7,39
448098081,25,6,11,9,51
448098927,56,22,15,24,117
448103807,85,10,6,13,114
448104082,10,11,2,1,24
448107845,39,3,2,3,47
448124802,36,9,2,3,50
448127862,49,3,2,1,55
448137721,55,6,5,16,82
448139966,104,42,20,25,191
448140993,17,4,2,4,27
448143162,131,20,55,13,219
448149585,49,23,3,5,80
448196901,51,38,79,9,177
448214011,107,16,2,1,126
448243260,103,29,31,1,164
448252384,84,26,5,1,116
448256032,21,4,2,1,28
448294932,37,3,2,1,43
448303887,56,3,2,2,63
448311548,120,61,4,8,193
448337988,40,26,25,7,98
448362429,106,3,2,1,112
448376015,106,12,2,1,121
448378492,11,3,2,1,17
448401845,169,3,2,3,177
448402630,101,4,20,1,126
448403233,83,21,51,4,159
448405400,10,4,2,1,17
448411538,18,3,2,1,24
448419448,151,45,8,6,210
448420254,51,28,2,2,83
448423611,44,50,30,8,132
448427413,74,12,8,2,96
448430307,79,3,2,1,85
448445810,13,3,2,1,19
448452578,11,3,2,1,17
448476487,102,53,71,14,240
448494236,43,63,13,3,122
448512451,11,3,2,1,17
448518898,130,3,2,1,136
448529305,10,8,2,1,21
448553213,58,48,31,6,143
448566922,10,3,2,3,18
448567028,161,3,2,5,171
448570532,45,3,2,1,51
448588077,23,10,2,1,36
448588382,12,3,2,1,18
448608938,46,3,2,2,53
448609297,75,32,5,1,113
448617169,160,63,101,62,386
448637807,28,31,2,1,62
448652325,99,3,2,13,117
448661410,18,10,16,5,49
448672652,76,3,2,1,82
448680208,42,25,6,1,74
448702278,102,12,19,11,144
448702812,64,51,10,10,135
448707761,217,3,2,11,233
448708834,85,97,3,20,205
448727099,87,3,2,1,93
448733491,194,18,15,15,242
448736108,159,3,2,20,184
448740690,46,21,32,10,109
448744754,32,118,40,1,191
448769244,10,3,3,3,19
448771194,39,24,3,35,101
448774858,22,41,7,5,75
448779650,11,38,2,1,52
448795494,71,17,33,50,171
448800513,94,14,2,22,132
448801318,67,24,21,9,121
448804494,15,3,2,1,21
448809795,41,21,2,1,65
448817786,37,17,6,6,66
448824316,53,9,4,2,68
448828644,21,3,2,1,27
448832781,28,31,5,1,65
448844582,93,8,22,20,143
448844942,97,9,10,1,117
448855775,184,13,6,4,207
448874437,11,3,2,1,17
448875895,14,3,2,1,20
448882607,45,3,2,8,58
448885592,115,13,2,2,132
448890811,160,25,33,4,222
448919276,156,51,95,73,375
448919780,112,3,2,1,118
448931184,37,29,4,6,76
448940009,189,16,2,4,211
448945916,87,6,15,3,111
448954071,26,18,7,1,52
448958739,173,7,7,1,188
448962082,124,28,2,4,158
448963882,50,32,19,10,111
448972544,63,4,17,14,98
448973987,35,77,2,1,115
448977587,11,3,2,2,18
448984271,111,6,25,5,147
448985850,35,21,47,1,104
448986366,45,43,3,1,92
449014411,68,22,2,1,93
449017252,10,10,2,1,23
449028288,16,3,2,1,22
449059235,10,10,2,1,23
449075042,53,3,2,23,81
449075487,118,29,3,8,158
449077939,20,3,2,3,28
449080740,28,3,9,3,43
449089310,129,3,2,20,154
449096513,18,3,2,1,24
449111970,97,27,3,8,135
449117713,112,8,13,8,141
449150405,210,3,2,4,219
449156095,233,86,4,19,342
449159226,168,38,6,12,224
449163912,125,21,33,11,190
449180138,11,43,2,1,57
449184051,26,9,2,4,41
449186544,10,4,2,2,18
449187955,22,12,2,1,37
449192365,105,73,16,2,196
449197425,16,3,2,1,22
449197725,37,38,3,17,95
449197787,128,4,3,13,148
449200051,33,43,14,22,112
449235186,39,5,2,2,48
449239791,62,59,73,18,212
449263410,32,3,2,1,38
449264047,13,15,2,1,31
449269613,102,37,2,27,168
449279559,70,47,53,5,175
449309220,57,27,27,7,118
449316825,11,3,2,1,17
449319950,17,3,2,2,24
449322945,120,27,2,41,190
449330935,58,3,2,2,65
449349373,33,63,2,6,104
449365438,31,14,2,1,48
449366814,64,16,10,1,91
449376013,27,7,2,22,58
449388602,38,3,2,1,44
449401285,54,7,11,1,73
449414139,107,55,51,17,230
449431066,40,30,2,1,73
449440581,106,3,2,1,112
449444353,105,52,12,18,187
449454687,98,3,2,4,107
449457392,11,34,2,1,48
449460777,24,50,37,4,115
449462799,16,14,2,1,33
449463164,13,3,2,5,23
449466481,11,3,2,1,17
449472690,107,83,5,5,200
449483400,144,3,2,6,155
449496506,84,3,2,3,92
449501091,30,3,2,1,36
449526459,1178,3,2,12,1195
449526691,165,24,2,1,192
449527463,48,94,31,6,179
449530403,25,29,13,2,69
449549943,150,15,30,7,202
449557992,133,52,23,1,209
449559905,41,7,5,3,56
449561220,13,5,4,3,25
449564565,266,3,2,4,275
449569848,25,3,28,3,59
449570432,76,24,17,1,118
449579703,89,24,9,9,131
449584041,24,4,2,9,39
449591489,75,34,17,1,127
449592404,77,60,26,15,178
449592832,75,20,24,8,127
449615677,13,3,2,2,20
449620407,99,52,2,5,158
449621649,30,3,2,1,36
449622170,83,3,2,18,106
449634704,50,12,6,1,69
449635809,228,65,2,11,306
449640624,72,8,2,1,83
449679756,31,28,2,1,62
449681468,68,3,2,1,74
449682636,58,27,2,7,94
449702372,63,26,2,2,93
449703033,64,21,4,6,95
449709175,53,3,2,1,59
449715525,21,3,2,1,27
449717938,61,9,2,2,74
449732612,92,4,31,1,128
449734478,38,67,2,3,110
449734909,126,38,49,5,218
449735273,200,3,2,1,206
449764437,32,49,8,26,115
449765347,33,15,2,4,54
449773121,33,3,2,2,40
449774170,15,23,20,3,61
449808237,20,6,2,2,30
449816044,22,6,2,1,31
449830991,132,48,8,19,207
449843803,176,3,2,1,182
449855711,11,3,2,1,17
449861691,38,45,2,4,89
449870135,13,7,2,1,23
449881292,10,3,2,3,18
449896930,13,10,4,1,28
449899548,76,15,2,1,94
449909853,14,3,2,1,20
449913576,98,12,24,9,143
449929261,19,3,2,1,25
449936667,93,40,30,3,166
449936747,40,30,4,2,76
449936810,10,4,2,1,17
449948552,39,5,2,10,56
449952241,24,3,2,3,32
449958207,30,40,12,1,83
449961102,11,3,2,1,17
449980901,85,19,2,3,109
449997819,80,32,24,1,137
450002711,13,3,2,1,19
450014557,61,55,2,34,152
450015078,27,3,2,1,33
450041036,64,3,2,1,70
450052775,151,3,2,4,160
450071313,95,11,2,1,109
450076715,28,28,2,12,70
450083639,80,3,2,1,86
450084340,83,16,2,4,105
450094025,17,37,2,4,60
450097821,32,3,2,1,38
450105525,31,23,12,9,75
450110601,79,18,24,1,122
450126988,49,13,2,6,70
450144096,67,27,9,2,105
450153419,88,11,3,5,107
450156307,48,34,2,1,85
450169652,137,31,3,1,172
450175827,137,3,2,36,178
450177844,10,6,2,1,19
450191379,58,3,2,2,65
450196562,15,3,2,1,21
450210284,329,3,2,15,349
450221711,165,9,16,19,209
450224803,47,27,12,10,96
450225468,142,3,2,1,148
450241209,94,3,2,1,100
450244806,57,18,39,21,135
450251811,23,13,2,1,39
450273134,45,3,2,4,54
450274045,94,3,2,1,100
450278086,129,3,2,1,135
450284382,196,3,2,12,213
450285701,12,8,2,1,23
450289881,61,5,2,3,71
450294955,25,24,31,1,81
450314148,78,3,2,1,84
450325698,73,3,2,23,101
450326557,19,89,43,20,171
450337099,44,36,19,45,144
450372086,183,3,2,1,189
450393759,12,3,2,6,23
450394221,70,11,2,1,84
450409464,151,3,2,1,157
450443658,71,33,121,15,240
450444349,74,36,2,55,167
450459614,38,36,11,2,87
450481821,65,85,41,65,256
450494348,20,21,2,2,45
450501835,32,3,2,23,60
450505891,30,3,2,1,36
450508031,107,3,2,4,116
450529091,73,36,68,1,178
450536875,48,3,2,1,54
450539903,38,3,2,6,49
450556141,157,37,5,15,214
450559186,48,22,2,30,102
450572379,107,29,4,32,172
450573237,56,79,34,1,170
450574186,13,3,2,1,19
450580261,30,23,11,1,65
450587433,221,30,2,32,285
450595055,35,3,2,13,53
450604608,161,13,2,5,181
450622030,68,21,51,1,141
450631171,64,18,17,23,122
450637997,196,3,2,20,221
450645596,77,49,34,20,180
450645876,189,3,2,42,236
450646376,11,3,2,2,18
450648397,41,3,2,1,47
450670579,104,9,12,7,132
450677386,20,3,2,1,26
450684072,217,29,4,3,253
450692426,67,15,46,5,133
450739951,38,31,6,1,76
450742813,129,31,54,1,215
450750689,61,14,17,1,93
450759618,11,3,2,1,17
450770613,155,7,2,6,170
450773197,54,23,4,15,96
450775574,12,3,2,4,21
450777553,127,32,2,4,165
450796363,41,68,73,7,189
450803423,88,28,2,3,121
450806309,96,8,21,2,127
450822124,93,29,2,1,125
450831354,69,3,2,1,75
450842525,66,55,2,3,126
450851259,32,41,3,4,80
450859481,89,20,2,7,118
450861384,49,5,3,1,58
450862764,35,24,51,10,120
450863208,73,3,2,1,79
450866195,48,3,21,1,73
450869405,31,32,10,1,74
450888610,74,5,6,11,96
450890860,75,3,2,1,81
450897780,139,3,2,1,145
450899468,11,3,2,1,17
450903543,15,4,2,1,22
450914938,55,66,2,2,125
450917402,24,29,2,3,58
450944407,97,23,26,12,158
450950179,99,3,2,2,106
450999021,12,3,2,1,18
451002445,15,3,2,1,21
451013999,32,17,7,1,57
451018882,43,3,2,1,49
451021966,99,3,2,30,134
451033867,191,14,12,1,218
451035839,13,5,2,3,23
451038763,114,3,2,1,120
451047865,90,58,23,2,173
451075169,151,36,4,6,197
451083989,17,3,2,2,24
451097279,82,29,115,15,241
451130972,31,56,61,14,162
451148042,18,4,2,1,25
451163804,31,3,2,1,37
451172683,159,7,3,6,175
451209039,95,30,2,1,128
451210902,49,50,44,120,263
451225374,13,3,2,1,19
451226528,18,3,2,2,25
451240069,51,46,11,15,123
451254408,35,36,39,41,151
451274219,10,25,2,1,38
451282210,30,10,9,1,50
451284308,12,14,2,1,29
451292721,115,85,3,10,213
451296765,55,41,17,23,136
451299978,29,24,47,1,101
451324007,92,58,42,25,217
451324605,141,46,23,2,212
451330297,70,26,11,3,110
451332297,35,21,3,2,61
451337424,24,19,2,1,46
451343375,107,3,2,1,113
451368613,18,3,2,1,24
451380000,331,3,2,2,338
451383342,87,20,2,12,121
451388380,59,24,25,11,119
451413982,17,3,2,1,23
451420727,71,30,8,4,113
451430258,57,27,116,1,201
451434141,52,30,2,1,85
451435182,105,6,2,2,115
451442774,29,3,2,1,35
451448917,71,3,26,1,101
451461712,38,11,2,4,55
451468712,35,39,18,1,93
451472146,82,21,20,7,130
451484173,34,5,22,8,69
451488835,70,3,2,4,79
451491544,15,3,2,8,28
451496121,43,58,20,1,122
451497541,86,9,70,3,168
451499295,205,10,5,1,221
451506517,10,5,2,6,23
451517795,154,25,2,3,184
451523257,20,3,2,1,26
451526284,205,47,69,10,331
451538102,91,33,2,13,139
451560758,159,3,2,3,167
451562705,120,22,12,25,179
451574479,10,9,2,1,22
451575791,105,12,17,5,139
451583652,75,19,12,7,113
451602023,16,3,2,3,24
451614808,12,3,2,3,20
451621834,11,3,2,1,17
451623210,20,13,2,2,37
451626539,116,3,2,1,122
451628543,120,11,69,2,202
451636005,231,3,2,1,237
451641724,20,3,3,1,27
451643929,106,3,2,1,112
451660423,35,3,2,9,49
451661150,14,3,2,1,20
451662184,123,28,4,1,156
451664194,11,3,2,1,17
451664457,11,12,2,1,26
451669285,10,9,2,1,22
451700977,150,19,33,14,216
451712683,85,8,8,2,103
451718481,54,8,12,5,79
451723040,17,3,2,1,23
451723070,76,46,33,25,180
451727591,153,3,2,25,183
451731407,146,26,64,4,240
451753179,23,36,2,2,63
451756089,153,17,2,4,176
451770365,95,21,17,1,134
451781729,42,13,2,1,58
451789502,71,36,69,8,184
451809898,96,6,2,1,105
451810099,92,19,2,1,114
451813556,119,18,2,1,140
451813963,332,3,2,69,406
451822415,16,31,2,1,50
451830176,51,3,2,1,57
451837499,213,3,2,2,220
451840384,15,15,2,1,33
451846526,12,12,2,1,27
451889676,25,24,10,3,62
451898278,52,12,2,1,67
451906171,69,3,2,1,75
451906367,18,21,2,1,42
451906790,77,43,50,6,176
451908867,37,68,2,9,116
451911463,101,25,14,24,164
451916091,17,48,12,2,79
451921892,36,55,3,8,102
451928321,81,3,2,1,87
451939062,269,3,2,49,323
451953082,11,3,2,1,17
451958691,29,3,2,4,38
451963048,221,3,2,6,232
451964420,107,5,2,37,151
451969141,111,48,62,49,270
451974468,169,3,2,20,194
451975669,13,18,2,1,34
451978115,55,9,33,4,101
451984329,51,25,9,1,86
451999027,54,15,10,4,83
452007518,196,3,2,5,206
452009273,79,4,8,5,96
452030405,63,24,12,5,104
452045654,53,23,4,1,81
452080004,10,9,2,1,22
452080383,123,3,2,10,138
452094099,21,9,5,2,37
452096282,66,29,55,35,185
452098026,57,19,3,4,83
452111647,12,3,2,3,20
452112126,53,36,10,24,123
452115283,63,18,2,1,84
452128062,11,12,2,1,26
452137172,25,9,2,69,105
452138170,72,3,2,3,80
452140302,59,3,2,1,65
452147114,48,16,20,15,99
452149814,14,3,2,1,20
452164934,73,45,40,8,166
452175269,21,3,2,1,27
452177895,73,16,4,3,96
452180569,108,32,153,1,294
452184408,24,3,2,1,30
452219340,10,9,2,1,22
452221083,25,8,2,3,38
452223179,15,3,2,1,21
452240591,132,6,6,9,153
452268692,33,12,4,3,52
452276357,57,3,2,12,74
452280993,105,19,7,1,132
452286795,11,8,2,1,22
452287498,78,35,67,3,183
452297406,144,3,2,1,150
452309384,168,5,2,2,177
452331973,40,27,26,8,101
452337377,24,43,3,22,92
452339166,81,15,20,3,119
452342619,12,46,2,3,63
452370602,61,18,2,9,90
452376447,37,32,2,4,75
452390847,162,38,12,3,215
452391497,114,31,117,32,294
452402894,48,3,2,1,54
452413099,115,76,7,2,200
452435797,11,3,2,1,17
452440351,14,6,2,1,23
452446286,29,8,2,1,40
452465609,90,9,2,3,104
452474522,57,42,24,2,125
452475715,29,3,2,3,37
452484277,10,15,2,2,29
452486200,66,36,3,16,121
452491292,94,25,24,1,144
452498161,51,16,2,3,72
452506677,14,3,2,1,20
452531785,115,16,2,8,141
452558215,53,3,2,4,62
452564298,19,30,89,6,144
452564781,18,14,6,1,39
452567012,186,3,2,8,199
452569730,132,3,2,1,138
452569786,115,15,2,1,133
452577537,26,3,5,1,35
452617665,63,3,2,3,71
452621343,86,41,26,1,154
452622459,40,22,2,1,65
452636292,408,5,2,31,446
452647445,10,4,2,1,17
452648985,74,3,2,1,80
452650217,16,3,2,1,22
452659190,38,3,2,2,45
452659201,128,3,2,1,134
452670884,10,7,2,1,20
452671470,83,10,3,6,102
452674245,58,11,2,7,78
452677239,85,15,14,6,120
452688103,25,3,2,2,32
452688512,32,13,2,4,51
452695231,21,20,3,1,45
452696467,24,3,2,1,30
452698040,102,17,7,21,147
452699797,172,56,64,9,301
452712564,57,16,5,5,83
452715953,34,9,3,1,47
452727002,149,3,2,2,156
452735075,49,14,2,1,66
452772509,197,30,2,9,238
452774466,145,26,2,13,186
452786071,37,3,2,2,44
452788442,48,25,11,6,90
452794189,19,36,12,10,77
452811605,83,19,2,7,111
452819035,18,25,13,3,59
452819266,101,3,2,1,107
452827010,141,115,35,38,329
452833017,10,3,2,2,17
452848719,12,3,2,1,18
452851279,58,82,79,12,231
452857712,86,10,2,1,99
452861590,24,34,2,13,73
452864670,70,41,2,5,118
452867822,41,3,2,1,47
452878970,130,33,76,45,284
452888895,43,30,2,19,94
452892332,31,3,2,1,37
452902461,104,31,2,5,142
452911942,66,9,2,4,81
452915785,78,46,8,1,133
452922861,11,3,2,1,17
452930093,11,3,2,1,17
452930358,13,12,2,1,28
452930587,70,13,8,1,92
452943496,72,76,35,15,198
452944590,47,16,27,1,91
452955446,26,22,25,8,81
452958341,84,25,18,34,161
452963756,17,10,2,1,30
452970900,69,19,2,1,91
452973776,40,22,9,11,82
452973969,74,8,16,28,126
452987066,13,18,2,1,34
453014411,52,6,2,23,83
453028896,13,9,4,2,28
453036757,102,6,2,13,123
453042985,91,4,3,7,105
453064608,11,3,2,1,17
453084097,20,3,2,1,26
453090567,165,11,12,5,193
453096456,23,18,2,24,67
453096845,13,3,4,1,21
453162486,74,31,2,2,109
453182136,81,3,2,5,91
453186766,41,44,2,1,88
453199763,11,3,2,1,17
453216151,69,20,2,1,92
453219156,68,3,2,2,75
453219695,178,16,29,40,263
453224940,45,63,20,1,129
453227402,85,28,53,22,188
453231056,43,3,2,1,49
453243277,20,3,2,1,26
453244154,11,6,2,1,20
453251942,11,4,2,1,18
453262046,45,26,18,25,114
453267867,66,40,4,1,111
453281507,84,84,72,2,242
453290090,147,20,97,4,268
453313775,82,24,14,1,121
453315149,39,16,9,5,69
453323673,37,16,2,5,60
453328582,39,39,12,1,91
453328618,59,8,2,11,80
453332888,30,29,35,3,97
453336214,10,5,2,1,18
453337723,54,29,26,1,110
453345327,33,27,32,1,93
453355314,48,24,58,61,191
453361898,40,3,2,5,50
453366420,62,7,2,10,81
453378077,185,3,2,5,195
453405184,57,3,2,1,63
453417699,291,19,51,6,367
453418921,47,14,2,13,76
453440158,52,7,11,5,75
453450171,457,3,2,49,511
453453742,33,18,2,3,56
453455673,35,50,37,19,141
453461079,64,3,2,1,70
453474110,34,17,7,1,59
453475239,146,15,2,2,165
453478829,10,5,2,1,18
453482227,32,33,11,9,85
453486754,146,9,2,23,180
453516780,56,35,32,1,124
453543755,24,21,2,2,49
453547606,118,15,3,1,137
453551002,1123,3,2,72,1200
453563067,13,3,2,1,19
453563258,44,36,58,1,139
453575598,45,60,44,18,167
453581081,59,30,21,1,111
453581466,110,3,2,1,116
453582966,18,9,2,1,30
453593296,59,14,2,2,77
453593886,117,57,157,9,340
453600667,115,15,24,17,171
453600673,42,6,43,1,92
453603749,22,27,15,2,66
453607510,90,79,24,58,251
453614113,32,129,7,2,170
453622030,25,4,2,1,32
453622606,18,5,7,3,33
453629757,26,142,47,2,217
453634413,45,8,2,4,59
453636403,27,5,2,1,35
453643810,82,11,2,1,96
453648199,99,3,2,3,107
453656197,21,70,11,1,103
453663788,168,14,20,2,204
453676820,50,32,2,2,86
453677813,148,33,2,3,186
453683860,80,13,2,1,96
453692396,12,4,7,1,24
453695204,61,78,8,36,183
453700899,79,3,2,1,85
453713812,14,3,2,1,20
453730091,26,64,2,1,93
453731016,20,3,4,1,28
453733619,70,29,87,16,202
453734043,49,33,17,25,124
453737978,29,3,2,1,35
453740353,120,3,2,2,127
453748065,16,104,2,6,128
453751897,49,19,2,1,71
453757018,46,4,22,23,95
453771484,51,3,2,9,65
453777853,20,10,2,1,33
453788900,37,88,22,2,149
453807397,69,3,2,1,75
453820571,157,3,2,4,166
453823403,30,69,2,4,105
453838706,12,38,2,3,55
453845033,76,57,10,3,146
453849536,40,11,2,1,54
453852910,170,29,3,1,203
453859942,70,3,2,5,80
453865905,255,3,2,3,263
453866486,136,19,8,24,187
453877441,12,3,2,1,18
453885897,31,26,2,9,68
453886112,34,4,71,1,110
453887937,34,26,14,1,75
453890585,200,37,2,7,246
453904909,27,56,4,10,97
453924889,39,31,7,1,78
453954174,47,73,10,44,174
453969847,109,3,2,47,161
453977219,22,7,3,5,37
453996292,17,3,2,1,23
454015170,33,21,2,1,57
454039383,43,37,62,1,143
454044915,84,3,2,7,96
454054093,51,49,6,6,112
454066653,26,26,2,2,56
454073854,36,5,2,20,63
454078410,68,7,2,1,78
454093529,122,10,2,2,136
454100446,34,14,2,8,58
454137161,62,41,3,10,116
454141256,134,16,2,6,158
454155143,95,4,2,5,106
454157409,91,64,5,10,170
454159654,155,28,3,1,187
454159952,101,18,4,1,124
454184221,176,47,36,11,270
454200672,40,23,22,16,101
454204941,149,21,17,3,190
454213440,109,3,2,1,115
454224315,117,12,12,78,219
454226312,15,3,2,1,21
454229329,35,3,2,1,41
454266120,144,42,12,4,202
454287419,15,3,2,1,21
454288666,45,6,2,4,57
454313601,78,8,38,6,130
454314063,15,8,2,1,26
454321810,72,3,2,11,88
454355732,31,31,2,1,65
454386414,75,106,3,14,198
454394523,35,3,2,1,41
454400535,24,3,2,1,30
454415356,114,9,2,1,126
454443623,509,3,2,5,519
454460041,472,3,2,3,480
454461574,23,22,2,1,48
454473357,12,13,2,1,28
454485177,27,14,17,4,62
454514917,14,3,2,1,20
454515558,89,10,4,4,107
454529851,114,23,56,13,206
454530443,18,3,2,1,24
454557559,35,3,2,6,46
454575318,59,8,3,2,72
454580570,17,3,2,4,26
454581254,46,3,9,3,61
454616306,197,35,47,9,288
454616508,69,15,48,22,154
454616538,18,30,2,2,52
454616696,93,3,2,17,115
454625106,27,3,2,3,35
454646761,121,3,38,10,172
454648317,11,3,2,1,17
454658759,45,37,2,10,94
454662252,119,3,2,7,131
454664572,19,21,6,5,51
454688615,122,12,3,2,139
454691321,36,48,6,5,95
454694188,121,3,2,1,127
454696558,47,20,38,5,110
454701398,55,13,2,2,72
454709199,29,4,2,1,36
454725110,13,3,2,1,19
454728379,17,69,38,1,125
454728925,57,3,2,1,63
454735872,12,3,2,1,18
454750783,44,6,14,1,65
454760885,17,9,2,1,29
454774779,91,44,4,21,160
454780875,39,27,2,1,69
454784926,79,17,9,12,117
454787758,16,3,2,1,22
454813692,73,42,4,18,137
454827593,149,3,2,11,165
454843485,13,29,2,1,45
454843723,122,3,2,1,128
454847867,26,3,2,2,33
454850398,11,6,2,2,21
454851289,81,16,56,21,174
454852857,18,6,2,1,27
454857029,12,3,2,1,18
454885281,136,21,36,1,194
454891202,86,16,13,12,127
454892774,59,52,27,1,139
454914394,83,33,19,10,145
454928406,85,3,9,1,98
454931182,23,29,12,3,67
454937883,15,7,2,1,25
454950406,30,5,37,1,73
454962662,30,42,2,4,78
454963200,20,4,2,4,30
454966085,10,8,2,1,21
454998007,110,54,10,9,183
454999482,11,4,2,1,18
455002050,13,14,2,1,30
455007625,57,23,9,23,112
455011994,153,19,42,12,226
455021776,10,3,2,7,22
455042632,345,3,2,15,365
455061755,100,28,26,4,158
455072610,43,37,4,19,103
455074810,11,3,2,1,17
455077712,69,20,31,10,130
455079387,30,45,16,6,97
455083093,17,3,2,1,23
455084188,61,48,23,5,137
455085174,73,3,2,12,90
455091425,266,3,2,1,272
455099895,35,32,2,1,70
455101628,31,61,8,1,101
455108741,62,6,19,5,92
455116553,32,51,2,4,89
455119645,92,3,2,1,98
455130799,13,12,2,1,28
455134129,132,31,36,3,202
455143065,21,3,2,1,27
455171051,59,22,18,20,119
455176924,33,65,3,1,102
455185150,48,26,2,3,79
455190486,39,18,8,2,67
455208089,69,19,39,11,138
455220432,78,19,2,1,100
455221368,46,23,19,4,92
455235190,17,20,17,1,55
455255180,50,3,2,1,56
455256467,36,3,2,1,42
455258630,20,43,11,2,76
455263066,70,4,2,1,77
455279653,106,30,2,5,143
455281707,31,22,3,1,57
455288577,120,24,2,3,149
455315364,53,3,2,1,59
455318869,30,4,5,4,43
455326630,12,3,2,3,20
455344456,51,42,2,9,104
455352816,35,65,7,14,121
455362517,100,37,13,10,160
455383689,114,43,88,3,248
455394564,40,180,88,300,608
455404867,62,14,61,7,144
455413148,30,73,5,1,109
455417693,106,3,2,1,112
455418795,130,15,2,49,196
455425457,105,3,2,7,117
455426832,61,3,2,2,68
455441261,25,6,2,1,34
455444458,34,7,9,3,53
455459299,12,3,2,1,18
455461763,27,3,2,4,36
455478949,64,9,2,1,76
455488348,88,3,47,14,152
455496212,22,16,2,1,41
455500134,72,26,15,2,115
455500274,70,3,2,1,76
455507435,10,3,2,4,19
455510340,23,15,9,1,48
455514380,11,12,2,1,26
455523922,39,27,17,1,84
455556830,86,40,2,1,129
455570370,123,3,2,1,129
455574216,29,58,18,3,108
455576076,113,8,2,2,125
455592910,47,3,2,8,60
455605432,31,62,11,14,118
455656798,91,3,2,1,97
455663125,78,24,2,5,109
455664477,73,24,2,3,102
455664631,37,19,12,2,70
455665753,10,11,2,1,24
455683359,64,3,2,18,87
455689218,19,82,27,1,129
455691518,36,19,2,2,59
455692981,60,12,2,4,78
455698101,77,14,32,12,135
455698845,10,3,2,2,17
455702250,47,52,2,1,102
455705126,83,25,46,2,156
455716858,11,4,2,1,18
455722125,172,24,15,7,218
455727759,49,33,32,25,139
455735103,17,3,2,2,24
455736102,10,5,2,1,18
455742318,113,31,2,3,149
455747844,137,3,3,2,145
455756514,15,3,2,1,21
455764516,56,3,2,1,62
455766669,81,3,2,4,90
455790243,72,36,11,2,121
455806753,21,35,19,45,120
455826054,17,3,2,1,23
455828046,11,30,2,1,44
455831098,29,17,2,6,54
455831486,187,62,3,61,313
455837267,45,12,2,6,65
455838030,101,114,39,9,263
455841569,17,16,2,1,36
455844689,76,3,2,1,82
455858059,13,21,2,7,43
455864939,141,51,23,3,218
455870162,18,18,5,3,44
455875457,16,18,21,16,71
455882753,42,38,38,1,119
455907452,19,3,2,1,25
455909007,80,23,15,3,121
455910517,23,19,23,1,66
455913384,17,3,2,1,23
455922880,28,48,15,20,111
455924458,15,3,2,1,21
455948105,41,21,64,1,127
455957023,34,18,29,1,82
455990671,19,47,2,2,70
455992076,26,91,2,5,124
455992808,72,31,12,3,118
455996382,138,37,9,1,185
456016343,114,19,2,7,142
456024565,24,9,2,2,37
456033015,17,5,2,5,29
456033359,213,11,33,6,263
456037555,117,28,2,1,148
456042342,95,48,68,5,216
456059645,136,51,2,2,191
456069626,93,29,2,1,125
456071575,189,51,49,9,298
456076638,49,3,2,1,55
456084151,32,3,2,1,38
456092650,208,81,14,10,313
456102319,28,7,2,1,38
456115847,121,3,2,6,132
456122829,132,3,2,1,138
456131461,62,22,64,2,150
456152233,163,3,3,7,176
456162533,20,12,2,1,35
456168113,17,3,2,3,25
456176914,102,34,2,17,155
456188556,49,21,3,1,74
456195372,10,3,2,3,18
456205861,78,14,2,5,99
456228696,13,3,2,1,19
456237851,11,3,2,1,17
456238127,18,3,2,1,24
456247970,96,55,2,56,209
456251482,84,81,26,6,197
456256986,48,3,2,1,54
456259882,15,32,2,1,50
456269848,163,33,46,8,250
456271172,146,3,2,9,160
456278687,58,69,20,18,165
456297196,25,14,2,1,42
456297978,65,89,32,34,220
456303556,108,45,44,9,206
456305497,50,3,2,2,57
456311194,11,3,2,1,17
456316495,108,4,2,5,119
456325209,151,19,3,1,174
456339920,16,6,2,1,25
456341955,150,23,20,45,238
456364623,16,17,5,1,39
456366196,10,21,2,1,34
456367668,46,3,2,4,55
456370747,15,8,2,3,28
456379797,46,3,2,1,52
456386775,38,8,2,3,51
456416430,32,3,2,1,38
456431325,301,3,2,9,315
456444021,16,65,2,1,84
456447596,46,3,2,3,54
456455047,32,9,2,2,45
456458401,79,9,52,32,172
456459757,23,13,2,2,40
456467374,103,3,2,1,109
456480162,77,3,2,1,83
456484159,80,20,7,3,110
456499689,56,13,4,8,81
456521509,64,47,2,71,184
456523604,1340,3,2,5,1350
456530968,14,3,2,1,20
456538700,415,3,2,11,431
456547217,11,3,2,3,19
456550047,16,3,2,1,22
456552709,11,3,2,1,17
456570856,51,37,2,2,92
456571648,18,4,2,1,25
456585136,12,6,2,1,21
456592953,32,3,2,2,39
456593589,22,3,2,2,29
456597051,72,37,17,9,135
456604087,16,7,2,1,26
456609571,89,14,2,3,108
456614635,76,16,10,4,106
456619512,51,21,111,3,186
456631565,46,96,2,3,147
456634907,32,3,2,10,47
456639403,16,3,2,2,23
456647245,21,11,7,2,41
456674725,73,25,2,2,102
456677024,55,6,2,12,75
456687510,41,13,4,7,65
456697600,55,19,3,13,90
456697892,62,39,70,1,172
456701304,113,29,2,50,194
456703819,54,12,2,3,71
456720191,33,24,2,12,71
456733374,29,52,7,1,89
456733594,26,36,2,1,65
456734156,45,15,13,10,83
456737457,115,3,2,2,122
456748294,140,28,5,1,174
456762878,127,20,63,4,214
456770327,17,5,2,1,25
456771806,35,17,14,33,99
456773980,67,18,2,1,88
456774326,269,45,30,94,438
456787513,67,3,2,1,73
456791048,41,3,2,2,48
456803424,20,3,2,6,31
456807795,11,6,2,1,20
456812953,30,4,2,1,37
456814992,65,35,90,10,200
456824681,213,27,12,10,262
456824737,79,3,2,1,85
456837555,176,16,7,6,205
456858506,15,3,2,1,21
456866855,109,29,20,3,161
456867394,139,38,2,5,184
456873851,13,30,9,4,56
456880140,106,21,4,82,213
456896143,135,49,3,28,215
456901523,65,19,2,8,94
456909333,41,3,2,1,47
456917857,28,22,14,1,65
456928174,60,12,8,4,84
456956683,50,18,62,5,135
456961063,11,7,2,1,21
456962194,14,3,2,1,20
456963028,13,23,8,1,45
456965288,33,14,2,1,50
456965871,25,3,2,1,31
456975541,85,4,2,2,93
456995188,39,3,2,1,45
457000327,88,3,2,1,94
457028370,57,63,11,50,181
457056850,2755,117,2,7,2881
457078375,98,22,43,5,168
457097122,133,16,14,9,172
457100757,10,12,15,1,38
457103295,72,14,3,1,90
457111002,178,23,3,5,209
457123143,10,5,2,11,28
457147051,101,3,2,3,109
457148039,134,23,2,14,173
457178441,32,16,2,3,53
457188144,25,71,71,5,172
457201096,22,30,2,2,56
457212081,65,3,2,4,74
457227209,67,38,5,5,115
457231148,68,45,7,6,126
457236894,77,28,37,5,147
457249623,19,39,19,12,89
457261889,27,27,13,2,69
457262400,71,62,2,3,138
457263153,116,6,2,23,147
457264370,11,3,2,1,17
457268188,21,3,2,1,27
457277046,127,3,2,1,133
457293741,60,75,11,3,149
457300640,22,39,18,2,81
457324173,91,6,49,48,194
457356057,110,6,57,4,177
457396653,72,7,2,15,96
457409379,129,8,21,45,203
457409521,26,23,14,7,70
457425473,93,90,68,5,256
457431665,29,3,2,2,36
457436632,16,3,2,1,22
457437065,45,52,21,28,146
457443341,277,26,10,4,317
457455341,81,19,6,11,117
457468497,46,18,2,10,76
457478633,89,67,85,18,259
457480764,81,10,41,1,133
457502587,16,19,3,8,46
457504364,21,3,3,1,28
457508020,179,8,3,22,212
457519996,10,7,2,1,20
457526563,11,7,3,1,22
457534690,22,37,2,1,62
457544622,67,44,26,7,144
457551533,138,32,2,11,183
457561419,181,62,4,18,265
457562320,45,12,33,12,102
457575646,42,27,2,1,72
457584257,115,3,2,1,121
457594208,73,60,4,30,167
457594236,28,37,2,5,72
457599869,61,3,2,1,67
457606210,84,3,2,13,102
457607652,36,3,2,1,42
457611086,26,20,4,7,57
457616653,74,74,75,12,235
457626697,11,10,2,1,24
457635388,47,19,2,5,73
457640237,81,3,2,5,91
457641551,73,31,66,7,177
457644217,110,23,2,11,146
457650077,43,43,2,2,90
457654961,11,3,2,1,17
457680593,27,73,48,2,150
457683507,14,15,2,3,34
457709178,32,3,2,1,38
457711891,42,9,7,4,62
457712563,45,35,17,12,109
457715735,148,23,2,4,177
457740587,23,37,12,1,73
457741242,13,4,2,2,21
457743780,72,31,11,12,126
457754701,40,3,2,1,46
457764094,73,3,2,1,79
457775037,68,3,2,1,74
457781998,62,3,2,1,68
457784311,57,45,19,4,125
457787257,15,13,2,1,31
457787368,13,7,2,1,23
457795009,18,29,2,1,50
457808801,12,3,2,1,18
457817888,18,11,2,1,32
457818182,62,3,3,1,69
457844311,58,20,2,1,81
457874563,13,3,2,1,19
457875573,13,9,2,1,25
457896746,49,20,20,10,99
457909455,30,3,2,2,37
457914623,121,10,2,1,134
457921494,31,39,32,1,103
457936810,61,3,2,1,67
457944053,84,3,2,14,103
457954765,53,28,54,4,139
457968792,27,49,2,6,84
458002174,26,4,17,27,74
458002575,50,7,31,9,97
458003937,61,26,30,17,134
458025869,35,4,2,1,42
458025958,56,20,19,46,141
458040296,155,3,2,1,161
458063410,11,11,2,1,25
458064963,89,113,4,1,207
458065236,21,24,13,1,59
458087160,41,20,2,1,64
458091809,93,12,7,2,114
458099254,45,3,2,2,52
458107375,99,15,2,1,117
458114414,28,17,30,7,82
458118486,26,20,9,4,59
458125685,11,3,2,1,17
458134902,10,3,2,5,20
458136445,12,9,6,1,28
458142508,21,34,30,3,88
458154038,151,25,45,4,225
458157702,90,12,3,4,109
458158558,36,3,2,1,42
458162926,39,5,4,15,63
458164830,121,11,2,2,136
458167091,91,33,11,8,143
458181401,105,9,2,1,117
458185275,37,38,4,3,82
458188776,41,24,2,1,68
458189339,121,37,35,19,212
458190522,102,12,2,8,124
458194982,37,26,34,2,99
458197406,67,55,86,15,223
458197668,25,3,2,1,31
458204380,35,3,4,1,43
458223476,132,18,17,70,237
458229448,11,3,2,1,17
458240617,184,12,6,5,207
458252358,13,7,2,1,23
458263338,18,15,2,2,37
458270767,48,15,13,1,77
458281262,99,11,46,8,164
458286862,54,3,24,11,92
458297537,25,3,2,1,31
458298257,102,99,20,36,257
458302136,75,65,15,5,160
458306057,77,6,2,2,87
458308805,46,94,15,12,167
458319579,43,23,2,1,69
458334169,12,3,2,1,18
458338585,16,4,2,1,23
458340055,68,3,2,1,74
458350449,104,33,189,36,362
458352425,50,38,4,15,107
458365729,11,3,2,1,17
458366329,10,9,2,1,22
458381045,42,19,2,1,64
458427188,56,3,42,3,104
458428242,143,52,8,14,217
458431815,27,15,13,7,62
458444766,25,37,2,6,70
458445551,306,3,2,3,314
458491744,105,3,2,1,111
458502722,104,4,2,2,112
458512977,42,9,28,6,85
458519648,15,4,2,1,22
458538192,10,6,2,1,19
458552538,195,30,6,30,261
458562885,15,34,3,20,72
458575371,125,5,2,37,169
458581226,107,64,69,21,261
458590239,24,11,7,9,51
458603055,10,3,2,2,17
458613645,105,38,40,3,186
458621469,78,23,2,1,104
458628300,157,3,2,17,179
458629065,95,3,2,1,101
458635252,103,23,5,5,136
458641884,11,13,2,1,27
458642206,15,3,2,1,21
458646495,119,14,2,3,138
458652664,46,30,22,81,179
458675206,31,66,2,1,100
458678212,13,3,2,1,19
458689912,119,29,52,8,208
458698830,87,16,23,1,127
458701767,47,13,2,3,65
458720490,153,64,13,7,237
458744288,16,3,2,26,47
458748872,11,3,2,1,17
458752885,94,3,2,2,101
458763911,23,3,2,10,38
458771975,65,45,85,3,198
458798419,48,16,12,44,120
458816995,84,21,20,7,132
458817884,75,19,3,11,108
458827212,53,46,39,1,139
458833192,12,3,2,1,18
458837999,27,29,48,2,106
458851284,13,3,2,1,19
458851926,43,75,74,11,203
458855312,92,4,21,1,118
458870613,111,41,2,4,158
458892212,12,3,2,1,18
458898750,62,13,16,20,111
458910500,107,38,144,5,294
458914872,38,6,2,1,47
458918455,133,3,2,1,139
458920407,11,3,2,1,17
458932590,11,10,2,1,24
458948167,59,13,2,1,75
458949271,26,3,2,1,32
458964065,194,143,2,1,340
458976365,61,51,8,7,127
459009234,14,19,2,1,36
459028855,69,69,2,9,149
459028992,13,3,2,1,19
459030068,21,4,2,6,33
459036051,44,51,94,10,199
459043011,148,17,23,17,205
459055807,59,95,51,37,242
459084784,35,14,2,3,54
459090631,11,60,2,1,74
459096628,149,3,2,1,155
459101094,74,4,2,9,89
459112214,126,59,94,3,282
459120378,74,25,80,13,192
459122840,25,4,5,5,39
459131825,94,39,14,8,155
459134160,17,11,23,1,52
459139019,15,3,2,1,21
459139806,31,3,2,13,49
459147750,139,3,2,4,148
459162712,67,40,2,1,110
459179132,46,3,2,1,52
459183122,211,89,75,1,376
459205145,20,4,2,1,27
459208504,606,3,2,28,639
459225180,34,25,26,5,90
459246866,26,11,2,35,74
459248989,105,22,12,27,166
459259995,19,9,2,4,34
459261462,168,51,91,11,321
459267534,31,8,3,2,44
459279086,74,37,28,94,233
459283531,51,4,3,1,59
459291234,49,16,30,3,98
459330586,62,47,2,6,117
459332832,95,3,2,1,101
459333568,96,3,2,1,102
459346448,49,12,2,6,69
459347252,16,3,2,1,22
459351455,68,3,2,1,74
459362922,41,15,2,4,62
459369513,54,43,15,2,114
459381700,44,71,29,44,188
459383633,38,21,46,9,114
459391201,11,3,2,1,17
459396298,11,3,2,1,17
459397432,35,34,19,6,94
459400304,36,10,3,4,53
459404925,62,3,2,1,68
459405091,102,28,12,1,143
459410434,164,62,3,10,239
459417804,48,26,10,2,86
459422978,120,23,25,42,210
459431892,11,3,2,1,17
459438206,61,41,39,14,155
459443185,121,12,2,9,144
459495112,36,49,2,11,98
459502545,132,72,36,50,290
459510681,75,41,22,1,139
459521060,29,45,4,1,79
459522672,47,16,21,1,85
459531001,102,3,2,1,108
459532695,87,34,52,22,195
459532727,23,3,2,1,29
459543762,179,3,2,3,187
459549075,27,3,2,1,33
459599485,36,9,3,2,50
459609966,26,3,2,4,35
459615237,13,3,2,2,20
459629095,39,69,37,5,150
459631856,341,33,5,6,385
459632753,12,11,2,3,28
459634135,15,30,2,1,48
459636450,22,15,5,20,62
459639493,96,12,2,6,116
459641470,112,36,19,21,188
459644292,40,4,16,17,77
459646755,66,22,30,2,120
459656780,66,31,14,1,112
459662684,150,16,56,11,233
459663697,13,3,2,1,19
459671106,11,3,2,1,17
459672589,134,17,51,1,203
459681653,18,3,2,1,24
459682483,11,6,2,1,20
459689927,125,6,51,1,183
459699872,20,3,2,2,27
459702966,137,66,55,9,267
459713381,10,5,2,1,18
459715427,27,15,139,8,189
459717718,202,10,2,1,215
459718001,125,18,2,1,146
459718377,107,24,11,20,162
459722891,27,20,19,1,67
459724276,10,4,2,2,18
459727857,36,17,2,9,64
459747204,46,17,2,1,66
459772646,108,32,3,1,144
459780476,11,3,2,1,17
459808446,62,11,12,1,86
459810096,10,3,2,5,20
459813008,26,12,12,7,57
459813012,39,43,11,46,139
459833492,16,3,2,3,24
459837178,26,3,2,1,32
459841879,70,43,19,9,141
459844253,12,3,2,1,18
459848574,23,30,2,1,56
459849791,90,7,36,10,143
459861898,11,3,2,1,17
459876493,51,3,2,9,65
459878920,43,39,8,3,93
459879654,95,3,2,1,101
459879858,24,50,2,12,88
459888352,44,10,2,4,60
459911360,209,3,2,13,227
459928291,10,12,2,1,25
459930177,184,3,2,1,190
459935447,45,3,2,2,52
459950656,10,11,10,2,33
459950963,109,44,105,1,259
459953095,15,3,2,1,21
459953332,10,6,2,1,19
459964532,92,3,2,1,98
459970695,58,12,24,7,101
459971046,20,51,2,2,75
459975939,242,49,5,1,297
459989760,185,10,75,4,274
459999128,93,27,2,8,130
460003069,108,3,2,2,115
460003990,15,5,2,1,23
460007372,10,3,2,10,25
460023741,35,11,67,4,117
460075401,48,15,2,1,66
460076218,23,3,2,1,29
460087791,112,54,10,12,188
460095572,110,3,2,1,116
460110497,10,8,2,1,21
460115044,16,3,2,1,22
460116397,85,11,23,9,128
460119152,40,48,11,23,122
460122766,165,37,2,1,205
460128823,64,3,2,1,70
460130762,21,3,2,1,27
460140523,10,5,2,2,19
460141436,44,3,2,13,62
460143151,74,3,5,4,86
460151509,14,3,2,1,20
460161203,28,26,3,3,60
460198775,107,24,3,23,157
460199560,28,96,2,17,143
460206351,12,3,2,1,18
460207957,166,38,2,10,216
460211959,61,10,3,7,81
460220501,78,30,2,6,116
460232189,153,17,2,11,183
460241530,14,7,2,3,26
460250829,12,3,2,1,18
460283265,63,9,4,1,77
460291116,42,78,2,10,132
460292340,68,16,2,4,90
460299190,45,3,4,1,53
460303231,15,25,5,1,46
460313105,115,13,36,3,167
460319582,53,20,3,1,77
460348502,79,7,2,8,96
460365711,107,43,53,1,204
460368349,61,27,9,2,99
460384409,169,58,2,8,237
460385691,95,41,15,30,181
460400439,51,80,5,2,138
460408565,99,29,2,16,146
460416793,30,34,4,51,119
460431902,10,7,2,1,20
460436707,32,37,2,1,72
460440996,17,27,2,1,47
460449771,50,15,23,21,109
460459884,26,33,9,3,71
460460393,93,21,30,1,145
460461358,18,28,2,1,49
460463444,72,19,2,11,104
460495169,16,3,2,1,22
460500947,35,18,2,1,56
460505272,102,45,7,19,173
460509336,91,36,2,22,151
460517524,76,3,2,18,99
460529762,31,35,2,1,69
460535892,47,45,60,1,153
460536497,79,24,3,13,119
460537081,25,22,2,1,50
460548631,129,33,39,8,209
460552423,33,95,15,1,144
460556193,69,3,2,1,75
460562340,10,29,18,1,58
460575488,47,3,2,1,53
460577281,19,3,2,1,25
460587397,74,32,7,22,135
460606111,202,33,3,2,240
460610704,40,54,11,7,112
460611195,13,3,2,2,20
460612124,55,3,2,13,73
460615984,12,3,2,1,18
460627615,49,23,15,4,91
460630456,74,3,2,1,80
460630508,49,25,13,2,89
460632460,50,6,6,10,72
460650524,73,22,2,5,102
460662267,121,5,2,4,132
460663515,64,6,13,18,101
460674655,17,3,2,2,24
460677274,48,14,2,7,71
460677636,71,13,3,10,97
460681895,46,7,2,1,56
460686641,11,3,2,2,18
460715561,15,43,2,1,61
460746546,153,3,2,1,159
460747187,29,14,2,1,46
460766286,17,10,2,5,34
460778374,16,15,4,4,39
460790499,46,3,2,4,55
460802393,21,33,52,8,114
460803728,11,3,2,1,17
460818202,65,22,14,28,129
460824946,32,20,3,1,56
460828465,11,3,2,1,17
460841258,72,6,3,1,82
460859074,92,3,2,6,103
460864556,38,3,2,1,44
460871765,113,3,2,2,120
460874998,130,3,2,1,136
460878775,79,3,2,6,90
460879367,45,3,2,1,51
460890498,51,20,2,1,74
460898702,88,9,4,12,113
460901535,18,13,2,2,35
460911800,174,56,3,1,234
460914265,19,3,2,1,25
460914472,86,19,18,7,130
460923340,51,60,6,4,121
460931482,11,3,2,1,17
460937298,110,55,75,5,245
460944610,81,33,11,4,129
460952782,36,3,2,1,42
460957739,54,8,2,9,73
460967226,25,6,2,1,34
460968005,15,10,2,4,31
460973134,26,44,15,1,86
460978355,22,78,34,8,142
460978983,91,32,2,4,129
460990098,25,3,2,2,32
461016448,42,8,2,1,53
461022079,14,18,2,5,39
461055948,78,22,14,43,157
461056436,48,3,2,2,55
461057253,81,4,2,2,89
461070060,10,8,2,1,21
461076658,67,74,22,3,166
461091766,172,37,7,16,232
461094724,12,14,2,1,29
461099720,78,13,13,12,116
461100041,118,3,2,2,125
461116275,153,19,89,29,290
461130765,21,27,39,4,91
461133525,85,3,2,8,98
461145834,27,59,14,17,117
461148509,13,3,2,1,19
461149926,583,23,4,1,611
461164414,19,9,4,1,33
461164701,46,54,2,1,103
461188365,45,32,27,16,120
461191578,49,11,10,12,82
461196952,25,3,2,1,31
461204926,37,32,5,2,76
461209974,45,58,68,4,175
461219405,62,4,11,1,78
461223147,190,8,3,12,213
461225585,17,10,2,6,35
461226703,11,3,2,1,17
461247681,10,3,2,6,21
461248269,79,17,38,63,197
461258129,92,21,8,1,122
461269842,18,17,17,8,60
461296629,178,18,2,1,199
461310703,107,3,2,2,114
461320784,117,34,26,8,185
461342770,11,3,2,2,18
461342949,38,33,2,8,81
461343278,11,3,2,1,17
461356986,35,26,2,1,64
461361869,51,39,2,1,93
461369966,15,86,4,1,106
461370804,29,3,2,2,36
461375804,120,52,20,29,221
461376244,48,53,25,6,132
461379185,11,3,2,1,17
461388278,34,3,2,1,40
461418508,24,45,2,10,81
461431686,62,16,2,18,98
461431710,71,12,13,8,104
461449460,56,20,9,15,100
461455105,51,28,2,7,88
461455915,23,3,2,2,30
461458499,126,46,38,2,212
461507137,14,3,2,1,20
461509767,96,14,95,3,208
461510642,30,40,3,17,90
461517103,79,24,32,18,153
461521530,114,4,4,3,125
461534497,11,3,2,1,17
461535155,55,16,2,7,80
461538351,108,3,2,5,118
461544552,50,3,2,1,56
461560231,53,44,9,34,140
461571157,46,17,3,1,67
461595871,81,74,24,2,181
461610574,30,36,2,10,78
461620614,71,19,2,4,96
461621633,59,33,14,2,108
461646139,17,15,3,1,36
461675318,184,38,4,1,227
461685937,62,28,40,1,131
461689487,45,3,2,1,51
461710265,65,10,3,11,89
461721267,68,3,2,7,80
461747009,26,3,2,1,32
461761433,33,68,3,1,105
461774572,52,3,2,1,58
461779913,35,53,3,8,99
461788124,120,7,2,3,132
461793210,36,37,37,2,112
461794283,138,33,164,1,336
461805669,13,3,2,1,19
461828752,23,3,2,1,29
461832264,13,3,2,8,26
461840431,61,3,2,5,71
461862200,10,5,2,1,18
461873165,58,10,2,4,74
461890319,18,43,2,1,64
461906611,47,8,2,5,62
461918740,106,29,23,54,212
461947480,49,3,2,1,55
461948425,251,37,20,1,309
461966133,33,6,10,1,50
461974775,11,3,2,1,17
461981431,44,25,20,9,98
461988311,155,3,4,7,169
461990634,57,26,35,1,119
462020191,80,26,3,14,123
462026542,82,3,3,4,92
462045976,13,3,2,3,21
462046041,169,3,17,6,195
462055503,13,16,2,1,32
462057242,47,3,2,1,53
462063309,17,17,14,1,49
462064141,10,4,2,1,17
462070613,34,90,41,4,169
462081147,44,28,11,1,84
462120355,55,7,2,1,65
462125810,95,14,2,1,112
462126869,69,13,3,1,86
462153992,15,14,2,1,32
462158189,64,25,2,11,102
462170046,10,3,2,2,17
462175901,162,38,2,7,209
462189120,36,3,2,3,44
462200492,15,3,2,1,21
462203544,10,4,2,2,18
462204397,20,36,2,6,64
462204622,12,3,2,1,18
462211939,10,8,2,1,21
462217530,83,46,2,5,136
462222271,21,10,2,1,34
462224494,94,36,5,6,141
462225869,41,36,21,11,109
462233581,130,3,2,4,139
462248053,12,3,2,1,18
462276474,22,3,2,1,28
462284184,38,195,22,14,269
462285170,53,25,2,4,84
462303641,30,33,4,2,69
462306177,50,34,33,11,128
462309281,10,3,2,2,17
462309826,93,64,2,1,160
462327300,35,42,2,1,80
462338442,65,3,3,7,78
462346213,164,3,2,1,170
462359325,261,3,2,4,270
462359656,13,3,2,1,19
462365092,103,10,2,5,120
462396402,11,3,2,1,17
462403669,11,3,2,1,17
462410741,130,7,2,4,143
462435718,48,69,24,12,153
462440838,115,42,2,7,166
462447790,59,3,2,7,71
462452712,50,43,4,1,98
462457273,17,3,2,1,23
462462427,75,3,2,1,81
462469390,71,24,67,15,177
462492097,54,57,11,2,124
462493401,54,43,3,16,116
462493690,55,3,2,1,61
462500303,105,3,2,1,111
462506765,116,63,10,2,191
462513958,58,30,19,10,117
462517925,138,3,2,1,144
462521608,107,3,2,6,118
462532755,45,18,2,1,66
462536543,91,19,66,64,240
462550077,52,11,12,1,76
462566181,31,3,2,1,37
462573818,66,93,2,4,165
462576282,60,23,24,4,111
462577550,10,3,2,2,17
462581240,115,11,17,15,158
462586964,22,52,6,3,83
462593798,11,3,2,1,17
462616045,32,5,2,6,45
462624926,40,60,14,1,115
462672058,22,33,3,1,59
462676006,38,30,17,1,86
462692999,12,3,2,1,18
462705477,20,17,2,6,45
462712551,64,3,2,1,70
462716212,48,17,2,3,70
462727035,10,9,2,1,22
462730335,209,15,25,7,256
462743868,411,3,2,2,418
462760057,82,23,2,3,110
462763813,11,3,2,1,17
462774010,15,14,2,1,32
462779857,96,3,2,1,102
462784285,49,47,14,24,134
462791098,44,25,25,10,104
462808598,208,25,38,2,273
462811741,68,24,83,66,241
462816998,198,22,50,3,273
462821206,26,3,2,1,32
462830878,37,9,9,17,72
462833006,77,28,2,9,116
462834491,87,36,2,7,132
462854268,75,3,2,2,82
462869184,263,3,2,1,269
462893134,105,14,25,4,148
462908412,54,22,3,2,81
462908876,29,3,2,2,36
462915441,131,3,2,14,150
462918345,48,3,2,1,54
462922239,19,6,3,5,33
462933481,129,4,18,1,152
462944696,109,26,8,10,153
462958923,198,21,104,26,349
462960666,33,43,6,10,92
462964243,123,13,55,18,209
462980570,64,73,77,8,222
462984117,52,24,10,11,97
462984127,163,12,39,15,229
462988505,84,42,5,2,133
463014001,27,30,44,2,103
463026146,20,21,2,1,44
463028239,58,3,2,2,65
463035055,15,3,2,1,21
463041331,128,3,2,1,134
463041849,18,39,16,14,87
463047517,32,36,2,1,71
463050769,61,3,2,5,71
463053707,22,3,2,1,28
463055506,421,3,2,1,427
463061327,27,3,2,1,33
463076309,113,18,23,9,163
463082886,95,3,6,1,105
463086696,150,53,2,9,214
463095722,54,3,2,1,60
463099640,58,3,2,4,67
463115785,31,3,2,1,37
463121750,47,3,2,13,65
463126418,74,3,2,2,81
463127203,50,3,2,21,76
463135447,203,3,2,1,209
463144549,18,3,2,1,24
463146657,51,41,2,3,97
463176990,103,5,2,4,114
463194092,62,20,96,10,188
463222534,31,3,4,1,39
463230242,41,28,3,1,73
463232087,12,3,2,1,18
463235100,31,27,72,1,131
463238819,13,3,2,1,19
463240402,73,19,21,1,114
463254268,22,48,4,1,75
463257520,12,3,2,1,18
463273533,67,6,74,2,149
463274565,24,25,11,1,61
463275513,50,3,2,1,56
463276698,70,6,20,1,97
463288264,57,24,35,2,118
463291006,30,3,2,4,39
463305664,30,6,4,5,45
463306051,38,3,2,1,44
463311014,127,16,4,1,148
463319070,31,3,2,1,37
463330650,91,55,88,1,235
463331045,37,37,42,1,117
463333744,87,13,14,7,121
463337962,149,31,2,2,184
463340213,63,3,2,1,69
463355392,14,12,2,1,29
463369808,106,3,2,1,112
463373839,187,36,36,65,324
463376994,11,9,2,4,26
463408973,18,12,27,5,62
463415939,90,3,2,5,100
463419343,19,49,2,1,71
463420266,56,3,6,1,66
463421865,91,3,2,1,97
463444901,74,3,2,1,80
463457061,40,24,29,11,104
463460602,17,4,10,4,35
463479161,12,11,2,1,26
463484319,12,5,2,2,21
463486507,149,18,2,1,170
463487737,36,3,2,1,42
463492186,14,12,2,3,31
463494181,51,24,30,32,137
463505497,70,13,60,1,144
463536769,158,17,2,5,182
463540839,41,61,16,19,137
463544922,87,3,2,1,93
463574814,71,34,24,15,144
463597558,32,24,7,1,64
463607212,55,14,3,6,78
463614181,13,31,2,2,48
463615367,54,3,2,1,60
463621202,27,3,2,1,33
463624547,19,3,2,1,25
463629497,13,3,2,1,19
463629790,25,38,26,1,90
463635950,75,12,2,1,90
463646352,47,26,21,43,137
463650896,27,15,7,1,50
463652157,107,48,32,6,193
463658727,71,30,2,18,121
463694659,63,23,12,2,100
463699387,10,3,2,2,17
463700750,109,53,85,7,254
463702434,221,82,2,4,309
463704516,10,36,2,6,54
463720890,87,11,5,1,104
463760929,171,57,82,5,315
463772831,69,16,12,4,101
463790991,96,13,2,4,115
463800596,25,6,2,1,34
463809311,238,34,3,28,303
463809927,45,18,2,4,69
463822400,12,3,2,1,18
463823369,216,4,2,19,241
463825837,56,4,2,14,76
463826908,16,3,2,1,22
463829696,19,43,2,1,65
463835256,32,75,12,4,123
463839439,35,18,43,10,106
463859687,15,23,5,1,44
463860690,24,3,2,5,34
463868106,200,43,9,1,253
463868135,109,3,2,2,116
463869606,36,3,2,1,42
463905114,10,3,2,2,17
463905263,10,5,2,1,18
463936311,214,3,2,4,223
463947564,32,33,2,3,70
463947725,15,3,2,1,21
463949372,23,29,7,15,74
463952538,27,41,15,3,86
463961836,71,26,19,2,118
463966580,72,10,2,1,85
463980408,41,33,9,3,86
463990801,155,18,12,5,190
464000771,10,8,2,1,21
464004910,106,24,8,1,139
464012011,38,3,2,1,44
464016701,15,5,2,1,23
464028335,12,3,2,1,18
464056022,273,5,2,1,281
464074234,33,127,2,1,163
464079207,19,8,2,1,30
464083710,80,78,5,5,168
464106102,49,3,2,13,67
464106424,36,27,31,11,105
464125505,130,6,4,15,155
464126716,11,4,2,1,18
464130929,49,3,2,1,55
464145358,229,29,56,1,315
464156009,13,9,2,1,25
464160885,15,15,6,1,37
464168343,129,50,100,3,282
464168995,63,17,2,1,83
464174679,21,5,2,2,30
464175323,239,22,2,4,267
464178676,91,10,35,13,149
464179319,58,8,2,2,70
464180676,11,3,2,1,17
464250138,25,27,29,21,102
464253625,124,15,3,12,154
464255296,43,3,2,1,49
464279455,34,5,2,1,42
464281365,117,7,2,52,178
464297454,72,4,2,16,94
464308143,74,42,66,4,186
464325400,92,64,3,118,277
464327452,18,10,2,1,31
464332832,46,3,2,1,52
464334045,12,7,3,2,24
464353043,33,52,24,1,110
464359344,51,3,2,2,58
464367983,56,11,28,1,96
464372576,135,23,14,2,174
464387739,53,11,2,2,68
464394580,85,24,2,7,118
464397999,94,9,2,8,113
464400624,40,9,2,1,52
464403318,11,5,2,1,19
464425803,124,5,13,25,167
464436074,31,11,2,1,45
464437954,103,19,18,11,151
464444271,83,21,2,1,107
464450551,59,11,2,9,81
464451033,17,3,2,1,23
464451378,108,21,38,2,169
464452662,51,3,2,1,57
464461580,33,31,3,1,68
464466491,75,28,10,8,121
464468385,47,26,10,9,92
464483925,82,4,68,1,155
464489114,20,3,2,1,26
464492269,33,16,2,6,57
464496192,203,3,3,6,215
464507214,115,7,4,5,131
464520800,47,14,34,38,133
464538184,888,3,2,7,900
464538964,100,17,2,2,121
464554943,258,12,2,1,273
464561062,119,25,2,5,151
464577758,10,4,2,2,18
464588005,10,6,2,3,21
464599736,30,32,54,20,136
464620218,126,69,16,33,244
464620915,50,3,2,6,61
464625708,121,11,2,1,135
464628350,15,3,2,1,21
464636007,13,3,2,1,19
464646420,10,6,2,2,20
464656415,94,3,2,2,101
464686896,11,9,2,1,23
464687085,59,3,2,6,70
464691974,81,47,11,9,148
464697706,46,18,27,5,96
464698934,81,3,2,1,87
464706157,89,6,2,1,98
464709442,82,22,54,23,181
464720165,104,16,31,14,165
464738764,85,9,5,4,103
464742115,68,23,2,9,102
464743164,186,3,2,4,195
464746944,67,4,4,3,78
464747639,63,34,28,2,127
464781031,70,32,50,9,161
464782305,104,9,31,3,147
464789705,80,23,12,5,120
464829726,44,34,3,1,82
464846859,98,35,2,2,137
464850052,98,39,3,4,144
464858738,123,4,12,8,147
464883078,22,4,2,1,29
464897156,53,32,23,2,110
464900064,175,5,28,13,221
464903773,25,9,2,1,37
464918265,106,3,2,3,114
464930335,10,7,2,1,20
464951205,15,3,2,1,21
464968617,41,39,9,1,90
464971174,427,3,2,3,435
464987518,11,3,2,1,17
464989717,107,56,2,2,167
464990807,29,3,2,1,35
464998209,60,13,48,6,127
464998387,209,62,2,4,277
465004789,26,13,2,1,42
465013444,14,8,2,1,25
465018467,83,39,2,11,135
465032622,85,33,35,4,157
465036984,65,15,2,5,87
465055811,34,64,21,5,124
465056373,10,3,2,2,17
465081426,39,46,65,1,151
465089516,60,9,11,21,101
465091333,116,3,2,2,123
465091604,19,9,5,3,36
465102633,48,3,2,1,54
465106011,12,3,2,1,18
465107115,61,4,13,8,86
465118057,41,18,8,4,71
465126423,24,4,2,2,32
465156944,16,19,2,1,38
465160366,14,9,2,1,26
465164027,56,78,54,18,206
465164878,26,9,7,1,43
465183365,33,40,6,1,80
465184441,53,35,3,15,106
465205094,30,3,2,1,36
465226107,101,47,6,11,165
465231728,379,13,2,10,404
465234517,75,40,2,1,118
465239399,30,28,9,6,73
465245399,153,3,2,6,164
465249468,51,41,19,21,132
465276811,20,3,2,1,26
465285730,58,4,2,1,65
465292203,99,3,2,1,105
465296147,16,3,2,1,22
465305722,63,14,19,2,98
465305741,41,6,2,1,50
465306153,60,27,76,26,189
465307917,56,9,3,1,69
465316032,19,10,2,1,32
465320318,62,26,48,7,143
465324762,72,3,2,5,82
465328815,157,5,49,30,241
465347124,108,63,64,22,257
465364642,54,19,18,4,95
465371588,53,34,22,11,120
465378540,72,3,2,5,82
465385072,186,3,2,1,192
465385736,35,39,37,33,144
465400136,11,3,2,1,17
465402930,13,7,15,1,36
465428323,18,6,2,1,27
465452704,16,6,2,2,26
465478000,109,39,19,24,191
465487059,38,3,2,1,44
465488219,31,10,2,3,46
465521944,51,18,5,4,78
465523549,79,3,4,11,97
465540661,129,105,51,29,314
465542613,34,10,2,34,80
465545079,96,3,2,5,106
465549163,10,3,2,3,18
465551336,11,3,2,1,17
465555571,51,16,2,1,70
465565270,89,15,4,12,120
465565333,184,3,2,1,190
465568001,12,3,2,1,18
465572285,14,3,2,3,22
465572315,157,3,2,1,163
465575211,104,3,2,14,123
465577072,103,43,3,1,150
465580370,56,3,2,1,62
465581729,17,42,2,10,71
465583720,19,3,2,1,25
465598588,124,12,2,1,139
465663496,19,3,2,3,27
465691353,23,3,2,1,29
465695888,32,3,2,6,43
465719586,11,12,2,1,26
465743168,67,3,2,1,73
465743936,67,43,5,1,116
465756877,148,3,2,4,157
465761144,10,46,2,1,59
465767263,29,31,35,19,114
465768210,93,18,36,1,148
465793421,21,68,164,10,263
465800548,42,3,2,1,48
465832234,111,38,33,18,200
465838532,45,8,3,1,57
465843566,13,3,22,1,39
465848810,91,3,2,1,97
465856245,10,9,2,1,22
465871590,168,16,81,4,269
465923438,26,13,3,44,86
465929241,19,18,5,6,48
465963728,31,21,4,1,57
465970364,13,16,7,2,38
465983381,96,18,2,1,117
466004822,74,59,8,1,142
466008565,32,59,2,1,94
466012407,43,79,33,37,192
466015643,29,3,2,1,35
466042867,209,52,18,7,286
466047249,22,3,2,1,28
466052281,29,37,3,4,73
466052437,52,14,9,1,76
466057124,86,26,4,1,117
466065758,39,127,68,25,259
466065800,12,3,2,2,19
466076135,34,28,3,1,66
466079462,58,4,2,1,65
466083693,56,3,2,2,63
466084681,55,41,16,10,122
466088169,73,67,2,1,143
466091495,69,3,2,1,75
466115068,90,25,6,35,156
466122179,25,3,2,1,31
466127646,94,8,2,2,106
466131221,146,19,2,44,211
466158438,70,10,2,1,83
466161214,28,13,8,1,50
466165973,101,21,83,2,207
466175528,64,3,2,2,71
466188270,54,20,29,1,104
466188760,30,23,38,1,92
466207905,12,13,2,1,28
466214030,15,3,2,1,21
466225918,16,7,5,6,34
466232036,63,23,2,1,89
466233587,20,38,2,5,65
466235377,113,13,16,3,145
466279932,20,19,6,1,46
466289184,25,3,2,2,32
466311752,50,3,2,3,58
466330115,83,22,17,6,128
466364718,46,62,10,1,119
466368320,504,3,2,19,528
466374640,24,7,15,2,48
466375024,11,10,2,1,24
466385133,63,78,10,4,155
466392895,39,3,2,8,52
466396732,80,3,2,2,87
466397344,65,3,2,1,71
466401274,162,187,2,3,354
466407570,63,63,10,4,140
466415156,68,114,5,7,194
466427682,47,33,22,7,109
466428396,36,39,14,10,99
466432281,50,3,2,1,56
466433286,10,4,2,1,17
466468321,16,44,2,1,63
466486085,17,41,2,1,61
466489545,104,41,27,11,183
466494768,81,3,2,10,96
466496463,67,3,2,1,73
466498433,21,8,4,8,41
466498647,22,10,7,3,42
466504330,23,59,8,6,96
466504420,27,3,2,1,33
466506435,62,20,20,15,117
466507357,53,3,2,1,59
466512216,20,5,2,1,28
466517751,110,40,26,29,205
466534539,13,3,2,3,21
466535944,38,5,2,5,50
466564663,94,3,2,4,103
466583319,23,24,3,1,51
466599121,58,34,2,3,97
466599182,13,3,2,1,19
466604770,11,9,2,2,24
466604930,45,48,2,2,97
466646467,23,46,2,2,73
466648590,94,8,2,1,105
466655324,24,33,12,1,70
466665956,73,112,2,11,198
466681003,25,9,2,5,41
466681843,151,11,2,17,181
466687183,50,57,91,7,205
466689705,14,86,25,4,129
466703805,55,82,49,11,197
466716821,78,110,2,50,240
466746026,75,16,22,2,115
466750870,127,12,2,4,145
466755354,31,3,2,1,37
466787235,103,3,2,1,109
466789182,69,3,2,7,81
466791540,76,15,2,5,98
466796841,92,32,11,1,136
466799843,47,43,2,6,98
466805073,37,3,2,1,43
466826160,80,37,55,13,185
466826683,210,106,2,17,335
466826793,97,24,2,3,126
466835961,31,3,2,1,37
466836844,78,3,2,2,85
466837612,11,7,3,1,22
466858288,12,9,2,1,24
466879146,23,17,11,1,52
466895689,157,57,21,1,236
466895966,51,45,18,25,139
466907063,52,8,2,1,63
466908816,37,69,48,21,175
466913507,11,3,2,1,17
466915849,10,42,2,1,55
466929632,66,75,34,84,259
466933133,77,3,2,2,84
466955704,18,3,2,1,24
466973440,76,64,34,25,199
466980095,98,15,2,2,117
466990390,10,12,5,2,29
466995049,125,34,56,12,227
467000386,137,3,2,8,150
467001704,84,28,2,1,115
467002168,27,19,2,4,52
467003136,12,29,4,1,46
467013336,14,3,2,1,20
467020995,91,10,2,1,104
467042685,17,20,2,1,40
467051961,29,13,3,2,47
467053919,25,3,2,1,31
467080759,30,32,8,9,79
467098642,135,27,3,5,170
467099100,17,3,2,1,23
467107360,203,16,2,2,223
467110533,56,3,2,1,62
467112283,53,30,11,23,117
467119748,23,5,3,2,33
467133244,104,3,2,3,112
467146327,13,3,2,1,19
467154021,62,19,5,9,95
467164934,18,18,5,6,47
467181149,86,33,9,3,131
467189638,108,45,18,3,174
467193396,88,30,3,1,122
467196807,73,10,19,4,106
467197553,59,3,2,1,65
467215116,131,13,98,1,243
467224001,27,23,56,1,107
467237991,28,37,12,1,78
467244522,65,3,2,3,73
467251425,15,5,2,1,23
467253499,60,25,3,99,187
467254624,25,18,2,1,46
467254818,13,3,2,1,19
467255378,99,37,2,12,150
467259180,12,17,2,3,34
467259773,21,26,32,1,80
467268236,158,16,2,3,179
467271696,54,18,2,5,79
467274865,19,3,2,1,25
467300597,24,18,2,4,48
467303440,50,3,2,1,56
467306497,17,9,2,11,39
467328291,45,54,57,2,158
467339884,66,33,43,1,143
467348311,11,3,2,1,17
467357353,155,15,2,4,176
467364737,38,5,2,5,50
467367192,83,48,12,31,174
467372178,17,4,2,5,28
467379952,49,20,36,1,106
467392024,74,57,5,31,167
467409530,29,11,2,1,43
467412182,18,36,2,2,58
467413214,192,14,2,4,212
467414717,70,26,5,9,110
467420603,88,31,24,56,199
467424327,31,3,2,1,37
467444133,69,3,2,1,75
467446652,19,3,2,1,25
467447129,60,3,2,4,69
467449382,57,20,2,2,81
467452336,121,3,2,1,127
467473750,26,8,2,1,37
467480383,13,3,2,1,19
467481182,41,40,29,25,135
467482068,37,34,52,1,124
467498046,20,3,2,2,27
467510367,25,109,2,1,137
467524563,37,24,15,3,79
467529780,51,17,35,2,105
467544860,42,35,20,12,109
467552071,17,20,2,2,41
467552915,69,61,2,12,144
467563738,34,17,2,1,54
467568101,55,42,17,2,116
467572156,11,3,2,1,17
467576259,56,8,16,2,82
467577232,14,26,2,19,61
467578426,189,25,4,12,230
467597259,60,9,4,2,75
467598810,66,3,2,3,74
467603461,45,41,26,14,126
467610923,82,3,2,3,90
467614651,11,3,2,1,17
467615220,72,24,19,2,117
467622923,19,27,4,50,100
467640859,436,3,2,51,492
467641539,38,3,4,21,66
467642523,61,75,65,15,216
467642645,11,13,2,1,27
467647018,76,25,2,3,106
467649501,59,3,6,1,69
467656777,95,32,34,5,166
467679209,13,3,2,1,19
467691131,61,29,48,1,139
467691311,59,7,44,8,118
467699784,10,42,2,1,55
467699818,10,34,3,1,48
467710084,104,3,2,1,110
467714867,141,69,41,16,267
467715575,10,4,2,3,19
467725061,12,3,2,1,18
467729171,151,13,16,16,196
467737666,23,3,2,1,29
467743546,78,16,12,6,112
467761578,21,3,2,3,29
467765297,34,3,2,1,40
467766705,16,30,2,1,49
467776932,90,3,2,3,98
467784638,94,21,4,4,123
467784773,51,45,12,10,118
467791618,28,6,10,4,48
467792460,85,35,23,7,150
467805013,41,3,2,1,47
467827788,29,17,5,20,71
467829474,17,37,3,1,58
467846940,81,3,2,4,90
467850642,98,3,2,2,105
467867452,156,12,4,3,175
467870238,16,10,4,3,33
467882081,11,3,2,1,17
467885558,36,3,7,3,49
467885813,62,18,2,1,83
467891382,28,26,2,1,57
467900877,35,10,2,1,48
467902384,84,29,24,3,140
467904518,73,3,10,1,87
467905105,38,38,45,4,125
467905920,87,14,2,8,111
467911881,125,23,2,3,153
467926385,14,5,2,3,24
467933203,53,17,19,2,91
467949014,15,3,2,1,21
467954971,71,23,9,49,152
467970797,17,18,2,1,38
467973227,223,4,2,11,240
467986305,58,45,2,4,109
468006477,64,66,11,21,162
468012921,160,18,3,6,187
468018329,15,7,2,1,25
468021353,57,26,35,74,192
468034208,58,3,2,2,65
468043232,266,23,3,29,321
468072866,128,20,23,1,172
468075776,199,3,2,8,212
468075914,59,18,2,1,80
468079302,71,52,38,10,171
468088228,13,36,2,1,52
468092478,163,3,2,7,175
468093897,14,3,2,1,20
468104355,68,15,2,4,89
468110670,143,24,75,1,243
468132104,57,13,2,1,73
468136756,52,9,17,8,86
468140143,84,3,90,8,185
468147892,140,10,13,14,177
468159293,113,33,4,13,163
468175068,47,3,2,5,57
468175145,53,7,3,1,64
468187248,225,11,9,10,255
468203909,20,13,13,15,61
468207728,10,3,2,2,17
468218423,66,13,2,8,89
468227465,54,21,58,3,136
468241269,106,3,2,2,113
468249307,17,3,2,1,23
468249519,65,19,46,3,133
468250012,127,3,2,3,135
468253301,39,27,27,2,95
468257312,10,5,2,2,19
468258683,21,3,2,1,27
468259651,101,37,33,13,184
468266197,19,13,24,58,114
468291292,28,3,2,1,34
468306827,48,3,2,6,59
468328263,11,3,2,1,17
468353348,66,20,11,2,99
468368995,224,50,17,16,307
468369105,58,77,13,29,177
468372725,79,4,2,16,101
468403960,124,25,48,12,209
468406328,16,17,2,1,36
468414182,100,20,17,69,206
468421991,21,43,20,10,94
468425004,82,25,8,5,120
468427815,40,16,3,1,60
468433803,65,93,64,5,227
468445230,189,65,17,17,288
468472940,25,3,2,1,31
468483435,71,15,19,1,106
468484029,44,12,16,7,79
468496494,146,3,2,13,164
468496575,36,7,2,10,55
468496800,27,38,21,9,95
468498662,49,66,31,1,147
468504844,51,12,3,1,67
468518818,15,8,2,1,26
468520173,98,18,17,1,134
468527739,51,19,2,8,80
468538699,61,43,34,3,141
468540962,53,5,10,1,69
468550204,156,17,2,1,176
468552299,96,3,2,1,102
468567142,123,3,2,7,135
468569730,146,28,14,13,201
468570333,26,5,57,6,94
468572015,49,25,24,14,112
468581831,69,23,46,23,161
468583619,88,5,3,1,97
468595121,10,3,2,2,17
468619325,182,68,3,14,267
468619449,79,12,20,14,125
468620811,45,57,16,4,122
468622091,54,6,2,4,66
468628765,53,28,19,1,101
468646676,40,32,2,3,77
468657423,94,3,2,1,100
468660640,33,24,3,1,61
468661393,20,68,2,1,91
468666108,188,20,4,17,229
468698107,18,3,2,1,24
468700939,20,21,2,1,44
468708012,66,20,42,56,184
468708662,42,102,53,4,201
468712274,106,3,2,1,112
468723213,12,3,2,1,18
468737604,11,4,2,3,20
468738582,43,3,2,7,55
468749411,58,13,2,1,74
468765795,20,3,2,1,26
468767390,11,3,2,2,18
468771359,147,20,2,1,170
468782617,24,9,4,1,38
468791957,10,4,2,1,17
468815724,54,3,2,3,62
468821491,65,62,2,12,141
468845324,49,17,2,1,69
468860515,110,4,2,7,123
468863818,45,54,2,12,113
468868339,185,47,30,16,278
468869415,38,3,2,1,44
468872319,135,24,3,3,165
468874919,15,36,6,1,58
468891902,83,31,10,33,157
468891970,144,14,2,1,161
468897365,122,83,15,49,269
468921138,55,42,19,14,130
468925951,10,5,2,2,19
468929929,58,15,9,1,83
468947595,83,3,2,1,89
468949149,17,28,2,3,50
468959945,10,12,2,1,25
468962079,59,8,8,1,76
468962165,23,3,2,1,29
468963201,48,21,37,7,113
468967218,50,20,27,3,100
468970377,16,4,2,1,23
468973140,59,3,2,2,66
468976941,10,4,2,1,17
468988257,25,32,29,4,90
468999413,44,10,3,1,58
468999517,30,3,2,7,42
468999941,59,3,2,1,65
469001647,83,16,27,3,129
469008632,187,3,2,2,194
469038366,169,41,25,12,247
469043690,140,3,6,2,151
469062134,80,38,33,21,172
469067266,131,32,19,10,192
469094445,24,17,2,1,44
469102177,210,3,2,2,217
469109324,145,3,2,10,160
469114382,64,23,76,31,194
469115508,94,24,2,2,122
469120021,56,24,12,3,95
469125582,22,3,2,1,28
469141583,109,22,16,6,153
469144474,20,3,2,1,26
469151144,90,3,2,1,96
469159897,155,13,2,1,171
469167485,299,3,2,1,305
469171822,69,27,35,2,133
469173451,62,10,38,3,113
469201814,67,24,3,1,95
469210558,12,38,2,1,53
469223718,40,3,2,7,52
469225300,11,8,2,1,22
469236593,128,3,2,11,144
469247819,50,31,17,4,102
469260403,313,3,2,36,354
469282733,112,4,74,2,192
469285506,45,62,13,16,136
469289135,20,3,2,1,26
469299522,86,15,5,2,108
469317025,45,7,2,1,55
469330373,56,46,3,23,128
469339848,53,6,12,1,72
469341587,12,3,2,1,18
469349675,77,55,6,2,140
469359759,12,3,2,1,18
469375498,15,4,2,2,23
469376623,10,8,2,1,21
469387222,205,3,34,61,303
469388871,133,35,17,26,211
469398436,115,16,4,2,137
469418735,81,17,97,6,201
469423228,105,12,74,2,193
469426813,67,149,19,2,237
469441762,15,3,5,9,32
469448378,16,3,2,1,22
469449693,44,4,2,1,51
469460373,60,31,55,5,151
469461575,24,20,3,4,51
469465434,230,3,2,26,261
469479968,137,55,8,10,210
469484994,38,3,2,3,46
469494595,23,3,2,1,29
469498734,125,4,49,14,192
469504161,18,27,24,2,71
469518427,44,3,2,1,50
469537275,19,11,2,3,35
469554102,161,6,2,20,189
469560162,15,3,2,5,25
469576924,19,16,2,1,38
469579744,13,3,2,1,19
469582896,66,3,2,9,80
469594533,10,20,2,1,33
469616116,14,3,2,1,20
469623272,87,15,26,3,131
469623764,55,29,15,4,103
469624982,44,11,24,25,104
469632069,54,3,2,1,60
469632108,28,14,10,3,55
469638061,77,17,2,1,97
469651459,53,53,56,16,178
469666723,36,3,2,3,44
469677398,66,47,7,15,135
469681598,49,63,2,3,117
469686302,38,42,45,1,126
469693647,30,3,2,2,37
469703628,10,3,2,2,17
469707153,77,15,37,19,148
469714029,56,33,4,1,94
469754698,22,55,12,1,90
469769086,47,42,2,4,95
469770453,63,120,25,1,209
469783128,27,15,46,6,94
469796258,35,45,7,38,125
469801333,114,3,22,2,141
469801523,92,30,12,25,159
469815324,57,17,34,17,125
469815393,55,3,2,1,61
469815803,68,3,2,1,74
469819234,45,28,10,1,84
469821059,79,23,26,1,129
469822765,62,6,11,1,80
469827751,54,54,41,8,157
469829067,43,5,2,2,52
469838280,37,18,2,1,58
469844228,16,56,2,1,75
469888996,14,7,2,1,24
469906581,67,20,2,14,103
469912343,198,10,4,5,217
469934041,104,3,2,2,111
469949262,45,75,4,25,149
469969600,85,30,22,22,159
470002338,109,12,22,1,144
470011528,45,25,37,34,141
470020185,20,10,2,1,33
470032679,95,30,6,16,147
470063702,44,49,2,24,119
470064994,119,11,5,19,154
470087417,117,32,79,3,231
470107058,75,3,2,2,82
470123135,77,3,2,4,86
470130068,124,21,123,1,269
470139765,152,3,2,5,162
470149568,14,3,2,1,20
470158562,10,9,2,1,22
470161104,42,16,2,1,61
470162043,97,3,2,1,103
470175136,19,24,3,1,47
470181626,21,20,15,3,59
470187409,107,9,12,34,162
470195997,12,3,2,1,18
470196892,27,7,2,4,40
470201892,54,3,2,4,63
470207817,34,3,2,1,40
470222364,158,56,2,10,226
470225323,11,3,2,1,17
470235902,96,41,47,53,237
470244402,16,9,2,1,28
470248545,30,16,22,29,97
470255797,50,3,2,1,56
470269344,77,17,3,8,105
470272655,53,7,2,1,63
470279101,90,3,2,13,108
470311623,29,25,2,1,57
470318945,164,27,2,10,203
470320392,16,28,22,1,67
470328555,92,20,5,8,125
470354348,63,3,2,1,69
470395842,55,14,141,3,213
470397132,38,58,22,8,126
470416306,73,17,2,11,103
470425515,63,15,22,1,101
470435112,66,37,37,1,141
470437598,26,26,5,5,62
470442489,17,3,2,1,23
470461444,84,17,2,2,105
470476077,71,6,2,2,81
470479400,24,3,2,1,30
470490186,40,21,10,1,72
470502519,51,3,2,1,57
470527347,55,27,31,4,117
470547551,60,3,2,2,67
470563553,120,3,2,7,132
470570957,77,56,67,4,204
470590939,40,3,2,1,46
470591902,128,11,37,33,209
470607317,163,58,41,44,306
470625676,17,35,11,19,82
470631335,17,3,2,1,23
470636782,108,27,7,34,176
470649189,104,15,7,3,129
470658585,88,16,6,14,124
470660534,33,16,15,7,71
470665693,81,56,13,38,188
470677251,151,34,21,10,216
470690050,50,93,2,3,148
470696137,59,4,3,1,67
470699648,68,7,77,2,154
470700118,63,3,2,1,69
470701871,13,18,2,9,42
470704293,123,3,2,1,129
470705002,57,3,2,1,63
470718417,157,3,2,2,164
470722598,168,44,90,11,313
470725259,218,54,25,3,300
470729851,75,30,36,29,170
470732123,73,51,8,3,135
470739646,42,3,2,1,48
470740509,32,23,36,4,95
470746086,71,3,2,1,77
470751143,105,3,2,10,120
470753942,15,3,2,1,21
470762397,60,3,2,1,66
470773221,58,13,22,4,97
470781859,27,14,7,6,54
470800499,111,7,18,1,137
470822835,45,74,10,3,132
470836990,33,9,2,4,48
470842927,43,3,2,1,49
470844572,121,17,2,3,143
470853193,107,52,23,3,185
470866821,83,27,30,22,162
470874631,17,3,2,11,33
470885863,79,39,76,1,195
470893177,61,17,4,1,83
470912828,20,3,2,3,28
470917924,29,28,3,5,65
470918242,159,16,31,4,210
470928851,82,29,12,1,124
470935035,13,23,4,8,48
470942150,130,11,2,1,144
470949923,45,33,2,1,81
470962897,137,68,2,4,211
470984974,121,43,2,7,173
471003355,86,8,2,9,105
471037331,42,9,4,2,57
471050307,53,46,47,4,150
471054485,10,5,2,1,18
471061529,11,11,5,1,28
471064192,14,40,31,11,96
471091650,32,40,2,66,140
471115862,132,26,61,60,279
471125838,12,3,2,2,19
471128407,111,3,2,1,117
471128653,102,14,4,2,122
471129765,15,5,2,5,27
471140697,126,52,30,56,264
471141807,10,5,2,1,18
471149799,10,3,2,3,18
471150987,74,30,3,5,112
471166133,124,3,8,1,136
471176033,11,3,2,1,17
471182109,13,9,2,1,25
471189495,45,12,5,1,63
471189942,12,3,2,5,22
471203519,46,57,5,2,110
471212833,162,3,2,1,168
471224907,211,50,2,20,283
471226284,57,24,2,2,85
471229198,143,12,17,2,174
471248743,57,17,2,1,77
471254910,44,3,2,1,50
471264818,65,21,7,2,95
471267286,15,43,2,1,61
471269585,26,28,2,5,61
471269755,17,3,2,1,23
471312083,151,26,67,7,251
471313595,67,54,7,17,145
471316193,54,15,9,8,86
471327262,67,3,2,1,73
471333125,18,3,2,1,24
471335535,53,29,8,1,91
471337565,89,63,11,2,165
471340958,112,36,43,6,197
471342407,64,3,2,1,70
471351678,123,11,11,2,147
471368440,52,65,35,20,172
471370647,47,55,10,30,142
471372065,50,19,14,1,84
471377037,29,3,2,4,38
471379420,53,34,20,16,123
471388708,37,22,2,3,64
471390291,128,14,25,1,168
471394181,120,60,2,3,185
471415263,10,7,2,1,20
471429199,83,4,3,1,91
471445323,76,31,4,1,112
471450148,16,11,2,1,30
471458490,11,3,2,2,18
471481760,57,23,10,9,99
471484745,110,12,2,12,136
471487103,136,20,9,1,166
471490467,13,3,2,2,20
471508822,13,15,10,1,39
471511435,103,3,2,11,119
471511543,51,16,64,7,138
471521813,208,3,2,1,214
471543289,29,3,2,2,36
471549643,28,28,24,5,85
471553375,23,24,2,8,57
471557272,39,3,2,16,60
471565306,60,3,2,1,66
471576388,104,22,2,8,136
471583639,63,3,2,1,69
471603958,96,8,11,2,117
471606564,36,19,7,21,83
471611454,84,3,2,1,90
471618606,33,20,2,1,56
471624484,22,3,2,1,28
471636216,108,17,3,4,132
471639773,34,65,18,29,146
471640591,59,3,2,1,65
471640724,12,3,2,1,18
471643398,37,5,2,1,45
471648514,31,42,9,1,83
471664720,13,18,2,1,34
471683320,13,3,2,1,19
471684083,29,56,30,21,136
471705445,165,3,2,6,176
471706718,56,4,2,7,69
471707331,102,9,4,2,117
471711823,41,10,4,3,58
471712508,174,22,41,30,267
471738355,25,5,5,2,37
471743765,20,3,2,1,26
471759952,125,10,16,5,156
471763350,114,3,2,21,140
471764752,13,3,2,1,19
471770208,61,19,2,4,86
471799034,11,3,2,1,17
471799781,50,62,2,2,116
471800941,33,3,2,1,39
471801963,11,15,2,1,29
471805969,29,9,3,5,46
471808151,14,5,2,1,22
471811164,11,10,2,1,24
471845868,103,35,101,2,241
471865223,69,20,3,4,96
471868042,89,3,2,19,113
471871721,168,45,17,33,263
471875273,13,17,2,2,34
471876186,35,3,2,1,41
471888754,93,68,3,6,170
471898168,56,4,2,2,64
471905231,42,12,2,1,57
471906595,66,85,81,1,233
471929902,83,9,9,3,104
471936421,17,3,2,1,23
471939565,103,7,175,2,287
471940418,129,3,2,64,198
471947328,11,3,2,1,17
471958198,80,3,2,1,86
471981372,93,17,4,15,129
471989861,35,3,2,1,41
471996429,97,15,2,1,115
472003256,18,4,7,2,31
472013813,110,18,2,12,142
472045208,135,3,2,2,142
472074903,90,39,40,15,184
472088627,106,3,2,1,112
472091113,25,4,2,1,32
472093533,59,27,2,1,89
472108790,94,9,2,3,108
472131721,13,3,2,1,19
472139094,29,19,2,1,51
472139141,16,3,2,1,22
472157521,44,8,2,2,56
472159648,107,21,12,6,146
472189161,19,50,2,2,73
472208447,42,3,2,2,49
472211408,31,3,2,2,38
472213192,23,9,4,6,42
472216055,217,26,4,2,249
472216077,163,9,2,10,184
472230168,16,20,35,8,79
472248052,82,11,3,2,98
472253296,112,25,151,41,329
472263891,126,41,4,4,175
472268529,76,5,8,79,168
472269855,99,23,10,15,147
472281246,71,10,2,1,84
472287460,50,35,10,5,100
472291317,272,3,2,10,287
472291671,45,21,68,60,194
472296097,46,20,6,4,76
472330891,18,3,2,1,24
472331607,109,58,6,5,178
472357282,10,6,4,1,21
472364350,20,26,2,2,50
472375672,50,11,20,1,82
472391714,16,30,2,3,51
472408093,57,3,2,1,63
472418962,12,3,2,1,18
472426542,11,3,2,3,19
472429176,35,24,20,11,90
472438209,116,36,18,12,182
472440571,178,20,2,1,201
472448325,104,3,2,1,110
472459309,71,18,106,26,221
472460334,95,55,2,8,160
472477391,59,54,46,21,180
472481221,42,11,19,1,73
472483663,122,19,57,1,199
472494862,39,16,2,1,58
472496730,59,4,2,7,72
472501122,65,27,5,4,101
472508563,71,21,2,1,95
472509130,20,3,2,1,26
472521623,70,3,7,1,81
472539062,16,5,2,2,25
472539549,96,41,65,1,203
472540124,60,24,2,8,94
472541540,25,11,4,1,41
472545534,88,3,2,1,94
472549689,29,61,27,17,134
472552479,50,11,49,1,111
472554982,12,3,2,1,18
472564528,19,46,2,1,68
472569866,10,3,2,2,17
472571818,11,25,2,1,39
472572586,86,13,13,4,116
472590141,132,25,44,2,203
472594805,11,3,2,3,19
472619050,42,6,4,1,53
472626722,131,19,20,20,190
472628603,337,33,24,11,405
472635215,71,36,27,1,135
472647701,38,3,2,4,47
472649317,27,7,2,10,46
472652165,189,3,2,3,197
472667723,142,14,2,3,161
472671929,67,7,2,4,80
472680383,138,18,6,42,204
472682988,28,3,2,1,34
472684451,103,43,34,4,184
472700322,87,3,2,8,100
472702941,60,20,9,12,101
472713762,13,3,2,1,19
472728944,26,58,5,6,95
472740048,67,16,2,7,92
472762259,133,25,40,7,205
472766477,13,3,2,1,19
472775430,96,3,2,4,105
472780252,23,3,2,1,29
472802107,56,26,21,3,106
472806844,14,3,2,3,22
472814739,60,5,2,1,68
472818184,33,14,2,1,50
472818971,29,33,9,5,76
472821811,25,35,15,1,76
472831061,98,5,3,1,107
472832849,40,38,70,40,188
472840989,120,24,2,3,149
472850540,49,14,19,7,89
472862300,13,3,2,1,19
472864364,57,3,2,1,63
472870365,33,42,2,4,81
472881906,17,4,2,2,25
472886897,43,3,2,2,50
472887728,10,7,2,1,20
472917670,30,7,2,5,44
472921906,27,3,11,1,42
472921923,110,3,2,1,116
472929454,161,7,23,11,202
472933807,77,11,2,1,91
472934461,66,3,2,10,81
472964261,114,39,4,17,174
472976240,33,42,10,3,88
472978049,33,16,4,2,55
472983634,244,3,2,7,256
472984113,243,3,2,50,298
472993566,18,38,4,1,61
472995896,21,21,2,2,46
473001212,49,3,2,20,74
473001371,159,26,19,1,205
473029996,100,3,2,8,113
473031575,22,19,2,10,53
473036455,44,54,24,4,126
473041643,186,12,3,7,208
473044870,134,57,26,30,247
473051799,13,13,2,2,30
473055859,30,23,2,1,56
473058226,42,19,3,1,65
473058584,125,86,3,1,215
473064536,20,19,17,4,60
473068208,16,29,2,1,48
473069329,109,3,2,4,118
473070326,11,3,2,8,24
473083892,38,80,2,8,128
473093863,11,3,2,1,17
473093871,65,6,2,1,74
473095125,122,29,3,2,156
473105157,45,3,2,1,51
473106300,57,17,13,10,97
473107562,19,3,2,1,25
473121204,16,3,2,1,22
473123631,13,17,2,6,38
473143798,47,3,2,2,54
473150837,152,3,2,33,190
473187398,77,3,2,1,83
473187579,166,75,92,26,359
473202973,93,3,2,1,99
473228543,38,3,2,1,44
473230873,67,48,14,1,130
473231173,11,3,2,1,17
473260202,94,3,2,1,100
473268809,59,3,2,1,65
473271465,183,21,2,35,241
473273460,106,3,2,1,112
473302071,11,3,2,1,17
473317680,43,33,35,5,116
473326840,129,60,17,2,208
473329952,27,58,36,22,143
473330515,62,20,2,4,88
473338228,58,13,2,11,84
473371086,14,4,2,4,24
473376139,58,3,2,5,68
473386193,39,73,16,20,148
473391681,35,24,13,6,78
473396652,144,26,3,65,238
473421320,12,3,2,2,19
473431826,19,3,2,1,25
473447052,32,25,2,1,60
473450834,74,17,19,1,111
473453791,105,17,5,1,128
473457932,140,117,69,15,341
473470196,103,19,24,18,164
473480175,30,17,48,2,97
473482411,45,21,18,13,97
473488338,13,3,2,2,20
473503674,139,7,22,35,203
473510158,44,16,12,5,77
473519284,30,9,2,1,42
473522330,169,26,18,30,243
473525748,10,34,2,1,47
473535802,16,12,2,2,32
473541531,23,3,2,1,29
473541695,102,3,40,1,146
473543025,87,29,38,17,171
473548214,58,5,4,6,73
473548275,10,10,2,2,24
473550562,135,3,2,6,146
473560382,55,40,17,10,122
473564837,118,3,2,5,128
473574344,12,3,2,1,18
473575423,39,94,44,8,185
473589392,115,26,2,12,155
473602328,75,3,2,2,82
473621358,114,13,2,1,130
473650699,51,36,15,3,105
473675533,190,4,2,2,198
473692052,37,5,2,4,48
473701900,41,79,19,6,145
473706805,51,23,23,5,102
473718539,49,52,50,14,165
473722257,14,16,2,1,33
473727280,42,38,3,1,84
473730982,18,6,2,1,27
473745772,11,3,2,1,17
473748429,42,3,2,1,48
473760724,52,19,46,31,148
473765135,73,34,19,10,136
473802060,11,3,2,1,17
473811326,84,29,70,1,184
473816018,60,9,22,16,107
473837424,40,33,24,1,98
473860156,10,3,2,2,17
473862698,13,3,2,1,19
473862749,90,28,75,1,194
473872963,162,3,2,3,170
473877690,76,3,2,1,82
473883994,33,17,49,11,110
473889122,55,62,28,5,150
473891714,56,33,2,3,94
473892019,209,3,2,15,229
473917826,126,37,5,14,182
473922959,97,50,5,1,153
473928946,488,3,2,7,500
473956383,10,3,2,2,17
473968444,11,3,2,1,17
473972847,70,22,8,1,101
473991892,21,3,2,1,27
473993355,55,43,26,1,125
473997627,15,9,2,1,27
474024940,13,3,2,1,19
474044483,68,11,2,5,86
474047097,13,3,2,1,19
474053973,13,3,2,1,19
474068369,58,39,2,2,101
474073508,18,11,2,17,48
474124053,35,29,3,7,74
474126192,44,57,26,11,138
474131762,45,21,99,6,171
474137373,11,3,2,1,17
474147424,84,13,2,5,104
474158424,56,15,5,37,113
474166529,81,8,24,11,124
474170651,21,41,2,1,65
474175052,135,5,20,10,170
474176776,89,20,2,1,112
474177091,514,3,2,69,588
474177345,70,3,2,1,76
474183733,24,9,3,4,40
474185946,76,52,12,2,142
474187464,57,3,2,1,63
474189374,82,26,103,3,214
474198174,51,27,4,3,85
474202702,19,3,2,1,25
474213477,55,3,2,1,61
474219980,19,3,2,2,26
474228628,114,64,11,1,190
474228882,129,4,2,4,139
474238508,100,12,2,1,115
474243358,50,45,7,1,103
474244605,40,22,19,1,82
474246597,125,32,2,10,169
474251073,124,16,15,5,160
474257421,33,62,2,10,107
474260612,17,14,2,1,34
474275484,26,13,2,2,43
474279298,18,22,7,1,48
474289379,108,3,2,1,114
474290520,31,3,2,1,37
474301228,20,3,2,1,26
474301968,17,30,5,2,54
474313879,44,32,2,1,79
474325516,81,18,2,1,102
474337582,92,3,2,6,103
474341714,28,3,2,1,34
474345648,54,14,3,10,81
474367140,132,13,2,3,150
474379217,181,16,14,1,212
474387110,11,3,2,1,17
474405584,104,8,113,5,230
474425426,153,3,2,3,161
474432450,113,21,13,1,148
474437115,50,14,2,1,67
474472618,18,34,23,1,76
474478719,67,53,45,1,166
474488047,89,28,2,1,120
474491065,41,3,2,1,47
474509125,97,19,2,3,121
474510298,38,13,5,3,59
474519734,50,3,2,1,56
474520514,52,55,67,7,181
474523429,69,61,2,7,139
474527877,32,77,13,3,125
474531920,50,3,2,3,58
474535431,93,7,2,1,103
474553608,143,31,2,2,178
474557143,17,3,2,1,23
474557821,26,49,23,3,101
474571499,39,59,25,1,124
474590105,37,22,8,14,81
474590197,139,8,2,1,150
474596183,156,48,55,3,262
474600561,116,47,109,4,276
474617861,99,55,2,1,157
474623535,10,11,2,3,26
474650989,89,3,2,1,95
474660943,137,3,2,1,143
474674584,55,5,21,5,86
474675051,28,57,2,1,88
474685725,13,7,2,1,23
474689699,33,33,8,8,82
474694711,68,4,47,1,120
474701503,12,3,2,1,18
474722869,38,25,2,2,67
474737636,27,7,2,1,37
474747148,18,22,5,1,46
474753024,51,3,2,3,59
474755561,139,13,2,2,156
474756768,53,36,16,40,145
474763659,73,36,2,12,123
474767420,105,32,8,24,169
474781748,40,28,21,2,91
474786052,19,20,2,1,42
474798306,49,25,12,1,87
474801019,90,16,2,1,109
474804480,63,3,2,4,72
474804875,49,13,2,1,65
474822156,14,3,2,1,20
474825591,21,3,2,5,31
474828090,87,17,28,1,133
474836022,23,3,2,1,29
474838963,74,26,9,6,115
474839664,133,41,2,4,180
474841791,10,16,2,1,29
474842250,923,3,3,13,942
474846185,47,3,2,1,53
474851724,10,12,2,2,26
474854562,64,37,44,1,146
474858473,261,34,2,13,310
474863029,51,14,2,1,68
474886923,60,39,31,1,131
474898061,74,3,2,3,82
474902559,113,37,46,1,197
474909944,82,76,14,1,173
474918398,138,7,28,1,174
474923921,106,3,2,1,112
474925063,13,3,2,3,21
474932180,11,3,2,2,18
474945109,66,59,130,5,260
474967681,89,3,2,5,99
474968355,13,11,2,1,27
474976662,113,24,2,1,140
474982478,35,23,12,19,89
474983719,61,49,68,5,183
474985381,109,15,36,5,165
475001752,14,3,2,1,20
475008753,71,43,15,2,131
475031021,207,9,4,1,221
475047287,153,25,2,2,182
475049434,1482,3,2,23,1510
475053330,68,3,2,1,74
475069870,10,6,2,1,19
475079428,17,3,2,2,24
475092903,11,3,2,1,17
475096388,29,15,3,1,48
475106321,82,48,2,5,137
475108815,58,15,2,4,79
475109494,57,5,2,20,84
475113292,47,49,36,5,137
475126817,59,15,2,1,77
475130405,101,14,2,1,118
475196091,95,50,66,1,212
475199787,36,20,2,1,59
475216174,42,3,2,1,48
475217248,56,40,4,3,103
475217373,76,3,2,1,82
475217778,17,3,2,5,27
475232941,80,19,36,31,166
475243820,41,10,56,2,109
475246779,29,3,2,1,35
475268081,39,3,2,12,56
475273782,23,19,2,1,45
475280733,12,3,2,1,18
475296454,37,3,2,1,43
475298098,35,26,16,1,78
475305046,145,3,2,6,156
475310337,65,47,34,5,151
475321038,11,3,2,1,17
475323946,11,3,2,1,17
475334848,36,16,44,13,109
475355870,130,28,18,16,192
475374370,52,3,2,1,58
475395181,217,22,2,16,257
475399875,59,3,2,1,65
475409384,177,3,2,45,227
475411186,169,16,42,8,235
475413718,13,3,2,2,20
475420487,105,14,18,12,149
475423098,36,13,2,2,53
475447759,95,10,2,2,109
475456546,131,21,4,45,201
475457530,46,3,2,3,54
475459919,76,14,2,9,101
475462750,75,40,124,1,240
475468400,203,31,4,1,239
475486406,35,25,7,1,68
475487280,27,3,2,1,33
475491157,53,8,4,4,69
475499023,99,8,28,6,141
475499893,60,12,5,1,78
475502302,13,3,2,1,19
475511161,100,3,4,1,108
475521696,13,3,2,5,23
475532183,75,4,12,4,95
475535102,25,59,57,13,154
475546018,171,28,39,20,258
475550893,109,3,2,1,115
475551869,12,3,2,2,19
475552448,25,47,2,1,75
475581787,135,17,27,29,208
475603464,15,3,2,3,23
475621273,35,26,2,9,72
475628859,80,3,2,9,94
475631300,54,3,9,3,69
475631960,25,3,2,8,38
475643243,107,34,11,3,155
475644102,15,3,2,3,23
475646345,117,6,27,12,162
475648170,10,4,2,1,17
475650858,18,3,2,1,24
475659800,35,7,2,1,45
475661269,75,45,2,3,125
475668091,163,42,49,33,287
475669162,183,13,9,31,236
475670384,172,3,2,1,178
475688758,37,21,2,2,62
475692592,24,69,27,1,121
475712366,107,44,80,11,242
475722113,112,51,6,1,170
475740212,19,6,2,1,28
475740244,104,13,6,1,124
475742214,93,29,2,9,133
475748388,45,7,2,1,55
475752662,99,3,2,1,105
475752795,92,35,2,1,130
475752967,100,3,2,2,107
475759294,54,177,8,1,240
475762417,65,50,59,27,201
475772031,34,14,2,6,56
475773393,131,18,2,1,152
475776753,26,18,3,2,49
475780212,74,18,26,5,123
475780337,24,3,7,3,37
475789305,167,3,2,10,182
475794031,141,16,92,94,343
475805135,68,38,2,1,109
475836182,20,52,2,1,75
475837859,11,3,2,1,17
475847169,57,30,27,65,179
475852385,166,3,2,1,172
475866583,41,52,56,3,152
475868901,105,15,71,8,199
475869468,45,17,50,2,114
475875024,183,3,2,28,216
475879057,17,3,2,1,23
475884692,18,13,7,6,44
475891184,30,3,2,3,38
475893176,90,22,2,43,157
475895266,184,11,2,6,203
475903137,38,8,29,2,77
475906344,12,25,2,2,41
475912068,58,3,2,1,64
475927145,38,32,85,5,160
475933662,40,34,17,1,92
475937205,157,28,48,7,240
475959037,22,3,2,1,28
475963039,36,41,2,10,89
475993002,21,3,2,1,27
476006747,57,15,16,1,89
476008403,30,68,30,16,144
476039447,11,3,2,1,17
476043234,10,17,2,1,30
476047160,23,45,25,1,94
476050962,17,8,2,1,28
476059646,56,42,11,1,110
476061311,76,24,22,1,123
476062861,20,3,2,3,28
476073012,10,4,2,1,17
476085961,49,59,32,13,153
476116362,51,20,15,5,91
476135886,20,3,2,5,30
476148796,85,37,36,18,176
476159290,15,3,2,2,22
476165672,55,8,26,15,104
476170433,75,15,3,1,94
476175946,29,28,15,15,87
476177012,34,19,3,1,57
476183019,87,15,12,4,118
476183172,28,3,2,1,34
476185480,41,14,2,1,58
476186961,54,22,2,8,86
476187642,18,14,2,1,35
476200050,16,11,2,2,31
476202268,70,3,2,7,82
476216555,23,4,2,1,30
476220656,23,174,55,1,253
476223984,38,21,7,16,82
476225035,122,8,51,1,182
476233658,33,8,2,3,46
476238179,59,19,2,3,83
476252168,116,11,2,4,133
476262932,105,10,22,1,138
476269115,35,50,2,1,88
476282567,29,31,4,4,68
476290619,26,3,2,2,33
476308990,43,14,6,4,67
476314470,88,3,2,16,109
476321306,135,26,4,1,166
476323561,19,9,2,1,31
476332081,31,3,2,3,39
476332226,148,66,2,5,221
476337579,95,3,2,1,101
476358035,41,3,2,1,47
476363267,28,25,7,20,80
476368047,228,3,2,1,234
476369121,64,83,2,4,153
476382860,100,3,2,3,108
476384258,34,3,2,1,40
476385695,79,3,2,7,91
476392588,31,41,51,1,124
476403469,110,3,2,94,209
476404490,24,3,2,1,30
476411868,18,12,26,20,76
476413006,158,3,2,1,164
476413887,35,32,44,1,112
476416896,19,3,2,2,26
476419610,36,21,6,10,73
476420486,10,4,2,2,18
476427949,49,3,2,1,55
476428512,92,23,20,17,152
476431882,21,30,20,1,72
476437535,23,58,110,4,195
476439742,60,16,2,15,93
476445827,118,7,4,3,132
476452872,10,4,2,1,17
476477702,48,3,2,1,54
476478539,12,3,2,1,18
476485587,47,23,2,1,73
476486773,78,25,20,3,126
476494482,11,3,2,6,22
476502930,108,33,8,32,181
476505034,30,3,2,1,36
476522684,58,3,2,1,64
476538178,49,39,12,5,105
476543198,147,4,2,1,154
476567382,46,15,2,2,65
476578871,48,12,54,2,116
476588836,55,47,11,18,131
476591540,159,44,2,1,206
476592934,11,3,2,1,17
476597091,335,3,2,12,352
476607054,59,19,2,1,81
476609852,36,16,5,6,63
476623108,80,3,2,3,88
476625676,49,25,2,6,82
476627012,58,43,36,4,141
476628834,42,31,2,1,76
476632647,107,3,15,2,127
476639956,47,57,2,1,107
476641989,51,36,2,1,90
476664915,72,54,2,5,133
476666095,174,3,2,6,185
476681790,37,38,27,1,103
476684725,57,34,10,1,102
476690230,44,121,17,8,190
476704654,11,3,2,1,17
476719354,48,3,2,1,54
476724867,60,25,13,4,102
476734735,117,24,26,6,173
476737691,37,17,2,1,57
476741230,19,23,2,4,48
476763036,72,18,22,3,115
476774342,27,23,19,1,70
476787102,13,3,2,1,19
476787117,93,4,2,1,100
476801819,13,11,10,11,45
476802930,138,3,2,4,147
476808426,80,7,9,1,97
476818404,40,54,58,13,165
476828984,11,11,5,1,28
476830498,242,13,3,2,260
476841950,15,3,2,1,21
476850726,151,23,17,1,192
476865619,29,69,2,2,102
476870837,81,29,5,6,121
476872882,107,48,6,11,172
476891113,42,24,30,1,97
476892297,19,3,2,1,25
476899332,55,22,2,3,82
476901802,69,3,2,1,75
476916823,79,26,17,35,157
476920245,44,28,2,1,75
476935659,52,3,2,4,61
476935665,217,26,2,3,248
476938106,87,15,48,7,157
476942769,43,7,15,45,110
476942770,22,11,2,1,36
476957208,20,3,2,1,26
476967660,68,44,52,2,166
476973570,181,39,5,1,226
476985631,58,6,50,2,116
476994223,107,9,21,26,163
476997253,44,33,16,18,111
477015192,42,58,14,6,120
477016523,10,17,2,1,30
477025318,64,5,2,3,74
477036434,136,31,2,10,179
477046988,22,6,2,1,31
477054405,122,37,2,22,183
477057545,47,23,2,2,74
477090816,16,3,2,1,22
477092580,183,15,8,12,218
477098302,34,12,2,3,51
477099668,27,33,2,2,64
477135209,22,37,6,1,66
477140176,21,10,2,1,34
477148889,25,3,2,1,31
477153680,14,3,2,11,30
477172536,24,3,2,2,31
477178883,64,20,2,6,92
477185904,20,3,2,1,26
477186743,41,7,4,1,53
477205264,133,5,12,15,165
477222684,45,40,2,1,88
477250197,91,24,2,21,138
477269830,57,12,2,4,75
477275996,40,40,25,3,108
477285302,26,12,5,15,58
477286915,38,54,27,1,120
477294174,64,3,2,11,80
477299321,80,26,7,11,124
477309961,163,35,2,2,202
477316449,26,9,2,1,38
477318034,84,3,2,1,90
477321238,28,3,2,1,34
477333480,11,5,2,1,19
477337792,109,29,55,7,200
477339672,200,44,3,16,263
477346175,12,4,2,1,19
477347090,57,3,2,1,63
477351190,76,19,10,11,116
477356776,77,3,2,8,90
477366528,30,49,22,1,102
477368095,55,9,15,1,80
477384138,43,22,22,2,89
477390413,20,20,11,7,58
477394764,67,3,2,1,73
477395442,190,3,2,7,202
477401526,48,3,2,1,54
477427840,56,9,2,1,68
477446263,27,3,2,1,33
477451905,35,3,2,5,45
477468768,34,11,3,4,52
477475764,237,6,2,2,247
477479957,139,34,78,26,277
477488523,47,24,44,1,116
477489074,63,4,4,10,81
477489102,13,3,2,1,19
477526923,17,12,2,1,32
477528920,184,18,2,26,230
477529571,121,15,2,1,139
477537575,19,3,2,3,27
477570065,83,37,132,6,258
477587659,13,3,2,1,19
477604223,28,20,4,1,53
477608067,23,3,2,1,29
477621539,109,13,39,8,169
477624119,49,15,7,7,78
477631639,118,16,3,6,143
477632093,45,9,3,4,61
477657737,22,3,2,1,28
477658018,15,22,2,1,40
477658604,128,8,2,10,148
477661918,14,5,2,1,22
477663310,56,36,4,6,102
477666877,40,38,22,15,115
477673720,49,84,9,2,144
477676145,65,3,2,1,71
477678656,55,13,2,1,71
477680378,141,12,10,5,168
477697624,12,5,2,1,20
477699384,98,33,13,11,155
477708250,36,29,5,2,72
477712718,12,3,2,1,18
477715175,52,3,2,3,60
477725189,43,40,88,13,184
477729976,28,3,2,1,34
477732385,13,3,2,1,19
477734468,117,5,2,5,129
477751381,56,27,7,1,91
477762977,85,3,2,1,91
477773956,101,27,57,1,186
477774690,30,16,30,1,77
477774710,82,23,36,14,155
477779158,32,12,12,4,60
477782518,103,102,67,42,314
477784119,47,4,11,43,105
477794148,28,13,2,5,48
477805733,134,3,2,1,140
477849601,75,5,96,2,178
477855614,18,22,2,1,43
477859291,70,3,2,1,76
477862585,95,3,2,5,105
477873550,38,88,12,56,194
477886783,45,22,2,1,70
477888680,45,28,2,1,76
477889284,144,18,51,34,247
477889371,65,6,2,3,76
477922043,110,3,2,11,126
477934946,198,3,2,1,204
477935627,11,5,2,1,19
477938708,16,4,2,1,23
477939951,27,4,2,1,34
477943526,98,14,3,7,122
477947840,189,4,2,41,236
477964420,16,15,2,1,34
477974414,78,15,2,6,101
477975597,136,18,15,3,172
477975627,140,55,2,23,220
477984474,33,26,2,1,62
477986461,107,12,50,9,178
477995111,26,3,2,1,32
478023641,29,3,2,1,35
478026577,43,3,18,2,66
478036294,57,3,2,1,63
478038609,22,16,11,1,50
478063812,38,3,6,1,48
478085059,112,5,2,6,125
478091927,11,3,2,1,17
478118821,57,21,120,1,199
478132560,84,3,2,1,90
478143540,51,44,38,48,181
478145387,48,71,61,6,186
478153906,62,5,2,1,70
478159556,107,11,2,1,121
478161491,22,3,2,1,28
478161732,12,3,2,1,18
478169000,63,29,3,1,96
478173038,27,69,6,5,107
478174454,59,3,2,1,65
478183406,45,3,2,1,51
478190929,71,33,6,5,115
478192145,106,24,3,12,145
478193185,13,10,2,1,26
478200488,99,30,32,8,169
478207947,56,6,2,1,65
478222098,18,3,2,1,24
478222135,150,34,4,8,196
478226325,81,43,28,2,154
478267492,37,3,2,1,43
478277224,131,41,67,8,247
478314111,39,5,37,1,82
478315507,97,3,2,1,103
478319247,19,3,2,2,26
478352006,178,43,2,1,224
478356603,54,23,18,6,101
478379627,32,42,6,4,84
478387561,103,27,17,1,148
478423556,26,3,2,1,32
478434124,77,42,41,69,229
478468448,60,5,3,1,69
478473457,10,65,3,1,79
478477949,54,33,39,8,134
478486369,49,3,2,1,55
478487417,27,8,2,3,40
478488716,81,29,14,18,142
478491422,74,20,3,1,98
478497803,32,3,2,2,39
478533691,20,3,2,1,26
478542964,143,104,81,3,331
478544625,11,3,2,1,17
478550008,23,3,2,1,29
478550947,86,12,63,6,167
478554735,11,3,2,1,17
478556786,24,29,8,3,64
478570014,23,37,6,27,93
478581071,60,19,40,23,142
478607612,53,7,2,1,63
478608051,30,3,2,1,36
478637780,397,3,2,6,408
478640987,76,15,35,9,135
478656430,244,67,75,6,392
478675431,32,32,3,2,69
478686477,53,29,2,1,85
478715412,25,18,35,1,79
478725987,35,5,5,7,52
478741247,122,8,26,1,157
478743265,69,20,34,5,128
478761546,109,3,2,21,135
478765328,32,84,41,3,160
478770473,159,51,2,11,223
478773992,124,108,55,3,290
478786140,10,7,2,1,20
478788359,20,3,2,2,27
478798358,111,27,2,2,142
478800146,42,3,2,1,48
478804336,98,8,9,4,119
478806078,42,23,7,8,80
478823608,37,40,2,1,80
478830844,122,5,57,4,188
478833980,109,22,2,1,134
478846846,17,79,43,2,141
478847350,30,39,50,1,120
478848328,95,25,16,13,149
478859853,116,3,2,3,124
478860668,27,38,17,1,83
478865390,93,24,2,2,121
478866698,66,27,15,1,109
478870822,28,17,3,3,51
478875625,48,3,2,1,54
478875638,19,10,5,1,35
478882624,101,52,10,39,202
478885612,131,3,2,3,139
478893055,11,10,5,1,27
478897659,142,34,3,2,181
478906375,76,56,14,49,195
478906417,90,8,2,19,119
478906740,178,66,79,23,346
478910283,117,18,2,22,159
478913029,16,5,2,1,24
478920460,10,9,7,1,27
478937669,153,10,53,2,218
478954707,26,3,2,1,32
478977761,147,28,9,32,216
478988591,111,18,2,10,141
478991814,55,96,48,3,202
478993767,84,3,2,1,90
479000201,10,20,2,4,36
479000402,66,21,19,1,107
479001675,111,3,2,1,117
479011684,63,12,10,1,86
479025927,64,41,19,1,125
479027684,38,30,24,14,106
479028418,188,86,4,3,281
479034787,104,35,93,15,247
479036811,31,3,3,11,48
479041692,124,3,2,2,131
479044824,65,3,2,7,77
479048631,52,3,2,4,61
479054079,189,49,31,115,384
479065692,115,40,23,8,186
479066262,60,16,4,15,95
479073730,14,37,2,1,54
479077902,19,3,4,2,28
479089868,109,22,10,3,144
479137074,189,3,2,6,200
479149567,71,14,2,4,91
479162249,50,17,2,4,73
479165888,10,3,2,6,21
479168480,36,14,34,1,85
479172560,247,3,2,5,257
479173121,20,3,2,1,26
479176473,69,5,9,3,86
479177733,76,63,27,5,171
479183913,15,17,3,11,46
479183934,99,24,10,15,148
479197700,82,3,5,1,91
479216420,74,34,34,23,165
479217129,145,27,48,9,229
479223830,10,3,2,5,20
479235399,26,7,3,1,37
479236555,138,13,3,1,155
479237272,10,6,2,1,19
479242903,107,35,39,64,245
479243009,33,35,7,1,76
479249191,81,24,65,5,175
479260477,36,23,2,2,63
479272174,28,35,5,4,72
479300408,111,36,3,2,152
479313791,63,3,3,4,73
479326872,87,42,8,9,146
479339008,75,62,15,3,155
479342618,54,52,17,7,130
479349063,24,37,14,1,76
479349462,12,3,2,3,20
479360494,32,6,2,1,41
479365448,51,22,2,12,87
479390788,101,21,5,3,130
479401506,60,23,2,1,86
479404504,105,71,19,18,213
479437431,11,5,2,1,19
479444718,17,3,2,1,23
479446240,104,40,7,10,161
479460662,33,3,2,6,44
479470282,143,3,2,1,149
479484462,19,10,2,2,33
479514769,79,4,2,3,88
479518167,84,17,80,1,182
479525896,114,43,6,12,175
479547480,212,36,42,13,303
479552306,43,25,8,61,137
479554642,64,13,22,28,127
479576698,69,16,7,1,93
479584357,47,3,37,1,88
479588429,80,3,2,1,86
479598991,68,25,5,1,99
479602169,12,3,2,1,18
479622161,39,23,8,4,74
479627201,10,66,3,1,80
479627398,41,10,2,3,56
479638693,154,4,3,1,162
479644655,12,25,2,3,42
479649136,95,34,6,10,145
479650445,18,3,2,3,26
479651517,46,7,20,1,74
479668208,21,17,94,1,133
479685495,68,9,19,1,97
479697233,78,17,6,14,115
479704895,49,3,2,6,60
479706442,19,20,2,4,45
479711145,10,8,2,1,21
479718284,127,3,2,3,135
479719333,87,14,2,9,112
479724307,75,16,3,1,95
479730058,177,14,2,51,244
479736035,120,30,2,2,154
479736297,38,23,15,4,80
479741936,52,43,18,12,125
479746658,49,15,22,1,87
479774963,54,8,2,1,65
479791413,49,30,2,4,85
479806984,13,3,2,1,19
479808606,11,14,4,2,31
479811343,74,16,2,1,93
479812681,98,13,17,4,132
479820720,69,25,18,14,126
479823806,92,11,15,1,119
479831525,191,39,55,48,333
479838664,20,8,2,4,34
479838673,10,3,2,2,17
479851566,133,3,2,1,139
479905390,35,7,2,1,45
479935508,11,3,2,1,17
479953955,10,4,2,1,17
479961301,89,10,2,1,102
479967437,56,23,56,40,175
479992762,10,4,2,1,17
479996814,13,3,2,1,19
479996918,105,13,19,8,145
480001359,20,21,2,4,47
480027921,42,14,28,1,85
480041334,22,3,2,1,28
480045487,40,3,2,1,46
480067397,88,20,2,1,111
480096079,10,4,2,1,17
480101330,63,49,3,3,118
480102849,17,3,5,1,26
480110962,127,3,2,2,134
480117776,16,12,2,1,31
480131898,12,6,2,1,21
480133567,48,62,12,6,128
480149724,10,4,2,1,17
480156510,55,17,31,12,115
480163318,38,25,3,6,72
480170644,30,89,14,3,136
480178700,30,3,2,1,36
480183628,24,3,2,16,45
480199470,55,3,2,1,61
480247563,49,8,2,1,60
480257379,18,9,2,1,30
480259469,12,3,2,6,23
480262358,13,14,2,1,30
480269883,42,8,2,5,57
480298137,303,3,2,1,309
480306259,36,31,25,9,101
480308364,140,4,2,1,147
480312126,30,31,63,1,125
480319508,166,35,83,24,308
480324146,12,13,2,1,28
480328217,29,24,2,1,56
480351932,21,3,2,9,35
480356149,162,37,55,7,261
480368303,79,24,2,13,118
480373021,58,30,22,3,113
480377506,98,23,8,1,130
480401304,20,10,2,1,33
480405661,94,43,35,36,208
480413371,10,3,2,2,17
480446011,56,37,2,25,120
480456254,17,24,2,3,46
480486822,92,18,5,12,127
480486980,19,27,6,1,53
480492100,19,27,2,9,57
480493933,38,3,4,1,46
480495787,106,15,2,6,129
480508390,75,10,20,1,106
480508888,12,3,2,1,18
480530278,60,25,2,1,88
480540658,15,3,2,1,21
480551035,28,58,7,1,94
480551753,74,3,2,7,86
480578705,54,37,34,14,139
480580083,49,7,2,2,60
480584212,19,6,2,1,28
480589361,125,3,2,1,131
480592632,17,32,2,1,52
480595557,29,15,2,5,51
480602458,76,50,26,48,200
480610667,34,31,2,1,68
480617853,63,3,2,3,71
480641812,105,21,20,2,148
480653509,215,3,2,2,222
480669111,91,111,56,3,261
480671084,86,57,20,23,186
480676824,59,18,8,2,87
480682341,46,7,25,1,79
480696250,76,13,3,5,97
480713456,88,63,62,1,214
480715295,12,3,2,1,18
480715809,33,3,2,5,43
480728399,104,3,2,4,113
480747611,42,10,2,5,59
480749254,51,79,37,1,168
480751007,51,3,2,5,61
480755609,71,19,3,1,94
480759884,15,3,2,1,21
480813689,10,3,2,2,17
480831137,114,19,6,1,140
480834618,70,41,16,16,143
480834796,19,3,2,1,25
480850479,103,3,2,3,111
480854536,34,3,2,21,60
480870399,24,19,2,7,52
480873573,44,15,2,2,63
480892572,12,14,2,2,30
480896163,206,3,2,1,212
480897705,83,29,2,1,115
480901298,50,3,2,1,56
480903907,82,9,51,6,148
480906057,244,45,3,6,298
480909166,105,72,13,10,200
480909773,11,3,2,1,17
480911102,68,39,18,17,142
480911124,11,3,2,1,17
480913021,31,16,2,3,52
480920145,49,17,23,13,102
480920654,10,5,3,1,19
480947045,63,19,2,1,85
480948462,23,33,2,17,75
480956017,13,3,2,1,19
480958101,97,37,2,1,137
480961122,17,15,2,1,35
480981810,21,3,2,1,27
480989700,14,3,2,1,20
480995987,16,9,2,8,35
481011777,179,23,12,15,229
481026573,96,37,5,6,144
481028139,24,23,13,1,61
481040792,87,15,57,1,160
481049833,49,16,8,10,83
481051326,16,21,16,1,54
481059610,128,3,2,1,134
481066111,150,42,23,1,216
481066807,20,3,2,1,26
481075027,32,13,2,19,66
481075245,87,23,25,70,205
481099571,84,25,11,4,124
481109643,61,18,19,1,99
481110034,10,16,2,1,29
481112235,76,3,2,1,82
481114700,62,3,2,3,70
481117124,54,8,7,1,70
481133743,56,27,34,30,147
481140692,1239,3,2,6,1250
481149233,142,52,6,10,210
481151032,248,73,59,3,383
481152307,35,14,2,5,56
481219880,22,29,96,7,154
481223637,14,4,2,1,21
481226383,10,14,5,4,33
481230102,29,3,2,4,38
481243613,17,5,2,1,25
481246037,14,3,2,1,20
481250658,77,21,2,1,101
481257023,10,13,2,1,26
481258902,10,8,2,1,21
481262034,32,23,6,8,69
481269791,19,31,2,8,60
481270720,33,60,10,1,104
481279150,66,3,2,2,73
481280458,23,3,2,4,32
481299844,58,3,2,1,64
481300843,117,3,2,4,126
481308090,10,5,2,1,18
481310246,56,8,2,3,69
481310942,36,3,11,7,57
481316719,15,3,2,1,21
481319056,12,3,2,1,18
481329816,46,21,2,1,70
481335549,13,19,2,1,35
481341081,138,89,2,36,265
481342899,100,38,28,1,167
481357286,41,62,28,1,132
481363622,11,3,2,1,17
481376076,81,3,2,4,90
481378262,29,16,12,1,58
481385324,33,10,51,1,95
481393535,81,51,7,6,145
481397045,12,6,2,2,22
481398406,120,51,7,7,185
481400118,27,4,29,3,63
481406881,167,3,2,1,173
481461977,48,14,2,10,74
481468520,53,6,2,1,62
481491795,211,3,2,22,238
481502407,35,61,15,3,114
481504875,122,30,50,3,205
481506983,18,3,2,1,24
481519046,84,55,3,5,147
481519667,123,35,2,2,162
481532288,14,8,2,2,26
481532467,12,11,2,1,26
481535462,75,14,2,1,92
481540970,122,21,4,14,161
481544225,25,3,2,1,31
481549844,55,3,2,1,61
481553880,20,3,2,1,26
481589253,59,19,3,1,82
481599066,19,3,2,1,25
481606010,46,6,6,5,63
481624081,10,5,2,1,18
481642704,69,31,37,91,228
481646464,69,10,3,7,89
481649860,43,30,3,4,80
481654094,12,4,2,1,19
481656146,14,16,18,1,49
481657087,10,15,5,4,34
481663888,85,25,8,14,132
481682145,82,25,7,8,122
481713734,99,34,55,1,189
481728542,50,27,4,2,83
481745718,74,3,2,1,80
481765422,44,30,37,5,116
481772598,21,9,2,4,36
481786337,14,3,2,1,20
481787231,60,63,9,3,135
481787294,50,13,2,4,69
481788882,64,3,2,1,70
481796534,281,3,2,1,287
481801210,169,64,17,20,270
481804063,61,54,2,1,118
481804744,94,27,13,10,144
481811448,13,13,2,1,29
481821302,75,27,32,25,159
481847282,77,31,14,1,123
481861701,46,10,12,3,71
481877931,33,4,2,2,41
481882040,11,3,2,3,19
481883317,20,14,7,3,44
481884273,31,3,2,1,37
481886040,10,17,2,1,30
481908676,30,3,5,1,39
481915102,116,3,2,6,127
481916975,27,27,2,1,57
481922527,22,36,11,1,70
481929623,13,10,2,1,26
481942983,31,3,2,1,37
481954796,13,17,6,1,37
481958539,13,9,2,1,25
481967793,84,15,7,22,128
481968363,18,3,2,1,24
481969522,60,3,2,1,66
481981649,97,27,12,5,141
481982751,10,3,2,3,18
481988003,141,20,2,39,202
481988639,16,6,2,6,30
481992144,37,13,2,1,53
481993194,194,16,88,14,312
481994929,79,35,20,7,141
482003287,48,22,2,1,73
482017891,19,3,2,1,25
482018240,71,3,2,1,77
482019090,37,9,2,1,49
482031732,80,21,2,1,104
482035338,48,29,48,2,127
482064908,25,3,2,1,31
482078796,11,3,2,1,17
482084056,53,8,3,4,68
482113146,147,46,23,6,222
482113327,106,22,2,1,131
482113522,31,54,22,4,111
482120134,18,3,2,10,33
482127946,217,38,2,14,271
482141211,11,3,2,1,17
482148473,25,27,2,1,55
482152220,35,46,63,52,196
482157153,33,12,2,1,48
482158582,90,4,14,1,109
482159568,68,81,67,7,223
482165139,18,9,3,1,31
482167293,32,3,2,2,39
482176404,88,16,22,32,158
482181058,21,3,2,3,29
482181763,48,26,10,3,87
482185544,87,4,2,2,95
482192196,161,20,2,1,184
482192438,31,7,2,1,41
482212370,49,49,11,1,110
482215773,92,44,4,3,143
482226788,27,19,29,6,81
482235716,23,21,2,1,47
482260352,10,6,2,1,19
482264377,47,12,7,11,77
482272627,86,3,2,3,94
482278728,23,10,2,9,44
482283530,10,5,2,1,18
482286492,125,3,2,1,131
482298958,53,53,28,10,144
482308050,43,16,2,1,62
482309706,20,26,6,7,59
482310122,43,3,2,1,49
482313638,108,3,2,1,114
482323249,96,6,5,6,113
482324640,11,3,2,1,17
482352424,60,69,6,13,148
482380828,10,11,2,1,24
482390976,138,3,2,11,154
482424725,116,22,56,8,202
482424941,24,34,2,1,61
482436985,22,3,2,2,29
482445793,39,7,3,1,50
482466956,11,3,2,1,17
482467379,12,6,2,1,21
482475399,73,3,2,1,79
482478823,28,16,3,1,48
482492802,21,7,2,1,31
482503187,67,12,3,12,94
482504674,67,3,2,6,78
482510567,77,62,2,1,142
482510814,154,3,2,2,161
482528492,63,21,49,30,163
482531090,11,4,2,2,19
482534060,83,12,11,1,107
482540476,20,28,2,19,69
482549051,65,40,4,35,144
482549353,37,3,2,1,43
482551341,239,30,23,12,304
482552683,43,49,5,5,102
482554778,39,19,2,3,63
482577726,67,18,2,2,89
482582783,56,9,2,36,103
482585141,10,3,2,4,19
482617519,69,3,2,9,83
482618341,51,14,35,12,112
482629744,39,24,11,4,78
482636000,14,6,2,1,23
482646408,159,10,2,20,191
482649982,34,22,28,10,94
482655916,52,9,2,1,64
482685861,15,6,2,2,25
482686094,65,3,2,1,71
482689297,155,3,5,1,164
482692470,216,44,29,2,291
482694949,13,3,2,9,27
482699655,44,56,25,1,126
482706160,211,17,3,5,236
482724771,72,56,25,39,192
482730752,93,11,2,1,107
482734814,150,17,2,1,170
482743654,84,12,25,5,126
482747804,12,3,2,1,18
482756823,14,4,2,3,23
482767806,76,46,4,9,135
482800939,75,12,76,3,166
482805029,200,3,2,1,206
482805446,64,20,81,1,166
482811141,26,26,13,2,67
482815873,11,91,2,5,109
482817245,68,15,2,3,88
482818213,66,20,2,1,89
482819310,33,3,2,1,39
482823958,66,6,2,3,77
482836419,20,81,2,1,104
482852881,23,20,2,6,51
482868002,265,3,2,16,286
482868024,37,3,2,1,43
482873268,112,3,2,1,118
482876795,12,20,2,1,35
482884092,86,3,2,2,93
482895447,32,9,2,1,44
482903796,83,3,2,6,94
482905592,118,18,2,1,139
482915072,174,13,6,49,242
482922406,75,79,2,2,158
482935392,95,11,2,5,113
482943052,157,16,2,1,176
482976438,11,3,2,1,17
482979286,35,3,2,1,41
482981415,63,3,2,14,82
482983378,76,3,2,1,82
482997318,53,9,28,2,92
482998523,76,28,3,28,135
482999132,17,19,2,1,39
483010938,81,26,3,1,111
483015114,282,32,37,12,363
483019196,105,16,3,16,140
483027058,13,13,2,7,35
483036488,46,15,2,2,65
483050696,82,53,12,3,150
483054647,52,89,18,20,179
483054861,179,3,2,8,192
483063066,161,65,19,15,260
483065164,143,21,15,8,187
483071247,88,3,2,2,95
483079177,42,3,2,3,50
483081136,55,5,2,2,64
483084693,64,12,2,1,79
483089985,156,47,19,32,254
483093726,72,16,35,1,124
483103297,92,3,2,1,98
483106504,59,3,2,1,65
483108908,94,26,14,7,141
483114070,57,16,11,1,85
483117086,15,3,2,1,21
483117616,81,33,17,3,134
483118700,63,10,23,1,97
483119056,47,15,2,12,76
483120435,14,44,11,2,71
483126878,94,33,7,14,148
483133160,38,28,41,5,112
483147428,11,3,2,3,19
483154417,11,3,2,1,17
483161824,43,6,3,1,53
483162554,53,3,2,6,64
483165318,71,8,2,3,84
483167301,32,10,2,2,46
483186889,57,5,2,9,73
483191658,38,30,3,3,74
483193734,147,29,4,1,181
483199066,31,41,56,1,129
483208677,24,3,2,7,36
483219796,71,4,7,1,83
483227835,129,74,2,3,208
483248438,76,24,9,1,110
483266103,145,3,2,11,161
483278248,74,3,2,1,80
483279182,168,7,2,5,182
483287173,24,3,2,1,30
483298927,71,44,2,1,118
483300071,42,12,2,1,57
483313266,42,3,2,1,48
483314316,76,29,17,3,125
483316288,26,14,2,2,44
483348209,235,91,49,3,378
483357591,39,3,5,1,48
483359869,105,38,2,5,150
483371967,11,5,2,2,20
483392276,70,18,7,3,98
483410561,57,7,18,17,99
483419483,13,24,2,1,40
483445203,115,3,2,4,124
483445460,68,3,2,1,74
483445531,30,9,20,9,68
483453326,13,60,2,1,76
483462493,35,25,28,1,89
483481706,56,52,39,9,156
483487347,11,14,2,1,28
483488723,28,3,2,8,41
483503880,92,33,2,3,130
483511515,54,22,9,21,106
483513912,86,14,54,8,162
483514664,12,3,2,1,18
483515138,13,3,2,2,20
483521284,10,3,2,2,17
483531188,21,4,2,1,28
483537132,47,11,58,9,125
483540406,136,26,3,2,167
483548865,86,3,2,1,92
483557149,173,26,65,2,266
483559600,11,3,2,1,17
483560656,38,3,2,1,44
483570128,207,3,2,18,230
483594615,32,36,2,1,71
483597432,36,17,2,1,56
483600008,47,3,2,1,53
483606541,66,54,2,19,141
483616664,28,7,2,2,39
483645867,11,21,2,1,35
483653028,97,84,27,4,212
483658115,52,12,2,1,67
483672816,39,37,2,1,79
483683489,161,15,28,9,213
483684853,33,24,3,16,76
483688907,10,28,2,1,41
483703099,22,5,2,6,35
483704186,142,26,20,9,197
483731251,62,128,5,61,256
483734479,87,32,3,27,149
483737908,22,3,2,1,28
483738000,52,49,27,7,135
483740158,23,18,2,2,45
483751131,30,48,16,5,99
483754003,100,12,2,4,118
483758704,53,13,37,5,108
483767109,19,3,2,1,25
483776952,84,30,24,7,145
483779756,36,16,2,3,57
483785409,39,37,2,2,80
483799594,100,18,101,1,220
483803960,70,13,2,1,86
483835107,21,3,2,1,27
483838314,43,8,2,2,55
483865019,53,61,25,3,142
483865794,80,63,13,38,194
483867622,27,41,8,1,77
483869917,57,11,2,1,71
483876430,42,24,18,1,85
483877324,188,3,4,9,204
483888225,10,3,2,3,18
483893228,50,3,2,2,57
483896514,12,48,4,2,66
483904730,12,3,2,2,19
483911845,24,6,2,13,45
483918266,121,18,15,4,158
483935613,27,42,14,2,85
483944454,95,76,52,35,258
483949184,36,8,2,4,50
483965777,10,8,2,1,21
483980669,36,3,2,1,42
483982930,24,47,2,1,74
483988534,10,22,2,1,35
483998834,106,3,2,5,116
484022014,36,18,17,1,72
484022875,72,16,5,6,99
484035574,97,9,3,2,111
484046363,11,3,2,1,17
484051691,13,8,2,1,24
484061195,66,21,4,16,107
484077973,33,24,7,3,67
484079407,61,15,2,1,79
484079958,81,25,2,40,148
484089850,31,107,41,1,180
484105584,56,50,5,15,126
484107026,148,15,8,13,184
484113147,22,30,21,1,74
484140534,38,46,2,55,141
484153653,174,10,3,1,188
484169788,44,36,28,1,109
484170507,111,48,22,36,217
484177446,39,9,46,2,96
484187692,114,3,2,2,121
484196729,32,67,10,12,121
484211193,76,31,2,22,131
484212697,19,5,4,1,29
484226402,164,3,2,3,172
484229560,14,3,2,1,20
484239519,14,3,2,1,20
484263112,31,21,2,1,55
484265404,78,53,33,10,174
484266635,34,8,2,3,47
484266758,110,11,2,1,124
484275979,13,3,2,4,22
484282369,101,112,3,18,234
484289653,116,21,51,1,189
484290858,22,13,2,1,38
484302238,83,3,2,2,90
484323430,38,18,25,10,91
484333722,56,3,3,1,63
484340495,77,3,2,3,85
484340747,79,3,2,1,85
484361537,10,4,2,1,17
484369974,161,3,2,2,168
484370598,205,3,2,1,211
484381408,65,29,50,1,145
484384730,42,3,2,5,52
484399281,312,3,2,13,330
484407507,75,68,2,1,146
484410382,86,49,58,3,196
484411734,129,33,48,3,213
484419154,94,79,2,4,179
484420819,31,3,2,1,37
484429502,16,3,2,1,22
484440464,99,63,16,12,190
484452438,24,8,2,1,35
484458437,14,15,11,1,41
484461608,43,21,20,6,90
484461784,45,78,18,19,160
484485380,78,3,2,1,84
484489597,107,21,45,9,182
484495466,10,6,2,3,21
484509887,115,3,2,1,121
484509900,105,21,105,1,232
484510017,11,3,2,4,20
484520246,57,15,4,29,105
484523396,68,3,2,4,77
484542784,54,9,2,1,66
484581107,56,34,6,3,99
484587988,114,19,58,1,192
484601151,160,22,2,4,188
484605393,50,3,2,5,60
484608644,14,12,2,1,29
484630258,21,59,11,1,92
484655780,67,40,8,22,137
484656437,18,3,2,1,24
484656706,33,54,6,1,94
484661748,99,38,2,15,154
484663088,11,3,2,1,17
484664388,214,3,2,5,224
484673465,158,28,9,1,196
484675168,16,15,2,1,34
484677512,38,7,2,1,48
484681765,14,3,2,2,21
484705154,40,26,5,23,94
484721804,102,16,2,5,125
484730787,50,13,58,1,122
484732713,198,48,3,19,268
484737725,18,29,5,3,55
484740373,36,28,3,1,68
484741699,400,3,2,52,457
484748943,10,5,2,1,18
484752123,21,3,2,1,27
484764923,18,3,2,1,24
484766574,100,24,5,2,131
484768876,80,19,2,1,102
484788082,68,4,2,1,75
484795139,10,3,2,28,43
484813486,146,32,7,3,188
484825864,53,70,8,1,132
484829006,115,3,2,1,121
484844545,97,20,3,11,131
484849979,20,43,15,1,79
484860847,37,3,2,15,57
484875335,12,3,2,1,18
484886981,119,8,2,4,133
484892168,106,26,21,3,156
484909408,73,44,9,1,127
484913934,32,36,73,21,162
484917156,13,24,2,3,42
484919084,54,3,2,2,61
484919193,62,39,4,51,156
484936469,33,26,91,1,151
484936908,13,3,2,2,20
484938305,188,30,3,2,223
484947034,31,8,32,24,95
484951923,13,3,2,1,19
484960297,51,26,2,1,80
484978976,79,17,2,8,106
484979320,135,14,29,1,179
484982141,85,33,6,8,132
484983376,110,58,47,18,233
484985475,157,81,3,1,242
484994260,174,17,6,1,198
485026104,15,23,2,1,41
485027431,131,33,2,11,177
485033645,75,51,2,3,131
485041561,39,9,3,2,53
485050753,62,3,2,1,68
485057011,22,92,60,2,176
485068973,15,42,2,1,60
485074492,90,23,2,1,116
485076365,37,3,2,1,43
485087224,10,92,2,1,105
485097647,72,3,2,2,79
485098169,36,3,2,1,42
485099331,77,3,2,1,83
485109221,140,45,42,6,233
485142414,145,23,2,2,172
485145814,13,4,2,1,20
485163691,69,26,43,11,149
485166484,11,3,2,1,17
485176888,24,3,2,1,30
485200619,79,3,2,1,85
485218662,52,26,2,6,86
485223306,128,3,2,9,142
485224208,48,29,24,20,121
485225954,20,3,4,2,29
485233392,92,17,3,1,113
485235815,30,30,29,4,93
485310468,27,8,4,4,43
485318959,10,9,2,1,22
485322492,11,3,2,1,17
485323191,14,4,2,1,21
485323297,85,7,27,29,148
485334990,28,26,2,1,57
485336445,143,20,2,1,166
485344334,29,27,2,1,59
485347646,38,8,2,15,63
485363002,35,20,2,1,58
485370082,118,55,38,7,218
485371875,45,3,2,3,53
485410345,159,40,2,32,233
485411322,35,3,2,1,41
485415800,107,24,3,1,135
485419069,152,28,31,19,230
485426335,125,3,2,53,183
485434897,157,50,67,107,381
485451600,158,3,2,2,165
485468079,65,18,34,56,173
485481426,10,46,2,1,59
485482007,36,10,15,1,62
485482643,12,35,6,1,54
485488288,90,11,7,14,122
485491047,72,24,56,1,153
485495541,101,78,76,26,281
485508774,37,25,16,7,85
485509027,23,3,2,1,29
485519547,11,3,2,1,17
485526877,28,3,2,3,36
485529767,46,62,4,17,129
485545332,217,25,2,2,246
485548417,91,25,2,8,126
485558410,31,45,2,4,82
485558771,45,59,20,8,132
485567631,75,10,2,1,88
485572390,119,3,2,1,125
485590290,48,3,47,1,99
485596747,64,29,13,3,109
485597316,131,59,65,1,256
485607661,215,3,2,63,283
485607955,124,8,2,13,147
485609415,94,3,2,5,104
485613742,55,25,2,17,99
485620267,46,3,2,5,56
485624986,73,3,2,20,98
485632903,11,3,2,1,17
485633814,50,5,35,2,92
485660366,99,3,2,7,111
485673099,83,18,47,3,151
485679676,13,3,2,1,19
485687377,158,3,49,1,211
485689957,10,16,2,2,30
485696885,28,37,6,1,72
485697304,123,38,2,28,191
485706536,143,3,2,4,152
485708241,42,20,2,1,65
485710520,84,14,18,4,120
485721733,11,3,2,1,17
485743893,13,13,8,1,35
485745491,131,11,17,10,169
485751321,66,161,15,17,259
485762344,108,38,32,8,186
485782653,92,19,3,4,118
485797978,78,26,24,3,131
485800807,37,6,2,3,48
485801005,136,13,17,1,167
485805901,98,19,6,13,136
485807304,58,31,85,10,184
485816199,11,3,2,1,17
485819127,26,5,4,1,36
485834745,23,5,2,2,32
485836189,13,3,2,1,19
485839345,57,33,7,1,98
485854770,12,31,2,1,46
485863309,55,3,2,2,62
485869499,111,3,2,13,129
485875474,55,7,40,2,104
485880948,185,20,2,1,208
485886442,18,3,2,1,24
485891049,79,6,2,3,90
485892704,20,3,2,1,26
485898708,79,54,2,1,136
485921697,14,3,2,2,21
485937086,271,3,2,1,277
485976839,118,3,2,1,124
485988631,83,10,12,28,133
485992882,26,3,2,1,32
486007331,31,44,30,3,108
486021256,140,20,95,21,276
486028868,97,36,5,12,150
486048857,134,40,13,24,211
486049834,73,29,2,14,118
486057727,62,16,21,1,100
486081398,44,40,40,6,130
486085503,30,40,5,4,79
486088976,70,24,14,1,109
486109362,126,32,4,26,188
486120356,164,3,2,1,170
486126277,94,3,2,2,101
486137309,44,44,11,1,100
486143762,105,3,2,10,120
486146654,56,24,7,1,88
486147636,522,75,28,32,657
486149369,78,3,2,1,84
486149374,23,3,2,1,29
486150380,114,29,2,7,152
486158733,105,17,2,2,126
486211424,58,16,6,5,85
486235430,194,24,24,12,254
486249713,11,3,2,1,17
486250240,10,9,2,3,24
486253160,22,18,2,1,43
486255587,66,11,2,1,80
486267820,14,50,2,1,67
486288144,39,42,20,1,102
486296470,55,14,2,2,73
486301418,24,8,2,1,35
486305729,43,29,2,4,78
486306412,11,8,2,1,22
486309308,83,8,2,5,98
486310461,123,8,2,1,134
486311005,27,18,2,1,48
486316255,183,73,80,14,350
486317427,81,22,25,5,133
486329153,55,4,2,1,62
486342597,137,11,2,1,151
486350944,11,3,2,3,19
486357182,82,6,2,7,97
486365059,12,3,2,1,18
486391239,42,22,6,30,100
486392288,97,34,35,1,167
486396557,67,3,2,1,73
486398625,72,3,2,2,79
486399733,119,32,2,5,158
486419214,13,3,2,1,19
486420722,70,30,15,7,122
486428915,10,13,2,1,26
486431343,66,15,19,1,101
486439077,114,3,4,2,123
486463085,14,43,2,1,60
486465890,21,14,4,1,40
486466411,18,8,2,6,34
486472683,11,3,3,1,18
486475975,102,19,2,1,124
486481798,94,21,24,11,150
486491831,10,14,2,1,27
486492523,12,16,2,1,31
486494482,13,3,2,1,19
486499946,21,4,7,1,33
486507136,79,21,2,1,103
486515265,29,3,2,3,37
486530480,112,9,8,1,130
486551448,39,4,2,1,46
486588852,33,74,4,5,116
486589531,45,25,5,1,76
486589623,33,3,2,3,41
486593483,60,10,2,4,76
486596377,25,26,3,1,55
486603414,68,22,2,5,97
486605384,91,12,2,4,109
486605685,47,3,2,2,54
486608572,53,24,21,13,111
486624517,54,22,2,1,79
486630499,11,3,2,1,17
486641864,10,47,2,1,60
486643569,48,34,45,1,128
486645741,20,32,16,1,69
486647134,35,14,13,1,63
486649760,24,30,26,1,81
486669227,19,13,3,1,36
486673101,102,27,11,37,177
486682361,45,28,4,10,87
486702310,14,37,5,15,71
486711565,112,3,2,10,127
486723131,167,43,29,88,327
486727730,85,57,25,10,177
486730120,46,33,6,4,89
486732259,24,3,2,4,33
486748772,114,13,19,2,148
486749388,60,11,3,3,77
486751466,61,8,2,1,72
486766964,372,3,2,10,387
486771124,121,6,4,1,132
486772822,84,25,27,14,150
486806390,80,3,2,2,87
486811367,12,9,2,1,24
486825204,51,25,5,14,95
486825587,86,3,2,1,92
486835789,30,55,2,1,88
486842755,29,30,14,1,74
486870220,85,144,44,6,279
486874230,107,49,4,2,162
486878516,164,3,2,16,185
486887835,147,3,11,11,172
486890941,60,32,30,3,125
486907629,12,3,2,1,18
486927718,55,29,2,10,96
486949342,15,3,2,4,24
486957337,30,27,48,1,106
486963309,34,5,2,1,42
486974675,60,54,8,9,131
486975398,63,26,2,12,103
486989209,86,39,20,1,146
487005176,18,25,12,3,58
487018498,32,52,11,1,96
487021939,32,67,20,14,133
487027233,58,3,2,5,68
487061884,130,3,2,3,138
487084480,53,12,20,1,86
487114608,22,8,5,1,36
487122148,43,45,33,1,122
487153669,141,3,2,15,161
487158664,28,6,14,1,49
487177006,82,12,2,7,103
487183877,22,33,43,10,108
487187720,112,46,2,49,209
487191136,21,22,2,1,46
487197338,12,3,2,1,18
487230621,11,15,2,1,29
487237598,84,15,43,8,150
487242622,21,3,2,1,27
487252158,76,3,2,1,82
487255434,17,3,2,1,23
487261091,114,28,4,3,149
487276511,136,3,2,2,143
487287191,95,29,3,1,128
487289996,86,23,50,12,171
487299351,58,11,2,3,74
487301752,67,84,23,1,175
487304393,60,30,2,15,107
487307029,119,44,22,5,190
487313789,41,23,22,7,93
487316529,127,15,148,1,291
487342241,10,12,2,1,25
487345914,34,49,2,3,88
487383312,70,29,67,7,173
487392346,43,17,24,24,108
487404523,10,13,2,1,26
487405444,58,22,35,11,126
487406724,32,18,15,7,72
487412961,12,3,2,1,18
487418527,11,3,2,1,17
487458597,49,3,2,1,55
487464715,73,30,57,4,164
487475944,123,56,30,1,210
487479795,48,30,16,5,99
487484680,41,51,16,26,134
487501513,73,4,2,1,80
487507035,10,7,2,2,21
487518406,169,10,2,1,182
487538286,48,3,2,9,62
487547446,27,12,3,9,51
487550540,74,58,23,10,165
487557481,24,20,6,5,55
487559218,33,29,8,1,71
487560327,235,13,6,1,255
487574316,34,3,2,1,40
487583341,132,48,77,1,258
487592843,38,3,6,5,52
487617817,102,56,53,59,270
487624898,78,17,28,1,124
487625761,205,3,2,1,211
487629556,159,50,103,9,321
487631243,51,46,56,2,155
487636540,78,25,3,1,107
487640109,79,63,8,6,156
487646260,101,72,50,6,229
487663705,17,3,2,1,23
487674585,51,3,2,9,65
487685863,31,10,2,5,48
487687958,137,22,17,6,182
487703815,117,22,46,5,190
487704100,112,21,2,8,143
487705841,26,34,5,1,66
487707422,32,23,7,5,67
487721688,14,3,2,1,20
487739038,37,49,2,1,89
487746036,116,4,2,10,132
487747998,96,3,2,6,107
487762494,86,3,2,3,94
487765151,16,12,3,1,32
487771287,17,3,2,1,23
487790267,97,3,2,1,103
487790747,105,3,2,4,114
487795533,88,21,138,6,253
487807364,125,38,27,9,199
487808579,54,107,5,8,174
487812662,53,76,47,3,179
487816402,69,25,98,1,193
487825505,15,3,2,1,21
487825526,16,3,2,1,22
487833339,53,3,2,1,59
487837605,131,3,2,3,139
487849991,51,3,2,2,58
487875127,106,3,2,1,112
487898719,67,22,27,28,144
487915667,20,6,2,1,29
487921051,197,31,44,8,280
487935920,13,3,2,1,19
487949401,26,3,2,1,32
487962232,21,5,2,1,29
487980130,115,32,40,35,222
487984718,45,50,44,14,153
487988341,164,71,43,63,341
487990346,25,3,2,1,31
488010356,12,6,2,1,21
488013269,39,3,2,1,45
488017215,57,21,64,16,158
488031582,76,44,53,2,175
488032220,31,3,2,1,37
488032992,204,5,2,2,213
488038666,74,25,2,3,104
488040007,47,13,73,8,141
488049040,50,17,3,2,72
488051052,42,15,2,1,60
488052245,38,3,3,1,45
488091241,69,3,2,1,75
488091766,12,5,2,1,20
488097987,19,26,2,1,48
488103375,134,3,2,1,140
488122855,10,4,2,1,17
488160257,134,3,2,4,143
488195454,90,27,18,12,147
488198332,23,46,2,1,72
488200959,83,17,2,3,105
488209725,120,81,59,25,285
488221168,52,7,52,2,113
488238046,24,6,2,1,33
488242354,27,9,2,27,65
488246748,33,3,2,1,39
488246795,63,3,2,23,91
488250541,22,26,16,1,65
488304103,10,10,2,1,23
488328797,23,3,2,1,29
488329191,18,3,2,1,24
488335645,81,3,3,2,89
488339859,36,14,2,1,53
488367683,128,81,42,8,259
488380920,30,3,2,5,40
488389619,49,16,2,1,68
488406280,16,3,2,1,22
488406801,14,5,7,1,27
488424602,12,16,2,1,31
488426498,872,3,2,14,891
488426697,17,3,2,1,23
488433552,35,11,3,6,55
488439590,74,5,12,1,92
488446818,61,3,2,2,68
488452323,91,11,51,1,154
488459523,52,4,2,6,64
488462822,106,29,18,10,163
488463880,36,25,58,2,121
488468343,143,26,3,1,173
488471140,73,3,2,2,80
488490257,22,11,2,3,38
488491509,22,13,2,1,38
488504235,10,11,2,1,24
488534007,216,3,2,6,227
488544045,109,25,3,3,140
488545011,16,3,2,1,22
488548205,63,8,8,2,81
488555861,28,34,6,1,69
488575421,12,25,2,3,42
488609559,45,3,2,1,51
488617317,102,17,9,101,229
488618742,73,3,2,1,79
488618952,111,12,3,7,133
488624559,18,29,7,1,55
488634140,31,33,13,28,105
488641370,47,51,3,12,113
488649803,72,20,2,14,108
488650708,41,12,31,3,87
488660784,28,15,17,2,62
488670739,176,40,73,12,301
488681550,38,3,2,23,66
488687856,11,3,3,1,18
488698787,20,28,2,2,52
488701635,26,13,3,1,43
488712974,14,3,2,2,21
488725261,10,3,2,2,17
488728399,42,73,34,4,153
488729699,119,3,2,2,126
488739468,31,22,14,3,70
488749229,81,32,32,2,147
488764289,148,3,2,3,156
488769049,28,31,2,1,62
488775026,15,4,8,1,28
488818804,48,7,2,14,71
488827584,10,7,2,2,21
488843623,48,16,112,9,185
488850875,15,4,2,1,22
488860167,14,3,2,1,20
488894496,11,9,2,1,23
488898138,21,9,2,1,33
488916278,48,8,4,1,61
488925228,38,3,2,2,45
488928197,148,29,54,20,251
488928464,11,3,2,1,17
488931886,55,42,2,2,101
488932523,51,20,36,14,121
488949790,93,45,16,1,155
488952445,27,17,2,21,67
488956528,128,24,138,4,294
488962668,15,10,2,1,28
488964225,37,17,7,4,65
488974848,61,53,26,21,161
488978903,18,9,2,2,31
488991566,11,46,11,1,69
488999255,59,9,14,3,85
489001076,11,38,2,4,55
489018476,17,3,2,11,33
489031791,23,3,2,1,29
489038279,129,27,2,2,160
489086631,19,21,2,1,43
489088678,49,31,89,46,215
489100836,10,6,2,1,19
489112649,36,22,8,3,69
489114481,43,38,22,20,123
489119084,16,9,2,1,28
489123670,52,9,22,3,86
489130940,41,20,2,1,64
489133770,95,27,4,17,143
489142079,44,7,2,33,86
489146977,116,47,80,6,249
489162662,61,21,104,4,190
489165277,87,3,2,5,97
489176160,21,8,2,1,32
489180440,138,3,2,1,144
489187940,101,33,14,15,163
489188540,24,8,6,1,39
489226514,10,16,2,1,29
489237118,102,22,3,3,130
489269937,25,16,46,1,88
489275010,19,11,4,1,35
489283290,63,11,5,3,82
489310414,18,3,2,2,25
489321040,108,9,2,1,120
489328022,13,3,2,1,19
489347670,60,41,16,11,128
489363882,80,3,2,1,86
489370187,46,3,2,1,52
489380979,10,10,2,1,23
489382952,238,3,2,1,244
489400884,62,3,2,1,68
489402231,20,3,2,3,28
489425922,11,3,2,1,17
489434530,108,12,2,24,146
489442429,248,71,10,15,344
489459707,152,107,18,6,283
489470117,23,32,13,1,69
489474802,35,5,3,1,44
489483320,159,3,7,1,170
489483819,12,8,2,1,23
489498068,22,7,2,1,32
489502820,17,18,2,1,38
489504769,170,11,4,1,186
489523596,11,3,2,1,17
489532941,17,12,2,1,32
489534241,10,4,2,5,21
489534770,284,3,2,2,291
489539560,104,4,3,1,112
489542546,64,3,2,1,70
489557986,73,41,4,3,121
489572867,21,17,3,10,51
489574285,83,35,2,17,137
489603961,10,30,3,3,46
489607925,10,3,2,5,20
489619715,10,20,2,1,33
489620127,106,3,2,4,115
489623018,125,23,57,16,221
489625524,62,22,28,17,129
489631802,226,64,65,11,366
489633852,61,36,37,12,146
489645398,33,14,2,2,51
489651183,59,21,9,10,99
489654817,38,32,4,11,85
489663854,73,26,33,2,134
489668829,69,30,13,9,121
489684197,60,3,2,1,66
489692480,11,43,2,1,57
489701994,19,19,18,4,60
489703625,23,22,10,1,56
489708905,45,8,2,1,56
489717811,162,45,2,16,225
489727485,29,3,2,2,36
489742346,135,6,8,24,173
489748019,133,3,2,1,139
489751654,30,14,2,1,47
489763127,12,6,2,1,21
489771618,144,32,25,3,204
489788837,28,10,2,2,42
489794311,45,38,9,1,93
489801361,12,3,2,1,18
489804579,71,38,83,42,234
489805111,89,44,18,1,152
489825633,213,11,12,18,254
489859957,36,6,2,3,47
489906040,18,3,2,5,28
489906097,116,14,112,5,247
489920025,33,7,2,1,43
489920977,12,3,2,1,18
489938605,50,27,4,2,83
489950267,180,37,2,24,243
489951544,35,16,5,6,62
489953265,19,19,2,15,55
490002309,25,3,2,2,32
490030247,98,20,32,2,152
490032481,38,3,2,3,46
490035170,31,15,2,1,49
490038232,49,21,4,1,75
490070810,73,111,62,23,269
490080200,97,47,17,4,165
490104421,28,11,2,1,42
490106592,36,42,84,2,164
490106907,10,4,2,1,17
490111225,108,37,30,3,178
490113980,28,14,6,26,74
490125469,47,20,22,42,131
490130867,139,3,2,19,163
490132641,99,3,2,1,105
490133088,24,18,2,16,60
490134750,18,48,2,1,69
490141351,33,6,2,1,42
490163901,137,3,2,1,143
490167103,48,20,5,1,74
490186797,71,54,12,28,165
490200619,83,51,32,38,204
490201049,34,19,27,1,81
490204746,124,3,2,4,133
490212659,17,3,2,1,23
490244166,115,20,7,4,146
490262015,73,3,2,1,79
490271058,16,22,43,1,82
490276528,41,94,2,1,138
490282274,45,62,37,5,149
490292572,13,15,2,1,31
490302910,68,25,13,5,111
490307394,119,3,2,2,126
490317999,140,62,27,17,246
490324527,51,58,27,13,149
490329521,161,6,2,1,170
490335040,78,3,2,1,84
490341188,11,3,2,2,18
490346278,12,3,2,1,18
490375421,19,17,3,1,40
490389378,86,12,2,1,101
490391764,56,28,42,19,145
490397568,67,3,2,4,76
490409019,29,29,7,1,66
490417545,140,10,2,23,175
490425303,45,49,5,2,101
490430393,64,18,2,15,99
490437933,17,23,2,3,45
490463112,11,3,2,1,17
490466606,20,14,2,1,37
490472120,32,61,4,9,106
490476936,217,9,39,29,294
490477984,62,29,2,2,95
490486406,129,26,2,1,158
490500024,13,3,2,1,19
490519036,16,3,2,1,22
490526904,90,34,64,4,192
490539646,15,13,2,6,36
490554659,76,42,8,3,129
490560042,69,5,2,3,79
490572564,13,11,2,1,27
490574531,144,3,2,1,150
490590594,31,42,2,12,87
490648138,102,3,2,6,113
490653735,35,55,25,16,131
490660769,28,3,2,1,34
490663965,11,15,2,1,29
490673836,98,11,32,2,143
490682462,17,20,69,2,108
490697729,27,11,20,4,62
490701340,102,30,53,27,212
490701875,11,3,2,1,17
490708987,10,6,2,4,22
490710942,99,10,2,1,112
490714812,43,19,8,5,75
490716906,105,3,2,1,111
490724774,45,53,2,12,112
490730057,27,27,26,3,83
490743896,163,3,2,16,184
490762907,67,3,2,1,73
490765478,17,3,2,1,23
490765617,12,46,2,7,67
490791132,31,19,6,5,61
490807412,28,7,2,1,38
490807841,18,4,6,1,29
490828417,115,3,2,1,121
490834117,11,3,2,8,24
490838695,23,17,20,1,61
490839893,75,24,2,19,120
490855855,55,8,8,2,73
490864565,54,23,34,39,150
490880661,45,20,17,8,90
490897451,50,26,82,5,163
490911375,158,3,2,9,172
490915362,73,10,28,34,145
490948822,55,3,2,18,78
490978229,19,47,7,1,74
490981888,62,3,40,1,106
490983278,39,17,4,2,62
490999554,123,3,2,69,197
490999918,24,6,2,1,33
491008315,23,47,2,1,73
491018898,55,19,43,8,125
491020902,17,40,23,2,82
491025869,148,49,37,7,241
491030673,47,17,111,4,179
491033402,44,7,35,1,87
491039951,70,67,16,4,157
491067299,101,32,19,67,219
491070465,32,4,2,1,39
491088406,46,42,12,3,103
491097578,22,3,2,1,28
491122600,120,38,25,1,184
491136191,122,33,82,4,241
491137536,14,35,4,2,55
491143812,116,3,2,1,122
491151275,47,21,77,5,150
491159978,11,14,2,2,29
491166289,97,40,2,1,140
491190998,72,53,12,16,153
491198372,77,17,67,5,166
491210306,155,3,2,5,165
491210611,43,42,8,19,112
491228153,92,3,2,3,100
491234709,14,3,2,1,20
491240624,13,3,2,1,19
491247064,71,37,17,3,128
491282293,97,18,78,21,214
491284573,54,3,2,1,60
491286351,11,4,2,1,18
491294676,26,3,2,1,32
491312751,88,3,2,5,98
491322928,59,23,113,33,228
491329973,428,67,2,2,499
491332084,11,3,2,1,17
491335880,171,3,2,3,179
491347208,24,3,2,3,32
491349871,13,3,2,7,25
491365702,89,12,2,1,104
491374319,69,3,2,3,77
491383852,111,3,2,1,117
491389162,149,3,2,15,169
491424303,13,51,2,1,67
491426100,19,11,2,5,37
491426544,108,31,44,54,237
491437638,79,12,58,1,150
491442710,19,3,2,2,26
491443687,83,3,6,25,117
491448620,12,12,2,2,28
491451880,159,3,2,6,170
491460014,106,48,5,1,160
491461280,16,41,11,8,76
491472115,34,14,75,1,124
491479606,59,20,3,1,83
491488341,48,21,30,30,129
491494213,50,22,44,7,123
491494701,22,3,2,1,28
491497130,14,3,2,1,20
491514606,78,31,12,5,126
491518247,16,19,9,1,45
491549870,58,39,2,10,109
491552666,15,3,2,1,21
491557874,30,14,3,1,48
491570284,45,3,2,1,51
491579534,52,30,7,4,93
491605977,77,11,18,8,114
491606614,15,5,2,1,23
491628377,53,31,16,1,101
491632523,12,3,2,4,21
491633632,31,73,39,1,144
491641444,26,6,2,1,35
491651071,97,15,3,1,116
491659115,30,23,48,1,102
491667832,149,9,6,7,171
491670313,17,18,3,2,40
491681486,72,3,2,1,78
491700161,19,3,2,5,29
491700583,48,16,45,20,129
491704342,72,49,98,1,220
491709721,40,51,29,2,122
491712751,77,14,15,55,161
491718770,64,12,89,1,166
491719761,61,8,18,10,97
491725569,34,47,4,2,87
491735090,56,89,2,3,150
491747124,12,24,2,1,39
491756432,30,24,4,2,60
491763306,37,25,36,11,109
491774095,10,16,2,1,29
491775131,78,22,2,1,103
491779424,11,18,2,1,32
491790436,38,3,2,1,44
491796498,72,8,2,1,83
491801660,13,17,2,1,33
491804154,37,3,2,1,43
491810224,54,44,21,1,120
491819198,87,3,2,29,121
491829237,83,3,2,5,93
491837832,110,17,63,1,191
491843100,90,13,68,34,205
491854120,89,30,2,7,128
491860439,307,20,2,24,353
491865443,31,8,2,1,42
491882888,46,29,2,24,101
491883370,83,19,14,1,117
491884920,11,3,2,1,17
491894283,11,3,2,1,17
491919031,13,3,2,1,19
491923578,84,3,2,25,114
491924657,115,3,2,14,134
491935130,28,38,2,14,82
491940043,207,53,13,1,274
491942259,75,3,2,1,81
491965266,72,35,18,67,192
491969019,33,3,2,5,43
491992136,49,56,33,16,154
492000682,12,3,2,1,18
492004797,27,3,2,1,33
492008622,37,13,2,3,55
492013697,48,91,5,8,152
492014255,30,38,4,1,73
492015327,49,16,2,3,70
492029221,39,60,13,10,122
492040495,71,10,2,1,84
492041066,98,4,51,15,168
492051633,11,3,2,1,17
492069342,57,27,2,1,87
492070229,41,3,2,1,47
492108166,49,4,2,12,67
492112134,46,20,14,1,81
492112506,99,4,24,1,128
492122051,65,3,2,1,71
492124025,54,23,15,2,94
492127454,39,12,2,9,62
492128929,42,3,2,1,48
492135557,11,3,2,2,18
492136370,52,50,26,16,144
492136654,15,5,2,1,23
492144428,78,3,2,1,84
492144465,71,3,2,9,85
492155591,15,6,6,16,43
492166491,52,10,2,1,65
492205368,58,20,2,2,82
492211943,227,3,2,5,237
492220375,22,3,2,1,28
492221061,210,44,25,42,321
492240018,14,16,7,1,38
492244618,138,32,3,7,180
492255173,42,45,2,8,97
492269273,28,20,5,1,54
492273099,57,15,14,16,102
492280298,107,21,47,4,179
492282619,73,15,33,1,122
492284690,10,3,2,2,17
492297825,11,3,2,1,17
492311669,37,3,2,1,43
492316346,48,4,2,1,55
492318609,27,20,9,1,57
492327182,17,10,23,1,51
492328992,89,19,2,19,129
492347521,12,3,2,1,18
492360882,119,39,4,11,173
492363243,14,3,2,1,20
492373882,93,4,2,7,106
492383405,97,23,76,16,212
492383712,140,3,2,1,146
492410903,157,16,15,4,192
492413535,81,18,2,2,103
492415827,11,3,2,7,23
492423374,38,11,2,5,56
492430032,98,29,18,17,162
492436670,44,29,8,3,84
492460826,80,3,2,2,87
492496916,10,3,2,2,17
492512301,17,9,2,1,29
492521558,75,17,43,12,147
492558188,17,72,2,1,92
492560628,32,12,2,7,53
492570095,13,3,2,1,19
492587294,170,17,24,4,215
492592237,139,9,76,12,236
492595299,38,17,19,30,104
492611683,38,8,2,2,50
492637615,15,3,2,1,21
492643794,83,114,6,54,257
492671989,49,3,2,1,55
492681497,16,3,2,1,22
492709435,88,3,2,4,97
492709447,39,54,28,6,127
492738486,84,3,2,4,93
492752887,11,3,2,3,19
492757417,165,35,138,1,339
492793361,47,4,3,2,56
492801833,43,5,2,1,51
492803368,156,14,2,56,228
492813954,167,3,2,2,174
492814711,92,22,9,1,124
492815972,64,3,2,9,78
492824143,152,25,20,18,215
492835189,51,32,39,1,123
492836533,28,3,2,9,42
492856201,53,43,25,1,122
492857214,29,3,2,1,35
492863426,163,18,86,2,269
492863537,75,33,2,21,131
492875479,89,21,2,2,114
492901377,64,3,8,6,81
492918436,38,18,15,1,72
492931514,146,16,4,5,171
492955257,33,11,2,3,49
492955880,28,3,2,1,34
492979058,54,42,10,5,111
492983810,70,3,2,3,78
492984573,148,45,2,23,218
492987894,75,3,2,18,98
492989097,77,14,2,1,94
492997246,52,3,2,2,59
493002205,46,49,16,5,116
493014107,131,16,36,23,206
493015873,145,3,2,1,151
493035351,29,24,4,4,61
493037483,155,49,3,23,230
493076766,71,26,9,6,112
493080828,60,19,2,1,82
493100073,46,46,4,6,102
493110048,33,46,6,1,86
493117198,63,3,2,3,71
493119275,40,3,2,1,46
493143367,193,33,2,1,229
493150056,66,3,2,1,72
493152029,160,51,36,64,311
493163663,132,11,2,4,149
493164864,79,41,14,18,152
493166684,177,28,50,10,265
493167429,33,23,95,2,153
493168344,72,3,2,3,80
493172347,19,3,2,2,26
493175093,90,3,2,1,96
493178139,28,36,31,2,97
493180903,17,24,32,7,80
493183496,12,7,2,1,22
493186750,66,3,2,7,78
493188934,92,18,22,26,158
493212305,92,23,4,1,120
493218017,23,73,2,1,99
493224155,26,40,33,22,121
493255755,226,3,2,1,232
493257127,111,24,25,5,165
493263510,131,3,2,16,152
493269661,90,3,2,10,105
493277301,121,61,2,9,193
493281259,48,14,2,1,65
493291409,172,46,2,3,223
493303256,39,17,8,5,69
493307677,219,30,2,17,268
493308905,106,3,2,2,113
493312184,108,23,2,2,135
493312781,102,35,3,12,152
493315690,10,4,2,1,17
493316714,13,9,2,1,25
493320434,21,3,2,1,27
493321416,70,21,60,1,152
493331074,16,44,2,1,63
493332458,101,13,106,7,227
493334491,80,9,3,2,94
493373635,46,21,29,3,99
493379016,79,53,59,3,194
493382379,10,4,4,1,19
493382466,12,27,2,1,42
493386264,26,37,22,11,96
493392780,10,6,2,1,19
493395494,55,34,2,3,94
493417077,34,3,2,1,40
493420116,107,7,7,1,122
493438905,14,3,2,1,20
493442626,96,3,2,1,102
493444523,32,3,2,5,42
493449027,24,5,4,2,35
493452166,117,8,2,1,128
493470680,45,61,43,40,189
493473291,38,3,3,7,51
493473692,59,109,18,13,199
493489061,32,3,2,1,38
493502096,11,13,2,1,27
493527510,65,14,2,6,87
493530151,44,12,2,1,59
493550647,18,10,2,1,31
493562848,56,5,21,4,86
493581891,44,31,61,16,152
493593652,60,44,17,2,123
493593714,37,5,14,11,67
493593731,136,30,2,2,170
493610207,69,3,2,1,75
493629185,74,41,63,63,241
493636932,29,3,54,10,96
493640665,17,70,26,1,114
493650445,77,49,116,5,247
493652994,412,28,45,39,524
493659481,16,15,7,10,48
493665298,121,19,12,8,160
493669622,26,56,2,1,85
493687724,53,31,5,13,102
493700044,73,23,8,23,127
493713569,98,22,9,9,138
493714015,34,19,2,1,56
493722422,34,3,2,1,40
493735234,177,21,74,3,275
493737195,43,3,2,7,55
493744228,74,4,4,5,87
493745615,44,23,5,1,73
493746126,18,9,2,1,30
493749571,58,38,3,10,109
493756440,28,3,7,9,47
493761892,46,24,3,4,77
493763626,60,3,2,1,66
493781319,38,3,2,1,44
493818240,51,37,34,4,126
493833957,31,86,16,1,134
493834007,20,15,2,1,38
493848503,82,3,2,1,88
493852826,21,29,16,1,67
493865210,32,48,2,1,83
493872755,102,24,57,15,198
493872976,37,15,2,1,55
493881005,101,20,2,1,124
493886338,121,55,29,14,219
493886652,56,24,2,11,93
493898704,83,11,31,3,128
493904835,26,16,11,56,109
493914087,49,28,22,4,103
493920821,54,35,3,5,97
493944802,36,3,22,1,62
493947054,85,37,12,3,137
493962334,95,30,48,1,174
493965549,50,6,2,17,75
493974118,28,3,2,1,34
493982013,42,11,2,24,79
493994687,143,3,2,3,151
494003999,153,11,2,4,170
494006642,45,3,2,1,51
494021482,132,35,4,2,173
494021564,13,3,2,1,19
494029328,118,7,22,4,151
494034743,57,15,2,5,79
494036098,130,4,3,1,138
494037542,16,3,2,1,22
494046551,36,39,3,1,79
494064303,118,3,2,1,124
494064594,12,3,2,1,18
494088354,61,23,6,4,94
494098891,45,37,11,2,95
494111375,45,13,6,4,68
494118342,12,3,2,1,18
494136495,40,3,2,1,46
494137653,27,3,2,1,33
494159569,89,9,3,1,102
494167461,70,74,157,3,304
494173571,208,39,3,29,279
494174544,11,3,2,1,17
494178508,66,3,2,6,77
494219461,50,16,3,1,70
494221623,157,3,2,1,163
494221936,169,3,2,3,177
494230814,43,20,2,8,73
494233311,82,20,174,7,283
494239090,38,19,25,8,90
494246748,30,3,2,1,36
494258859,71,17,5,14,107
494261414,65,26,2,23,116
494261894,68,24,2,3,97
494264258,140,3,2,1,146
494270479,27,11,2,8,48
494272258,12,3,2,1,18
494275363,67,8,22,16,113
494297857,210,3,2,1,216
494299318,42,88,8,2,140
494311999,103,12,2,2,119
494314502,10,29,2,1,42
494330168,16,27,20,4,67
494346957,49,30,9,44,132
494347187,31,33,3,25,92
494347902,72,8,2,2,84
494352104,30,23,9,2,64
494355910,48,9,5,2,64
494368275,107,23,8,3,141
494372151,146,21,42,6,215
494377503,26,3,2,1,32
494380234,33,3,2,11,49
494428929,27,3,2,1,33
494444075,83,21,2,4,110
494455488,157,3,52,7,219
494456292,14,4,2,4,24
494460861,14,3,2,1,20
494469502,51,3,2,1,57
494487352,13,4,2,5,24
494495129,11,3,2,1,17
494495134,95,16,11,2,124
494517033,28,3,19,8,58
494525421,28,13,2,2,45
494534545,80,36,51,1,168
494538399,102,5,4,11,122
494542071,17,42,2,1,62
494549462,126,17,43,6,192
494564649,25,10,17,1,53
494565507,108,11,33,1,153
494570900,10,15,2,1,28
494586141,14,9,19,1,43
494600172,38,15,2,3,58
494604771,52,21,23,1,97
494610859,62,32,3,18,115
494616319,27,53,2,1,83
494619514,92,3,2,5,102
494627984,39,50,24,58,171
494665746,71,28,3,1,103
494678273,25,3,2,1,31
494696863,47,3,2,10,62
494700180,176,9,22,46,253
494712848,23,6,4,1,34
494716290,35,5,2,3,45
494718932,151,16,2,9,178
494722163,19,21,2,1,43
494729537,10,5,2,1,18
494734047,10,3,2,2,17
494734762,48,4,21,1,74
494746864,37,3,2,1,43
494757703,111,21,24,1,157
494779319,17,36,23,16,92
494801805,27,3,2,11,43
494803057,46,29,3,2,80
494809813,38,32,2,6,78
494810834,96,3,2,1,102
494821477,78,57,15,2,152
494829673,158,48,39,25,270
494844282,106,3,2,1,112
494852708,17,26,2,2,47
494861052,10,25,2,1,38
494870454,58,3,2,8,71
494883735,15,9,8,1,33
494889538,10,3,2,3,18
494908558,11,3,2,1,17
494924612,22,21,12,23,78
494929332,64,23,38,2,127
494933401,76,27,25,1,129
494955079,147,33,3,5,188
494958110,94,3,2,1,100
494964313,88,3,2,2,95
494984539,129,9,3,6,147
494992599,31,24,42,1,98
494995831,19,23,2,4,48
494999099,33,27,2,1,63
495005068,218,38,3,1,260
495010887,77,13,12,9,111
495015063,107,27,28,53,215
495015069,33,27,16,15,91
495027288,29,27,2,7,65
495031136,47,15,2,11,75
495037143,33,4,13,1,51
495041009,46,3,2,6,57
495046251,167,18,33,5,223
495051734,55,3,2,4,64
495075296,121,43,135,2,301
495089660,80,25,82,1,188
495103657,27,21,2,2,52
495118749,11,3,2,1,17
495122683,24,74,2,1,101
495139730,46,33,78,31,188
495139925,13,3,2,1,19
495143389,17,17,2,1,37
495154868,19,8,5,14,46
495156197,21,17,8,4,50
495171528,60,3,2,1,66
495178388,44,4,2,2,52
495201542,60,47,2,1,110
495205176,14,9,2,1,26
495207062,51,3,2,1,57
495210412,25,4,33,7,69
495235605,39,6,5,28,78
495253761,13,3,2,1,19
495255588,13,3,2,1,19
495256359,44,27,37,6,114
495256636,11,10,2,1,24
495265700,57,27,26,5,115
495286642,11,3,2,1,17
495289263,97,40,71,1,209
495297390,11,3,2,1,17
495328885,17,7,2,2,28
495345561,23,5,2,1,31
495346687,12,3,2,1,18
495359724,28,5,3,4,40
495361437,45,14,131,11,201
495380807,24,5,2,1,32
495383294,46,31,34,3,114
495387652,14,33,6,1,54
495389279,23,9,5,9,46
495400991,190,3,2,4,199
495403009,68,9,2,18,97
495409514,124,17,2,9,152
495420442,127,26,111,14,278
495421916,133,25,3,2,163
495451262,31,29,10,12,82
495453538,59,27,3,6,95
495491576,80,3,2,1,86
495495351,25,3,2,1,31
495495480,122,6,2,4,134
495509170,23,3,2,1,29
495512566,84,28,2,2,116
495512928,101,15,24,14,154
495514138,23,27,2,1,53
495516523,29,58,8,1,96
495518887,19,3,2,1,25
495528511,204,3,2,12,221
495529511,208,7,7,3,225
495532665,145,3,2,8,158
495536704,38,3,2,1,44
495548531,168,3,2,1,174
495554809,17,83,6,3,109
495563506,42,31,17,2,92
495565597,108,100,21,11,240
495574033,29,25,2,46,102
495594260,61,55,30,32,178
495601066,131,22,40,1,194
495604509,65,3,2,5,75
495608334,23,14,2,4,43
495636164,86,88,23,31,228
495650411,97,11,2,5,115
495651075,88,27,115,21,251
495656018,55,5,2,1,63
495679830,75,24,41,48,188
495681872,98,6,5,1,110
495722705,12,3,2,1,18
495724503,86,7,3,1,97
495748317,73,27,22,10,132
495768822,66,25,4,33,128
495781134,68,6,2,1,77
495788178,81,3,2,2,88
495800054,30,23,3,2,58
495801372,53,30,41,43,167
495813852,298,3,2,1,304
495822439,21,3,2,1,27
495825841,26,16,2,1,45
495868759,48,9,3,1,61
495877614,80,4,83,3,170
495893029,45,79,23,5,152
495894805,39,5,2,5,51
495933305,98,12,2,2,114
495936068,13,3,2,2,20
495940111,79,30,160,27,296
495947230,45,53,3,4,105
495951817,152,44,6,13,215
495952667,68,10,2,1,81
495957054,46,3,2,2,53
495967699,53,39,4,3,99
495972528,28,14,3,5,50
495974161,27,7,19,1,54
495975513,35,3,2,6,46
495977999,60,9,2,7,78
495999708,41,3,2,1,47
496005233,98,57,2,7,164
496006302,40,12,3,12,67
496012638,18,3,2,1,24
496014159,18,7,2,1,28
496016539,16,24,2,2,44
496022971,43,13,2,2,60
496041879,206,3,2,1,212
496047938,12,3,2,1,18
496060677,17,9,10,1,37
496063832,113,20,2,2,137
496077747,74,3,2,1,80
496093827,94,33,6,13,146
496129856,31,14,2,6,53
496134571,76,3,2,2,83
496160287,10,11,3,1,25
496164527,125,27,47,29,228
496170008,117,3,2,7,129
496178389,20,37,3,4,64
496221395,24,23,2,11,60
496221804,67,18,12,1,98
496232192,70,22,23,6,121
496233586,21,40,7,3,71
496235945,63,24,2,13,102
496238749,70,102,50,3,225
496247513,92,15,2,1,110
496249087,43,3,2,1,49
496249302,115,34,2,1,152
496252202,66,48,3,10,127
496256815,17,3,2,1,23
496263205,93,3,2,3,101
496264140,116,26,2,5,149
496278793,217,10,2,7,236
496286407,12,3,2,1,18
496287574,144,17,32,67,260
496292966,10,19,2,1,32
496298446,35,11,4,1,51
496299784,106,3,2,5,116
496313375,84,15,18,4,121
496320880,59,48,5,3,115
496325127,205,16,16,20,257
496330574,143,17,2,4,166
496346323,61,77,16,1,155
496360432,168,24,2,1,195
496386110,86,17,2,2,107
496398826,20,19,2,2,43
496443726,121,3,2,1,127
496444385,23,20,12,1,56
496447847,48,3,2,1,54
496455882,124,3,2,20,149
496456533,12,3,2,9,26
496476182,103,13,24,1,141
496479422,105,42,40,32,219
496492717,105,3,2,1,111
496505772,73,4,2,1,80
496507815,115,54,13,19,201
496511155,38,5,2,1,46
496517063,33,18,2,1,54
496525391,278,3,2,77,360
496530525,86,18,31,6,141
496535795,33,17,2,1,53
496538278,65,36,3,2,106
496544079,47,51,2,17,117
496548510,86,3,2,2,93
496551463,123,3,64,1,191
496553758,10,7,2,1,20
496560426,23,41,51,10,125
496595470,57,28,7,8,100
496597048,19,38,17,4,78
496600325,26,3,2,8,39
496602612,193,13,2,3,211
496607516,62,40,13,1,116
496610110,125,4,73,5,207
496627588,132,14,2,6,154
496659936,26,48,13,2,89
496662444,17,9,2,1,29
496663608,43,3,2,1,49
496672707,11,3,2,1,17
496673626,15,3,2,1,21
496674251,63,3,2,7,75
496676064,233,3,2,1,239
496677509,101,36,5,26,168
496688284,102,46,15,29,192
496690406,102,10,3,18,133
496698802,16,16,2,13,47
496702800,70,49,42,1,162
496714803,37,21,9,20,87
496715291,95,39,140,3,277
496721759,63,20,34,1,118
496722375,10,18,2,1,31
496728008,12,38,2,1,53
496737845,146,33,3,4,186
496747144,14,3,2,1,20
496750933,26,3,2,1,32
496768885,89,3,2,1,95
496778308,16,7,2,2,27
496779481,153,35,10,2,200
496792292,52,59,74,5,190
496819559,16,6,2,1,25
496819932,74,46,2,7,129
496822911,107,93,37,17,254
496825247,18,23,2,2,45
496829858,95,18,44,2,159
496845020,11,9,2,1,23
496854307,45,8,2,6,61
496858785,71,3,2,3,79
496864619,145,55,85,17,302
496869940,96,11,2,1,110
496880658,110,3,2,1,116
496883701,17,19,4,11,51
496886659,10,9,2,1,22
496893314,208,4,2,76,290
496932870,85,8,53,3,149
496936106,125,55,40,22,242
496947506,38,20,21,1,80
496950450,45,44,15,16,120
496957416,60,3,2,5,70
496960291,195,3,2,3,203
496961147,11,3,2,1,17
496967453,20,3,2,8,33
496986072,18,47,5,1,71
496994877,10,3,2,2,17
497007887,73,47,38,73,231
497036175,118,20,2,1,141
497050365,206,136,71,1,414
497090359,207,3,2,12,224
497095477,90,34,43,1,168
497108916,99,41,2,5,147
497112152,111,3,2,1,117
497114814,66,23,85,2,176
497131437,76,4,2,1,83
497141618,130,3,2,5,140
497148859,140,86,18,8,252
497173823,20,20,28,5,73
497175153,149,5,2,3,159
497176971,117,5,13,34,169
497190074,41,5,2,5,53
497192530,67,92,3,19,181
497195329,42,12,19,7,80
497200039,96,33,2,1,132
497202053,29,23,18,6,76
497211499,12,8,2,1,23
497228500,73,54,134,4,265
497242188,44,21,6,17,88
497242445,28,22,2,1,53
497242536,18,3,2,3,26
497246035,67,7,2,7,83
497275357,171,70,2,1,244
497276194,60,16,4,4,84
497297726,20,45,2,1,68
497307950,16,31,8,22,77
497313937,16,17,8,2,43
497336223,12,4,2,1,19
497337136,18,3,2,1,24
497364786,11,5,2,4,22
497376353,52,3,2,1,58
497378776,29,12,27,1,69
497413802,49,5,2,5,61
497414527,84,26,5,17,132
497416270,58,17,5,9,89
497417536,110,3,2,2,117
497426378,35,18,2,9,64
497442475,140,29,2,1,172
497443965,50,3,2,4,59
497444925,55,29,3,1,88
497462799,104,32,2,15,153
497469635,222,3,2,1,228
497478381,21,9,4,2,36
497485633,11,6,2,1,20
497489763,186,41,74,11,312
497492218,26,3,2,1,32
497495616,27,16,8,9,60
497509680,31,63,9,4,107
497538661,18,18,2,1,39
497538862,84,21,2,3,110
497559027,38,66,25,9,138
497560503,84,29,2,9,124
497572428,216,38,2,1,257
497576917,45,3,2,1,51
497580454,68,3,2,1,74
497592734,49,27,12,2,90
497603348,32,34,2,8,76
497604666,123,28,2,13,166
497614568,68,3,2,1,74
497617105,53,3,22,1,79
497621324,25,20,15,3,63
497628487,76,48,25,1,150
497631183,79,16,2,3,100
497656748,157,17,2,14,190
497663969,281,25,19,1,326
497667909,20,32,7,1,60
497683822,219,59,80,56,414
497685555,46,3,2,3,54
497689062,70,33,2,1,106
497707516,52,4,9,1,66
497714976,13,12,5,4,34
497740016,29,21,28,1,79
497743136,11,9,2,2,24
497752539,120,16,33,16,185
497754030,72,15,2,6,95
497762907,11,3,2,1,17
497767311,46,38,4,1,89
497775683,14,4,2,1,21
497775921,84,43,25,25,177
497776544,33,3,2,2,40
497784775,12,3,2,1,18
497806511,82,6,12,10,110
497812444,22,78,2,3,105
497827032,67,3,2,5,77
497837436,69,43,76,6,194
497837915,123,41,72,2,238
497840873,1251,3,2,18,1274
497853120,53,12,2,3,70
497857825,61,13,8,2,84
497864608,15,3,2,1,21
497883397,76,14,2,17,109
497884735,80,3,2,32,117
497890017,18,3,2,1,24
497892305,177,53,2,3,235
497892441,36,3,2,5,46
497896236,114,3,2,6,125
497912090,171,25,29,8,233
497925985,152,47,73,20,292
497928670,30,3,2,1,36
497941914,34,12,2,1,49
497963826,17,3,2,1,23
498001904,160,3,2,5,170
498009896,10,33,2,2,47
498025129,17,3,2,1,23
498025485,40,3,2,2,47
498025941,83,15,4,1,103
498032194,13,5,2,1,21
498044074,125,3,4,3,135
498046905,32,3,2,1,38
498050011,93,18,25,14,150
498051495,90,26,7,2,125
498051584,70,35,2,8,115
498065701,39,25,14,2,80
498066009,58,50,23,23,154
498073992,625,92,2,14,733
498082511,85,28,17,7,137
498097187,11,3,2,1,17
498101038,11,4,2,1,18
498101250,13,5,2,1,21
498103126,52,20,10,2,84
498103915,164,36,2,11,213
498115395,18,19,22,9,68
498121028,118,17,3,28,166
498122318,88,20,2,1,111
498150098,88,31,6,1,126
498160083,31,3,2,5,41
498166243,33,22,2,7,64
498176591,93,19,9,1,122
498193803,13,11,2,1,27
498195424,15,18,2,1,36
498195823,40,38,2,6,86
498196125,56,9,2,4,71
498213991,103,30,33,3,169
498221742,57,14,2,3,76
498223622,91,21,40,7,159
498237587,10,6,2,1,19
498241313,54,15,33,1,103
498250918,57,30,10,20,117
498251902,71,9,2,6,88
498271734,12,14,8,4,38
498274549,76,63,19,10,168
498275323,117,47,28,12,204
498279870,32,9,2,6,49
498284831,52,21,4,1,78
498305790,58,3,4,1,66
498318413,42,28,41,1,112
498318683,120,25,76,1,222
498320037,140,31,42,28,241
498323353,101,27,20,1,149
498338558,11,3,2,1,17
498346284,50,37,2,9,98
498347491,46,23,103,1,173
498349828,14,74,29,1,118
498355208,10,4,2,1,17
498390768,164,38,146,2,350
498393425,40,3,2,12,57
498410058,21,3,2,1,27
498410623,10,3,2,2,17
498424718,70,11,2,1,84
498436584,60,49,5,2,116
498454879,58,3,2,1,64
498459566,74,66,21,17,178
498460431,39,20,2,1,62
498462738,104,20,2,7,133
498466296,20,25,3,1,49
498466959,11,4,2,1,18
498476097,52,41,7,26,126
498487413,123,15,3,3,144
498492471,134,46,54,7,241
498498255,99,29,2,4,134
498499156,86,61,51,1,199
498500736,30,15,26,1,72
498514931,100,5,2,1,108
498515629,53,24,30,12,119
498516209,91,15,3,5,114
498534458,33,3,2,6,44
498575134,87,24,25,18,154
498594425,368,4,6,9,387
498618121,21,103,23,9,156
498625253,63,5,9,1,78
498649364,22,3,2,2,29
498657969,35,3,2,6,46
498658242,106,3,2,1,112
498681235,34,3,2,3,42
498686930,55,17,5,1,78
498687722,83,3,2,1,89
498706243,208,3,2,2,215
498714044,59,37,14,40,150
498732483,31,149,16,4,200
498737146,36,34,21,6,97
498754259,33,9,17,4,63
498759274,211,3,2,4,220
498759568,69,11,2,1,83
498765170,90,13,21,3,127
498767630,30,6,2,1,39
498771199,43,23,12,6,84
498781525,15,9,2,4,30
498782829,108,48,18,2,176
498795591,24,27,3,1,55
498848785,18,3,2,2,25
498864970,19,3,2,7,31
498868156,85,10,26,15,136
498874279,41,5,2,1,49
498884687,144,20,2,12,178
498885237,115,3,8,1,127
498887267,13,3,2,1,19
498887598,193,62,34,5,294
498918137,60,3,2,1,66
498921955,32,13,3,25,73
498943901,12,3,2,1,18
498945704,78,13,2,4,97
498985736,19,12,2,1,34
498989511,14,3,2,1,20
498990708,11,3,2,1,17
498993041,48,17,13,11,89
498999061,24,49,11,2,86
499008007,19,8,2,1,30
499017699,71,47,8,17,143
499042636,71,39,8,9,127
499046925,66,117,108,21,312
499056657,101,29,14,6,150
499072599,29,44,10,9,92
499092640,75,9,2,5,91
499105263,95,3,2,1,101
499108570,61,62,80,4,207
499127066,35,13,2,5,55
499132595,103,21,35,7,166
499147589,24,3,2,1,30
499177054,79,3,2,1,85
499180875,15,3,2,1,21
499186040,62,22,5,1,90
499191707,60,53,8,28,149
499235885,45,3,2,12,62
499236970,72,16,8,1,97
499263278,17,14,46,2,79
499269339,70,3,2,2,77
499272677,111,3,2,32,148
499275623,83,3,2,8,96
499277946,24,3,2,4,33
499284517,48,24,9,2,83
499289579,112,4,5,5,126
499301107,59,3,2,1,65
499302030,67,30,5,13,115
499310492,188,3,2,36,229
499315088,49,16,18,2,85
499324565,54,28,4,19,105
499329850,66,26,15,3,110
499330970,48,31,11,1,91
499345570,51,16,19,4,90
499365854,79,9,2,1,91
499373509,40,70,33,2,145
499393731,57,5,2,1,65
499397807,68,3,2,4,77
499402346,38,58,20,2,118
499403331,28,14,4,3,49
499407488,139,17,41,9,206
499449267,33,24,2,6,65
499450186,43,3,2,5,53
499479066,221,20,3,9,253
499488285,127,26,53,24,230
499501670,135,22,25,7,189
499511128,14,3,2,2,21
499517587,18,6,2,1,27
499531149,80,3,2,1,86
499532841,137,65,41,24,267
499538112,49,29,36,10,124
499552975,36,3,2,1,42
499558117,15,3,2,1,21
499573161,98,68,17,5,188
499579665,71,3,2,1,77
499587434,122,68,37,24,251
499587722,63,3,2,4,72
499589262,12,3,2,1,18
499589563,47,28,5,16,96
499596711,10,3,2,2,17
499610523,26,3,2,1,32
499610701,72,32,75,4,183
499617211,62,15,5,1,83
499623453,117,42,61,12,232
499624850,60,6,2,10,78
499641032,20,21,2,16,59
499642287,26,17,3,1,47
499650144,77,18,3,1,99
499650504,43,3,2,3,51
499653164,61,16,7,4,88
499656438,502,3,2,8,515
499665058,185,4,2,12,203
499670673,38,45,6,1,90
499677266,46,24,2,5,77
499685519,123,9,2,1,135
499694434,47,15,2,2,66
499700656,183,3,2,3,191
499714038,96,11,3,1,111
499741562,224,29,2,1,256
499744724,82,18,2,2,104
499752025,40,3,2,1,46
499752529,84,9,17,1,111
499756467,11,5,2,2,20
499762660,12,3,2,1,18
499777310,80,24,11,8,123
499820969,76,9,12,3,100
499826035,45,32,2,4,83
499829344,111,12,2,6,131
499839268,37,76,2,11,126
499841906,96,38,11,2,147
499843952,117,30,2,17,166
499846147,23,8,3,4,38
499846754,94,4,2,1,101
499856641,10,4,2,1,17
499859425,30,3,2,1,36
499864740,140,12,2,1,155
499874307,52,11,18,4,85
499885041,21,4,2,1,28
499886909,32,43,2,1,78
499890149,172,3,2,3,180
499901455,15,3,2,1,21
499903437,26,3,2,2,33
499924356,32,24,4,1,61
499926972,71,3,2,5,81
499930928,84,3,2,5,94
499955243,60,16,2,2,80
499958779,16,3,2,1,22
499965909,39,160,61,38,298
499972185,45,12,2,1,60
499974343,112,6,2,2,122
499993744,27,38,15,5,85
499994775,34,3,5,6,48
499998576,68,17,14,11,110
500019737,11,3,2,1,17
500021311,27,23,10,7,67
500025092,129,3,2,9,143
500031129,696,3,2,13,714
500036571,19,3,2,10,34
500040943,32,94,82,27,235
500041449,274,3,2,2,281
500045908,15,12,3,4,34
500063347,57,11,10,23,101
500067692,16,23,2,5,46
500076289,14,3,2,1,20
500086239,84,23,48,2,157
500089742,19,7,2,2,30
500130989,19,3,2,3,27
500138633,10,14,2,1,27
500146183,24,3,2,8,37
500156697,70,15,10,22,117
500158433,31,44,2,1,78
500183974,19,31,2,32,84
500200174,134,3,2,5,144
500207356,13,3,2,1,19
500216856,60,31,13,1,105
500225177,84,13,11,1,109
500232193,66,3,2,1,72
500234401,28,10,2,7,47
500261967,26,14,2,5,47
500273238,13,3,2,1,19
500279962,11,3,2,1,17
500284448,44,3,2,4,53
500285656,45,7,2,1,55
500309257,110,18,44,1,173
500309862,14,15,2,1,32
500313934,11,5,7,1,24
500320841,71,11,24,7,113
500338133,168,3,2,68,241
500338754,142,9,33,6,190
500375476,37,25,2,4,68
500376306,60,3,2,6,71
500397792,22,3,2,1,28
500403478,88,14,3,5,110
500409581,35,3,2,1,41
500413897,67,30,32,1,130
500414574,15,3,2,1,21
500427813,45,8,2,6,61
500436041,132,31,41,82,286
500447890,51,3,2,1,57
500456617,107,43,2,3,155
500485776,74,3,2,1,80
500512848,74,3,2,1,80
500520142,86,3,2,1,92
500535905,22,3,2,1,28
500538580,47,6,2,1,56
500555975,24,13,2,2,41
500561367,16,7,2,2,27
500562040,135,17,3,1,156
500587132,58,15,2,1,76
500587564,31,10,2,3,46
500588123,18,19,2,1,40
500614406,44,3,2,1,50
500702860,35,42,8,2,87
500706780,58,10,2,1,71
500707286,46,10,66,12,134
500722281,130,3,2,1,136
500722432,43,28,27,3,101
500726023,90,3,2,1,96
500736932,15,11,2,1,29
500749521,43,12,21,1,77
500752861,78,81,160,4,323
500757578,116,15,9,1,141
500763176,73,10,3,1,87
500773267,10,3,2,2,17
500791890,59,14,2,2,77
500815204,131,29,2,14,176
500819025,24,38,2,1,65
500825119,13,7,2,1,23
500830875,19,4,2,1,26
500835287,21,29,2,1,53
500836650,30,34,24,1,89
500837311,46,27,12,14,99
500864697,40,3,2,1,46
500873751,26,3,2,1,32
500881788,18,3,2,1,24
500882850,50,25,50,1,126
500898468,13,23,2,1,39
500904746,43,33,5,1,82
500925214,114,21,2,1,138
500934388,46,4,2,13,65
500947939,13,3,2,1,19
500950710,165,12,2,1,180
500966374,41,3,2,1,47
500970209,33,19,8,1,61
500974635,41,22,2,12,77
500976623,102,34,4,17,157
500982890,13,5,2,1,21
500986331,173,13,2,1,189
500987236,19,3,2,1,25
501003041,61,25,3,1,90
501010990,22,3,2,3,30
501018397,64,41,33,1,139
501032206,18,3,2,1,24
501033384,41,3,4,10,58
501035344,131,14,44,30,219
501047716,108,43,2,2,155
501047999,11,9,2,1,23
501052493,55,11,2,8,76
501059303,33,6,2,5,46
501059965,32,106,54,18,210
501080701,154,20,6,1,181
501082395,26,21,2,5,54
501102106,58,20,2,3,83
501103941,141,3,2,1,147
501114095,13,3,2,1,19
501115486,96,24,3,32,155
501116973,54,3,2,1,60
501118500,105,3,2,36,146
501118805,69,17,57,14,157
501123893,63,20,22,17,122
501131055,14,13,2,1,30
501137166,41,29,2,4,76
501139582,20,3,2,1,26
501157457,34,3,2,3,42
501159838,176,26,2,3,207
501162311,18,8,2,1,29
501170625,69,3,2,2,76
501207423,59,20,5,9,93
501216800,11,7,2,1,21
501221257,70,52,42,1,165
501234385,89,3,2,2,96
501237391,47,18,23,1,89
501253403,146,3,2,1,152
501274370,44,24,35,8,111
501280164,35,33,2,1,71
501281029,14,3,2,3,22
501287897,57,3,2,32,94
501304466,46,3,2,1,52
501334396,22,3,2,1,28
501340274,114,5,2,4,125
501342862,54,18,3,1,76
501351205,24,5,2,1,32
501358953,37,31,2,11,81
501363088,118,24,181,12,335
501376423,41,3,2,1,47
501385728,10,6,2,1,19
501388076,10,4,2,1,17
501389980,34,27,4,1,66
501396083,13,11,2,10,36
501398161,39,4,2,2,47
501411522,49,16,40,1,106
501413835,75,22,16,1,114
501435925,32,34,2,1,69
501438095,74,10,3,1,88
501441461,57,16,4,1,78
501448670,13,3,2,1,19
501454871,25,7,2,10,44
501456290,79,30,26,3,138
501458809,18,3,2,1,24
501460780,110,37,3,3,153
501465858,28,13,2,7,50
501468157,17,9,5,7,38
501480637,95,32,9,8,144
501485576,66,17,3,8,94
501486615,31,3,2,1,37
501492155,28,10,3,2,43
501514573,14,3,2,1,20
501515599,28,52,3,9,92
501521637,91,6,2,9,108
501531357,28,76,14,3,121
501531725,36,73,3,1,113
501552522,137,17,32,7,193
501553526,167,3,2,15,187
501559434,95,11,35,13,154
501574424,180,3,21,1,205
501575882,11,3,2,1,17
501577681,11,3,2,2,18
501592513,106,29,7,8,150
501610886,69,3,2,1,75
501610896,112,3,2,1,118
501621883,77,4,2,1,84
501647185,148,9,3,6,166
501651573,95,44,2,6,147
501658116,16,3,2,1,22
501668740,52,50,8,1,111
501696152,56,19,2,4,81
501701958,86,76,2,7,171
501702551,30,45,19,1,95
501704911,66,13,2,1,82
501705134,40,42,39,8,129
501709794,60,10,2,6,78
501735457,140,34,51,1,226
501744812,88,24,9,10,131
501778328,48,83,17,6,154
501788378,15,3,2,2,22
501801926,24,3,3,6,36
501809212,84,41,2,2,129
501810000,111,3,2,1,117
501819365,57,21,5,12,95
501828617,70,3,2,3,78
501830934,19,4,2,1,26
501853233,88,34,2,3,127
501856833,36,20,35,1,92
501864411,30,20,2,7,59
501872459,108,3,2,26,139
501872676,18,3,2,6,29
501876035,10,4,2,1,17
501876182,92,17,31,1,141
501876288,62,65,30,11,168
501881385,49,18,17,2,86
501885106,191,44,13,1,249
501886431,16,6,6,1,29
501898717,37,19,3,1,60
501902240,89,19,12,1,121
501910188,16,28,35,19,98
501912906,86,6,8,27,127
501914213,21,53,18,1,93
501921378,13,3,2,1,19
501923836,11,3,2,1,17
501927262,78,11,24,10,123
501929311,196,3,2,15,216
501932004,103,48,2,1,154
501942789,28,26,2,1,57
501964708,19,3,2,1,25
501967760,12,52,9,1,74
501973058,44,13,2,3,62
501978424,19,5,2,1,27
502000279,104,4,3,6,117
502010938,98,59,4,1,162
502012106,82,21,7,4,114
502013472,101,11,2,4,118
502013915,108,81,28,25,242
502016548,45,5,2,13,65
502033965,76,20,2,1,99
502034304,38,24,2,4,68
502049071,39,3,2,1,45
502054089,12,27,2,1,42
502063734,142,24,2,2,170
502081995,10,5,2,3,20
502082928,48,16,5,4,73
502089426,58,23,17,1,99
502096734,53,19,8,2,82
502102391,11,16,3,3,33
502118894,206,3,2,1,212
502119348,30,57,20,5,112
502124204,52,38,18,9,117
502131515,54,3,2,1,60
502136301,73,64,88,11,236
502137279,16,3,2,1,22
502139988,44,18,2,4,68
502140711,33,27,2,1,63
502164148,138,5,7,6,156
502173256,250,5,2,7,264
502177364,71,3,2,1,77
502186933,49,14,2,3,68
502197386,89,39,8,2,138
502200562,37,7,2,2,48
502201523,55,6,2,4,67
502204234,11,4,2,1,18
502214927,121,3,2,1,127
502215533,29,51,43,14,137
502222854,123,4,8,2,137
502228362,30,3,2,1,36
502230197,143,25,2,1,171
502234759,34,12,8,1,55
502234807,60,13,2,1,76
502273569,34,3,2,1,40
502278259,128,3,2,1,134
502283194,25,33,2,3,63
502300651,48,3,2,3,56
502320995,90,3,2,1,96
502332104,33,16,22,1,72
502334352,11,3,2,1,17
502337171,59,14,2,11,86
502341389,27,11,2,1,41
502350105,140,20,4,4,168
502354325,54,25,78,13,170
502369039,11,9,5,2,27
502372840,29,3,2,1,35
502378370,34,36,3,4,77
502380567,92,20,6,6,124
502400850,11,3,2,1,17
502404052,28,5,2,4,39
502423820,30,5,2,4,41
502467182,10,7,3,1,21
502468118,72,15,2,6,95
502472014,166,23,67,6,262
502474881,22,3,2,2,29
502480522,102,31,16,20,169
502482829,70,18,20,1,109
502484871,13,3,2,2,20
502518238,31,12,4,3,50
502526702,48,19,2,2,71
502527604,238,84,3,72,397
502529014,80,26,12,2,120
502547659,64,11,4,4,83
502552181,19,17,20,10,66
502563124,40,3,2,2,47
502569399,169,9,2,10,190
502595367,164,3,2,16,185
502615524,40,58,10,17,125
502621270,37,21,24,10,92
502622316,93,3,2,1,99
502623251,45,5,2,6,58
502627739,13,17,2,2,34
502647076,35,38,36,8,117
502652844,16,22,2,1,41
502675749,129,41,44,22,236
502687827,19,3,2,1,25
502694800,118,68,2,1,189
502696305,79,13,2,3,97
502713650,11,3,2,1,17
502720752,20,18,2,1,41
502725052,29,6,2,1,38
502726268,90,67,7,20,184
502726441,18,23,2,4,47
502739561,23,36,4,8,71
502740075,11,14,4,1,30
502742658,18,3,2,1,24
502754536,72,3,13,1,89
502769626,75,24,2,4,105
502773292,21,18,2,1,42
502795965,27,3,2,1,33
502810718,66,30,61,114,271
502817929,33,3,2,6,44
502840078,10,4,2,2,18
502887753,69,9,2,6,86
502890492,183,62,35,7,287
502891777,113,16,2,8,139
502896137,40,14,28,36,118
502898352,69,51,2,6,128
502906681,26,3,2,1,32
502907565,37,7,2,13,59
502908053,36,3,2,2,43
502915783,15,3,2,1,21
502919952,103,22,80,1,206
502927797,105,3,2,5,115
502953735,45,3,2,3,53
502955290,81,11,10,12,114
502988343,66,25,35,5,131
502989674,21,38,38,1,98
502993154,19,10,8,5,42
503058867,56,15,2,1,74
503061882,65,3,2,5,75
503088457,44,28,15,3,90
503089987,75,26,4,16,121
503101642,89,20,2,10,121
503111216,43,14,26,1,84
503114676,203,34,3,5,245
503116346,58,10,97,9,174
503131108,238,13,12,24,287
503142140,109,33,47,83,272
503143277,31,23,2,15,71
503162713,36,27,5,1,69
503166522,421,4,2,15,442
503171084,338,3,2,3,346
503172348,66,23,23,56,168
503176174,11,3,2,1,17
503176849,147,39,2,10,198
503207573,60,4,2,1,67
503224354,46,19,68,8,141
503231503,108,38,7,2,155
503241806,20,15,2,1,38
503242524,13,20,2,5,40
503250062,124,32,3,2,161
503262767,118,19,3,5,145
503262949,96,13,2,4,115
503267637,67,28,37,1,133
503270154,118,48,3,8,177
503273536,41,64,2,1,108
503274800,132,22,2,3,159
503276810,22,3,2,1,28
503280962,32,13,2,2,49
503285878,69,7,2,13,91
503293967,98,3,2,1,104
503296947,95,3,2,1,101
503312354,97,13,25,12,147
503314439,229,19,14,2,264
503317464,10,10,2,1,23
503319285,32,31,2,11,76
503341508,27,56,2,1,86
503344740,67,36,13,14,130
503350171,55,3,2,1,61
503350275,19,21,2,1,43
503355367,13,11,2,1,27
503360028,64,3,2,1,70
503364847,122,32,4,29,187
503368785,94,55,28,12,189
503369471,12,3,2,1,18
503373528,11,3,2,1,17
503390131,15,47,36,19,117
503390787,101,59,90,3,253
503417593,41,15,22,5,83
503424528,27,52,19,1,99
503432956,92,16,24,37,169
503447366,26,27,4,1,58
503452033,13,7,2,1,23
503455608,82,3,2,1,88
503457343,111,9,2,1,123
503463624,15,3,2,1,21
503470565,12,10,2,1,25
503475602,31,3,2,1,37
503490844,23,17,2,1,43
503494947,36,4,37,7,84
503507969,77,22,15,12,126
503519123,20,59,20,1,100
503534314,43,38,32,9,122
503539100,134,18,72,15,239
503557922,79,33,11,24,147
503568885,64,61,2,5,132
503574685,38,3,2,1,44
503584136,106,3,2,1,112
503596637,23,3,2,1,29
503597103,13,49,12,2,76
503624501,71,65,2,3,141
503634927,77,12,2,4,95
503644000,42,58,2,2,104
503648000,98,18,2,4,122
503648084,12,10,2,1,25
503651139,17,5,2,4,28
503667121,15,3,2,1,21
503674606,38,9,9,4,60
503675033,58,35,32,15,140
503697464,50,5,39,7,101
503707155,48,11,9,7,75
503717758,62,3,2,1,68
503719614,66,41,8,7,122
503723665,38,11,3,11,63
503726792,42,22,52,3,119
503729828,16,21,5,13,55
503739772,13,17,2,1,33
503754907,229,41,3,9,282
503758294,10,5,2,1,18
503763367,23,3,2,2,30
503763807,45,19,3,2,69
503771909,113,34,2,18,167
503777898,28,3,2,1,34
503793082,39,8,2,1,50
503794780,10,18,2,1,31
503797852,24,25,4,1,54
503805514,77,50,33,1,161
503817818,60,22,2,7,91
503830316,25,3,2,5,35
503832219,25,3,4,2,34
503871727,44,3,2,2,51
503880573,49,7,29,5,90
503895958,124,24,29,12,189
503897213,108,3,4,1,116
503897229,76,77,149,13,315
503920574,63,16,6,2,87
503923276,26,3,2,1,32
503957356,10,27,2,1,40
503975258,15,3,2,1,21
503975390,47,3,2,2,54
503985771,38,3,2,3,46
503991830,195,4,4,9,212
503992085,20,4,11,10,45
504016614,49,3,2,2,56
504020820,55,46,16,8,125
504025817,128,3,2,1,134
504027749,39,31,13,26,109
504030369,82,3,2,1,88
504030534,64,25,98,6,193
504036388,16,3,2,1,22
504050933,11,3,2,1,17
504056599,10,3,2,2,17
504080372,37,11,72,6,126
504085603,124,3,2,1,130
504088784,83,10,12,2,107
504091396,22,16,2,2,42
504095636,30,86,2,1,119
504123089,35,25,7,11,78
504129115,61,70,2,23,156
504135494,48,53,53,3,157
504139059,97,15,22,3,137
504153937,88,3,2,3,96
504160210,174,24,13,29,240
504168058,22,7,2,7,38
504170746,10,6,2,1,19
504172817,242,37,5,4,288
504182312,102,6,2,1,111
504196173,15,3,2,1,21
504199430,42,18,2,4,66
504207350,185,74,2,1,262
504212345,11,3,2,1,17
504255313,78,3,2,2,85
504265310,98,45,30,47,220
504265475,88,4,2,1,95
504270390,35,3,2,1,41
504278854,48,45,21,2,116
504300040,74,24,9,1,108
504313917,91,21,106,1,219
504323932,39,3,2,1,45
504329678,35,10,7,1,53
504340421,81,14,17,2,114
504344218,38,49,2,4,93
504347437,86,3,2,2,93
504352135,82,3,2,27,114
504361400,69,5,72,35,181
504363786,71,27,61,14,173
504368659,10,6,2,1,19
504379951,65,5,49,1,120
504397301,17,5,2,1,25
504400522,65,42,2,8,117
504401390,21,4,2,1,28
504414703,10,10,2,1,23
504424219,76,4,2,1,83
504432689,93,11,2,4,110
504433018,132,3,2,15,152
504450061,16,10,2,1,29
504460270,175,19,3,7,204
504463308,77,15,5,1,98
504473467,30,3,2,6,41
504479486,30,3,2,1,36
504493647,69,22,2,6,99
504521465,29,3,4,1,37
504528947,79,3,2,15,99
504532484,11,3,2,1,17
504534791,17,32,2,1,52
504545539,42,15,2,14,73
504548939,42,3,2,8,55
504561123,30,26,32,1,89
504573043,69,17,15,10,111
504586302,11,31,2,6,50
504598757,10,9,2,3,24
504620723,44,4,2,1,51
504624144,37,4,2,1,44
504627756,13,3,2,2,20
504635733,58,9,14,3,84
504639199,48,46,32,5,131
504654010,11,3,2,8,24
504665026,65,31,5,14,115
504671416,52,14,2,5,73
504695705,58,3,2,1,64
504697559,31,16,17,17,81
504699230,64,3,2,1,70
504704425,53,22,7,41,123
504717675,64,16,5,3,88
504726589,64,66,45,3,178
504733783,17,12,2,2,33
504742283,13,13,3,6,35
504745353,63,40,32,10,145
504746389,117,67,52,29,265
504753354,60,37,12,1,110
504757671,11,3,2,1,17
504758936,114,58,6,27,205
504759848,136,34,40,27,237
504768605,75,19,48,16,158
504775093,100,18,11,30,159
504781910,111,14,2,1,128
504792877,59,25,44,12,140
504793394,22,116,2,2,142
504807868,33,3,6,1,43
504811966,82,3,2,4,91
504814299,105,17,2,1,125
504836543,60,29,31,2,122
504844398,32,19,2,1,54
504860767,52,51,37,5,145
504866495,13,3,2,1,19
504884593,62,3,2,7,74
504891697,75,3,2,1,81
504900703,35,10,4,8,57
504904129,43,34,13,25,115
504907788,153,3,2,9,167
504908008,80,52,63,9,204
504912202,70,26,14,7,117
504912952,47,74,2,1,124
504914276,15,13,4,1,33
504942150,82,22,2,1,107
504968628,118,3,2,1,124
504972875,39,3,2,1,45
505025406,75,23,49,1,148
505030285,52,33,6,1,92
505039524,15,29,2,1,47
505039989,11,3,2,1,17
505041503,81,30,46,18,175
505048557,52,29,7,1,89
505051113,132,67,4,1,204
505052983,80,38,3,20,141
505066691,11,3,2,1,17
505068011,17,3,2,1,23
505077387,62,3,2,1,68
505077512,10,26,23,1,60
505079512,38,16,2,3,59
505080205,53,46,7,30,136
505090066,43,28,2,2,75
505096350,82,41,3,4,130
505100455,42,3,2,1,48
505100551,77,3,2,6,88
505104016,23,3,2,2,30
505109958,10,4,2,1,17
505129228,40,31,2,15,88
505131402,45,3,2,1,51
505139053,56,3,2,7,68
505152914,22,17,4,7,50
505157607,12,8,2,1,23
505194541,15,34,12,1,62
505207910,49,3,2,1,55
505208207,11,3,2,9,25
505226253,56,3,2,1,62
505238524,17,3,2,1,23
505294348,53,43,38,4,138
505306407,224,3,2,5,234
505315050,115,10,2,1,128
505328242,174,16,2,5,197
505338885,121,89,13,1,224
505341637,11,38,2,1,52
505374764,79,13,2,11,105
505386208,73,3,2,1,79
505388247,17,3,2,1,23
505390218,40,41,11,2,94
505423661,94,13,2,1,110
505428179,10,3,2,2,17
505431099,33,3,2,1,39
505463497,103,3,2,29,137
505468656,13,35,2,1,51
505480552,99,3,2,1,105
505485797,116,3,2,6,127
505512356,56,3,2,1,62
505512802,11,3,2,1,17
505513911,62,8,2,10,82
505524867,11,6,2,1,20
505526217,20,3,2,1,26
505538678,17,13,2,1,33
505539803,67,19,2,6,94
505550386,12,7,2,1,22
505559501,35,61,2,1,99
505572736,111,48,61,36,256
505579840,116,43,15,1,175
505587181,94,31,12,1,138
505598193,56,45,26,2,129
505606630,57,25,2,1,85
505620979,80,9,7,7,103
505622769,29,23,10,21,83
505626220,48,10,2,1,61
505630632,17,5,4,11,37
505644057,87,17,2,1,107
505644115,194,18,17,3,232
505649172,86,18,3,3,110
505656190,109,28,22,1,160
505681500,80,8,6,2,96
505687318,15,45,2,1,63
505715744,18,3,2,1,24
505727089,58,15,6,4,83
505729970,34,48,24,11,117
505735805,128,51,88,1,268
505737013,79,4,21,13,117
505740031,29,15,51,3,98
505742745,12,4,2,1,19
505744385,11,6,2,1,20
505744980,14,3,2,1,20
505748625,96,127,78,1,302
505765368,61,3,2,1,67
505776141,106,47,4,2,159
505779108,216,3,2,4,225
505787689,123,17,2,2,144
505801502,15,3,2,1,21
505804672,104,16,3,17,140
505812221,135,3,2,5,145
505831950,183,10,6,2,201
505847756,40,3,2,2,47
505861897,60,64,9,4,137
505868075,11,3,2,1,17
505885557,15,3,2,1,21
505885874,10,5,2,1,18
505897178,20,3,2,10,35
505898139,28,46,2,3,79
505898517,64,29,2,1,96
505905746,50,20,12,9,91
505914076,38,12,5,1,56
505919989,125,49,8,1,183
505932258,170,46,19,11,246
505932871,49,3,2,12,66
505935596,104,28,28,1,161
505944835,10,9,2,4,25
505959069,142,20,7,6,175
505972150,33,5,2,6,46
505983416,21,3,2,1,27
505997456,16,4,2,1,23
506003285,47,35,11,1,94
506021536,45,11,2,2,60
506032117,165,4,3,4,176
506046601,124,13,70,5,212
506053482,19,3,2,5,29
506055507,51,22,2,1,76
506059417,18,3,2,3,26
506062479,72,21,2,4,99
506064992,66,18,2,3,89
506075063,29,7,2,1,39
506076765,57,17,2,35,111
506103397,44,16,7,2,69
506108403,66,25,2,4,97
506114428,45,3,2,1,51
506114642,16,3,2,1,22
506121398,18,23,2,1,44
506146726,67,3,2,1,73
506151816,56,25,2,13,96
506170707,21,65,8,1,95
506177501,75,33,18,1,127
506182893,10,5,2,1,18
506218340,14,26,12,4,56
506230490,69,17,8,1,95
506230541,87,23,2,5,117
506244716,93,12,16,4,125
506262207,75,3,2,1,81
506268712,78,3,2,1,84
506269152,23,27,24,21,95
506287925,61,13,2,9,85
506290205,10,3,2,3,18
506292726,63,3,2,3,71
506305082,55,34,22,5,116
506316605,21,14,13,1,49
506319874,16,68,2,2,88
506329694,18,3,2,1,24
506337925,22,3,2,4,31
506355265,46,26,5,2,79
506359516,120,3,2,1,126
506376535,67,11,7,4,89
506382175,165,4,2,14,185
506385940,41,7,2,1,51
506395783,35,5,4,1,45
506414270,45,94,2,7,148
506415095,94,16,41,2,153
506427759,12,3,2,1,18
506432592,20,25,7,1,53
506434898,10,14,2,1,27
506455755,49,14,4,3,70
506462761,119,26,14,11,170
506465202,139,78,45,32,294
506478638,24,3,2,2,31
506495944,26,46,2,1,75
506497214,108,16,45,1,170
506513961,123,42,50,6,221
506523718,85,30,22,5,142
506526617,28,34,19,14,95
506534517,74,29,42,3,148
506558654,116,8,2,3,129
506592034,126,5,5,2,138
506603529,33,21,10,7,71
506635387,86,24,40,16,166
506643400,192,25,125,22,364
506661804,13,34,2,1,50
506661850,75,3,2,28,108
506663898,11,3,2,1,17
506668650,63,7,2,1,73
506697348,73,3,2,1,79
506725805,10,3,2,2,17
506759888,30,29,20,58,137
506777050,112,3,3,8,126
506802055,129,21,5,4,159
506805919,18,58,6,3,85
506807668,62,21,8,2,93
506826385,106,27,15,6,154
506844874,73,3,2,1,79
506866430,26,3,2,5,36
506867605,136,10,80,8,234
506872671,25,23,7,7,62
506874874,10,5,2,1,18
506889246,51,66,21,13,151
506891171,182,62,2,1,247
506895209,120,23,2,2,147
506897913,42,3,2,1,48
506902110,57,3,2,3,65
506911677,15,71,18,1,105
506916341,45,24,10,13,92
506928649,45,21,37,1,104
506934763,185,22,87,5,299
506947677,117,17,39,1,174
506954130,104,3,2,1,110
506970466,100,3,2,1,106
506970517,73,30,3,17,123
506972264,32,39,12,1,84
506988553,37,4,2,4,47
507001505,81,10,11,1,103
507018738,149,126,7,17,299
507022371,25,128,9,1,163
507026206,32,3,2,1,38
507031601,69,3,2,1,75
507032498,96,29,28,25,178
507037897,10,5,2,1,18
507049807,80,101,38,7,226
507051266,46,10,2,2,60
507092562,36,31,2,15,84
507102961,154,3,2,14,173
507119424,96,3,2,3,104
507126890,66,32,126,12,236
507127776,98,3,2,1,104
507142975,42,76,6,8,132
507151929,35,50,65,1,151
507160894,15,3,2,3,23
507163965,83,3,2,1,89
507170434,11,3,2,1,17
507176241,37,14,2,1,54
507180713,73,44,74,7,198
507208779,74,21,4,1,100
507219125,159,33,2,2,196
507219810,47,61,12,1,121
507238809,145,41,29,21,236
507240112,11,3,2,5,21
507259883,12,3,2,1,18
507261190,108,29,4,11,152
507263509,103,56,100,3,262
507266181,28,67,8,3,106
507277651,59,50,31,20,160
507280921,18,4,2,2,26
507282794,45,3,2,1,51
507286374,31,26,3,1,61
507302222,139,3,2,3,147
507304394,73,31,14,22,140
507313275,132,4,10,1,147
507315789,15,3,2,1,21
507319720,10,7,2,1,20
507324181,109,11,2,8,130
507324281,81,3,2,1,87
507332215,64,52,11,1,128
507344992,97,3,2,2,104
507369603,64,3,2,3,72
507376343,22,21,2,1,46
507380575,76,9,3,1,89
507383461,87,3,2,7,99
507394383,110,3,3,1,117
507394494,114,4,2,4,124
507405517,54,30,2,1,87
507407263,25,3,2,1,31
507408344,12,54,2,1,69
507408644,13,4,2,1,20
507415083,14,4,2,1,21
507417303,17,3,2,16,38
507418896,135,5,2,1,143
507425241,36,50,23,2,111
507446282,14,3,2,1,20
507453101,26,3,2,1,32
507483233,26,6,2,3,37
507501362,62,11,28,4,105
507503078,51,31,3,3,88
507544554,59,3,2,1,65
507547481,86,31,26,6,149
507550543,50,3,2,1,56
507560563,13,7,2,1,23
507563361,123,41,19,5,188
507581857,99,3,2,19,123
507586380,85,7,97,5,194
507588077,10,42,2,1,55
507595552,14,4,2,4,24
507608975,73,6,2,6,87
507610062,27,3,2,2,34
507620157,52,21,35,2,110
507644491,22,12,2,1,37
507654555,33,3,2,6,44
507655554,60,33,10,9,112
507672480,138,12,44,6,200
507673159,109,26,48,30,213
507674090,16,3,2,1,22
507680518,71,35,7,1,114
507685460,51,22,4,20,97
507693888,46,45,5,6,102
507701562,23,3,2,7,35
507703674,19,5,4,7,35
507704018,39,4,9,5,57
507705259,195,27,3,8,233
507707933,54,3,2,1,60
507720021,29,45,15,17,106
507729817,46,3,2,1,52
507732167,61,23,2,4,90
507743153,49,25,13,1,88
507744661,58,23,22,1,104
507746490,106,49,65,13,233
507749358,22,3,2,4,31
507759988,16,3,2,2,23
507771359,92,3,2,1,98
507781636,60,3,2,1,66
507795047,112,26,65,1,204
507796779,72,3,2,18,95
507804196,142,50,72,3,267
507807294,119,17,13,11,160
507813415,47,102,20,2,171
507818576,80,14,5,1,100
507818894,44,25,2,22,93
507819117,107,26,117,2,252
507819650,19,41,16,1,77
507823131,78,22,11,10,121
507831795,21,16,13,2,52
507861646,12,3,2,1,18
507871020,52,17,24,11,104
507874681,93,22,26,1,142
507880555,27,23,20,1,71
507881967,33,3,2,3,41
507887943,25,18,2,1,46
507889903,10,10,2,1,23
507893993,10,4,2,1,17
507913038,26,3,2,1,32
507913546,13,8,4,2,27
507915447,42,3,2,3,50
507939219,141,10,31,33,215
507944954,13,5,2,1,21
507945732,77,4,2,11,94
507970566,14,3,2,1,20
507973075,12,4,2,1,19
507993868,51,35,11,12,109
508007505,67,65,22,19,173
508016765,65,49,23,25,162
508038849,81,3,2,2,88
508042231,93,65,18,59,235
508044826,18,49,2,1,70
508046226,51,3,2,1,57
508052132,19,3,2,1,25
508055402,88,27,68,6,189
508066659,61,43,2,1,107
508070496,107,30,2,2,141
508073440,55,66,28,26,175
508087357,20,9,35,7,71
508089702,67,30,6,41,144
508100024,32,5,2,13,52
508116168,87,18,6,7,118
508128981,101,3,2,12,118
508160126,90,9,2,7,108
508165462,36,3,2,1,42
508168936,205,23,2,8,238
508195223,71,3,2,6,82
508201608,44,57,2,1,104
508210717,61,21,13,1,96
508216495,14,5,2,1,22
508219030,91,12,3,4,110
508222495,10,12,2,1,25
508230229,106,32,31,1,170
508231115,24,26,2,1,53
508237634,62,15,26,16,119
508252221,13,3,2,2,20
508252378,23,9,2,7,41
508268116,18,3,2,2,25
508274453,86,34,24,22,166
508284667,62,21,6,18,107
508304468,10,15,2,1,28
508306757,34,77,43,3,157
508318813,114,17,24,6,161
508324410,18,3,2,1,24
508329259,90,30,14,5,139
508341300,13,29,2,3,47
508347192,111,25,44,2,182
508361249,64,3,2,1,70
508369235,71,18,36,3,128
508373447,31,3,2,1,37
508373991,46,3,4,1,54
508379039,84,73,57,12,226
508379765,45,7,11,2,65
508388333,111,23,2,1,137
508398956,46,18,22,2,88
508400509,53,3,2,1,59
508412275,37,3,2,2,44
508418047,16,3,2,1,22
508426801,135,26,3,2,166
508440708,104,39,63,4,210
508450132,88,18,4,8,118
508455894,11,3,2,1,17
508457986,69,32,31,34,166
508461328,11,17,2,1,31
508469138,119,53,34,26,232
508470121,35,44,2,15,96
508472294,10,6,2,1,19
508476889,15,3,2,2,22
508484525,156,3,2,7,168
508488316,11,9,2,4,26
508497243,14,3,2,1,20
508498935,11,3,2,1,17
508502219,53,3,2,1,59
508512275,23,17,2,5,47
508535192,18,3,2,4,27
508540967,45,39,2,1,87
508542767,150,33,88,13,284
508547065,18,8,5,13,44
508573541,84,9,12,1,106
508582064,46,95,2,6,149
508585299,47,13,2,1,63
508591274,23,46,37,25,131
508594468,66,3,2,3,74
508594889,88,16,5,31,140
508610795,65,23,6,5,99
508636245,47,6,3,1,57
508644689,36,10,2,6,54
508675600,260,31,40,2,333
508681225,31,35,60,3,129
508681598,95,81,24,7,207
508683244,11,3,2,1,17
508694858,11,3,2,1,17
508715674,81,9,2,37,129
508720317,14,3,2,1,20
508733305,131,23,2,3,159
508742845,140,16,140,155,451
508745861,68,28,21,21,138
508750094,18,38,3,4,63
508751421,40,40,8,1,89
508755520,10,40,2,1,53
508757687,32,15,2,6,55
508758778,58,19,8,3,88
508759480,35,16,2,1,54
508764108,56,61,26,32,175
508767371,60,26,67,36,189
508769884,38,16,2,1,57
508771980,16,3,2,1,22
508783083,51,3,2,1,57
508791275,64,30,22,7,123
508802651,62,56,17,5,140
508808700,58,108,17,9,192
508808909,87,16,4,20,127
508811177,12,31,9,1,53
508820571,11,5,2,1,19
508829194,13,3,2,11,29
508830965,23,5,2,1,31
508842431,138,3,2,4,147
508863685,128,25,4,1,158
508869416,22,3,2,1,28
508871976,17,3,2,1,23
508899559,21,7,18,1,47
508921731,126,50,54,3,233
508922575,138,50,2,6,196
508926226,20,32,13,4,69
508929174,44,6,2,6,58
508935581,30,25,2,2,59
508937046,163,39,41,3,246
508939159,91,67,16,3,177
508954729,42,14,2,1,59
508959055,10,4,2,1,17
508959803,18,35,22,1,76
508966265,154,3,16,2,175
508985822,12,3,2,1,18
509011890,59,3,2,1,65
509021548,12,3,2,1,18
509024288,203,37,34,70,344
509032789,110,16,37,5,168
509041152,11,3,2,2,18
509042044,82,120,12,6,220
509045002,51,22,13,2,88
509047867,16,3,2,5,26
509051194,58,3,2,4,67
509074768,66,14,2,9,91
509076731,100,17,29,25,171
509078173,46,3,2,1,52
509083935,12,15,2,1,30
509088583,118,3,2,6,129
509090297,32,25,10,1,68
509119767,12,20,2,1,35
509126432,154,56,18,10,238
509128679,150,3,2,19,174
509132680,61,30,2,38,131
509133830,93,15,2,3,113
509163300,14,3,2,1,20
509165533,48,16,4,3,71
509174062,38,24,50,5,117
509205548,171,37,98,14,320
509224419,27,17,10,5,59
509245768,19,3,2,1,25
509252697,23,3,2,1,29
509258804,305,39,51,53,448
509266003,12,3,2,1,18
509286545,12,3,2,1,18
509287008,121,3,2,1,127
509287458,16,7,2,2,27
509288526,58,3,2,1,64
509292421,16,3,2,1,22
509292853,11,3,2,1,17
509297287,69,14,31,12,126
509298122,55,100,16,1,172
509300584,13,3,2,1,19
509305448,49,10,2,13,74
509307978,63,22,2,4,91
509314955,48,3,2,1,54
509315385,93,16,22,15,146
509322515,24,27,2,3,56
509327688,11,3,2,1,17
509343705,147,27,10,93,277
509348966,149,3,2,1,155
509358526,152,46,40,5,243
509378384,32,11,24,15,82
509386868,265,3,2,1,271
509387379,79,10,14,1,104
509388573,14,3,2,1,20
509391889,119,19,2,1,141
509394982,15,17,2,1,35
509406335,13,4,2,1,20
509410123,45,43,2,31,121
509410300,80,6,28,3,117
509413132,20,56,17,1,94
509413415,45,20,2,1,68
509426920,1011,3,2,19,1035
509428985,35,18,19,12,84
509431137,147,10,2,3,162
509439340,128,31,18,1,178
509451002,19,3,2,1,25
509454841,57,4,2,1,64
509457714,592,3,2,7,604
509461578,25,3,2,1,31
509471723,21,3,2,1,27
509473836,32,21,2,1,56
509474424,73,18,5,127,223
509476341,104,45,13,2,164
509493100,37,19,18,1,75
509497087,150,21,2,1,174
509510800,20,23,24,1,68
509512226,48,21,27,32,128
509514172,130,26,31,6,193
509518280,14,3,2,10,29
509521032,15,3,2,4,24
509548742,11,3,2,1,17
509550475,21,3,2,1,27
509551589,111,12,3,1,127
509569825,106,9,3,2,120
509572360,54,6,6,1,67
509577915,32,3,2,1,38
509583263,65,3,2,1,71
509583849,27,3,2,1,33
509585444,46,4,2,1,53
509590489,19,23,2,1,45
509597974,30,11,2,1,44
509604829,89,10,4,2,105
509608020,21,16,2,6,45
509621356,20,3,2,1,26
509624439,45,29,2,1,77
509625207,11,4,2,1,18
509626952,95,3,2,1,101
509629722,105,71,88,11,275
509630245,101,52,93,40,286
509639697,23,39,2,7,71
509641792,36,3,2,3,44
509654601,59,46,8,10,123
509662680,35,12,2,5,54
509666494,21,65,9,1,96
509671222,136,3,2,7,148
509684503,96,9,4,1,110
509688495,13,11,2,1,27
509689878,186,114,27,3,330
509690257,81,9,2,1,93
509701277,46,3,2,5,56
509706371,42,26,2,2,72
509720980,34,4,2,6,46
509734179,59,29,2,1,91
509735297,68,37,36,69,210
509749667,51,15,2,1,69
509750107,17,10,2,1,30
509752050,33,38,9,6,86
509759916,44,32,2,3,81
509766772,10,3,2,3,18
509767231,10,3,2,8,23
509768179,15,3,2,1,21
509769115,76,3,2,1,82
509784371,53,3,2,1,59
509788656,145,5,10,2,162
509789417,47,3,2,1,53
509796283,34,14,2,5,55
509796597,68,16,8,1,93
509797223,22,5,2,1,30
509797565,90,3,2,1,96
509802671,74,41,18,1,134
509804388,48,39,24,6,117
509832946,77,11,2,1,91
509833335,161,3,2,5,171
509837774,145,3,2,13,163
509855937,44,12,4,8,68
509862400,16,3,2,1,22
509875715,62,52,39,30,183
509892980,49,43,16,13,121
509898638,34,3,2,1,40
509906870,20,3,2,1,26
509909687,16,17,4,1,38
509911745,20,3,2,1,26
509923106,13,3,2,1,19
509927174,303,40,77,13,433
509945174,83,26,9,6,124
509967569,10,6,2,2,20
509977202,62,8,4,2,76
509985307,24,17,2,2,45
509986212,58,3,2,1,64
509988165,56,42,20,2,120
509989657,77,109,77,49,312
510017091,44,22,30,4,100
510018945,10,3,2,2,17
510026201,11,6,2,1,20
510042126,56,9,3,1,69
510043564,21,17,14,4,56
510047027,83,26,35,6,150
510094934,44,3,2,2,51
510109597,60,14,21,13,108
510137654,12,3,2,1,18
510142431,170,3,2,2,177
510149765,10,5,2,1,18
510150324,127,27,75,11,240
510169463,89,3,2,1,95
510179078,29,3,2,1,35
510185925,14,6,2,1,23
510188242,68,30,16,1,115
510194951,11,3,2,1,17
510195295,63,3,2,2,70
510199292,61,12,8,5,86
510200460,23,3,2,11,39
510202224,46,24,39,2,111
510212084,46,3,2,1,52
510212240,12,16,2,1,31
510234524,65,35,2,5,107
510236558,115,3,2,42,162
510237867,44,39,2,6,91
510257721,109,20,3,2,134
510259625,13,3,2,1,19
510268590,13,3,2,1,19
510271464,35,3,2,3,43
510326282,129,3,18,2,152
510328324,36,42,12,4,94
510328411,11,3,2,1,17
510333598,80,9,6,1,96
510335285,16,16,2,1,35
510340171,11,3,2,1,17
510342132,75,25,2,4,106
510342885,19,15,2,4,40
510350905,13,3,2,1,19
510369424,84,32,21,3,140
510374716,186,34,13,8,241
510396048,12,3,2,1,18
510408912,122,5,2,26,155
510414184,118,86,2,13,219
510435029,12,3,2,1,18
510435849,223,3,2,6,234
510440485,12,3,2,1,18
510445592,183,3,2,9,197
510455257,21,15,14,9,59
510474894,70,15,3,2,90
510475333,74,13,2,4,93
510475694,69,3,2,19,93
510479958,59,3,2,5,69
510480294,39,23,14,7,83
510483345,39,70,2,2,113
510487611,111,7,13,46,177
510492051,17,3,2,1,23
510502311,115,3,2,10,130
510522790,61,15,2,1,79
510541406,37,3,2,3,45
510543707,142,28,42,12,224
510545571,115,3,2,1,121
510554501,12,3,2,1,18
510564881,92,31,2,4,129
510571715,162,64,24,5,255
510586062,68,3,2,4,77
510605560,60,41,40,13,154
510613570,62,54,35,3,154
510616671,38,64,29,1,132
510623167,25,56,2,5,88
510626376,123,33,46,27,229
510630511,39,15,18,7,79
510633876,87,25,2,1,115
510659713,92,3,2,4,101
510660548,39,48,4,13,104
510664770,124,3,2,3,132
510672800,95,3,2,1,101
510695368,108,20,2,8,138
510698631,57,12,2,4,75
510719852,18,3,2,1,24
510721410,11,3,2,1,17
510722465,114,12,167,1,294
510729124,39,10,2,1,52
510729923,292,4,2,32,330
510746465,24,3,2,1,30
510767971,213,3,2,2,220
510771564,88,12,2,1,103
510779700,132,40,31,6,209
510781831,81,3,2,1,87
510783476,41,114,52,1,208
510785159,81,25,81,4,191
510789725,39,45,7,1,92
510797161,106,19,35,1,161
510800228,17,3,2,1,23
510814632,44,77,11,54,186
510815952,70,74,30,1,175
510817533,13,5,2,1,21
510831466,35,12,2,1,50
510840308,24,9,2,4,39
510844054,83,3,2,3,91
510845765,60,17,83,13,173
510854074,25,3,2,1,31
510856624,76,21,2,1,100
510861187,26,21,7,1,55
510863110,51,19,21,2,93
510867983,11,3,2,1,17
510870107,117,72,2,1,192
510884720,117,50,68,13,248
510900360,21,3,2,1,27
510909486,130,37,74,18,259
510914130,53,7,2,1,63
510942776,71,10,2,32,115
510960380,116,18,77,2,213
510970836,240,3,2,3,248
510973414,13,3,2,1,19
510975359,18,7,2,1,28
510985470,93,15,4,1,113
510991366,41,3,2,6,52
511008214,96,3,2,1,102
511016940,39,30,68,3,140
511021330,36,31,34,10,111
511037161,158,3,2,3,166
511037295,52,44,33,18,147
511040522,53,20,2,4,79
511046568,147,22,2,4,175
511051208,39,36,2,1,78
511062317,58,4,2,6,70
511071819,52,33,22,1,108
511084255,47,59,15,6,127
511084324,35,42,18,1,96
511097302,145,3,2,1,151
511118993,18,38,2,1,59
511125425,134,28,2,3,167
511125647,42,24,3,4,73
511129178,69,3,2,1,75
511145245,56,3,2,4,65
511155153,11,3,2,1,17
511161927,21,16,2,1,40
511166583,24,32,13,10,79
511175683,21,7,2,3,33
511181604,19,3,2,1,25
511201279,69,3,34,3,109
511207688,101,30,2,1,134
511219617,65,3,2,1,71
511228530,144,3,2,1,150
511231224,39,40,49,11,139
511241230,11,3,2,2,18
511241819,138,49,12,13,212
511258128,41,5,3,1,50
511261477,96,12,3,1,112
511262339,220,3,2,23,248
511268486,12,3,2,1,18
511271924,61,3,2,1,67
511272123,99,18,2,3,122
511277032,21,51,2,2,76
511277408,43,22,6,2,73
511317883,62,23,3,2,90
511326511,118,66,9,1,194
511339077,10,58,47,4,119
511346238,20,3,2,3,28
511352794,28,23,2,5,58
511354110,203,3,2,6,214
511360587,78,17,27,1,123
511375923,15,19,2,1,37
511378411,15,49,2,1,67
511383229,106,11,7,10,134
511397767,57,52,6,12,127
511421629,11,3,2,2,18
511423434,95,3,2,1,101
511440562,58,3,2,2,65
511462413,81,3,2,1,87
511463349,84,18,2,1,105
511466863,24,21,2,7,54
511470039,99,3,2,6,110
511478409,30,24,2,4,60
511485081,147,3,2,7,159
511492264,27,11,3,1,42
511501950,46,3,2,7,58
511521835,70,3,2,1,76
511522998,187,110,47,75,419
511527914,56,25,14,9,104
511528791,22,3,2,3,30
511533333,34,18,2,3,57
511555604,113,57,3,1,174
511564070,20,3,2,1,26
511565263,94,19,2,3,118
511565867,18,3,2,1,24
511566554,34,14,84,1,133
511571632,23,3,2,1,29
511575848,23,20,7,12,62
511575973,11,3,2,1,17
511580639,38,12,2,1,53
511586294,34,4,2,1,41
511588475,130,3,2,1,136
511596218,45,3,2,2,52
511600140,22,10,5,10,47
511601611,32,15,6,10,63
511608172,34,3,2,3,42
511623633,139,37,11,18,205
511628998,81,10,2,1,94
511636556,36,25,2,13,76
511649971,62,27,3,1,93
511657244,15,3,2,2,22
511659581,57,10,2,6,75
511661512,43,9,2,1,55
511680193,93,49,2,5,149
511681442,12,3,2,2,19
511691653,12,3,2,1,18
511709456,13,3,2,1,19
511718442,20,10,4,4,38
511725688,12,3,2,1,18
511729242,84,34,12,19,149
511746885,123,16,2,1,142
511750633,113,3,2,4,122
511752295,33,64,63,4,164
511753595,53,3,2,2,60
511756231,51,3,2,1,57
511768673,11,5,2,1,19
511775919,142,17,31,1,191
511789600,38,5,2,1,46
511803563,66,104,121,1,292
511806350,95,4,2,1,102
511813619,297,47,2,3,349
511815408,166,36,2,5,209
511820973,87,67,18,2,174
511838190,259,3,2,7,271
511838199,86,22,13,1,122
511840844,77,19,8,28,132
511843036,66,3,2,1,72
511844622,39,15,4,7,65
511872187,98,72,55,46,271
511875536,46,19,37,1,103
511896276,43,21,2,1,67
511899331,43,41,8,24,116
511903774,112,21,2,6,141
511914257,14,30,3,1,48
511939975,30,9,2,4,45
511954703,105,66,18,17,206
511981058,13,35,2,1,51
511987943,11,21,2,7,41
511994942,104,14,69,1,188
512000621,41,6,2,2,51
512003641,15,4,2,1,22
512006614,71,64,2,2,139
512023858,40,3,2,1,46
512024421,86,3,2,3,94
512024876,33,65,38,1,137
512048614,88,11,3,6,108
512057764,55,21,2,2,80
512079818,17,3,2,1,23
512089249,180,3,2,3,188
512100749,25,61,21,6,113
512101217,149,27,89,15,280
512112776,58,7,23,42,130
512114065,13,3,2,1,19
512124009,123,17,2,5,147
512136751,67,33,3,1,104
512137495,25,25,10,1,61
512143371,244,57,27,29,357
512144092,23,3,2,1,29
512179903,149,27,2,10,188
512182544,142,51,4,1,198
512185694,27,3,2,1,33
512188677,227,30,2,15,274
512192834,20,3,2,1,26
512193815,181,9,22,15,227
512197390,112,12,2,2,128
512199298,145,73,2,4,224
512203567,11,19,2,1,33
512237935,22,3,2,1,28
512257728,204,30,3,1,238
512260940,24,5,2,3,34
512262924,22,3,2,1,28
512263412,10,4,2,1,17
512265577,71,10,18,2,101
512270927,102,3,2,2,109
512293422,127,50,30,25,232
512295919,47,23,24,12,106
512305410,131,46,2,4,183
512319125,20,10,2,1,33
512320183,172,3,2,1,178
512320306,58,3,2,2,65
512338664,21,3,2,1,27
512339982,38,93,2,24,157
512360031,46,124,13,26,209
512362432,18,3,2,1,24
512365601,33,13,2,9,57
512368419,16,18,2,1,37
512378637,82,20,2,2,106
512383872,62,19,2,2,85
512394470,30,81,15,2,128
512407026,46,3,2,1,52
512408249,38,19,26,1,84
512418343,74,27,38,6,145
512422371,58,51,32,14,155
512430736,93,34,49,3,179
512433283,57,35,76,2,170
512459453,82,21,24,27,154
512461605,42,22,5,8,77
512463215,101,24,73,11,209
512466875,132,3,2,1,138
512467531,48,5,2,1,56
512470678,61,103,32,9,205
512484733,82,21,2,1,106
512486788,49,21,9,8,87
512496032,43,6,4,3,56
512498748,18,3,2,1,24
512499593,497,12,14,22,545
512503546,11,3,2,2,18
512535352,48,3,40,1,92
512535690,22,16,2,8,48
512559601,108,7,9,2,126
512577052,149,21,2,2,174
512577758,103,25,3,3,134
512578156,75,19,88,25,207
512586970,80,9,28,9,126
512590403,78,3,2,1,84
512595853,180,3,2,1,186
512600211,31,10,2,1,44
512601529,37,3,2,1,43
512605859,116,3,2,2,123
512613239,72,24,3,1,100
512613269,66,3,3,1,73
512617074,78,5,11,11,105
512619281,147,3,2,1,153
512623277,11,22,2,1,36
512636843,33,34,2,3,72
512638748,27,21,2,29,79
512638988,189,3,2,16,210
512639475,151,3,2,10,166
512640368,59,45,7,6,117
512648622,60,21,2,3,86
512661924,49,18,2,3,72
512669290,63,60,4,7,134
512671053,19,5,3,1,28
512682543,114,3,5,56,178
512686112,123,48,3,2,176
512689324,79,27,31,9,146
512721132,136,27,5,24,192
512743978,106,23,25,21,175
512746173,130,3,2,1,136
512748064,20,3,2,1,26
512755435,42,23,2,4,71
512757178,190,3,2,8,203
512771164,111,3,2,34,150
512783155,50,40,3,60,153
512784241,16,10,2,16,44
512790502,26,3,2,3,34
512799142,36,44,3,2,85
512815225,12,3,2,1,18
512826554,47,37,11,1,96
512847845,15,6,2,2,25
512851107,95,23,2,4,124
512858536,22,32,92,32,178
512872107,27,28,2,1,58
512882406,17,20,2,3,42
512898888,85,38,9,6,138
512899516,95,24,3,1,123
512925294,38,8,7,2,55
512927851,72,20,81,3,176
512929444,15,3,2,1,21
512945601,70,3,2,2,77
512956266,83,16,11,14,124
512959656,48,3,2,1,54
512968099,40,15,2,17,74
512977581,64,12,11,7,94
512999889,16,28,2,3,49
513005391,18,16,2,2,38
513019306,11,3,2,1,17
513025212,35,68,61,3,167
513029172,87,29,25,12,153
513032988,197,52,21,14,284
513052912,12,3,2,1,18
513066659,14,8,4,1,27
513087931,120,24,8,7,159
513089268,59,3,2,3,67
513096866,73,50,2,8,133
513109561,66,11,5,7,89
513116382,44,10,2,2,58
513118184,10,12,2,1,25
513120427,58,17,2,9,86
513123894,15,3,2,1,21
513123895,72,67,2,22,163
513137433,200,25,42,1,268
513137664,175,3,2,1,181
513147122,20,7,2,1,30
513149670,142,3,2,3,150
513171680,20,24,2,17,63
513173525,164,3,2,13,182
513187133,21,19,34,1,75
513197774,65,16,22,8,111
513228785,46,81,36,6,169
513240813,22,3,2,1,28
513264794,326,3,2,4,335
513269155,19,3,2,3,27
513276496,184,3,2,3,192
513278501,120,20,15,31,186
513296836,75,50,113,7,245
513298920,148,31,35,1,215
513301712,18,12,2,1,33
513316030,60,3,2,9,74
513318569,50,85,66,1,202
513319207,73,12,2,11,98
513319618,23,56,2,4,85
513328097,145,16,2,1,164
513332264,16,3,2,1,22
513352443,16,21,2,1,40
513363719,22,3,2,8,35
513365388,61,41,31,4,137
513386291,29,3,2,3,37
513394441,22,50,22,5,99
513414777,13,3,2,1,19
513415254,166,4,29,6,205
513445941,23,21,2,1,47
513455067,96,65,21,8,190
513462046,85,48,48,23,204
513477172,177,25,60,4,266
513481173,192,28,2,11,233
513491035,15,3,2,1,21
513493011,88,3,2,1,94
513507087,11,3,2,1,17
513520411,222,30,15,1,268
513539803,50,59,3,6,118
513543999,13,3,2,3,21
513569108,38,33,32,1,104
513571938,123,85,27,12,247
513573056,11,3,2,1,17
513576897,10,5,2,1,18
513577523,105,41,55,16,217
513586275,76,28,17,14,135
513587406,74,38,3,8,123
513595310,188,3,2,1,194
513600142,29,7,2,1,39
513608364,58,6,2,5,71
513613046,50,6,3,4,63
513617604,103,100,31,62,296
513632201,45,22,71,5,143
513646671,32,3,2,1,38
513651149,33,13,12,3,61
513663976,11,8,2,8,29
513672677,134,3,2,1,140
513677006,99,28,30,11,168
513679225,12,3,2,1,18
513680937,34,3,2,1,40
513682849,86,12,2,2,102
513694236,63,5,2,11,81
513696028,12,32,2,1,47
513698346,316,3,2,19,340
513701312,16,3,2,1,22
513701512,139,39,29,16,223
513706014,100,4,12,15,131
513709946,89,16,11,8,124
513730336,62,87,7,8,164
513738978,32,63,4,4,103
513749372,12,4,2,1,19
513754692,197,3,2,1,203
513755135,23,3,2,1,29
513756081,70,13,2,4,89
513764017,88,29,22,3,142
513764512,17,3,2,1,23
513793389,11,3,2,1,17
513799697,111,3,3,2,119
513808884,77,48,48,7,180
513815342,28,9,4,5,46
513826843,22,3,2,1,28
513837162,67,99,19,18,203
513842430,32,104,9,9,154
513842755,67,10,48,23,148
513845128,21,43,2,2,68
513855152,28,46,17,9,100
513857459,128,19,2,1,150
513857692,63,3,2,1,69
513870515,31,51,5,4,91
513878885,190,3,2,37,232
513883761,88,23,14,2,127
513886896,10,3,2,2,17
513888095,42,14,78,8,142
513894818,55,55,3,1,114
513917638,136,3,2,1,142
513918096,10,3,3,1,17
513934618,18,4,2,1,25
513959253,45,3,2,1,51
513967848,22,24,3,3,52
513969225,52,51,49,4,156
513974521,13,24,2,1,40
513987724,36,29,3,1,69
513992829,66,3,2,4,75
514008952,232,27,16,4,279
514011149,15,6,2,1,24
514030829,105,50,70,3,228
514031626,16,3,2,5,26
514033521,12,3,2,1,18
514034088,18,29,2,57,106
514034626,73,29,2,1,105
514038357,15,25,2,1,43
514049748,13,20,3,1,37
514050172,31,9,2,1,43
514087378,109,27,119,51,306
514091187,27,32,2,7,68
514099261,101,25,49,13,188
514104553,31,23,2,2,58
514112067,43,41,64,2,150
514116936,62,3,2,1,68
514146479,65,10,20,6,101
514151142,60,24,8,2,94
514159376,148,50,52,3,253
514166965,23,3,2,1,29
514168398,10,49,4,2,65
514178431,13,3,2,1,19
514197748,122,30,38,60,250
514214979,99,15,5,9,128
514237982,74,8,85,1,168
514281393,45,26,14,1,86
514282109,15,3,2,5,25
514286266,15,32,2,5,54
514288335,21,25,2,1,49
514312984,77,13,2,10,102
514314275,112,10,3,4,129
514315298,15,3,2,1,21
514315718,39,36,89,26,190
514321936,33,3,2,1,39
514325687,43,5,2,3,53
514332898,79,45,15,8,147
514361004,20,8,2,4,34
514361509,11,3,2,1,17
514377055,141,3,2,1,147
514384682,54,3,2,1,60
514396479,15,3,2,1,21
514413515,88,8,2,1,99
514417796,12,3,2,1,18
514421850,17,76,10,3,106
514424011,76,40,46,18,180
514432926,41,12,2,1,56
514435929,94,8,21,9,132
514439657,14,3,2,1,20
514440788,83,29,22,24,158
514443560,164,3,2,3,172
514443649,113,26,26,9,174
514448490,111,41,2,1,155
514457717,15,3,2,1,21
514473151,18,11,2,1,32
514476523,16,3,2,1,22
514478906,48,37,4,1,90
514486769,10,3,2,2,17
514488425,27,22,2,4,55
514492149,75,34,2,9,120
514493827,180,13,19,15,227
514522690,62,33,28,11,134
514525618,89,4,3,17,113
514527769,117,3,2,1,123
514528512,12,3,2,1,18
514532638,95,21,2,1,119
514536839,35,43,7,3,88
514540957,115,28,44,12,199
514545925,28,32,50,1,111
514565693,35,3,2,1,41
514570426,69,3,2,1,75
514583625,104,60,8,31,203
514583961,11,7,2,1,21
514593571,11,3,2,1,17
514601248,153,33,58,3,247
514617693,18,3,2,1,24
514619567,10,3,2,5,20
514620431,119,52,2,1,174
514629964,38,9,2,1,50
514635765,127,13,95,2,237
514645697,70,3,2,1,76
514647169,76,19,62,1,158
514652608,223,3,2,9,237
514653207,28,10,9,1,48
514660280,55,45,55,13,168
514663105,65,7,6,1,79
514665059,10,5,2,1,18
514674559,220,3,34,1,258
514688808,82,3,2,1,88
514699074,146,28,50,3,227
514700710,24,15,2,6,47
514723311,70,3,2,1,76
514734970,61,13,11,12,97
514750155,91,8,25,1,125
514772148,69,36,3,1,109
514785195,12,3,2,1,18
514785365,64,3,2,2,71
514788342,11,10,2,1,24
514807906,60,13,3,7,83
514815553,95,25,13,19,152
514847406,23,20,16,4,63
514854151,120,3,2,14,139
514874267,24,3,2,1,30
514875020,70,9,14,1,94
514911268,75,3,2,8,88
514919025,78,39,22,1,140
514938412,41,59,21,22,143
514943486,10,16,2,1,29
514949724,12,5,3,1,21
514960333,13,3,2,1,19
514972830,88,7,4,10,109
514973182,84,5,2,1,92
514990779,38,21,2,1,62
514996140,33,3,2,1,39
514998323,55,3,2,2,62
515005679,24,16,2,3,45
515014372,26,57,13,3,99
515045920,23,3,2,6,34
515095492,11,3,2,1,17
515100866,45,34,45,9,133
515120763,12,19,11,3,45
515129068,64,26,67,11,168
515133491,13,8,2,1,24
515149877,42,85,11,11,149
515150047,26,3,2,1,32
515150712,96,10,64,2,172
515160106,33,73,2,6,114
515168305,48,3,29,1,81
515172441,11,4,2,1,18
515177089,262,25,2,13,302
515177415,19,16,2,1,38
515185369,82,16,2,34,134
515208011,29,91,2,1,123
515208403,12,3,2,3,20
515209979,75,12,2,6,95
515218621,150,15,12,5,182
515232399,31,5,5,17,58
515256787,13,3,2,2,20
515263005,49,48,4,3,104
515282523,52,53,3,1,109
515284245,31,34,22,5,92
515288059,188,21,32,15,256
515290647,28,36,11,4,79
515340369,10,3,2,14,29
515342855,164,41,58,2,265
515349095,29,4,2,1,36
515366561,10,9,2,1,22
515375702,13,3,2,1,19
515385774,84,51,78,16,229
515400023,11,27,3,1,42
515404931,33,37,3,17,90
515409568,56,13,2,15,86
515413286,83,37,29,11,160
515417027,27,3,2,2,34
515420024,89,3,2,9,103
515424376,114,52,2,2,170
515425213,73,15,15,3,106
515438213,38,67,2,4,111
515452660,10,3,2,3,18
515463331,164,11,2,3,180
515467097,187,38,9,30,264
515468198,85,3,2,4,94
515472847,262,3,2,17,284
515481747,70,12,2,1,85
515494630,28,3,2,4,37
515507643,10,12,2,1,25
515509848,95,10,20,21,146
515512878,26,3,2,4,35
515513408,73,3,2,5,83
515536462,120,3,2,10,135
515547017,34,42,12,1,89
515557878,211,3,2,22,238
515560587,79,3,2,9,93
515560665,67,3,6,2,78
515563235,107,12,2,2,123
515590920,55,3,2,1,61
515591559,77,22,13,10,122
515592234,45,13,5,4,67
515592950,42,56,2,1,101
515613921,13,11,3,1,28
515616267,139,3,2,4,148
515621972,53,23,2,49,127
515624928,66,9,2,1,78
515645405,10,5,2,1,18
515658059,176,3,2,5,186
515666133,47,34,2,3,86
515666379,10,6,2,7,25
515669166,16,16,2,1,35
515678967,86,13,62,41,202
515694368,34,3,2,3,42
515716978,102,47,2,49,200
515752877,12,3,2,1,18
515757848,83,49,61,9,202
515761374,71,10,2,1,84
515782075,93,3,2,2,100
515794533,137,3,2,3,145
515799918,156,12,2,11,181
515803383,84,3,2,4,93
515814262,43,51,12,7,113
515823507,50,3,2,1,56
515831843,66,72,2,1,141
515832385,67,26,2,6,101
515839726,174,3,2,3,182
515850416,70,7,11,7,95
515860375,86,33,50,3,172
515866683,54,78,3,25,160
515874236,139,11,5,1,156
515888779,36,11,3,1,51
515892338,52,37,2,2,93
515893559,111,10,94,5,220
515903959,95,49,2,4,150
515906617,37,22,2,1,62
515908274,10,3,2,2,17
515936710,61,9,16,9,95
515938114,47,3,2,3,55
515947045,89,12,15,8,124
515974425,16,3,2,3,24
515977766,41,49,2,4,96
515984865,53,3,2,6,64
515994709,60,45,37,72,214
516000613,58,3,8,23,92
516011600,11,13,2,1,27
516016459,48,23,5,12,88
516021508,49,20,2,7,78
516040403,142,18,4,5,169
516041839,49,18,51,8,126
516054409,30,53,14,1,98
516056446,34,67,86,2,189
516064335,51,38,28,8,125
516065134,66,61,28,2,157
516065876,80,11,2,1,94
516082803,30,3,2,1,36
516089944,93,44,19,1,157
516105812,25,3,2,4,34
516117219,58,29,13,11,111
516119956,78,68,42,16,204
516129887,49,19,2,2,72
516131491,78,17,2,17,114
516143793,12,3,2,1,18
516151674,17,24,7,3,51
516182557,21,29,2,1,53
516189485,79,37,2,1,119
516198561,161,23,96,77,357
516200420,10,5,2,2,19
516219646,15,52,2,2,71
516228165,57,17,185,3,262
516247545,91,30,45,19,185
516252039,177,25,59,21,282
516256984,16,3,2,1,22
516270865,15,18,8,26,67
516273546,16,3,2,1,22
516274680,22,3,2,1,28
516330919,11,3,2,1,17
516339437,125,3,2,1,131
516345241,27,16,16,2,61
516367306,85,29,10,10,134
516386188,12,3,2,1,18
516391183,91,54,2,4,151
516413570,75,39,30,1,145
516428110,103,22,2,5,132
516460316,11,3,2,1,17
516472282,22,23,2,1,48
516483013,85,13,28,3,129
516491067,38,13,2,1,54
516491409,19,26,2,4,51
516500673,63,16,10,2,91
516502914,34,48,2,5,89
516517595,10,43,2,1,56
516524425,160,3,2,39,204
516530765,29,3,2,1,35
516539542,117,65,2,4,188
516581984,63,30,2,2,97
516587615,22,52,17,8,99
516589646,94,13,19,27,153
516595859,129,3,2,2,136
516599305,53,3,2,2,60
516603546,24,3,2,1,30
516615380,71,35,14,7,127
516618736,123,20,2,3,148
516637561,65,8,2,3,78
516640764,117,24,46,8,195
516656033,126,45,2,3,176
516661661,26,28,2,16,72
516665000,134,9,34,65,242
516668836,27,3,2,2,34
516690535,210,34,6,26,276
516710839,34,32,9,1,76
516718352,96,26,23,3,148
516724924,68,88,7,3,166
516730161,30,18,4,4,56
516739759,110,13,15,9,147
516739764,54,12,7,1,74
516739862,94,3,2,9,108
516748490,81,7,2,8,98
516755953,13,8,2,1,24
516798783,58,3,2,1,64
516802619,41,14,2,1,58
516810895,125,22,2,14,163
516818003,14,14,2,1,31
516823511,98,3,2,12,115
516836166,34,47,7,9,97
516872709,25,3,2,7,37
516873448,110,29,15,2,156
516881908,193,26,84,30,333
516888109,65,3,2,1,71
516898498,114,4,2,1,121
516924432,17,3,2,1,23
516928106,30,44,3,1,78
516949729,16,3,2,1,22
516967778,53,11,13,21,98
516969170,66,6,2,2,76
516976655,38,39,18,9,104
517024210,10,6,2,2,20
517025409,20,26,2,1,49
517036875,33,33,2,4,72
517061244,23,8,11,10,52
517064974,23,3,2,1,29
517072388,115,47,226,2,390
517077550,68,49,41,1,159
517081207,41,34,5,4,84
517086544,126,30,3,5,164
517103040,73,3,2,1,79
517109598,68,3,2,4,77
517120059,81,10,34,9,134
517127279,17,3,2,1,23
517149997,70,3,5,3,81
517155899,72,3,2,2,79
517163035,225,3,2,8,238
517163761,25,3,2,1,31
517174993,98,3,2,5,108
517196923,19,3,2,5,29
517198348,74,48,126,42,290
517200921,34,3,2,1,40
517209323,55,3,2,3,63
517210474,65,3,2,4,74
517214029,151,10,2,1,164
517218438,88,13,2,1,104
517227453,13,9,2,1,25
517243321,260,14,14,2,290
517254117,18,3,2,1,24
517275304,43,46,20,9,118
517279906,11,6,2,1,20
517281754,66,12,2,18,98
517304240,81,3,2,1,87
517306106,179,103,36,60,378
517314350,43,17,2,2,64
517316528,22,85,35,3,145
517321184,78,64,12,3,157
517333350,102,21,17,1,141
517334977,56,3,2,1,62
517345536,11,11,2,2,26
517351998,37,23,2,1,63
517352795,11,3,2,1,17
517356435,13,31,2,1,47
517360994,73,11,41,1,126
517361491,122,34,48,73,277
517371314,47,30,14,4,95
517373516,27,20,2,8,57
517373667,113,24,8,5,150
517380053,66,3,2,1,72
517381801,62,16,25,1,104
517388674,69,26,24,1,120
517425810,35,15,2,1,53
517427513,45,12,2,16,75
517456683,24,5,2,1,32
517467997,44,60,19,2,125
517471790,10,4,2,1,17
517474469,125,34,20,107,286
517477051,32,3,2,1,38
517482234,99,3,2,1,105
517485145,67,39,3,1,110
517486618,64,20,13,54,151
517498068,62,71,5,33,171
517526611,15,3,2,1,21
517529124,116,16,2,1,135
517536647,23,28,28,3,82
517544090,100,18,8,1,127
517581409,40,11,3,10,64
517582070,12,37,2,2,53
517583273,27,24,3,1,55
517585588,70,30,2,20,122
517591202,57,19,9,9,94
517597448,106,25,26,9,166
517600776,16,12,2,1,31
517600890,20,3,2,1,26
517604449,15,3,2,1,21
517624506,52,4,2,1,59
517629356,43,3,2,1,49
517637786,45,14,13,1,73
517642176,147,3,2,9,161
517647465,67,37,25,10,139
517656302,25,11,5,1,42
517661648,72,13,44,3,132
517674554,41,18,37,2,98
517677376,82,11,2,7,102
517678999,10,5,2,1,18
517691846,25,24,2,2,53
517699457,89,111,85,4,289
517703414,11,3,2,1,17
517722674,10,5,2,1,18
517732439,41,21,15,45,122
517736857,60,3,2,2,67
517743740,45,19,9,7,80
517761093,11,4,2,1,18
517766461,23,34,26,4,87
517785837,22,3,2,1,28
517788816,15,4,15,5,39
517792036,30,3,2,1,36
517795693,54,4,2,3,63
517797200,42,9,3,5,59
517806066,34,3,2,1,40
517806308,22,41,16,2,81
517808372,21,23,6,4,54
517811761,20,11,2,1,34
517814552,50,3,3,1,57
517819183,91,14,2,3,110
517822297,121,22,2,3,148
517826090,135,51,107,9,302
517832208,42,4,3,2,51
517865042,90,3,2,2,97
517869538,122,3,2,11,138
517874085,79,3,2,5,89
517878085,68,21,2,1,92
517878188,10,15,10,4,39
517887255,46,27,52,3,128
517911413,34,10,2,5,51
517918779,161,9,2,36,208
517919865,68,25,2,4,99
517971386,11,3,2,1,17
518010299,20,5,2,1,28
518018767,65,28,8,55,156
518020484,98,28,8,21,155
518028757,30,3,2,1,36
518033243,101,3,2,1,107
518033521,76,3,2,4,85
518042240,43,11,14,3,71
518060136,95,55,34,21,205
518069084,38,34,2,1,75
518074952,118,12,49,11,190
518079832,11,6,2,1,20
518086016,59,26,29,11,125
518089954,30,6,8,3,47
518096699,49,3,2,1,55
518103982,16,50,2,1,69
518116308,17,5,2,1,25
518126860,208,29,2,5,244
518132650,24,3,2,2,31
518135456,80,27,58,1,166
518137043,58,32,112,33,235
518146004,90,3,2,2,97
518167360,111,20,17,1,149
518180051,114,57,47,8,226
518181734,17,3,2,3,25
518198748,62,9,2,1,74
518217515,54,61,33,4,152
518236185,43,36,5,2,86
518241523,153,12,42,12,219
518245741,31,59,2,1,93
518251164,87,3,2,1,93
518263185,38,43,59,5,145
518266536,20,9,2,2,33
518279497,56,3,2,1,62
518307357,146,3,2,4,155
518309614,88,32,5,17,142
518316172,49,55,2,1,107
518320897,127,48,34,23,232
518336049,195,3,2,12,212
518338439,36,3,2,1,42
518339081,55,17,60,1,133
518352987,41,6,2,1,50
518354705,11,12,2,1,26
518362236,39,37,13,7,96
518368533,39,57,39,3,138
518374807,110,11,2,2,125
518394942,86,3,2,2,93
518401134,11,3,4,1,19
518406490,83,24,7,10,124
518415901,86,15,2,7,110
518420477,63,14,4,40,121
518433999,63,3,2,1,69
518438094,37,3,2,5,47
518440881,61,30,75,1,167
518441698,11,17,32,2,62
518443324,12,3,2,1,18
518445842,47,27,18,3,95
518456538,17,22,2,1,42
518461632,13,3,2,1,19
518472408,61,56,64,12,193
518476662,15,3,2,2,22
518500396,93,8,2,1,104
518504384,71,11,29,11,122
518506521,33,3,2,1,39
518523778,61,29,18,2,110
518529127,59,14,12,15,100
518530618,49,3,2,1,55
518547995,34,58,24,1,117
518553456,133,3,2,7,145
518557060,10,4,2,1,17
518558812,14,3,2,2,21
518559665,141,3,2,7,153
518576160,28,16,2,6,52
518596489,13,3,2,1,19
518596641,47,20,4,1,72
518604167,81,3,2,1,87
518608117,58,12,27,14,111
518615951,30,26,2,1,59
518616715,45,20,30,2,97
518625085,75,14,2,1,92
518648123,50,3,2,1,56
518651562,40,26,9,3,78
518655280,22,17,3,1,43
518659820,42,3,2,16,63
518668075,87,7,30,5,129
518694890,16,3,2,1,22
518695419,129,14,2,8,153
518701410,61,3,2,1,67
518713879,103,16,5,1,125
518716192,74,31,83,1,189
518735563,76,9,65,16,166
518736630,40,4,2,1,47
518739370,14,4,2,2,22
518739757,59,39,5,1,104
518764756,14,3,2,1,20
518776041,32,16,2,2,52
518784199,14,7,2,3,26
518797214,102,3,2,3,110
518815123,47,35,17,1,100
518823947,216,3,2,8,229
518826918,36,20,25,1,82
518830302,44,12,10,8,74
518832096,153,23,4,2,182
518833583,50,3,2,3,58
518834655,93,11,2,10,116
518838594,69,129,34,15,247
518843628,18,24,5,2,49
518850575,133,3,2,1,139
518856702,41,6,2,2,51
518865437,30,38,13,1,82
518874815,85,14,3,3,105
518879907,12,19,29,1,61
518884993,51,31,4,1,87
518886804,117,15,41,1,174
518901836,58,9,2,32,101
518902012,76,35,14,4,129
518925720,39,3,2,1,45
518932831,39,27,3,13,82
518945054,27,3,2,3,35
518945652,124,32,20,26,202
518949829,29,3,2,1,35
518952038,33,20,23,1,77
518952157,181,54,10,11,256
518952452,27,3,2,1,33
518967685,123,24,2,2,151
518972606,141,3,2,1,147
518994651,34,35,2,6,77
518999679,44,9,2,1,56
519019064,157,11,3,6,177
519021070,225,6,5,3,239
519025551,239,38,7,12,296
519027615,34,48,4,3,89
519030623,18,12,13,1,44
519036620,33,10,2,1,46
519062216,28,39,10,29,106
519066700,44,14,13,1,72
519085434,29,3,2,1,35
519089449,57,18,2,1,78
519104348,68,19,4,24,115
519117408,215,12,38,12,277
519124281,72,14,2,11,99
519134872,17,17,2,1,37
519156817,55,15,49,1,120
519158005,19,3,2,2,26
519164576,57,15,2,2,76
519166470,34,18,9,1,62
519170982,35,6,2,1,44
519177899,52,23,22,2,99
519200047,15,24,11,3,53
519201588,217,3,2,63,285
519209108,26,11,2,1,40
519211538,11,3,2,1,17
519211551,53,22,9,3,87
519213664,95,14,3,1,113
519228231,31,41,2,3,77
519247851,303,43,13,4,363
519251250,92,46,2,36,176
519254879,32,32,22,4,90
519259277,32,3,2,1,38
519260250,17,53,2,1,73
519261837,116,40,38,39,233
519275287,16,3,2,1,22
519289400,69,43,2,1,115
519301366,12,3,2,1,18
519305939,30,14,7,12,63
519309243,88,9,18,1,116
519324244,165,33,3,26,227
519326184,58,10,3,12,83
519327311,94,36,2,5,137
519332978,208,18,45,12,283
519333062,88,28,28,34,178
519342289,120,3,2,1,126
519346661,35,34,19,12,100
519382573,39,36,53,22,150
519394092,33,7,2,1,43
519397012,14,3,2,3,22
519399015,144,3,2,1,150
519400348,42,56,6,7,111
519401410,1007,3,2,14,1026
519401473,18,6,2,1,27
519402262,250,18,7,70,345
519402991,13,3,2,1,19
519404500,157,84,79,36,356
519412461,107,3,2,21,133
519439842,16,20,2,1,39
519448645,164,21,17,59,261
519453644,35,19,4,1,59
519455381,25,8,2,3,38
519465936,46,3,2,1,52
519471326,72,3,2,7,84
519472607,87,28,6,10,131
519477739,12,3,2,1,18
519480870,24,38,24,8,94
519482724,21,3,2,1,27
519483421,79,39,32,3,153
519506254,268,3,2,9,282
519513209,121,22,21,2,166
519517071,22,3,2,1,28
519531463,13,14,2,1,30
519533860,141,50,17,13,221
519551645,21,3,2,1,27
519556733,67,3,2,13,85
519560942,111,3,2,1,117
519568727,20,3,2,4,29
519570919,81,8,2,1,92
519582009,160,3,2,1,166
519592682,77,7,2,1,87
519592898,23,12,2,1,38
519602992,38,13,4,11,66
519611154,39,14,2,1,56
519621219,12,3,2,1,18
519631483,38,5,2,1,46
519640693,27,3,2,1,33
519650445,13,3,3,1,20
519657728,28,3,2,1,34
519666361,101,51,2,1,155
519671303,65,23,24,31,143
519679602,80,36,50,8,174
519682413,54,51,2,1,108
519684837,33,58,4,2,97
519704403,328,3,2,8,341
519710277,30,31,4,9,74
519711130,109,13,2,4,128
519712822,116,25,110,4,255
519718842,179,12,13,14,218
519725821,53,42,60,24,179
519726273,24,19,8,2,53
519738390,30,11,2,5,48
519743394,33,3,2,2,40
519750473,10,6,2,5,23
519763058,106,3,2,1,112
519768186,28,15,81,3,127
519776604,48,3,2,1,54
519789486,50,4,5,2,61
519813726,37,41,2,4,84
519814062,87,14,24,5,130
519827351,18,3,2,1,24
519840603,124,122,10,27,283
519845692,112,3,2,2,119
519849494,31,9,4,1,45
519851184,10,9,2,3,24
519862073,168,85,27,1,281
519885244,19,20,69,21,129
519891366,10,14,9,1,34
519905596,54,13,58,9,134
519912659,144,3,2,1,150
519917913,134,23,10,5,172
519925068,174,45,3,1,223
519925554,30,3,2,1,36
519934740,73,44,6,5,128
519940820,11,3,2,1,17
519947992,52,76,21,17,166
519962084,97,5,24,6,132
519962939,23,3,2,1,29
520003361,11,3,2,3,19
520011561,17,3,2,1,23
520013796,37,38,16,17,108
520015925,81,12,2,1,96
520031991,128,22,2,1,153
520037283,41,3,2,1,47
520039353,122,9,7,1,139
520052964,20,7,2,1,30
520053709,63,13,4,1,81
520072841,35,29,3,3,70
520074619,86,3,2,1,92
520084193,24,9,2,1,36
520110437,113,39,14,12,178
520114262,137,3,11,2,153
520119107,132,3,2,4,141
520139027,39,49,4,4,96
520140924,28,3,2,6,39
520145341,135,38,93,4,270
520145482,14,9,2,1,26
520155894,11,5,2,2,20
520159749,80,13,18,10,121
520163911,19,4,2,1,26
520169517,28,51,3,1,83
520169546,41,3,2,1,47
520169585,59,6,4,2,71
520176047,86,11,2,1,100
520176664,93,20,101,8,222
520178584,43,3,2,1,49
520184726,45,3,2,5,55
520190050,146,135,34,1,316
520197189,24,6,2,2,34
520224224,100,3,25,5,133
520238128,19,9,2,1,31
520238516,21,5,2,1,29
520254981,54,37,85,10,186
520273313,19,3,2,1,25
520274739,190,72,58,27,347
520283748,89,3,2,1,95
520287953,51,22,2,7,82
520291016,73,3,2,1,79
520291687,183,3,2,9,197
520297352,70,12,2,1,85
520324914,54,81,2,1,138
520332888,29,15,2,1,47
520350496,63,14,4,1,82
520354677,97,8,22,4,131
520364354,111,3,52,1,167
520365661,52,53,87,9,201
520370205,58,42,28,3,131
520383088,11,3,2,1,17
520385746,55,3,2,8,68
520409621,76,3,2,1,82
520411468,38,37,8,2,85
520414704,58,25,43,98,224
520431130,69,3,2,1,75
520433911,45,71,2,1,119
520440833,82,3,2,1,88
520447781,20,3,2,1,26
520482466,35,3,2,1,41
520496040,13,10,2,1,26
520496704,16,3,4,2,25
520499824,52,44,3,1,100
520503116,11,22,2,1,36
520506165,100,25,4,8,137
520515584,15,3,2,1,21
520517243,32,32,28,1,93
520522632,67,14,31,1,113
520541916,116,19,2,2,139
520544187,23,3,2,1,29
520546279,60,48,22,20,150
520558594,80,17,2,12,111
520618285,58,32,11,8,109
520624374,85,3,2,2,92
520631024,128,31,42,1,202
520631895,38,3,2,15,58
520632192,22,15,10,6,53
520664811,17,4,2,3,26
520692365,288,45,2,50,385
520693590,18,23,27,1,69
520701081,78,3,32,1,114
520710624,13,3,2,1,19
520712719,174,44,8,40,266
520720299,118,19,14,11,162
520758171,66,5,2,3,76
520764419,17,5,2,1,25
520769012,26,3,2,1,32
520770242,109,25,28,4,166
520776180,27,16,29,3,75
520785645,16,3,2,1,22
520792776,12,3,2,1,18
520799983,124,23,6,6,159
520806882,180,50,2,2,234
520822144,116,53,59,116,344
520830713,67,3,2,1,73
520832053,11,3,2,1,17
520848816,11,3,2,1,17
520850650,50,3,2,1,56
520856245,19,3,2,4,28
520868855,83,21,20,7,131
520872392,58,16,6,13,93
520895460,61,15,8,6,90
520899731,34,10,28,4,76
520909049,19,21,2,1,43
520917378,122,30,13,1,166
520917583,45,22,5,2,74
520919822,20,11,2,1,34
520919870,12,3,2,1,18
520929597,76,26,3,14,119
520933501,12,3,2,1,18
520939154,84,56,25,12,177
520940106,14,3,2,2,21
520942518,87,3,2,1,93
520949881,104,3,2,5,114
520984985,97,10,5,6,118
521018348,108,31,11,1,151
521026570,119,3,3,6,131
521038852,94,29,5,2,130
521044335,29,20,2,1,52
521044818,13,15,28,1,57
521057274,18,3,3,4,28
521077551,31,3,2,1,37
521079181,135,3,2,6,146
521081958,127,29,3,6,165
521084492,106,49,104,15,274
521085297,164,58,2,2,226
521094148,72,52,9,5,138
521118105,83,10,21,49,163
521129924,114,18,2,2,136
521138016,14,7,2,1,24
521146316,15,14,2,1,32
521148044,69,15,4,7,95
521151968,14,3,2,1,20
521161667,62,12,2,1,77
521171789,30,64,28,14,136
521175186,50,13,2,1,66
521176214,178,3,2,5,188
521180491,11,3,2,1,17
521181686,106,3,2,1,112
521207505,11,10,2,1,24
521213667,79,3,2,7,91
521219598,51,22,29,2,104
521227898,31,4,2,1,38
521229708,60,53,26,1,140
521230021,97,47,12,9,165
521231821,105,24,2,2,133
521238952,278,9,2,17,306
521245890,135,35,2,4,176
521248335,117,33,25,60,235
521253049,10,4,2,2,18
521258739,37,23,3,4,67
521262539,110,3,2,7,122
521266147,16,3,2,1,22
521280453,81,23,71,9,184
521301350,90,39,2,4,135
521301794,55,39,40,6,140
521310344,43,5,2,1,51
521320533,141,5,2,8,156
521331222,21,3,2,1,27
521331866,98,43,57,12,210
521345432,52,14,36,5,107
521353950,200,80,110,4,394
521361056,162,3,2,1,168
521388161,36,6,2,7,51
521394811,48,51,25,1,125
521397126,107,59,110,66,342
521407402,38,3,2,3,46
521408594,25,3,2,2,32
521424337,36,3,2,21,62
521428000,144,20,34,3,201
521444413,188,55,14,22,279
521461782,12,3,2,1,18
521468043,62,11,28,1,102
521468435,49,21,89,1,160
521477477,32,33,2,1,68
521493622,17,27,2,4,50
521499045,37,17,2,1,57
521533391,37,131,16,28,212
521543471,80,17,5,8,110
521545705,72,52,3,27,154
521546274,10,11,2,1,24
521559866,18,3,2,1,24
521564681,36,3,2,5,46
521587061,31,23,2,1,57
521598093,91,29,84,38,242
521598849,11,3,2,1,17
521610694,82,31,3,1,117
521649993,131,25,15,1,172
521663294,18,12,2,1,33
521666633,186,3,2,1,192
521667511,49,43,29,21,142
521678517,35,3,2,1,41
521687541,14,20,5,1,40
521688598,26,14,2,1,43
521692929,17,11,2,1,31
521693662,12,18,2,1,33
521699756,32,30,8,10,80
521700658,51,4,2,3,60
521702186,24,7,3,1,35
521712462,82,48,25,3,158
521712952,22,3,2,1,28
521744563,53,8,2,2,65
521747250,87,31,2,8,128
521766025,41,10,8,8,67
521779273,12,27,2,1,42
521780128,165,11,2,1,179
521782268,119,10,29,1,159
521811994,108,6,2,1,117
521822451,59,27,5,1,92
521844035,154,3,2,6,165
521846292,50,12,3,1,66
521848061,63,3,2,18,86
521850423,139,19,4,8,170
521856792,32,18,2,4,56
521858630,159,46,134,1,340
521861238,89,88,2,7,186
521883406,74,57,61,2,194
521904066,10,3,2,2,17
521908993,58,33,35,4,130
521913887,42,42,15,2,101
521915432,46,9,2,32,89
521926436,29,92,5,3,129
521942030,92,3,2,1,98
521948324,70,3,2,11,86
521949739,10,9,8,1,28
521981627,32,3,2,1,38
521985880,140,17,65,1,223
521990550,160,3,2,2,167
522005604,173,23,2,5,203
522023782,58,10,2,9,79
522055536,14,7,3,4,28
522056123,15,3,2,1,21
522062503,67,3,2,8,80
522067980,21,3,2,1,27
522076883,19,4,11,1,35
522083367,10,8,2,3,23
522096924,42,50,45,11,148
522104555,13,3,2,2,20
522111731,92,8,39,13,152
522112973,50,4,17,1,72
522120843,49,48,2,28,127
522132213,181,3,2,11,197
522139091,11,3,2,3,19
522164983,21,39,18,16,94
522174663,87,3,2,1,93
522176574,35,5,2,1,43
522177722,51,61,27,2,141
522200123,46,3,2,1,52
522202356,116,3,2,1,122
522234718,56,15,3,4,78
522237308,190,3,2,1,196
522240949,33,3,2,4,42
522243822,83,4,5,2,94
522264704,12,3,2,1,18
522271070,38,35,5,1,79
522276772,134,5,7,3,149
522303677,39,36,14,1,90
522304935,41,25,5,1,72
522323021,25,3,2,1,31
522324150,116,3,5,38,162
522325736,72,18,2,12,104
522328524,161,30,2,5,198
522329849,99,3,2,25,129
522359696,84,21,2,1,108
522364712,80,33,2,1,116
522382167,28,3,2,1,34
522391959,11,7,2,1,21
522396354,34,11,20,6,71
522397739,15,5,2,1,23
522400703,68,13,11,4,96
522407300,52,26,61,2,141
522407996,356,3,2,12,373
522416006,10,3,2,2,17
522434297,56,7,2,1,66
522460290,74,32,2,10,118
522461296,17,3,2,1,23
522478654,18,5,2,6,31
522507199,50,34,23,15,122
522510472,104,10,2,3,119
522516084,10,32,2,11,55
522531817,37,19,18,1,75
522532185,69,8,9,14,100
522555140,426,3,2,50,481
522561387,75,18,26,6,125
522562173,63,30,2,1,96
522569135,42,11,2,1,56
522570493,87,10,2,12,111
522574086,60,13,2,5,80
522580215,22,7,2,2,33
522583015,13,3,2,1,19
522588638,37,43,4,1,85
522595299,73,46,14,11,144
522608356,44,41,60,42,187
522611704,29,12,41,9,91
522635359,66,35,2,5,108
522637608,83,9,4,4,100
522645508,106,3,2,21,132
522646536,139,11,4,93,247
522651421,100,3,2,1,106
522656810,10,4,2,1,17
522671319,23,34,4,4,65
522676931,46,29,2,15,92
522682083,16,3,2,1,22
522715629,79,9,2,3,93
522719124,68,23,2,8,101
522721577,64,6,2,1,73
522730360,97,3,29,10,139
522752322,16,3,2,1,22
522770082,110,4,3,74,191
522773421,103,45,18,47,213
522786758,76,32,23,63,194
522790905,104,29,89,12,234
522794826,12,3,2,1,18
522797961,29,21,44,5,99
522823261,37,8,3,1,49
522847470,151,48,20,3,222
522851019,11,3,2,1,17
522864437,60,22,12,1,95
522871301,61,33,2,4,100
522874116,26,3,2,1,32
522874172,140,23,19,21,203
522880141,12,3,2,1,18
522882462,66,3,2,2,73
522900105,69,3,2,1,75
522915703,10,9,2,1,22
522918701,19,3,2,1,25
522924710,60,140,80,6,286
522933005,46,33,55,1,135
522939805,18,3,2,1,24
522963301,56,36,25,3,120
522964940,18,3,2,1,24
523003711,124,19,2,1,146
523033767,12,3,2,1,18
523048236,49,15,22,19,105
523049068,107,28,20,14,169
523056416,84,3,2,5,94
523065034,40,31,2,2,75
523082179,45,3,2,5,55
523083909,24,3,2,1,30
523086400,72,3,2,7,84
523110474,131,3,2,1,137
523126922,152,3,2,66,223
523130842,27,13,12,1,53
523131792,91,28,16,11,146
523136294,206,3,2,1,212
523137493,11,3,2,1,17
523160225,14,9,3,4,30
523165592,195,6,2,5,208
523165668,72,10,16,2,100
523188899,86,3,3,8,100
523194054,35,48,4,1,88
523199708,124,3,2,2,131
523204651,91,3,2,5,101
523211948,11,9,2,2,24
523215994,81,20,4,1,106
523217794,29,29,7,17,82
523225357,179,19,2,4,204
523249224,42,3,2,1,48
523273865,38,16,2,1,57
523275333,15,13,2,1,31
523277434,28,35,8,11,82
523278563,45,41,16,7,109
523280215,56,3,2,1,62
523298997,66,3,2,1,72
523316164,48,45,2,3,98
523316879,45,3,2,20,70
523364863,70,26,2,6,104
523368038,64,31,28,12,135
523390654,64,14,9,23,110
523391539,48,4,2,1,55
523392258,309,10,4,9,332
523400571,49,3,2,5,59
523407786,106,24,6,2,138
523428797,13,50,2,1,66
523433313,11,3,2,1,17
523441211,16,3,2,1,22
523444914,85,15,2,1,103
523451746,133,3,2,4,142
523458808,31,3,2,1,37
523461085,26,3,2,1,32
523465006,120,3,2,1,126
523483988,108,4,3,15,130
523487299,67,11,30,6,114
523488186,19,3,2,1,25
523517647,108,14,41,10,173
523520564,19,23,25,10,77
523556988,57,35,32,2,126
523563828,119,3,2,4,128
523599212,20,64,8,3,95
523601789,13,3,2,1,19
523602844,98,47,4,4,153
523605339,173,34,27,1,235
523613579,11,3,2,1,17
523616848,56,29,2,7,94
523619743,12,3,2,8,25
523630512,29,55,4,3,91
523632049,173,3,2,1,179
523633337,42,64,45,16,167
523664562,106,39,8,2,155
523683344,119,3,2,1,125
523693961,83,9,2,3,97
523694514,50,19,23,19,111
523699926,346,3,2,8,359
523700084,77,3,2,2,84
523709473,132,30,2,1,165
523721846,14,18,2,8,42
523728687,153,3,2,1,159
523735285,46,14,6,25,91
523735578,71,53,18,3,145
523740185,23,9,2,9,43
523752495,70,3,2,4,79
523760828,62,35,10,1,108
523765625,37,61,10,1,109
523768428,56,45,23,32,156
523772397,176,3,2,81,262
523780267,57,55,47,18,177
523788850,40,39,3,13,95
523790386,11,3,2,1,17
523792733,115,38,4,1,158
523809618,91,10,20,10,131
523827187,127,3,2,1,133
523837001,23,14,2,1,40
523855590,36,22,2,7,67
523858153,59,3,2,1,65
523860561,40,3,2,1,46
523860712,123,36,2,3,164
523860910,76,26,42,1,145
523867415,71,33,8,1,113
523870521,231,114,2,5,352
523874202,161,3,2,14,180
523887654,70,32,2,2,106
523901507,28,3,2,6,39
523905959,34,4,9,6,53
523911549,76,177,16,66,335
523915292,124,3,2,1,130
523947638,74,34,66,28,202
523964273,37,64,38,18,157
523966840,153,3,2,2,160
523975410,83,3,2,3,91
523982086,78,4,2,1,85
523984309,28,3,2,1,34
523997733,11,3,2,1,17
523999634,41,53,3,20,117
524012868,13,8,2,1,24
524041794,128,13,3,1,145
524042231,89,13,3,5,110
524046097,10,5,2,1,18
524058866,10,5,2,1,18
524075759,141,36,20,57,254
524078187,28,28,2,10,68
524086271,11,3,2,1,17
524087082,23,9,5,3,40
524095298,181,37,118,27,363
524110916,28,3,2,1,34
524112643,33,7,8,8,56
524124550,23,43,2,15,83
524128535,44,7,6,4,61
524143100,101,12,2,1,116
524143382,16,31,3,5,55
524148126,59,16,15,2,92
524149125,40,3,2,2,47
524158785,63,3,2,1,69
524159512,61,3,2,5,71
524164993,10,3,2,2,17
524175590,125,15,22,10,172
524219832,25,31,2,3,61
524225144,31,3,2,1,37
524234767,57,3,2,1,63
524252028,71,10,48,24,153
524252827,43,33,2,1,79
524253607,14,3,2,1,20
524254201,131,8,40,2,181
524264944,62,19,12,3,96
524270864,57,3,2,1,63
524278345,113,24,27,4,168
524281017,115,10,20,2,147
524292225,11,3,2,1,17
524293965,67,40,12,6,125
524301084,16,6,2,6,30
524323737,71,12,8,3,94
524331703,27,7,2,6,42
524347881,21,103,18,15,157
524356096,115,32,43,1,191
524358978,100,21,2,23,146
524365026,19,5,2,1,27
524368096,15,3,2,1,21
524371555,35,3,2,1,41
524384223,72,3,2,1,78
524384445,105,3,2,1,111
524395214,22,55,3,1,81
524396074,15,73,14,1,103
524399358,33,3,2,1,39
524405905,74,13,86,8,181
524418660,55,63,2,56,176
524421677,47,23,2,6,78
524434263,70,19,5,7,101
524462994,16,27,2,1,46
524463612,15,5,3,6,29
524478198,96,13,2,1,112
524497478,38,32,38,4,112
524516147,95,26,24,18,163
524533957,55,30,19,1,105
524534299,194,3,2,50,249
524535768,187,3,2,2,194
524544279,10,18,9,1,38
524546737,11,3,2,1,17
524561851,53,78,10,45,186
524566917,183,102,31,34,350
524595337,90,28,20,22,160
524609023,231,3,2,1,237
524609668,56,7,2,1,66
524616897,134,17,228,9,388
524636458,97,53,41,3,194
524654669,89,11,2,2,104
524655821,543,41,38,2,624
524657515,57,83,5,6,151
524665750,77,14,14,7,112
524668528,33,3,2,1,39
524679201,57,6,2,1,66
524698277,65,14,4,1,84
524698656,43,60,37,5,145
524703414,11,3,2,1,17
524712965,44,17,2,6,69
524713690,13,21,14,1,49
524714647,119,62,4,3,188
524722954,43,3,2,1,49
524725559,14,15,2,1,32
524729057,20,25,2,9,56
524732124,76,24,94,4,198
524736044,134,18,2,6,160
524740253,26,3,2,2,33
524745619,11,5,2,1,19
524757317,239,52,48,20,359
524764506,76,20,28,5,129
524764824,144,3,2,1,150
524777371,32,20,8,7,67
524789414,40,22,2,37,101
524789587,59,44,2,3,108
524790872,159,7,45,10,221
524818445,34,7,2,1,44
524822821,65,3,3,1,72
524823170,92,72,51,8,223
524823580,99,39,33,4,175
524826943,94,46,81,24,245
524842120,72,3,2,20,97
524858109,15,3,2,1,21
524859220,70,17,2,18,107
524861600,109,8,2,4,123
524877743,24,9,2,1,36
524885863,89,25,49,16,179
524895127,10,3,2,3,18
524896843,14,50,2,3,69
524918157,44,7,21,2,74
524920945,179,26,3,1,209
524922322,52,3,2,1,58
524924437,31,12,2,1,46
524926422,59,4,31,16,110
524926491,97,3,2,1,103
524927315,19,3,2,1,25
524945560,35,3,2,1,41
524957436,42,3,2,1,48
524959446,84,26,5,1,116
524969376,11,13,2,1,27
525008254,166,44,6,54,270
525037365,57,46,4,1,108
525041992,12,3,2,1,18
525051574,42,17,2,1,62
525078146,23,9,2,1,35
525093516,29,49,17,1,96
525117469,73,13,5,3,94
525123236,24,10,2,1,37
525140360,107,12,2,1,122
525149594,11,3,2,3,19
525154812,23,3,2,9,37
525190713,13,3,2,1,19
525195318,37,32,53,2,124
525204024,28,6,4,4,42
525209773,114,13,35,1,163
525212525,10,7,2,1,20
525254823,11,4,2,1,18
525257862,10,10,2,2,24
525267206,87,3,2,8,100
525285284,16,3,2,1,22
525285780,10,45,2,1,58
525295671,18,3,2,3,26
525303857,12,3,2,1,18
525305916,86,18,24,14,142
525320763,57,25,2,1,85
525321784,36,57,3,1,97
525326633,32,17,27,10,86
525336062,12,3,2,1,18
525367654,62,3,2,1,68
525379312,236,26,90,1,353
525385183,64,3,2,4,73
525412208,45,10,4,7,66
525412990,117,27,15,2,161
525472137,102,5,2,3,112
525474970,85,10,2,2,99
525482301,70,24,29,2,125
525486348,35,3,2,1,41
525491683,62,3,2,1,68
525493791,164,28,41,7,240
525503057,76,129,79,12,296
525504838,61,3,2,2,68
525509788,47,29,2,3,81
525513812,75,34,69,2,180
525516300,91,33,11,20,155
525528525,56,18,2,7,83
525559150,138,10,37,2,187
525561121,63,28,30,3,124
525561299,10,3,2,3,18
525563713,41,24,14,11,90
525565997,47,38,2,5,92
525566228,47,13,8,1,69
525570002,89,12,2,17,120
525574803,121,61,7,1,190
525598038,30,37,63,1,131
525599022,38,128,2,10,178
525601749,29,13,2,4,48
525603990,61,34,2,1,98
525611309,21,8,2,1,32
525615939,236,3,2,1,242
525628190,84,38,62,9,193
525638823,130,30,25,37,222
525660628,28,8,13,5,54
525661675,50,17,6,4,77
525691077,70,6,15,1,92
525697666,58,15,45,42,160
525704435,13,3,2,1,19
525707976,43,45,50,8,146
525710053,13,8,3,1,25
525711576,97,29,6,1,133
525720492,44,31,8,13,96
525731434,94,8,2,2,106
525747422,100,186,80,2,368
525751457,110,3,2,3,118
525756716,38,20,25,1,84
525762627,64,40,14,12,130
525770526,74,3,2,1,80
525779768,12,3,2,2,19
525790715,78,48,23,3,152
525815409,16,39,2,2,59
525815846,10,4,2,1,17
525828582,54,3,2,8,67
525841675,16,14,3,7,40
525841848,13,12,2,11,38
525847656,20,3,2,1,26
525853642,62,3,2,2,69
525860305,156,3,2,3,164
525865607,10,3,2,3,18
525873598,53,21,31,4,109
525876488,104,3,2,1,110
525883758,114,51,4,59,228
525895961,48,69,26,15,158
525911144,30,25,2,17,74
525915977,130,11,17,2,160
525920783,10,4,2,1,17
525922044,73,53,56,25,207
525924978,61,34,7,2,104
525941041,58,25,47,19,149
525949585,69,3,2,2,76
525952698,98,3,2,1,104
525963642,12,3,2,3,20
525965472,90,7,2,1,100
525967920,87,38,51,18,194
525979866,11,4,2,1,18
525984659,144,71,6,6,227
525990985,139,52,2,22,215
526002321,70,36,11,4,121
526011232,57,3,2,1,63
526012188,87,5,2,2,96
526015620,112,22,98,9,241
526017149,75,3,2,1,81
526018053,13,8,2,1,24
526018599,39,5,2,1,47
526036057,38,17,86,13,154
526051841,13,13,2,2,30
526054917,38,3,2,1,44
526065431,12,3,2,2,19
526066490,93,53,2,13,161
526067593,126,3,11,2,142
526077480,49,24,49,22,144
526080922,12,4,2,3,21
526085279,26,3,2,6,37
526097271,38,142,30,1,211
526097894,32,29,2,19,82
526100637,42,15,9,1,67
526110740,166,17,23,2,208
526114293,12,3,2,1,18
526148768,15,3,2,1,21
526154454,124,61,104,42,331
526173163,64,27,24,11,126
526195015,38,54,67,15,174
526195125,41,4,2,1,48
526207045,11,46,2,2,61
526217864,12,9,2,1,24
526227149,51,3,2,5,61
526230531,98,3,2,3,106
526231822,142,3,2,3,150
526242000,16,3,2,1,22
526245983,11,3,2,1,17
526264384,13,57,35,1,106
526272799,91,10,3,2,106
526276428,48,18,12,7,85
526279199,134,3,2,4,143
526279529,130,39,2,7,178
526280301,96,3,2,4,105
526333157,20,3,2,3,28
526337994,39,10,9,1,59
526339477,42,18,45,6,111
526342843,71,16,2,27,116
526372969,105,3,2,1,111
526379885,37,5,2,23,67
526386624,133,3,2,13,151
526395087,13,3,2,5,23
526395725,61,13,2,3,79
526401621,21,22,2,1,46
526403078,121,18,10,9,158
526412896,145,34,51,1,231
526415534,234,49,2,31,316
526431162,93,108,26,5,232
526434724,36,3,2,1,42
526449481,36,19,40,1,96
526451752,18,3,2,1,24
526469803,14,5,2,1,22
526473627,12,3,2,1,18
526482148,16,3,2,7,28
526484309,102,3,8,13,126
526484966,118,23,21,1,163
526496412,46,27,13,11,97
526511026,59,3,2,4,68
526518066,52,55,26,2,135
526527354,72,39,3,2,116
526532563,69,9,19,4,101
526543396,52,41,43,19,155
526546044,69,41,26,21,157
526547235,21,8,2,1,32
526548059,70,18,46,10,144
526548142,30,14,2,2,48
526553016,16,23,2,1,42
526575906,52,3,2,1,58
526578558,70,42,21,3,136
526594461,50,20,5,1,76
526608959,58,31,21,1,111
526614082,50,3,2,1,56
526618213,74,3,3,1,81
526619908,15,21,8,1,45
526623498,107,3,2,1,113
526639364,22,35,64,11,132
526649818,23,8,4,3,38
526657666,31,28,2,12,73
526666112,101,4,2,2,109
526667288,37,3,2,1,43
526667438,82,3,2,3,90
526682594,17,3,2,1,23
526697875,11,8,2,1,22
526704610,62,32,2,10,106
526711890,124,25,31,1,181
526729075,41,6,2,1,50
526732571,177,21,2,1,201
526740884,62,3,2,3,70
526754178,341,3,2,7,353
526754970,44,3,2,13,62
526757703,28,5,2,1,36
526757772,87,3,2,1,93
526757810,61,27,2,4,94
526774850,57,30,41,40,168
526781911,18,3,4,1,26
526782973,94,46,43,5,188
526803897,41,24,24,6,95
526809145,27,45,19,3,94
526842705,31,11,2,1,45
526845452,38,42,2,9,91
526851236,12,13,21,15,61
526852409,19,14,2,10,45
526861713,110,33,22,6,171
526891008,70,18,69,6,163
526900553,47,3,2,7,59
526905180,231,5,76,2,314
526910129,165,3,2,1,171
526937596,10,3,2,2,17
526949715,12,3,2,1,18
526952589,92,11,18,29,150
526955955,137,12,85,20,254
526963657,10,6,2,1,19
526978876,25,3,2,1,31
526991739,142,8,2,8,160
526993652,11,3,2,1,17
526996781,58,12,2,1,73
527007023,103,36,43,2,184
527025224,87,24,59,31,201
527031027,792,3,2,4,801
527031902,652,3,2,19,676
527033548,13,3,2,1,19
527042619,86,78,115,24,303
527056981,183,17,6,57,263
527068181,141,3,26,1,171
527093272,54,3,2,1,60
527093515,171,3,2,1,177
527118020,83,16,50,7,156
527128506,15,3,2,2,22
527137784,67,13,2,1,83
527144552,43,3,2,3,51
527145797,75,3,2,1,81
527158771,18,3,2,1,24
527169611,58,16,67,2,143
527180564,101,9,94,7,211
527182960,25,5,2,8,40
527219723,24,58,73,59,214
527225740,26,29,6,1,62
527238850,13,4,2,1,20
527245812,22,43,2,8,75
527252652,147,3,2,52,204
527261743,31,39,26,1,97
527262486,26,28,3,22,79
527273383,105,35,2,7,149
527281196,96,3,2,1,102
527287574,191,3,2,2,198
527292360,17,3,2,1,23
527298312,17,3,2,1,23
527342648,231,36,2,15,284
527381405,759,33,2,104,898
527396590,103,21,89,3,216
527399156,158,3,2,3,166
527411116,46,14,5,7,72
527417787,60,27,23,2,112
527418418,44,24,3,14,85
527421508,15,3,2,1,21
527431480,330,3,2,1,336
527435241,231,16,40,33,320
527446814,29,20,2,1,52
527448535,61,33,26,3,123
527451206,35,3,2,2,42
527458675,22,3,2,2,29
527461348,143,36,31,1,211
527464244,13,3,2,2,20
527466548,143,37,4,1,185
527470332,75,23,2,1,101
527475165,111,39,22,9,181
527480794,16,3,2,1,22
527486992,43,22,53,4,122
527494049,25,3,2,1,31
527506904,19,46,2,1,68
527517468,321,3,2,1,327
527518353,22,3,2,1,28
527535621,23,74,2,1,100
527537287,50,3,2,1,56
527539385,10,3,2,5,20
527539871,79,20,62,1,162
527552615,82,24,3,16,125
527594086,11,4,2,1,18
527601949,83,23,2,1,109
527610047,45,27,9,5,86
527613084,123,32,58,10,223
527629042,113,4,12,16,145
527641402,23,47,2,1,73
527650574,13,11,6,1,31
527668520,12,3,2,1,18
527673844,67,23,17,1,108
527677569,256,3,2,14,275
527689417,28,22,5,5,60
527692132,41,3,2,15,61
527699124,74,21,2,7,104
527702156,74,3,2,1,80
527708125,45,11,11,81,148
527708312,82,4,2,4,92
527711678,78,9,2,1,90
527719812,16,3,2,1,22
527721473,59,3,2,1,65
527728551,10,3,2,2,17
527730474,20,29,2,3,54
527762044,184,76,39,38,337
527767657,73,14,4,2,93
527772902,120,3,2,12,137
527794718,68,3,2,1,74
527797065,30,10,2,1,43
527803721,90,18,22,6,136
527807473,63,31,4,6,104
527849870,170,4,2,1,177
527853504,29,23,2,1,55
527855613,73,28,2,1,104
527872635,63,51,34,4,152
527888917,145,74,2,20,241
527900549,131,3,2,2,138
527902599,43,3,2,1,49
527916961,23,3,3,1,30
527922219,19,3,2,5,29
527929545,11,6,2,1,20
527950679,43,37,2,6,88
527976247,61,11,55,8,135
527987215,118,3,26,8,155
527988245,16,3,2,1,22
528023783,57,19,89,19,184
528034026,137,3,2,1,143
528037274,128,3,2,9,142
528053499,94,17,8,15,134
528058432,22,73,20,2,117
528078385,121,72,3,1,197
528083837,98,19,31,15,163
528086775,110,3,2,1,116
528087811,36,47,2,3,88
528096533,59,12,2,1,74
528096831,21,26,2,1,50
528106653,167,12,4,2,185
528107460,101,52,2,1,156
528117145,28,3,2,1,34
528118170,12,5,2,3,22
528124385,135,21,98,45,299
528128909,42,75,2,1,120
528130837,54,16,2,4,76
528131608,85,3,2,2,92
528135861,14,3,2,1,20
528154972,40,15,8,4,67
528172277,79,27,9,2,117
528173157,10,4,2,1,17
528177107,109,22,2,2,135
528183888,28,3,2,1,34
528204400,23,35,2,1,61
528217201,13,21,2,1,37
528236140,48,3,2,1,54
528236644,24,39,16,2,81
528244040,21,3,2,10,36
528245031,84,30,3,3,120
528248948,11,12,2,1,26
528252838,13,3,2,1,19
528259677,205,50,2,1,258
528275035,119,44,2,1,166
528275246,12,7,2,1,22
528279775,24,3,2,1,30
528283696,53,25,18,21,117
528321843,10,15,2,1,28
528325176,14,3,2,3,22
528325267,21,14,4,7,46
528332793,18,3,2,1,24
528337521,127,39,36,11,213
528338509,97,3,2,4,106
528368504,96,19,7,2,124
528375661,38,15,3,1,57
528385952,10,22,2,3,37
528387287,33,4,2,1,40
528392069,13,73,3,1,90
528414280,41,21,3,8,73
528429754,65,32,65,37,199
528437773,76,3,2,1,82
528460588,18,11,2,2,33
528473017,142,7,2,9,160
528475014,41,35,25,8,109
528476178,125,13,13,17,168
528492974,41,3,2,1,47
528497278,12,3,2,1,18
528519007,17,3,2,1,23
528527087,172,37,4,5,218
528530672,13,3,2,3,21
528536751,10,19,3,1,33
528545142,11,3,2,6,22
528570758,64,16,18,1,99
528581737,34,22,5,3,64
528583371,39,16,2,1,58
528587834,157,3,2,10,172
528600668,43,3,4,5,55
528603769,12,3,2,1,18
528614075,53,7,2,1,63
528620764,10,25,2,1,38
528622736,24,32,71,2,129
528622965,191,4,2,7,204
528626479,42,3,12,2,59
528631677,176,31,80,12,299
528640529,30,3,2,1,36
528662378,37,9,2,1,49
528667358,108,4,3,1,116
528671102,66,52,2,1,121
528676795,14,3,2,1,20
528695996,52,3,2,1,58
528706871,122,24,2,1,149
528708181,28,3,2,4,37
528709946,24,15,2,1,42
528710736,58,35,3,11,107
528778359,10,10,2,2,24
528785474,55,13,50,4,122
528786101,100,24,22,16,162
528794064,13,8,2,3,26
528815093,11,3,2,1,17
528816927,82,37,7,2,128
528822728,24,3,2,1,30
528843509,121,3,3,1,128
528844663,37,6,2,4,49
528860352,161,3,2,5,171
528865685,70,3,2,1,76
528885592,109,34,7,10,160
528886625,105,3,2,3,113
528892863,68,9,2,6,85
528898960,10,32,2,7,51
528902851,184,19,2,1,206
528904038,49,3,6,8,66
528920501,92,15,60,1,168
528926866,63,28,2,1,94
528935837,24,15,2,1,42
528972900,79,48,39,2,168
528973219,165,34,25,1,225
528982145,129,3,2,1,135
528983255,10,5,2,1,18
529013854,18,3,2,6,29
529016567,149,70,67,39,325
529020378,21,3,2,1,27
529050805,47,19,57,8,131
529054123,24,3,2,1,30
529054327,34,6,2,9,51
529055930,110,18,60,19,207
529058031,55,3,2,3,63
529068451,49,3,2,8,62
529086843,34,63,23,1,121
529127688,59,79,90,3,231
529129777,35,86,17,4,142
529132587,32,33,2,22,89
529140814,26,3,2,2,33
529141271,13,3,2,1,19
529145752,12,18,2,1,33
529147996,26,3,2,1,32
529150978,95,3,2,1,101
529161227,167,9,2,3,181
529163273,36,25,4,2,67
529163536,30,6,2,1,39
529167629,156,24,4,12,196
529182054,128,28,4,8,168
529191314,70,96,12,8,186
529198586,32,37,3,1,73
529201223,78,17,2,1,98
529223567,12,3,2,1,18
529223883,86,17,74,3,180
529228957,19,3,2,1,25
529231238,63,64,4,11,142
529237138,96,3,2,1,102
529237591,57,60,7,43,167
529256242,71,33,95,1,200
529258029,20,5,2,4,31
529273709,64,13,15,2,94
529274361,291,37,2,7,337
529281859,152,3,2,2,159
529281942,76,9,3,16,104
529303930,49,9,2,2,62
529306474,31,22,2,1,56
529312525,150,3,2,1,156
529328407,110,39,32,3,184
529333775,80,22,2,1,105
529341289,63,36,7,10,116
529358037,65,22,46,30,163
529368332,83,25,2,9,119
529376989,61,55,18,11,145
529382969,86,3,2,1,92
529384544,108,21,2,2,133
529387435,40,10,24,2,76
529391127,26,28,12,1,67
529393280,195,3,2,57,257
529394459,12,16,2,1,31
529398412,79,8,4,10,101
529411117,170,19,2,4,195
529413097,152,10,2,15,179
529419002,13,6,2,1,22
529463663,12,3,2,1,18
529465505,16,15,2,1,34
529465741,20,3,2,1,26
529469894,33,47,17,1,98
529483460,217,43,8,4,272
529491026,23,10,2,1,36
529505999,12,3,2,1,18
529510090,55,29,15,20,119
529521384,52,50,2,2,106
529527809,20,3,2,1,26
529539163,49,25,12,2,88
529546720,84,14,4,18,120
529555520,44,9,3,4,60
529577198,30,31,18,1,80
529577569,82,93,55,1,231
529578291,69,3,2,1,75
529578841,24,8,2,3,37
529587231,31,82,14,31,158
529590617,13,3,2,1,19
529593665,104,13,70,5,192
529596593,45,52,9,15,121
529612257,31,15,16,1,63
529626579,13,3,2,2,20
529633433,24,20,2,1,47
529647565,24,3,2,2,31
529652307,17,3,2,1,23
529654170,105,4,2,1,112
529694945,13,27,2,2,44
529696747,33,3,2,2,40
529709372,55,3,2,1,61
529720593,86,3,2,2,93
529727852,83,22,2,1,108
529751005,49,3,2,1,55
529779522,72,22,2,2,98
529787751,344,67,76,79,566
529794378,65,34,3,5,107
529810888,18,31,6,3,58
529813953,85,14,2,2,103
529814593,76,57,33,7,173
529824744,31,10,2,2,45
529848427,85,24,19,3,131
529848923,34,10,6,26,76
529857090,53,29,4,51,137
529884573,66,38,28,4,136
529923989,56,16,3,9,84
529933824,63,3,2,1,69
529940306,22,3,2,1,28
529971914,134,42,68,22,266
529991567,97,20,20,6,143
529998150,47,3,2,2,54
530002583,34,40,18,8,100
530004687,46,21,4,2,73
530007141,154,3,2,2,161
530011061,111,13,6,7,137
530013722,344,3,2,3,352
530015035,149,12,5,14,180
530032360,36,8,2,1,47
530033509,138,53,47,3,241
530034015,90,3,8,1,102
530034569,20,3,2,1,26
530034894,336,3,2,4,345
530036757,49,14,3,3,69
530042921,104,3,3,3,113
530056285,26,95,2,1,124
530059864,25,9,7,4,45
530081265,27,57,20,12,116
530085175,93,28,2,3,126
530085584,107,3,2,1,113
530104248,113,3,2,15,133
530104941,17,3,2,1,23
530114200,192,31,3,12,238
530116898,102,26,53,5,186
530144714,178,5,2,1,186
530146146,38,15,9,1,63
530161895,117,3,2,1,123
530172529,166,24,55,1,246
530185847,10,5,2,1,18
530186130,64,65,26,18,173
530190356,57,24,3,4,88
530200357,151,18,2,4,175
530203963,10,16,2,1,29
530204484,148,24,2,1,175
530216111,200,3,2,1,206
530235230,48,20,2,6,76
530248034,88,39,14,3,144
530295952,87,20,13,1,121
530298572,73,21,10,6,110
530299562,28,3,2,10,43
530301852,117,20,2,2,141
530328903,72,20,2,3,97
530336188,10,10,2,2,24
530343828,18,42,5,8,73
530347831,18,3,2,1,24
530370796,52,18,11,2,83
530380634,181,3,2,1,187
530389274,16,3,2,1,22
530409398,134,63,36,1,234
530435480,25,30,6,1,62
530436831,70,14,11,1,96
530438910,59,29,122,12,222
530445222,65,21,2,2,90
530451603,132,59,31,2,224
530465651,28,10,2,1,41
530478450,111,3,2,6,122
530481994,33,39,6,7,85
530503218,11,3,2,1,17
530515828,58,12,37,4,111
530526795,12,12,7,1,32
530532484,13,3,2,1,19
530542153,111,6,12,6,135
530559857,16,23,2,2,43
530563918,84,6,97,5,192
530573767,63,15,2,1,81
530580377,10,3,2,3,18
530583294,35,3,2,1,41
530586516,165,11,3,1,180
530601300,102,11,2,1,116
530611460,17,53,2,1,73
530654654,89,3,2,5,99
530659048,72,3,2,2,79
530666655,11,3,2,1,17
530671899,12,46,2,1,61
530672123,21,3,3,3,30
530680162,70,18,11,18,117
530684770,12,3,2,1,18
530684984,113,59,20,4,196
530694484,51,9,2,6,68
530701763,80,23,2,2,107
530702216,51,46,82,4,183
530740355,40,21,2,1,64
530758159,113,5,12,4,134
530774387,90,18,2,1,111
530793257,24,35,12,20,91
530810816,14,6,2,1,23
530835212,126,3,3,1,133
530868489,92,7,2,5,106
530869242,79,36,15,32,162
530873368,11,3,2,1,17
530874126,44,26,2,1,73
530883520,171,3,2,7,183
530893162,10,7,3,1,21
530903028,24,3,2,1,30
530911678,30,47,9,1,87
530917630,63,30,2,7,102
530932898,16,6,2,1,25
530937107,109,3,2,2,116
530951924,12,3,2,5,22
530953024,162,5,2,1,170
530953688,14,8,2,2,26
530975850,13,3,2,1,19
530985054,80,19,33,1,133
530993464,163,3,11,2,179
531011667,12,3,2,1,18
531019795,40,15,2,4,61
531027444,32,30,3,1,66
531041058,55,17,14,6,92
531047241,16,10,2,1,29
531048804,10,7,2,2,21
531057243,11,22,2,1,36
531059916,48,3,2,1,54
531062170,58,37,2,1,98
531068282,114,32,12,1,159
531070648,44,3,2,1,50
531072058,117,10,18,25,170
531074086,138,19,2,1,160
531077929,153,17,2,9,181
531087499,26,3,2,1,32
531090742,10,19,2,1,32
531121237,110,4,2,2,118
531125602,54,63,3,1,121
531133111,35,16,6,1,58
531134533,51,39,3,3,96
531138927,22,3,2,1,28
531157764,36,10,2,5,53
531179063,22,27,11,1,61
531188498,15,4,2,1,22
531191367,56,29,74,3,162
531192852,77,31,25,18,151
531196221,87,53,7,1,148
531200447,107,41,2,30,180
531208298,13,3,2,1,19
531230822,37,12,4,7,60
531251631,55,60,31,12,158
531262348,232,7,2,2,243
531263873,111,3,2,8,124
531285682,20,39,2,1,62
531299033,79,25,63,1,168
531310202,132,31,22,2,187
531312301,67,17,24,12,120
531315062,25,32,3,3,63
531342061,43,3,2,5,53
531342321,15,3,2,1,21
531351233,111,86,74,5,276
531364979,25,95,2,13,135
531372976,259,3,2,6,270
531383100,67,4,2,35,108
531399329,28,3,2,2,35
531418685,132,40,33,37,242
531422752,10,17,2,1,30
531444755,10,4,2,6,22
531445629,44,15,3,1,63
531450400,102,3,2,1,108
531457409,18,3,2,1,24
531458435,32,19,10,2,63
531465597,66,9,2,1,78
531468299,89,39,3,52,183
531468572,247,97,10,79,433
531476655,72,22,52,19,165
531485558,42,3,4,6,55
531489454,12,3,2,1,18
531490410,16,3,2,4,25
531506696,75,3,3,1,82
531510383,27,11,2,1,41
531519299,29,27,3,1,60
531527663,88,14,17,5,124
531527785,32,3,2,2,39
531528176,11,3,2,1,17
531531057,140,31,79,4,254
531545648,598,17,2,3,620
531550707,22,7,2,1,32
531561574,142,47,43,6,238
531570648,25,33,2,1,61
531597028,11,12,2,1,26
531609103,85,3,2,3,93
531617894,76,3,2,1,82
531633277,65,7,2,1,75
531635466,11,3,2,1,17
531652375,12,7,2,1,22
531657801,20,6,2,2,30
531661510,11,3,2,1,17
531663656,60,76,2,1,139
531674174,91,3,2,1,97
531691723,29,34,3,18,84
531707204,11,3,2,1,17
531714189,13,22,2,1,38
531718836,65,42,6,17,130
531723815,22,10,2,1,35
531748634,43,20,27,5,95
531762285,16,14,2,4,36
531771766,39,50,10,1,100
531779612,28,68,2,1,99
531787027,51,3,2,1,57
531789568,21,3,2,1,27
531804857,372,3,2,1,378
531811134,41,34,21,1,97
531813029,11,4,2,1,18
531836638,58,20,4,8,90
531847287,40,12,9,1,62
531851171,12,3,2,1,18
531854789,37,5,2,4,48
531869934,10,3,2,4,19
531882927,18,3,2,1,24
531883154,48,10,2,3,63
531884148,199,3,2,4,208
531904670,56,17,53,29,155
531925087,15,3,2,2,22
531925940,93,23,95,3,214
531931051,17,13,3,1,34
531939535,108,3,2,1,114
531939982,21,26,7,21,75
531944258,49,18,3,1,71
531958117,54,31,42,32,159
531960649,76,70,42,3,191
531960809,129,62,2,2,195
531965043,86,9,2,2,99
531966535,54,3,2,12,71
531968443,15,3,2,1,21
531972920,36,5,2,3,46
531979122,10,10,2,1,23
532026956,87,66,5,1,159
532035835,40,120,14,7,181
532040892,31,3,4,1,39
532048762,65,19,4,2,90
532060490,85,16,73,3,177
532064808,90,19,12,8,129
532113004,77,11,6,1,95
532115449,189,41,42,4,276
532125100,35,15,27,1,78
532135894,82,27,4,55,168
532135969,149,12,32,4,197
532152646,14,30,2,1,47
532172808,30,16,2,1,49
532176865,156,10,115,15,296
532181498,91,10,4,1,106
532182727,53,21,9,21,104
532189199,51,9,2,1,63
532203062,40,3,2,1,46
532217948,19,3,2,1,25
532229018,163,27,2,1,193
532236524,103,43,83,5,234
532272880,134,23,3,13,173
532285457,85,3,2,1,91
532285784,235,3,2,3,243
532286095,19,3,2,3,27
532288646,208,42,3,10,263
532290554,11,3,2,6,22
532294875,35,9,2,13,59
532295042,24,31,2,1,58
532302667,49,15,17,20,101
532314423,133,24,88,9,254
532316717,57,3,2,9,71
532329767,23,54,2,1,80
532330503,153,20,2,13,188
532331808,107,3,2,8,120
532333363,46,7,6,10,69
532346023,10,15,2,1,28
532352859,40,41,2,1,84
532369837,28,3,2,1,34
532374441,11,3,2,2,18
532379749,23,3,2,1,29
532392900,86,24,99,2,211
532410193,74,4,2,19,99
532411058,15,3,2,1,21
532411315,38,64,149,1,252
532418470,12,3,2,2,19
532431817,73,37,99,13,222
532433550,81,13,2,4,100
532458688,13,8,2,1,24
532458881,56,28,12,12,108
532461338,16,9,2,1,28
532468511,40,3,2,1,46
532473571,151,48,6,3,208
532478787,332,3,2,6,343
532480711,82,5,3,2,92
532485405,40,52,61,5,158
532491367,83,31,5,4,123
532492541,22,3,2,1,28
532502953,80,22,164,1,267
532524308,116,37,2,1,156
532526729,17,45,4,5,71
532528476,24,8,2,3,37
532554079,77,3,2,12,94
532570845,14,3,2,1,20
532571798,92,25,4,5,126
532590795,72,40,67,5,184
532609618,50,17,17,1,85
532618680,18,3,2,1,24
532627499,117,9,2,2,130
532636260,27,60,11,4,102
532649628,116,3,2,1,122
532651967,83,36,2,4,125
532666635,17,65,19,2,103
532667100,44,22,6,8,80
532667216,46,56,15,4,121
532673518,13,3,2,1,19
532679866,138,50,50,84,322
532686604,268,3,2,9,282
532687918,40,3,2,2,47
532689522,47,3,2,1,53
532691652,45,39,80,39,203
532699147,13,3,2,1,19
532713325,13,13,2,1,29
532718523,68,72,31,5,176
532739561,220,13,23,3,259
532746892,68,5,2,6,81
532750893,39,54,58,1,152
532767795,53,3,2,3,61
532770967,14,3,2,1,20
532777502,149,52,2,3,206
532780779,90,40,18,5,153
532790065,188,11,2,32,233
532790181,41,12,27,4,84
532792078,87,72,19,29,207
532798501,10,9,2,1,22
532800571,94,3,2,1,100
532800999,80,117,53,1,251
532803961,10,32,2,5,49
532805510,24,3,2,5,34
532810380,17,5,16,1,39
532811936,134,34,2,1,171
532817093,33,70,3,22,128
532833621,261,3,2,13,279
532836793,10,7,2,1,20
532840639,20,3,2,1,26
532856481,99,38,7,1,145
532872246,16,3,2,3,24
532872625,94,3,4,11,112
532876665,12,24,2,9,47
532877210,11,3,2,1,17
532881851,29,3,2,1,35
532885585,37,12,25,9,83
532887132,1250,3,2,22,1277
532903544,79,32,37,6,154
532913002,150,37,23,9,219
532914882,38,56,10,1,105
532916704,125,42,30,1,198
532917134,64,58,7,5,134
532926107,55,30,2,1,88
532934587,115,14,3,3,135
532948167,95,30,2,7,134
532969852,13,4,2,6,25
532977199,224,3,2,59,288
532977666,12,3,2,1,18
532985343,10,4,2,1,17
532989175,14,3,2,1,20
532990048,92,54,42,68,256
532997045,19,4,2,1,26
533021884,131,3,2,12,148
533031117,84,14,4,1,103
533053877,52,25,11,1,89
533066144,15,3,2,1,21
533066724,23,40,20,2,85
533083232,96,13,2,1,112
533109252,100,43,32,2,177
533145513,10,6,2,1,19
533176158,20,26,2,1,49
533182636,23,18,2,2,45
533184036,13,3,2,1,19
533184898,91,21,2,10,124
533190357,49,3,2,1,55
533199831,60,26,16,1,103
533212817,142,3,4,13,162
533223185,11,21,6,5,43
533227179,10,6,2,1,19
533229436,34,3,2,3,42
533233378,17,13,2,1,33
533237934,29,7,2,8,46
533245558,29,23,15,1,68
533246785,32,3,2,1,38
533250917,117,126,26,37,306
533260162,23,3,7,2,35
533274004,232,38,33,33,336
533275183,43,7,2,6,58
533302043,11,3,2,1,17
533318678,58,21,7,1,87
533333279,72,14,13,6,105
533334416,73,12,2,1,88
533358770,53,11,16,1,81
533362028,12,3,2,1,18
533376385,15,3,2,1,21
533382935,60,6,2,5,73
533385496,19,18,2,1,40
533386664,66,10,3,7,86
533390178,170,8,100,11,289
533393721,36,3,2,4,45
533395550,75,7,2,1,85
533437430,58,28,49,9,144
533440344,12,3,2,1,18
533449267,74,22,3,1,100
533457846,21,3,2,1,27
533460505,111,30,2,1,144
533470839,14,3,2,1,20
533490353,165,44,59,18,286
533509745,50,26,2,1,79
533529856,93,40,88,2,223
533549345,98,37,32,4,171
533563665,75,21,2,2,100
533565736,138,14,52,1,205
533566126,35,6,23,1,65
533572702,53,7,2,6,68
533578714,45,6,2,1,54
533610054,73,30,44,2,149
533610860,23,95,20,3,141
533612130,68,49,6,13,136
533620330,176,14,28,1,219
533626600,46,6,35,1,88
533630624,27,33,37,1,98
533631788,18,19,8,1,46
533633240,18,3,2,9,32
533646505,67,41,26,1,135
533648031,33,3,2,1,39
533685283,84,3,2,1,90
533694766,35,8,18,1,62
533700648,20,9,2,3,34
533714894,36,3,2,1,42
533717976,31,11,7,4,53
533722209,10,5,5,2,22
533736109,12,3,2,1,18
533750987,88,22,16,37,163
533751408,34,56,20,16,126
533754464,16,36,26,4,82
533762279,72,3,2,1,78
533763216,11,4,2,1,18
533768333,12,3,2,1,18
533777078,38,44,4,1,87
533786841,28,24,2,1,55
533792970,37,81,6,6,130
533801959,59,52,2,1,114
533805675,284,3,2,4,293
533812189,10,3,2,2,17
533815502,127,9,2,1,139
533817488,52,3,20,1,76
533824360,151,15,3,2,171
533825344,10,3,2,2,17
533835777,49,10,11,1,71
533838569,63,3,6,1,73
533845887,71,3,2,4,80
533856102,67,40,17,19,143
533862779,88,39,47,77,251
533881185,56,23,65,6,150
533891167,177,39,28,20,264
533896363,47,10,3,3,63
533902281,21,3,2,2,28
533902386,31,3,2,6,42
533903411,17,3,2,1,23
533911626,174,22,3,3,202
533916584,10,3,2,4,19
533930200,35,11,19,1,66
533952411,30,20,4,1,55
533960540,61,12,2,1,76
533966398,73,20,5,4,102
533977069,17,13,3,1,34
533981347,36,5,3,1,45
533985044,37,3,2,2,44
533985258,72,115,15,7,209
533989901,24,3,2,10,39
533991935,103,27,18,1,149
533992027,83,3,2,1,89
533994020,58,17,10,8,93
534000814,20,3,2,1,26
534044840,17,8,2,10,37
534048229,65,39,2,17,123
534056084,11,3,2,1,17
534059867,64,9,49,5,127
534060933,88,42,2,2,134
534065592,94,8,40,6,148
534071758,19,12,2,1,34
534076536,73,12,18,1,104
534080784,40,7,2,1,50
534105886,11,4,2,1,18
534114228,28,3,2,1,34
534122417,80,24,2,1,107
534131291,123,35,5,4,167
534134040,66,3,8,3,80
534140077,99,3,2,1,105
534140770,92,59,39,8,198
534153776,114,4,2,9,129
534166973,36,3,2,1,42
534174046,103,3,2,1,109
534188297,26,31,44,1,102
534195801,55,33,24,3,115
534228305,146,22,50,11,229
534235896,111,26,6,7,150
534240550,39,61,2,1,103
534247522,21,3,2,1,27
534247712,50,3,2,1,56
534265083,40,3,2,1,46
534266690,73,9,2,1,85
534275272,30,21,2,1,54
534278328,132,14,27,1,174
534278890,72,3,2,10,87
534280348,105,40,7,8,160
534288442,14,4,2,1,21
534288736,29,19,25,60,133
534295991,74,23,13,8,118
534314787,69,3,2,1,75
534332718,52,13,68,1,134
534337966,25,13,47,5,90
534352618,10,4,2,1,17
534356379,164,25,108,2,299
534362322,98,40,7,16,161
534391898,91,3,2,3,99
534404591,11,4,2,1,18
534412838,61,3,2,3,69
534432106,12,38,10,1,61
534437625,54,3,15,2,74
534439401,17,14,2,1,34
534439710,13,7,2,2,24
534446879,23,3,2,2,30
534463450,25,10,2,49,86
534474326,60,3,2,13,78
534483974,24,36,2,1,63
534485610,24,23,2,1,50
534503217,15,3,2,1,21
534518905,232,41,5,16,294
534521212,61,5,2,1,69
534530590,40,35,36,3,114
534537945,11,5,2,1,19
534538170,87,20,2,6,115
534548843,191,17,2,3,213
534577576,68,43,8,18,137
534581004,55,20,72,11,158
534587336,24,3,2,4,33
534603896,11,3,2,1,17
534610613,12,3,2,1,18
534620337,71,3,2,3,79
534625263,39,53,2,5,99
534625904,63,10,2,5,80
534627761,15,3,2,1,21
534628693,200,3,2,3,208
534647823,17,36,5,1,59
534650962,49,17,8,21,95
534656546,33,29,9,4,75
534660395,11,3,2,1,17
534667673,32,11,2,20,65
534673181,28,3,2,1,34
534675285,71,63,29,2,165
534693545,149,3,2,11,165
534699253,117,17,2,2,138
534704405,117,3,2,1,123
534722682,124,68,71,1,264
534725591,141,12,2,4,159
534742170,12,3,2,1,18
534753910,24,37,3,8,72
534759952,10,9,2,1,22
534759978,132,3,6,1,142
534786970,62,16,35,1,114
534794120,11,3,2,1,17
534794186,34,3,2,1,40
534794539,47,43,14,1,105
534794678,169,21,2,5,197
534807355,146,16,2,1,165
534807403,32,4,2,4,42
534808619,213,3,2,1,219
534810172,52,31,6,6,95
534828082,157,3,2,29,191
534864953,66,17,17,3,103
534870800,25,28,3,2,58
534874393,68,27,67,70,232
534877258,12,3,2,1,18
534884548,108,3,21,5,137
534891734,149,44,2,10,205
534896578,79,40,169,27,315
534906502,88,19,58,1,166
534911004,32,3,2,1,38
534911725,81,35,97,4,217
534921196,12,3,2,1,18
534922242,37,40,2,2,81
534934987,85,43,31,10,169
534943853,73,3,2,1,79
534953226,11,15,2,1,29
534953974,18,20,26,3,67
534958899,10,3,2,3,18
534962509,75,3,2,2,82
534965341,11,3,2,1,17
534969924,13,3,2,1,19
534993105,124,26,2,1,153
535002102,12,4,2,1,19
535006715,19,15,10,4,48
535016071,150,23,5,1,179
535020121,165,12,90,9,276
535041085,86,23,3,1,113
535046709,12,20,2,1,35
535056652,66,3,2,2,73
535069018,39,53,20,5,117
535077177,37,10,2,1,50
535077190,154,43,7,17,221
535082309,41,36,39,6,122
535094213,28,4,2,1,35
535095780,51,6,3,1,61
535100302,10,4,2,13,29
535101124,47,62,2,3,114
535104183,21,3,2,1,27
535110473,68,3,24,1,96
535110843,18,30,2,11,61
535113212,12,4,2,1,19
535113419,10,9,2,1,22
535117166,46,16,2,4,68
535119320,71,31,8,29,139
535119982,21,25,4,1,51
535123721,68,21,2,1,92
535125427,141,3,2,27,173
535127692,13,9,19,1,42
535133678,79,41,4,2,126
535138233,17,4,2,1,24
535172784,56,25,19,7,107
535201536,36,32,14,3,85
535202495,64,10,2,4,80
535216413,55,3,2,6,66
535229578,22,3,2,1,28
535241415,45,12,40,1,98
535249090,126,3,2,2,133
535249148,17,14,2,1,34
535254344,25,10,2,1,38
535256141,15,17,2,2,36
535270557,68,32,3,1,104
535272508,11,3,2,1,17
535284681,20,19,2,1,42
535295163,50,18,2,1,71
535297487,134,7,2,12,155
535314660,12,3,2,1,18
535319506,124,72,51,4,251
535321980,17,12,2,1,32
535322342,16,26,3,1,46
535332496,74,38,20,15,147
535341870,59,7,2,2,70
535344898,74,3,2,3,82
535349514,18,3,2,1,24
535358054,21,3,2,1,27
535361761,11,9,10,5,35
535365456,111,3,2,1,117
535366813,13,3,2,1,19
535389891,48,3,2,1,54
535390670,38,17,2,2,59
535400866,64,65,73,34,236
535412452,49,22,21,6,98
535413692,78,11,10,16,115
535416720,46,3,2,1,52
535426990,60,4,2,1,67
535428096,99,21,22,1,143
535429515,54,27,6,3,90
535439373,20,3,2,1,26
535456621,56,17,49,9,131
535477981,40,15,8,10,73
535483762,39,15,3,5,62
535487204,31,39,2,73,145
535491313,24,3,2,1,30
535503647,12,3,2,1,18
535512810,94,3,2,2,101
535521397,19,3,2,1,25
535538381,43,21,2,17,83
535545251,78,4,2,1,85
535546299,84,11,3,2,100
535548411,43,3,2,1,49
535548617,165,47,63,11,286
535572805,67,34,2,21,124
535576703,11,3,2,4,20
535597238,67,3,16,12,98
535615193,12,3,2,1,18
535621371,99,9,14,3,125
535628712,152,3,2,1,158
535645181,64,3,2,19,88
535669986,32,3,2,1,38
535682325,51,20,51,17,139
535693128,66,25,2,6,99
535706550,13,12,2,1,28
535708762,73,11,2,1,87
535716727,22,16,5,10,53
535719066,41,3,2,6,52
535721661,59,32,41,11,143
535721683,61,34,41,3,139
535721744,16,23,49,14,102
535732960,48,7,2,1,58
535745909,19,12,2,6,39
535749501,83,11,3,1,98
535758451,95,71,4,15,185
535761424,21,3,2,1,27
535768136,46,28,3,1,78
535784533,108,114,62,22,306
535795651,46,67,8,14,135
535796210,469,3,2,105,579
535798791,45,90,19,37,191
535801070,224,36,66,8,334
535806890,13,3,4,1,21
535811886,170,19,2,6,197
535822951,18,3,2,1,24
535826574,73,18,2,1,94
535828829,10,12,2,4,28
535831310,52,10,2,1,65
535832045,57,36,14,20,127
535844146,71,31,15,1,118
535851108,46,57,6,10,119
535851405,71,36,14,1,122
535860139,21,3,2,1,27
535861952,15,15,2,1,33
535879369,10,4,2,1,17
535890310,77,33,11,1,122
535897902,123,17,2,4,146
535908178,125,12,26,25,188
535909415,58,64,13,3,138
535911248,58,24,2,4,88
535917674,76,13,2,2,93
535922130,147,21,2,3,173
535932301,10,7,2,1,20
535934228,12,42,2,1,57
535944895,16,3,2,1,22
535947041,154,14,2,32,202
535961765,127,5,9,14,155
535964228,62,35,18,14,129
535964229,52,3,6,4,65
535965318,70,14,19,4,107
535965355,41,9,35,1,86
535972565,99,15,2,1,117
535986950,71,3,2,6,82
535989904,11,3,2,1,17
536011713,54,14,3,4,75
536012667,55,3,2,1,61
536018905,10,5,2,1,18
536019650,44,5,32,1,82
536037555,73,6,2,7,88
536044261,213,75,2,1,291
536047785,45,29,3,1,78
536064988,13,3,2,1,19
536081869,101,13,35,7,156
536084770,15,14,2,1,32
536090691,13,4,3,5,25
536128802,72,10,109,1,192
536134650,57,20,3,7,87
536147196,18,3,2,1,24
536158439,104,66,2,1,173
536162923,87,38,2,2,129
536167697,62,20,26,1,109
536171146,33,10,2,1,46
536187535,17,45,2,1,65
536204908,56,11,4,3,74
536206790,12,3,2,1,18
536213300,65,15,4,2,86
536221045,34,45,2,3,84
536224140,97,19,52,2,170
536227109,142,21,2,1,166
536250208,10,3,2,10,25
536251634,13,5,9,7,34
536254796,33,41,69,7,150
536260501,35,33,8,1,77
536278081,28,29,10,1,68
536292006,47,3,2,1,53
536310378,41,24,8,9,82
536314550,150,27,80,39,296
536332794,23,32,16,1,72
536339304,10,5,2,1,18
536353250,58,3,2,4,67
536354166,28,13,19,14,74
536360833,163,23,2,3,191
536382806,202,3,2,6,213
536397815,72,20,48,1,141
536411148,20,3,2,1,26
536426360,48,10,2,1,61
536428205,67,3,2,7,79
536430513,109,21,2,5,137
536431204,42,5,2,17,66
536452903,15,14,2,1,32
536458927,17,27,2,1,47
536462071,77,3,2,3,85
536464653,18,3,2,1,24
536471371,94,56,62,18,230
536483119,64,3,2,1,70
536489664,25,5,2,1,33
536528980,22,3,2,2,29
536530811,64,16,2,3,85
536556002,53,11,2,6,72
536558334,120,21,15,2,158
536562486,134,51,142,9,336
536581063,94,21,20,2,137
536590857,70,26,5,2,103
536603361,67,18,40,3,128
536614194,30,3,2,1,36
536617656,124,44,3,3,174
536619984,83,42,37,38,200
536626340,72,22,30,20,144
536627060,42,8,4,21,75
536646009,17,3,2,1,23
536664276,101,54,2,3,160
536665747,35,47,22,5,109
536672632,16,3,2,1,22
536675527,18,27,5,1,51
536677670,52,41,48,21,162
536693935,76,29,17,20,142
536695231,87,58,3,2,150
536707801,26,15,13,1,55
536715938,58,13,2,2,75
536718735,37,38,19,3,97
536719404,23,3,2,1,29
536720182,38,9,2,8,57
536723516,13,3,2,3,21
536723972,123,5,5,1,134
536731615,71,4,2,15,92
536732800,76,3,2,1,82
536733403,10,18,2,1,31
536748279,90,35,2,2,129
536751244,90,34,2,16,142
536761076,44,51,2,3,100
536771985,23,3,2,1,29
536799947,19,8,26,1,54
536803176,56,37,11,2,106
536809489,23,6,2,1,32
536810498,111,6,2,2,121
536817379,234,3,2,1,240
536822453,72,3,2,1,78
536823583,50,37,15,15,117
536825152,56,12,17,31,116
536831752,24,3,2,3,32
536861672,69,30,50,4,153
536868453,124,3,2,1,130
536868600,71,11,36,2,120
536871366,32,30,2,12,76
536873151,10,4,2,1,17
536873400,94,18,2,3,117
536875576,25,3,2,1,31
536875992,36,3,2,1,42
536880955,32,25,2,1,60
536882662,17,32,2,1,52
536883031,33,51,2,3,89
536895608,131,10,2,6,149
536921289,122,3,2,2,129
536954513,19,23,2,1,45
536957937,19,3,2,1,25
536964255,64,3,2,1,70
536970045,85,30,2,8,125
536970761,171,3,29,1,204
536974583,14,13,2,1,30
536993416,173,42,136,10,361
537005079,12,23,10,2,47
537014223,67,4,2,2,75
537025679,75,4,2,7,88
537035726,14,3,2,1,20
537036191,11,35,2,9,57
537036559,68,3,2,1,74
537047368,328,3,2,1,334
537054460,103,22,24,14,163
537073370,13,3,2,1,19
537105582,60,54,6,4,124
537111967,13,9,6,4,32
537116900,32,25,37,29,123
537126343,11,3,2,1,17
537127482,183,13,8,8,212
537131544,124,3,2,1,130
537134638,45,50,13,20,128
537135822,147,28,3,1,179
537139212,52,43,59,1,155
537151995,225,3,2,23,253
537156170,27,3,2,1,33
537161994,10,50,8,1,69
537182413,128,28,2,1,159
537188608,51,34,2,1,88
537208161,117,33,116,58,324
537215854,285,62,63,47,457
537228082,301,15,3,30,349
537233182,18,3,2,1,24
537237685,66,32,4,5,107
537238875,40,31,3,1,75
537239309,75,36,31,3,145
537244763,15,3,2,1,21
537254194,10,7,2,1,20
537262089,34,3,2,30,69
537263880,80,3,2,2,87
537274407,22,6,7,16,51
537276910,122,42,2,2,168
537291100,240,27,41,6,314
537295839,78,3,2,1,84
537301098,24,19,2,7,52
537325683,58,19,19,1,97
537328549,69,3,2,3,77
537345137,89,5,14,27,135
537369224,10,4,2,1,17
537378327,44,53,2,3,102
537383779,73,55,183,50,361
537403474,15,3,2,1,21
537413663,56,30,2,3,91
537416648,13,25,2,8,48
537446293,23,3,2,2,30
537447088,96,12,25,8,141
537449891,113,14,12,10,149
537452809,72,10,2,3,87
537454102,31,30,3,17,81
537462667,173,78,11,8,270
537468837,72,3,2,1,78
537470123,10,12,2,1,25
537470828,63,15,2,1,81
537473289,79,3,2,1,85
537474639,48,3,2,1,54
537481980,57,22,6,3,88
537486879,43,21,14,1,79
537494492,29,3,2,1,35
537496770,67,23,2,4,96
537500024,166,3,2,3,174
537511656,16,9,2,1,28
537522875,27,3,2,1,33
537524061,107,67,98,14,286
537525079,19,3,2,1,25
537527551,74,3,2,24,103
537533850,82,10,2,49,143
537536272,20,12,35,6,73
537538755,48,18,2,6,74
537553764,11,3,2,1,17
537558573,52,13,2,6,73
537566191,22,35,3,2,62
537577582,26,45,74,1,146
537584913,12,12,2,1,27
537587660,85,5,2,1,93
537598863,149,3,2,19,173
537603971,86,24,2,3,115
537607851,16,3,2,1,22
537608804,40,3,4,1,48
537641264,85,3,2,1,91
537671434,122,34,21,1,178
537694239,12,3,2,1,18
537698590,36,3,2,1,42
537700983,126,56,18,41,241
537703673,128,3,2,1,134
537733219,59,28,23,3,113
537739628,75,29,3,1,108
537742105,56,6,41,11,114
537743130,31,54,3,2,90
537778794,73,3,2,6,84
537791908,58,3,2,1,64
537797196,87,38,11,1,137
537800689,70,3,2,1,76
537807389,80,3,2,1,86
537808424,36,3,2,1,42
537814475,13,3,2,1,19
537840938,55,13,2,3,73
537847629,14,3,2,6,25
537852654,22,21,29,7,79
537858801,110,21,6,1,138
537860470,11,3,2,1,17
537863710,49,28,98,1,176
537870341,38,19,10,6,73
537875416,76,3,2,1,82
537880602,25,15,2,1,43
537890049,44,25,6,1,76
537904432,21,6,2,1,30
537943681,41,37,2,3,83
537944870,61,14,2,2,79
537958712,49,22,44,2,117
537960302,79,16,3,7,105
537973138,51,19,2,1,73
537976979,11,29,2,1,43
537990195,32,113,17,1,163
537998125,37,19,2,10,68
538000034,21,3,2,8,34
538002984,200,3,2,1,206
538017170,12,4,2,1,19
538018094,60,50,27,16,153
538027675,147,3,2,3,155
538032613,158,30,4,12,204
538038804,108,3,2,46,159
538044192,42,42,4,4,92
538059215,103,3,2,1,109
538062096,90,3,2,15,110
538081505,102,4,2,1,109
538098314,18,19,2,1,40
538101218,76,5,2,3,86
538103952,101,14,2,9,126
538121416,173,3,2,2,180
538121801,23,4,12,1,40
538126917,15,3,2,5,25
538142036,141,3,2,2,148
538173913,31,74,4,2,111
538194958,10,25,4,1,40
538201106,19,14,3,14,50
538205292,43,3,2,2,50
538209702,59,4,3,1,67
538253482,13,3,2,1,19
538254168,39,3,2,4,48
538257820,26,5,3,3,37
538262915,100,99,5,4,208
538264046,112,3,2,1,118
538264843,22,12,2,3,39
538268555,197,20,40,6,263
538276356,13,3,2,1,19
538279504,40,3,2,1,46
538290042,42,20,16,5,83
538298093,10,3,3,1,17
538319330,45,3,2,31,81
538319963,24,32,20,1,77
538321821,16,23,2,1,42
538322314,13,12,2,16,43
538350487,239,3,2,3,247
538355540,11,3,2,1,17
538356058,11,3,2,3,19
538357720,38,3,2,1,44
538383417,78,108,31,43,260
538384956,44,37,18,1,100
538386096,131,41,70,7,249
538386682,74,3,2,1,80
538395912,36,29,3,5,73
538396368,157,70,32,4,263
538398978,66,40,13,5,124
538410493,215,65,2,4,286
538412533,53,58,39,42,192
538416904,76,9,6,2,93
538422465,212,50,16,20,298
538424375,103,3,2,5,113
538448008,11,3,2,1,17
538450908,75,18,73,13,179
538450997,82,3,2,2,89
538472736,76,36,28,7,147
538484332,50,22,2,1,75
538489666,96,12,2,1,111
538494671,93,49,47,16,205
538496668,54,3,2,1,60
538506274,39,3,2,1,45
538516199,77,38,28,3,146
538521316,10,7,2,2,21
538522642,41,9,2,4,56
538527763,14,3,2,1,20
538548474,121,3,2,1,127
538550217,44,19,2,2,67
538559546,32,3,2,1,38
538569508,209,38,3,23,273
538575359,80,9,2,1,92
538585363,134,81,17,40,272
538590357,51,3,2,1,57
538622784,24,30,9,1,64
538639358,16,8,2,6,32
538670027,85,3,2,1,91
538679893,29,3,2,2,36
538683584,17,21,2,12,52
538691762,99,40,20,1,160
538696233,221,3,2,1,227
538699731,68,29,7,4,108
538704256,58,29,2,14,103
538704687,115,11,43,7,176
538706111,17,11,2,3,33
538710488,49,15,37,12,113
538729118,14,34,16,2,66
538753425,47,3,2,2,54
538766574,147,16,29,5,197
538786027,11,10,2,1,24
538786059,12,3,2,1,18
538791090,33,16,3,5,57
538795106,69,31,24,1,125
538808812,181,11,13,6,211
538831553,45,34,9,28,116
538833008,74,68,2,5,149
538833716,14,19,2,1,36
538835110,117,3,2,15,137
538835849,121,27,76,14,238
538838598,23,11,2,1,37
538842802,29,6,2,1,38
538846892,67,37,37,4,145
538847548,50,3,2,7,62
538863606,125,18,30,1,174
538868097,20,3,2,1,26
538874317,20,19,2,4,45
538879744,28,31,2,2,63
538883231,80,8,11,1,100
538885438,23,5,2,20,50
538903690,83,15,2,1,101
538905347,24,64,9,3,100
538912830,50,41,20,6,117
538916982,28,22,2,2,54
538918926,91,24,4,2,121
538919022,115,19,25,7,166
538921631,341,48,24,2,415
538924388,78,3,16,1,98
538936597,18,17,10,5,50
538943912,43,3,2,1,49
538950558,49,3,2,1,55
538955785,123,48,78,5,254
538956589,74,3,7,2,86
538958844,95,3,2,23,123
538966694,78,3,2,12,95
538973468,29,36,3,1,69
538978177,123,13,2,12,150
538986577,88,5,13,3,109
538998284,238,34,17,10,299
539001444,56,39,2,7,104
539002797,89,3,2,1,95
539008611,13,43,8,1,65
539010197,209,3,2,1,215
539012060,127,3,4,2,136
539013938,28,35,21,21,105
539019193,123,17,2,1,143
539022025,38,41,25,2,106
539033337,82,45,63,38,228
539040626,16,3,2,1,22
539045718,146,26,86,1,259
539084709,41,3,2,2,48
539086816,33,31,46,3,113
539088767,189,7,3,8,207
539093906,11,3,2,1,17
539096826,11,23,2,1,37
539103604,84,34,7,1,126
539127863,163,27,94,6,290
539139090,21,22,20,1,64
539146603,116,41,55,3,215
539157188,186,22,2,1,211
539159517,36,41,3,5,85
539188370,126,3,2,4,135
539188494,112,35,93,55,295
539191893,27,3,2,1,33
539230413,58,65,39,35,197
539241789,13,15,2,4,34
539245192,61,17,51,8,137
539254928,81,38,4,1,124
539261534,126,8,88,3,225
539261546,15,3,2,1,21
539262440,29,3,2,1,35
539272451,52,74,28,20,174
539274629,100,27,80,1,208
539277056,82,9,7,1,99
539285287,24,37,7,1,69
539297145,20,12,3,1,36
539337965,130,3,4,16,153
539355553,44,72,9,7,132
539363644,84,32,2,18,136
539373175,17,5,10,2,34
539376698,22,23,8,5,58
539382672,22,3,2,1,28
539392540,52,41,2,6,101
539399512,42,27,14,6,89
539405635,192,33,39,25,289
539408563,88,30,19,2,139
539432755,105,20,2,1,128
539435299,18,37,2,6,63
539435311,116,3,2,1,122
539436882,27,3,2,1,33
539448473,36,9,3,1,49
539452341,10,18,2,1,31
539464569,39,31,10,3,83
539469435,87,3,2,1,93
539472147,32,3,2,10,47
539477032,37,3,2,1,43
539481602,58,23,9,3,93
539501371,144,24,2,26,196
539504500,49,3,2,2,56
539513162,44,43,2,13,102
539515987,158,13,17,23,211
539522746,50,3,2,5,60
539526603,94,47,12,10,163
539535301,31,31,2,1,65
539541238,46,11,2,5,64
539541859,22,30,30,1,83
539548107,130,54,3,1,188
539549465,27,24,2,1,54
539560761,118,25,75,6,224
539563989,177,3,2,4,186
539565577,183,3,2,4,192
539568956,43,6,2,1,52
539581342,47,3,2,1,53
539593685,75,52,2,1,130
539601064,163,3,2,1,169
539623062,33,3,2,5,43
539638274,137,19,2,14,172
539651393,272,3,2,1,278
539660587,110,23,68,18,219
539664081,57,16,26,1,100
539681169,98,70,127,2,297
539683506,96,35,24,7,162
539707020,89,19,49,1,158
539710934,11,3,2,1,17
539726811,17,24,3,1,45
539738047,37,69,37,11,154
539741911,10,3,2,5,20
539747429,20,4,2,1,27
539755623,136,30,2,1,169
539756018,14,7,3,2,26
539768857,33,8,2,2,45
539778721,12,3,2,3,20
539783716,46,10,15,1,72
539798822,41,44,51,13,149
539799348,60,19,8,2,89
539820786,172,114,112,76,474
539834087,99,25,5,3,132
539850989,64,31,2,2,99
539851118,53,41,4,3,101
539851688,55,18,4,1,78
539855991,26,3,2,1,32
539859310,57,11,12,2,82
539864344,72,21,14,3,110
539868546,51,44,47,30,172
539872775,24,49,7,12,92
539874514,148,14,2,95,259
539884458,13,3,2,1,19
539899302,124,3,2,9,138
539907504,64,47,43,2,156
539908925,117,8,2,6,133
539909966,64,3,2,1,70
539925228,150,3,2,1,156
539925371,28,37,2,2,69
539925680,110,3,2,1,116
539933423,124,28,22,4,178
539941415,157,3,2,3,165
539943018,57,28,3,1,89
539950876,37,43,17,19,116
539953506,29,10,10,1,50
539961925,69,46,2,2,119
539968001,34,65,2,1,102
539982044,19,8,46,13,86
539982332,12,3,2,4,21
539983485,166,17,2,11,196
540005751,12,3,2,1,18
540028768,23,5,2,1,31
540031757,62,17,34,11,124
540039561,76,26,124,11,237
540042753,46,42,9,35,132
540043446,71,3,2,5,81
540043690,441,89,14,36,580
540061927,98,15,2,2,117
540065000,223,59,2,3,287
540072593,11,3,2,1,17
540073440,44,45,8,1,98
540073849,94,20,92,2,208
540081409,13,4,2,1,20
540085124,249,30,2,6,287
540100823,19,3,2,1,25
540104773,45,3,2,2,52
540107447,67,46,2,13,128
540108637,119,25,36,1,181
540109329,35,20,14,4,73
540109857,96,4,2,3,105
540112586,85,6,2,1,94
540113067,315,3,18,3,339
540115960,60,10,2,1,73
540122642,79,3,2,22,106
540131270,25,25,2,1,53
540135171,46,31,81,23,181
540139717,18,51,19,1,89
540146565,312,3,2,3,320
540151850,17,13,4,1,35
540153436,39,46,18,8,111
540170764,19,3,2,1,25
540172934,48,29,9,10,96
540175267,82,8,2,3,95
540176761,49,10,2,2,63
540179057,40,7,6,8,61
540180516,108,9,9,33,159
540182519,88,31,52,17,188
540186814,283,3,2,5,293
540197465,59,14,8,2,83
540199996,87,45,2,1,135
540207344,70,13,2,13,98
540212180,158,35,23,10,226
540222192,92,11,3,3,109
540233186,106,3,2,6,117
540233929,64,11,23,5,103
540240187,26,27,18,7,78
540255352,150,3,2,4,159
540255421,23,3,2,1,29
540256815,18,20,2,2,42
540268069,22,4,2,1,29
540273001,69,13,11,1,94
540291272,58,3,2,1,64
540315653,23,3,2,1,29
540338967,11,7,2,1,21
540367727,19,29,42,18,108
540380481,43,10,5,11,69
540389097,254,20,5,3,282
540394041,61,47,21,1,130
540408166,41,8,92,1,142
540416150,52,19,2,5,78
540418663,22,21,2,1,46
540419461,24,3,2,2,31
540453820,31,144,12,2,189
540457030,52,11,18,17,98
540458720,119,8,30,12,169
540469019,31,3,2,1,37
540469068,25,45,47,3,120
540475268,20,44,2,1,67
540497852,110,14,6,1,131
540518225,98,11,4,1,114
540519785,247,3,2,5,257
540533207,10,3,2,2,17
540549231,11,3,2,4,20
540550269,66,31,99,1,197
540551203,29,19,2,2,52
540555746,19,7,2,2,30
540556278,192,3,3,1,199
540557700,135,93,41,9,278
540564121,10,3,2,8,23
540568324,241,12,11,9,273
540571113,66,7,5,11,89
540577002,63,3,2,1,69
540577453,92,7,3,7,109
540585801,38,37,14,1,90
540588223,37,3,2,1,43
540594024,20,3,2,2,27
540604962,61,17,57,1,136
540608344,52,5,2,1,60
540610641,13,29,3,11,56
540616032,188,86,67,47,388
540616438,112,43,2,5,162
540616443,19,17,10,5,51
540616885,13,3,2,2,20
540651140,123,14,27,10,174
540669866,17,3,2,1,23
540677365,93,44,15,3,155
540677996,102,32,52,29,215
540698083,215,4,2,1,222
540710309,120,3,2,2,127
540712448,29,17,19,3,68
540743630,139,24,3,5,171
540746794,11,3,2,1,17
540748899,37,28,5,1,71
540751685,176,37,2,22,237
540755474,33,3,2,1,39
540761335,39,7,8,1,55
540776037,33,3,2,1,39
540787234,63,30,100,3,196
540791781,25,24,2,1,52
540792930,44,47,7,58,156
540799238,31,3,2,1,37
540808168,38,126,19,8,191
540849305,21,7,2,1,31
540853663,20,4,2,1,27
540886711,22,4,2,1,29
540907368,28,18,13,2,61
540914778,85,55,12,24,176
540922642,72,36,18,4,130
540930277,100,3,2,2,107
540939095,67,26,13,22,128
540939308,30,3,2,1,36
540947614,210,18,2,2,232
540949823,52,46,2,2,102
540955804,17,19,2,1,39
540994652,11,40,3,3,57
541003412,33,34,31,1,99
541025392,104,4,2,1,111
541037186,191,3,2,3,199
541040636,50,3,2,1,56
541046854,58,3,10,1,72
541047129,56,16,29,7,108
541055790,124,17,14,1,156
541064308,111,45,44,18,218
541081739,115,18,2,12,147
541086375,72,28,7,1,108
541088720,11,26,2,2,41
541096134,41,18,7,1,67
541101261,37,16,2,1,56
541128190,21,25,9,2,57
541129914,118,3,2,1,124
541138063,73,3,2,1,79
541144311,13,3,2,1,19
541170477,131,22,4,1,158
541171359,32,3,2,1,38
541171653,171,39,2,1,213
541173145,207,3,2,3,215
541174174,45,28,90,8,171
541180456,122,3,2,3,130
541201870,18,54,10,13,95
541217898,41,36,2,10,89
541224542,11,38,2,1,52
541243397,30,52,4,3,89
541256408,157,3,2,1,163
541262292,133,65,53,2,253
541269897,54,118,2,42,216
541273036,118,11,58,1,188
541297282,105,19,2,3,129
541318582,32,6,2,4,44
541326952,44,3,2,1,50
541328916,63,16,2,9,90
541333733,24,3,2,1,30
541339802,53,10,20,8,91
541343394,82,17,109,15,223
541354076,58,3,2,3,66
541374514,83,11,15,2,111
541379229,59,4,2,1,66
541409753,10,5,2,1,18
541412494,10,3,2,2,17
541415373,55,19,48,2,124
541430473,14,32,20,3,69
541431848,36,34,2,3,75
541431897,36,3,2,4,45
541435164,64,32,20,5,121
541444745,11,3,2,1,17
541471100,79,4,40,2,125
541471456,10,7,2,1,20
541472277,13,69,16,6,104
541477347,10,29,2,1,42
541483218,83,39,3,10,135
541509968,274,5,11,2,292
541526054,11,4,2,1,18
541529797,19,3,2,1,25
541538838,74,48,24,37,183
541556992,100,3,2,1,106
541558635,117,63,84,18,282
541566040,50,16,2,3,71
541566883,81,3,2,2,88
541567853,17,3,2,1,23
541573847,13,3,2,4,22
541587224,12,14,4,1,31
541594028,30,3,2,3,38
541595584,55,23,58,1,137
541599267,45,6,40,1,92
541613495,105,16,41,3,165
541624612,82,37,15,6,140
541634882,17,3,2,1,23
541653689,14,3,3,1,21
541656727,16,3,2,8,29
541657458,21,28,37,8,94
541660303,335,3,2,3,343
541694889,35,5,2,23,65
541709174,82,40,2,1,125
541713610,12,3,2,1,18
541726078,114,3,3,3,123
541730305,71,16,29,22,138
541730657,81,18,2,2,103
541743920,79,37,4,7,127
541748978,96,11,2,1,110
541804419,62,21,13,16,112
541809935,66,15,7,1,89
541817741,161,17,2,24,204
541820126,32,8,5,5,50
541838223,35,8,8,2,53
541859060,52,4,26,5,87
541865071,233,40,51,2,326
541869958,114,8,17,2,141
541882267,56,22,10,1,89
541885165,66,3,2,1,72
541888110,155,3,2,2,162
541892135,71,7,6,11,95
541894296,66,42,6,1,115
541895215,12,22,2,1,37
541912456,1254,3,2,15,1274
541920704,172,46,3,1,222
541921834,17,23,2,1,43
541934261,98,31,42,6,177
541944475,63,24,5,2,94
541956937,94,3,2,1,100
541958227,105,101,32,28,266
541962097,12,31,2,1,46
541967267,69,24,2,1,96
541969278,108,36,46,50,240
542001673,181,57,30,35,303
542028124,318,3,2,5,328
542039650,133,3,2,1,139
542049762,97,28,12,3,140
542052801,43,4,2,1,50
542061386,54,38,5,5,102
542063207,462,29,46,3,540
542065819,24,16,4,5,49
542079444,147,6,2,7,162
542093242,107,3,2,1,113
542096632,103,60,2,5,170
542108137,17,3,15,6,41
542113918,92,39,99,9,239
542115601,37,3,2,1,43
542130217,29,3,2,1,35
542132416,51,3,2,4,60
542145380,74,3,2,6,85
542149605,126,3,2,1,132
542156437,81,40,8,11,140
542165670,46,6,55,7,114
542192671,98,18,26,1,143
542194899,34,29,21,2,86
542198133,50,63,2,1,116
542202510,110,9,5,7,131
542222284,17,24,2,1,44
542234738,10,24,2,1,37
542240477,42,39,8,19,108
542241968,30,38,4,6,78
542257085,75,12,128,1,216
542262682,11,3,2,1,17
542269254,112,6,2,7,127
542273632,10,3,2,2,17
542289967,106,18,2,1,127
542291413,13,8,2,1,24
542296691,173,38,8,9,228
542301285,18,12,2,5,37
542322248,31,3,2,1,37
542335208,102,36,45,24,207
542364714,191,18,2,1,212
542393494,12,3,2,1,18
542419159,143,35,85,23,286
542421334,94,3,2,2,101
542423012,53,4,2,1,60
542441275,21,25,8,1,55
542459997,23,23,2,3,51
542462466,125,30,33,3,191
542498453,49,25,34,2,110
542507508,79,3,2,2,86
542510700,17,3,2,1,23
542514011,10,42,2,1,55
542522163,127,21,55,1,204
542526828,141,19,41,10,211
542533772,96,15,52,1,164
542537060,95,22,85,3,205
542545219,29,3,2,1,35
542589611,73,24,2,12,111
542595998,37,39,2,1,79
542602745,52,3,2,1,58
542622356,71,3,2,1,77
542635291,62,18,2,9,91
542645517,83,3,3,1,90
542647130,58,63,32,7,160
542660336,20,85,13,4,122
542660996,11,3,2,2,18
542682653,12,3,2,1,18
542706249,94,36,3,5,138
542709124,138,3,2,1,144
542714521,10,42,2,1,55
542726522,30,15,3,3,51
542729299,14,11,2,2,29
542730182,11,3,2,1,17
542741891,42,30,19,8,99
542766963,61,12,6,4,83
542773588,100,20,33,24,177
542786925,256,53,38,18,365
542797673,142,51,46,3,242
542800637,34,3,2,12,51
542811315,36,27,2,1,66
542812464,31,5,2,6,44
542819251,109,13,2,3,127
542822214,120,3,2,14,139
542835936,32,7,2,1,42
542842251,74,3,2,9,88
542863409,88,19,2,16,125
542867096,78,3,2,19,102
542867547,22,16,2,1,41
542871150,41,42,6,26,115
542873491,93,75,98,10,276
542893242,69,34,10,24,137
542911398,111,3,2,2,118
542919261,134,26,2,1,163
542920208,117,35,93,22,267
542952207,27,45,25,5,102
542969896,121,30,58,9,218
542979173,44,27,37,1,109
542983414,69,7,2,1,79
542985038,20,51,2,1,74
542991293,17,3,2,1,23
542995223,43,28,15,4,90
542995881,36,25,4,1,66
543000761,110,3,2,14,129
543011514,106,12,70,65,253
543012647,12,4,2,3,21
543023294,34,16,4,1,55
543040924,175,20,2,12,209
543042763,58,7,3,10,78
543043734,67,28,10,2,107
543054149,57,3,2,3,65
543055613,77,67,62,41,247
543105010,43,9,2,10,64
543107620,57,64,39,40,200
543120947,16,3,2,1,22
543122810,18,33,2,1,54
543124251,17,21,2,2,42
543134629,42,53,9,1,105
543148234,79,76,2,2,159
543151932,158,3,2,1,164
543156100,44,31,77,4,156
543157174,41,13,2,4,60
543157710,57,18,2,4,81
543159775,106,4,2,1,113
543184852,76,3,2,1,82
543205286,102,7,2,6,117
543227036,90,37,50,5,182
543235280,77,10,2,5,94
543236019,71,13,11,47,142
543242599,32,3,2,1,38
543247473,61,3,2,1,67
543252641,30,3,2,1,36
543263645,61,17,7,2,87
543271752,104,99,6,11,220
543276755,99,26,115,8,248
543295910,126,5,6,8,145
543315799,288,3,2,19,312
543316147,27,3,2,7,39
543338703,42,3,4,1,50
543340970,19,3,2,1,25
543342221,216,44,60,73,393
543343073,10,8,2,1,21
543351831,23,13,4,1,41
543355851,15,15,14,1,45
543358704,67,28,8,1,104
543359831,57,16,7,10,90
543370134,67,12,2,1,82
543374157,84,3,2,2,91
543376868,55,33,2,1,91
543383402,163,3,2,1,169
543399296,100,17,57,1,175
543401465,221,33,56,12,322
543416908,38,18,18,34,108
543479559,71,4,2,10,87
543480259,24,6,73,2,105
543491619,44,23,2,1,70
543498073,141,37,107,28,313
543512111,21,3,2,2,28
543513081,100,37,154,2,293
543519468,103,24,22,30,179
543534956,62,23,31,11,127
543545155,29,25,4,8,66
543550825,19,25,2,2,48
543554399,158,3,2,16,179
543587321,38,20,10,2,70
543595161,106,36,51,39,232
543615767,14,3,2,1,20
543617219,86,14,100,1,201
543617295,53,44,69,12,178
543633627,35,17,15,18,85
543648174,22,3,2,1,28
543657558,16,7,2,1,26
543674226,170,11,2,1,184
543676746,64,15,5,12,96
543693187,36,3,2,1,42
543711526,49,18,6,8,81
543733795,11,3,2,1,17
543746587,45,3,4,2,54
543766408,63,19,3,5,90
543775975,62,5,2,4,73
543783371,36,11,2,2,51
543789743,38,17,16,5,76
543815711,469,3,2,2,476
543817041,141,34,2,15,192
543833495,36,24,2,3,65
543835218,12,3,2,1,18
543836162,31,28,2,1,62
543840249,99,4,2,1,106
543842219,23,3,2,7,35
543843876,409,3,2,3,417
543845730,36,6,20,1,63
543849185,144,3,2,5,154
543855387,127,18,15,16,176
543864278,12,3,2,1,18
543872308,54,4,2,4,64
543878829,33,88,3,4,128
543904206,94,28,49,8,179
543904728,21,54,5,43,123
543910363,43,3,2,2,50
543918574,85,44,9,60,198
543919440,28,7,2,1,38
543924783,35,3,2,7,47
543930016,75,3,2,1,81
543931949,113,14,2,3,132
543945544,118,43,91,16,268
543951831,12,5,2,3,22
543960138,58,114,17,3,192
543964896,14,3,2,1,20
543970332,82,31,27,3,143
543974376,11,3,2,1,17
543982615,97,31,130,12,270
543990612,31,5,3,1,40
543993835,49,22,71,2,144
544005446,39,4,28,10,81
544015010,426,116,29,8,579
544018973,63,14,3,7,87
544024631,47,57,103,9,216
544035203,25,19,10,2,56
544048421,66,13,29,1,109
544050557,158,24,43,73,298
544064353,15,3,2,1,21
544077200,12,3,2,1,18
544081195,147,3,2,1,153
544108604,14,3,2,1,20
544118620,96,20,13,9,138
544121083,23,3,2,2,30
544129112,78,10,2,8,98
544135367,33,58,104,6,201
544151406,11,3,2,1,17
544160483,23,3,2,1,29
544176730,12,10,2,1,25
544179531,87,9,29,14,139
544180653,94,38,34,1,167
544199764,27,3,2,1,33
544200331,63,3,2,9,77
544215455,11,3,2,2,18
544228376,280,15,2,1,298
544230057,12,3,2,8,25
544240006,88,6,3,1,98
544240984,64,77,2,20,163
544245431,15,56,2,1,74
544246916,64,26,14,2,106
544248689,38,38,5,4,85
544258928,21,10,5,1,37
544262927,166,3,2,11,182
544264836,72,24,31,3,130
544285050,204,25,119,22,370
544287805,36,13,23,3,75
544289931,31,19,2,1,53
544304247,19,11,3,1,34
544315672,50,29,2,4,85
544317994,17,3,2,1,23
544331025,30,21,2,3,56
544349422,17,6,2,2,27
544356332,56,5,2,1,64
544360064,35,3,2,2,42
544368782,41,19,5,113,178
544380189,10,6,2,1,19
544380907,61,3,2,1,67
544407198,64,45,19,4,132
544410473,27,3,2,1,33
544412285,39,15,2,8,64
544413841,86,59,29,31,205
544414555,71,83,59,16,229
544420524,173,34,42,13,262
544428247,82,41,18,15,156
544428948,117,24,11,1,153
544433664,33,50,6,9,98
544448795,13,18,2,3,36
544450274,75,3,2,6,86
544454019,21,3,2,4,30
544456564,127,3,2,2,134
544459307,100,28,51,19,198
544468594,118,25,4,106,253
544483308,117,8,2,10,137
544495569,19,54,5,13,91
544503480,29,55,2,1,87
544527236,43,3,2,2,50
544527622,81,3,2,1,87
544527652,95,26,2,6,129
544529584,14,10,2,1,27
544534765,39,50,2,2,93
544541204,27,70,3,34,134
544549204,15,6,2,1,24
544556085,20,4,2,1,27
544564056,23,3,2,1,29
544574101,121,28,2,3,154
544576756,191,26,2,29,248
544578209,67,30,2,5,104
544581936,70,7,50,7,134
544581956,27,3,2,1,33
544584719,35,26,27,8,96
544585260,34,34,2,1,71
544603343,432,3,2,34,471
544615373,91,10,24,5,130
544619103,191,14,3,23,231
544650984,44,15,2,2,63
544658622,16,8,2,1,27
544665376,108,3,2,3,116
544669214,45,45,15,51,156
544678405,95,53,14,5,167
544678999,31,23,123,1,178
544693871,29,81,2,1,113
544694203,23,10,2,13,48
544697517,97,19,7,1,124
544740211,10,4,2,1,17
544742736,33,24,37,5,99
544753483,30,23,2,4,59
544754149,51,43,29,1,124
544778887,79,12,2,11,104
544780637,34,3,2,5,44
544806329,89,4,2,1,96
544812195,115,21,2,1,139
544814528,36,16,4,9,65
544820637,49,3,2,1,55
544827834,273,5,2,20,300
544830125,122,16,85,9,232
544835392,35,3,7,1,46
544857648,10,3,2,2,17
544867238,17,6,3,2,28
544872157,27,3,2,1,33
544883674,68,4,5,1,78
544909735,86,3,2,2,93
544921486,283,3,2,2,290
544973169,41,3,2,7,53
544974423,166,14,11,1,192
544979984,92,60,2,2,156
544985729,44,4,10,1,59
544998708,62,63,10,41,176
545001616,33,4,29,13,79
545009339,116,29,18,4,167
545015911,84,10,2,2,98
545026788,39,3,2,1,45
545027301,76,9,21,8,114
545045895,148,16,48,2,214
545069799,53,3,2,2,60
545078445,98,8,2,4,112
545078649,204,42,23,1,270
545079068,10,7,2,1,20
545103385,77,8,43,1,129
545109106,27,21,10,1,59
545112942,15,4,2,2,23
545128236,22,22,2,1,47
545142300,55,11,3,1,70
545149553,10,8,2,1,21
545155617,247,6,2,8,263
545155895,66,77,25,2,170
545173459,16,10,2,1,29
545193177,73,18,8,1,100
545194364,73,17,23,3,116
545198012,21,6,2,1,30
545214877,48,14,3,2,67
545233540,88,52,16,7,163
545234790,168,3,2,1,174
545241425,20,3,2,1,26
545247101,130,33,57,4,224
545247329,61,30,44,14,149
545260509,45,30,21,1,97
545263680,50,44,24,7,125
545263910,37,3,2,1,43
545284750,94,49,2,2,147
545288585,141,3,2,3,149
545294311,69,18,70,1,158
545298385,12,9,2,1,24
545307439,45,8,2,1,56
545319094,40,13,28,2,83
545330497,43,3,2,1,49
545354916,10,11,2,1,24
545362301,34,16,2,1,53
545365938,19,30,2,4,55
545380263,147,16,2,1,166
545387083,18,3,2,1,24
545387925,76,29,28,12,145
545392028,60,3,3,1,67
545408617,10,107,18,1,136
545420578,128,3,2,1,134
545436091,11,3,2,1,17
545436893,32,26,44,1,103
545443855,10,12,2,1,25
545450827,10,3,2,2,17
545452439,11,3,2,1,17
545457290,46,3,2,1,52
545459861,211,10,13,5,239
545464899,96,14,39,14,163
545466307,11,17,2,1,31
545491958,12,3,2,1,18
545501628,90,3,2,1,96
545501870,63,31,6,2,102
545503049,181,22,13,7,223
545504136,63,23,2,2,90
545505303,82,3,2,2,89
545531416,83,28,11,15,137
545532042,10,24,3,3,40
545535267,55,66,67,38,226
545571454,61,14,2,1,78
545574909,12,3,2,4,21
545577368,13,10,2,1,26
545644919,68,24,13,4,109
545647322,47,33,20,3,103
545658615,141,29,2,1,173
545660386,25,38,6,1,70
545665569,43,36,11,1,91
545667591,22,24,3,1,50
545667914,10,3,2,2,17
545671219,10,13,2,1,26
545671887,13,3,2,1,19
545676060,159,9,2,3,173
545685339,93,26,81,3,203
545686088,64,12,28,1,105
545686758,57,3,2,1,63
545690579,103,18,55,6,182
545691343,71,3,2,1,77
545710134,13,3,2,1,19
545715875,42,24,2,1,69
545733253,10,4,2,1,17
545741939,65,3,2,5,75
545746813,74,3,2,2,81
545758083,68,74,43,9,194
545762108,35,40,6,5,86
545768058,63,62,18,45,188
545774195,32,3,2,1,38
545802140,10,3,2,2,17
545813010,24,8,2,1,35
545831623,26,3,2,1,32
545832513,18,56,2,1,77
545856944,21,3,2,2,28
545857697,94,30,17,16,157
545864594,98,37,53,2,190
545876982,22,4,2,19,47
545885484,117,29,2,6,154
545892572,77,14,4,1,96
545894634,173,56,5,5,239
545903366,99,6,2,5,112
545906339,50,3,2,1,56
545908134,15,43,2,1,61
545911640,43,26,7,11,87
545915807,146,9,42,1,198
545921874,27,33,7,7,74
545933469,13,47,2,1,63
545965279,105,14,2,3,124
545970700,84,9,2,3,98
545980118,28,3,2,1,34
545983834,204,24,26,9,263
545992944,161,3,2,7,173
545999824,103,18,6,32,159
546000293,44,9,2,16,71
546004035,12,5,2,1,20
546016177,68,58,2,3,131
546027799,69,55,6,9,139
546066331,12,27,4,4,47
546069057,18,3,2,3,26
546075076,45,3,2,1,51
546091194,10,10,2,1,23
546091461,19,3,2,1,25
546092941,12,3,2,1,18
546094653,10,14,3,2,29
546103584,106,3,2,1,112
546103943,11,3,2,1,17
546104243,37,9,2,1,49
546107170,179,3,2,1,185
546109434,94,68,70,19,251
546115765,17,25,2,5,49
546129635,76,9,7,7,99
546148819,15,41,2,1,59
546169509,74,5,2,1,82
546180981,100,3,2,3,108
546181933,30,3,2,3,38
546182364,18,17,3,1,39
546191427,56,3,2,1,62
546203204,53,3,2,1,59
546203313,54,9,11,1,75
546217499,46,15,43,7,111
546220209,32,3,2,2,39
546240134,307,3,2,18,330
546244943,28,19,7,7,61
546245177,50,24,8,9,91
546249803,62,26,12,5,105
546254213,54,4,4,1,63
546268333,49,39,2,31,121
546284742,105,21,59,3,188
546287358,27,26,40,3,96
546293878,93,18,6,2,119
546324515,64,8,3,2,77
546334217,206,15,2,8,231
546334480,10,34,2,1,47
546341743,28,15,6,1,50
546351054,126,3,2,6,137
546384068,22,34,21,27,104
546404864,53,3,2,1,59
546405457,111,3,2,6,122
546419140,115,3,2,1,121
546434506,90,22,2,10,124
546438089,195,29,3,3,230
546438112,35,3,2,1,41
546438293,108,3,2,47,160
546443759,41,3,2,1,47
546443885,14,7,2,3,26
546444044,53,3,2,1,59
546471032,39,11,2,1,53
546477181,46,15,34,2,97
546493354,18,39,2,3,62
546493912,81,14,16,1,112
546500778,14,3,2,1,20
546505905,20,27,2,2,51
546512692,20,4,2,1,27
546528004,88,3,2,2,95
546538139,22,30,15,2,69
546549031,164,63,3,2,232
546557321,75,29,2,1,107
546566609,84,33,5,5,127
546570507,46,3,2,3,54
546591127,20,3,2,1,26
546608308,41,3,2,1,47
546613110,14,22,2,6,44
546618730,49,95,2,5,151
546629517,101,5,10,6,122
546657093,60,53,2,66,181
546660670,24,10,3,1,38
546675900,11,8,2,1,22
546687128,87,3,2,10,102
546687985,100,72,2,1,175
546693550,56,23,27,15,121
546695424,74,5,5,1,85
546710332,39,3,2,1,45
546711345,111,3,2,2,118
546726837,92,25,2,10,129
546728490,62,46,4,14,126
546738890,11,3,2,1,17
546778868,65,3,2,1,71
546781669,80,24,37,5,146
546783025,33,44,47,1,125
546787991,63,5,62,5,135
546792106,33,3,2,1,39
546808451,797,3,2,5,807
546815257,128,31,2,2,163
546825344,61,53,8,39,161
546826357,10,3,2,3,18
546833969,94,31,48,7,180
546843155,28,20,41,3,92
546873217,69,36,2,5,112
546880017,124,16,3,9,152
546882621,26,3,2,1,32
546896776,98,3,2,1,104
546903536,36,3,50,5,94
546908009,10,10,2,1,23
546928219,148,10,10,1,169
546928968,94,7,2,1,104
546952578,58,15,41,1,115
546963036,14,12,2,1,29
546974581,17,10,2,2,31
546989697,127,3,2,1,133
546990596,22,71,17,3,113
546991079,11,6,2,1,20
547015082,85,19,55,2,161
547031028,150,41,2,6,199
547044090,179,48,27,3,257
547049979,59,3,2,1,65
547054292,127,12,27,1,167
547054837,45,12,2,2,61
547069819,35,8,4,6,53
547083309,118,22,2,2,144
547099480,76,20,26,12,134
547102345,67,43,6,15,131
547117783,21,31,2,1,55
547120197,18,11,2,3,34
547126378,56,13,2,2,73
547127529,11,3,2,4,20
547136798,290,3,2,3,298
547160444,101,7,36,2,146
547161211,62,25,2,1,90
547164524,14,3,2,2,21
547170290,122,3,2,4,131
547213378,19,7,2,4,32
547217891,54,29,35,27,145
547222606,21,34,2,1,58
547226823,80,3,2,6,91
547230993,62,42,11,29,144
547234749,19,9,2,1,31
547243816,38,25,19,5,87
547247832,14,51,2,4,71
547274653,66,47,2,1,116
547278420,69,86,123,6,284
547289133,85,22,5,2,114
547292799,46,18,2,1,67
547306966,11,8,2,1,22
547308961,56,126,11,1,194
547317258,38,45,7,6,96
547324393,125,21,3,20,169
547326204,127,14,2,9,152
547329273,13,11,2,1,27
547346205,12,3,2,1,18
547346296,1074,3,2,25,1104
547362059,14,27,2,1,44
547362168,12,30,5,1,48
547372415,74,3,2,9,88
547379975,16,6,2,1,25
547381735,70,26,38,1,135
547409463,32,7,15,8,62
547412997,32,57,2,25,116
547422027,76,8,9,11,104
547440311,10,8,2,1,21
547470573,24,51,2,4,81
547479535,13,3,2,1,19
547482604,44,53,2,1,100
547493934,35,12,27,1,75
547504057,90,3,2,1,96
547508811,37,3,2,1,43
547515334,98,14,2,1,115
547519417,12,3,2,1,18
547522293,53,3,2,1,59
547545809,38,33,4,6,81
547553771,30,42,55,13,140
547560153,15,27,2,1,45
547588873,67,27,12,3,109
547599829,115,58,24,1,198
547605159,41,31,2,8,82
547614291,61,66,12,12,151
547626566,293,3,2,2,300
547628526,12,3,2,1,18
547629071,111,54,22,29,216
547634478,84,25,2,13,124
547636015,71,3,2,1,77
547637232,21,3,2,1,27
547653384,72,93,69,31,265
547664402,37,3,2,1,43
547671391,18,42,2,9,71
547676337,12,3,2,1,18
547688115,67,3,2,1,73
547689305,61,23,3,7,94
547693949,67,21,43,1,132
547698737,27,8,4,1,40
547699800,37,10,2,3,52
547700454,52,22,42,14,130
547712608,67,15,7,1,90
547741467,94,38,45,14,191
547750579,58,59,2,2,121
547783261,26,34,38,81,179
547789711,150,4,4,7,165
547790136,79,3,2,1,85
547802603,11,20,2,5,38
547808324,23,21,3,3,50
547816120,243,3,2,15,263
547816432,78,3,2,18,101
547823035,16,5,2,2,25
547824105,10,3,2,2,17
547827368,58,3,2,1,64
547837420,39,6,11,7,63
547842222,42,7,3,3,55
547846146,68,28,2,3,101
547848304,19,8,2,4,33
547861493,97,34,25,4,160
547875349,103,9,40,1,153
547875541,21,3,2,1,27
547890372,79,3,2,1,85
547892829,155,24,6,1,186
547893422,138,18,2,15,173
547896367,20,3,2,1,26
547902213,12,3,2,1,18
547904735,38,50,56,4,148
547907973,44,23,8,6,81
547908037,162,26,32,26,246
547912253,31,3,2,1,37
547914739,23,3,2,1,29
547918783,22,12,2,1,37
547927283,33,37,45,2,117
547930652,136,9,9,3,157
547954283,83,16,46,1,146
547960624,90,3,2,3,98
547963159,61,64,3,3,131
547971136,119,3,2,1,125
547974788,11,3,2,1,17
547979684,12,3,2,1,18
547982056,84,12,2,4,102
547989154,181,10,10,3,204
547990266,50,6,3,10,69
547995881,34,3,2,2,41
548000917,110,3,2,3,118
548003546,124,16,16,5,161
548006268,78,42,4,1,125
548031235,21,11,3,1,36
548032196,134,6,4,1,145
548041425,140,64,26,7,237
548049523,38,15,63,9,125
548052762,10,7,2,1,20
548052808,121,36,12,6,175
548056973,67,5,2,1,75
548062508,118,18,3,16,155
548066254,34,21,25,4,84
548073911,215,4,2,1,222
548076394,136,26,3,1,166
548078452,14,63,14,3,94
548079042,24,3,2,1,30
548080758,86,15,50,57,208
548086537,20,19,2,3,44
548089264,121,3,2,2,128
548114442,117,11,5,1,134
548118140,12,48,2,1,63
548140514,98,90,6,6,200
548146965,62,3,2,1,68
548154160,40,3,2,1,46
548167465,58,31,7,16,112
548176676,37,3,2,1,43
548184540,35,52,38,1,126
548191828,146,3,2,2,153
548195001,69,11,9,1,90
548202188,80,16,74,3,173
548227543,14,16,2,1,33
548239249,44,13,11,3,71
548246621,94,35,22,5,156
548247312,97,3,2,3,105
548247817,59,3,2,1,65
548253546,10,3,2,2,17
548256523,14,3,2,1,20
548259428,39,19,50,4,112
548272800,21,9,2,2,34
548275462,16,3,2,1,22
548275807,70,21,4,7,102
548283506,32,3,2,1,38
548284154,11,3,2,1,17
548291417,49,3,2,1,55
548296494,81,36,4,2,123
548296629,11,3,2,1,17
548310666,55,3,2,5,65
548318899,34,11,9,7,61
548326724,79,3,2,3,87
548327706,86,23,2,10,121
548333241,53,3,2,1,59
548334239,25,6,3,1,35
548356290,80,22,6,10,118
548357620,172,3,2,6,183
548365171,36,22,2,1,61
548371528,96,30,15,7,148
548375648,131,40,36,3,210
548382470,22,3,2,1,28
548388729,51,3,2,4,60
548393753,11,3,2,2,18
548394863,28,3,2,1,34
548400276,59,56,12,13,140
548402091,19,19,2,29,69
548410509,29,13,2,1,45
548455595,61,9,11,27,108
548460467,32,20,47,5,104
548473975,14,11,2,2,29
548478034,53,22,73,4,152
548484704,56,72,30,26,184
548496917,132,7,15,1,155
548505539,170,35,6,14,225
548506143,95,45,5,2,147
548515576,33,9,2,1,45
548516405,11,52,2,1,66
548520073,74,3,2,2,81
548522801,17,35,2,1,55
548542332,20,3,2,1,26
548549245,104,24,20,11,159
548566466,30,10,28,17,85
548568525,62,62,31,3,158
548570102,27,8,7,3,45
548574144,191,59,83,40,373
548577448,11,3,2,1,17
548579902,112,3,2,7,124
548587232,21,11,25,1,58
548598695,173,25,7,2,207
548601478,168,27,2,27,224
548607777,53,56,3,18,130
548614883,12,3,2,1,18
548618255,183,19,2,15,219
548620309,119,3,2,4,128
548633183,40,8,6,1,55
548637769,80,22,40,1,143
548641281,26,17,2,7,52
548658404,27,14,5,5,51
548661520,73,8,2,5,88
548662301,118,22,114,1,255
548678155,63,82,19,66,230
548685766,13,3,2,7,25
548697382,65,3,2,1,71
548705519,40,29,13,1,83
548706564,103,18,17,5,143
548707271,67,3,2,17,89
548707822,89,30,22,1,142
548710545,10,3,110,1,124
548713000,19,3,2,1,25
548717926,13,3,2,3,21
548722571,46,13,20,2,81
548727002,63,82,2,17,164
548729574,26,31,33,10,100
548733617,125,34,5,4,168
548738479,107,3,2,4,116
548748949,70,14,11,7,102
548759327,147,29,2,3,181
548761916,155,18,2,34,209
548771415,252,3,2,2,259
548788504,24,3,2,1,30
548794078,65,17,2,1,85
548797846,147,122,27,26,322
548808887,85,67,25,22,199
548828844,178,46,7,21,252
548868725,135,68,23,60,286
548877184,146,22,12,14,194
548888068,13,3,2,1,19
548890570,60,20,23,2,105
548904167,47,32,3,3,85
548907578,12,3,2,1,18
548909511,107,34,116,32,289
548911455,65,61,18,2,146
548922723,19,24,2,3,48
548925731,67,59,2,9,137
548925857,63,9,13,15,100
548926122,29,3,2,3,37
548935361,33,3,2,1,39
548964426,18,12,8,1,39
548974877,78,51,57,9,195
548976288,133,3,49,7,192
548979542,12,3,2,1,18
548988609,79,3,2,1,85
548995480,22,5,2,1,30
548995811,91,24,2,6,123
549009337,18,5,3,6,32
549012682,26,16,2,2,46
549024419,46,91,30,6,173
549033233,84,3,2,7,96
549054545,173,28,2,2,205
549055566,20,3,2,1,26
549059278,51,62,3,2,118
549066666,55,23,34,1,113
549068458,79,28,35,7,149
549071496,102,8,47,5,162
549073441,20,33,5,3,61
549084442,223,42,150,6,421
549093119,94,55,180,5,334
549095654,31,3,2,1,37
549105981,73,39,2,5,119
549125130,83,3,2,1,89
549136843,175,15,2,2,194
549140549,45,29,3,5,82
549145482,54,5,42,1,102
549146567,43,13,5,3,64
549148655,99,37,34,64,234
549157265,37,11,18,10,76
549170581,239,74,2,12,327
549171624,64,116,7,2,189
549206531,71,9,11,1,92
549216222,15,3,2,1,21
549225939,127,71,107,18,323
549240323,68,19,27,1,115
549242743,72,11,2,1,86
549243883,52,37,13,19,121
549262838,71,3,2,17,93
549268352,180,54,3,19,256
549278610,99,14,26,1,140
549287417,46,11,2,3,62
549306706,76,44,14,8,142
549308507,23,3,2,4,32
549308940,97,3,3,1,104
549316901,107,3,2,1,113
549363446,16,34,10,1,61
549376535,44,27,4,10,85
549378086,92,25,10,14,141
549379723,62,20,2,1,85
549432444,53,19,5,6,83
549446564,13,3,2,1,19
549451828,44,65,2,11,122
549453025,47,6,2,1,56
549453137,48,3,2,1,54
549457246,22,3,2,1,28
549466482,119,3,66,1,189
549480871,13,3,2,1,19
549496576,26,13,2,3,44
549498577,107,3,2,6,118
549506981,49,44,6,41,140
549508236,10,3,2,2,17
549543700,34,5,2,4,45
549552503,20,3,2,1,26
549554780,28,106,23,3,160
549555299,39,20,2,1,62
549565666,111,28,69,5,213
549572205,30,57,5,1,93
549574512,44,15,46,2,107
549587056,99,19,22,10,150
549592085,86,4,5,6,101
549602463,11,7,2,1,21
549603760,167,3,2,4,176
549605245,70,3,2,1,76
549620124,50,14,2,14,80
549628157,13,3,2,1,19
549629579,77,36,2,4,119
549631342,111,12,2,2,127
549637010,119,66,52,55,292
549648824,36,9,12,16,73
549649704,122,38,33,18,211
549657143,146,63,47,61,317
549663900,41,6,3,11,61
549673799,30,28,41,8,107
549680159,653,3,2,35,693
549685112,64,59,4,6,133
549694042,11,3,2,1,17
549694200,51,61,9,4,125
549699754,42,20,24,1,87
549703541,175,19,14,2,210
549713999,44,9,2,37,92
549714618,10,3,4,1,18
549720053,97,53,12,1,163
549728307,31,3,2,1,37
549730262,39,45,17,7,108
549738424,91,3,4,1,99
549751722,11,3,2,1,17
549754438,11,3,2,1,17
549754903,241,3,2,7,253
549757834,71,49,2,17,139
549785131,71,30,13,4,118
549790981,72,55,29,2,158
549798606,129,13,17,57,216
549802722,23,16,4,2,45
549810820,48,25,2,19,94
549814168,124,3,2,2,131
549831157,10,4,2,1,17
549841687,61,3,2,1,67
549863725,23,9,3,1,36
549871383,10,6,2,1,19
549892487,25,5,10,10,50
549900165,117,6,5,13,141
549907746,23,28,3,1,55
549914785,153,32,5,26,216
549916431,96,38,28,2,164
549918552,87,26,16,6,135
549924226,51,43,8,1,103
549939215,53,9,18,7,87
549945209,95,3,2,1,101
549946511,10,4,2,1,17
549977302,158,21,25,20,224
549977480,53,15,12,2,82
549992003,44,15,2,1,62
549994489,13,3,2,3,21
549998431,81,13,2,5,101
549999688,10,3,3,1,17
550000288,110,3,13,2,128
550013236,44,21,2,10,77
550020539,169,45,3,2,219
550021231,127,3,2,49,181
550029706,25,10,2,1,38
550036039,14,36,7,2,59
550042999,33,10,2,4,49
550064419,12,3,2,1,18
550064506,86,42,2,17,147
550076763,72,3,2,14,91
550086276,185,8,33,1,227
550086497,81,3,2,1,87
550094341,64,3,2,1,70
550098752,31,3,2,3,39
550105177,12,3,2,1,18
550124029,98,39,131,1,269
550126363,26,19,6,4,55
550131198,58,25,3,1,87
550132216,27,6,2,1,36
550135184,108,79,50,6,243
550151981,94,3,2,1,100
550152345,19,3,2,1,25
550173281,33,9,7,2,51
550179311,136,35,2,1,174
550186819,66,3,2,1,72
550198102,20,24,5,2,51
550208860,31,42,2,1,76
550230019,79,14,62,1,156
550236810,77,18,2,4,101
550247295,111,48,3,5,167
550253987,23,4,2,3,32
550273307,38,3,2,1,44
550289131,138,19,2,1,160
550301675,19,3,2,1,25
550304923,106,23,3,12,144
550324662,120,5,2,4,131
550336478,42,3,2,1,48
550337109,134,15,3,3,155
550355048,161,62,111,3,337
550357981,32,11,45,2,90
550360898,155,18,8,4,185
550364096,75,15,2,7,99
550368861,17,3,2,4,26
550380660,66,3,2,1,72
550394531,85,78,119,11,293
550400001,10,4,2,1,17
550412199,378,6,2,1,387
550413600,51,9,2,1,63
550416230,46,34,2,1,83
550422129,20,12,2,1,35
550424547,220,15,7,4,246
550480509,51,44,2,1,98
550485486,44,70,5,5,124
550503943,20,43,2,1,66
550507535,19,3,2,1,25
550524006,204,28,2,19,253
550529027,15,17,2,1,35
550537304,46,26,64,19,155
550541977,60,15,10,1,86
550547346,49,15,9,9,82
550558249,24,30,2,1,57
550568099,77,3,2,7,89
550574934,19,13,11,1,44
550583812,28,3,2,4,37
550586985,49,25,23,8,105
550590553,98,3,2,1,104
550598232,39,27,2,1,69
550602956,117,20,76,1,214
550608758,57,3,2,4,66
550609930,76,13,12,1,102
550625334,10,8,4,2,24
550632168,110,12,9,25,156
550645771,92,39,11,45,187
550658487,73,31,3,1,108
550659980,82,3,2,1,88
550688894,179,72,2,12,265
550703921,183,3,2,53,241
550713737,33,6,2,3,44
550729912,57,58,62,1,178
550742836,34,3,4,1,42
550743088,28,17,2,4,51
550757139,19,31,3,1,54
550768009,55,17,2,1,75
550777890,15,3,2,1,21
550782731,79,34,6,18,137
550795064,85,40,20,33,178
550802113,67,27,2,1,97
550808290,24,18,5,5,52
550811464,95,6,5,1,107
550826593,12,3,2,1,18
550830900,10,3,2,12,27
550832392,31,15,2,1,49
550838480,47,3,2,1,53
550839732,44,3,2,1,50
550843057,96,45,4,1,146
550849301,70,3,3,33,109
550884269,71,8,2,1,82
550896207,17,3,2,2,24
550897124,112,33,146,5,296
550904876,99,39,13,13,164
550905853,20,49,28,4,101
550916724,37,44,38,10,129
550924028,55,25,2,10,92
550925310,89,22,5,1,117
550932457,136,3,70,3,212
550951388,75,3,2,1,81
550956477,117,3,2,3,125
550956797,11,3,2,1,17
550963196,10,3,3,1,17
550963739,41,37,2,2,82
550979448,10,3,2,4,19
550979463,86,51,4,14,155
550981492,73,12,16,5,106
550983017,146,3,2,71,222
551007354,66,11,2,10,89
551055739,158,61,72,5,296
551072720,208,3,2,1,214
551075063,107,9,2,6,124
551076240,95,20,92,2,209
551086604,18,5,2,2,27
551092781,57,3,2,2,64
551101102,89,3,2,1,95
551115131,56,3,2,1,62
551136820,13,3,2,7,25
551136908,14,5,2,2,23
551136973,76,25,47,3,151
551180705,12,3,2,1,18
551212242,22,3,2,1,28
551214885,51,19,2,1,73
551222231,10,8,2,1,21
551253174,149,14,5,17,185
551253617,43,152,10,5,210
551262823,61,8,2,14,85
551263403,10,3,2,12,27
551267134,147,3,2,3,155
551275408,43,3,2,3,51
551303549,20,3,2,1,26
551305278,107,9,15,1,132
551322587,152,54,75,35,316
551325543,163,38,105,1,307
551328815,21,27,4,5,57
551335901,687,3,2,58,750
551357573,14,3,2,1,20
551357708,10,4,2,1,17
551367074,140,3,2,6,151
551376260,87,37,33,4,161
551376513,12,9,2,6,29
551390398,57,9,2,2,70
551391326,18,3,2,1,24
551396339,12,3,2,1,18
551403045,86,3,2,1,92
551420255,131,14,54,5,204
551420807,101,5,6,11,123
551435004,85,13,2,3,103
551441668,93,10,2,3,108
551444086,29,21,13,1,64
551447420,16,3,2,1,22
551449805,21,59,3,1,84
551470381,65,79,24,35,203
551475355,36,3,2,1,42
551476478,62,12,3,16,93
551481139,65,12,11,18,106
551486017,42,3,19,1,65
551501734,78,30,2,1,111
551503469,144,5,10,10,169
551512523,12,16,8,1,37
551518949,11,3,2,1,17
551539658,92,55,6,52,205
551543756,93,10,41,4,148
551559340,32,41,3,7,83
551566668,98,5,2,1,106
551576867,12,6,2,1,21
551578176,30,3,2,3,38
551580543,55,29,111,2,197
551581166,125,10,4,3,142
551596330,26,25,10,3,64
551604047,63,11,2,11,87
551609905,81,35,57,12,185
551626383,250,25,2,2,279
551632489,210,32,27,1,270
551650592,35,41,2,1,79
551652647,128,10,40,2,180
551660939,18,35,2,1,56
551669604,104,18,2,1,125
551675672,72,3,2,1,78
551680189,85,22,14,10,131
551700951,39,29,2,1,71
551701512,10,8,2,2,22
551703040,27,11,2,2,42
551707551,137,3,2,1,143
551721706,28,31,17,12,88
551738033,66,3,2,1,72
551758963,44,14,4,1,63
551777629,19,3,2,4,28
551777946,29,3,2,1,35
551779766,377,60,114,10,561
551805742,10,5,2,1,18
551806617,17,3,2,2,24
551807715,43,12,6,15,76
551827004,116,55,2,19,192
551843301,98,3,2,1,104
551844217,96,38,72,5,211
551846066,24,5,2,6,37
551850387,82,9,2,2,95
551854251,105,30,37,9,181
551864596,22,23,18,1,64
551867195,66,3,2,2,73
551872937,48,3,2,1,54
551894101,100,7,3,9,119
551905425,94,3,2,1,100
551906163,13,3,2,1,19
551906222,37,3,2,2,44
551923266,17,5,2,1,25
551926513,18,3,2,1,24
551930080,48,33,4,9,94
551933466,56,3,29,8,96
551938738,118,12,2,7,139
551939599,84,73,19,23,199
551940588,71,6,2,1,80
551943067,109,29,7,3,148
551943609,74,18,2,2,96
551973677,85,24,13,4,126
551974760,13,3,2,1,19
551997367,45,24,3,2,74
552005391,10,16,2,1,29
552011762,20,9,2,2,33
552013533,122,36,2,1,161
552015353,96,36,18,14,164
552024324,140,3,2,37,182
552026133,32,86,11,9,138
552027817,71,47,30,5,153
552036013,62,3,2,1,68
552047367,26,10,13,20,69
552054105,14,16,2,1,33
552062896,11,4,2,1,18
552070085,12,110,2,3,127
552072034,141,28,3,31,203
552086971,92,21,40,4,157
552088829,16,3,2,1,22
552097316,14,6,2,1,23
552111344,71,53,13,7,144
552111937,141,32,4,7,184
552116566,113,28,34,4,179
552123949,83,9,4,7,103
552136706,29,3,2,2,36
552147206,12,6,2,1,21
552151804,51,3,2,2,58
552152555,16,25,2,1,44
552156842,75,7,9,1,92
552166560,47,15,26,23,111
552173535,85,21,3,12,121
552188718,82,21,2,16,121
552193069,16,15,2,6,39
552202947,159,12,88,4,263
552206334,11,3,2,1,17
552217164,48,30,5,4,87
552220298,121,10,4,41,176
552233479,98,3,2,1,104
552238330,34,3,2,2,41
552253587,95,13,15,2,125
552260956,39,35,25,12,111
552266457,33,25,40,13,111
552275243,76,3,5,4,88
552282732,64,3,2,1,70
552283994,63,10,2,1,76
552287807,142,5,8,23,178
552299795,31,56,39,1,127
552305448,110,3,2,2,117
552313275,69,19,142,8,238
552320177,41,29,80,2,152
552323108,13,3,2,1,19
552327458,98,15,2,3,118
552329588,10,3,2,2,17
552331793,132,3,2,1,138
552338813,34,3,2,4,43
552339541,97,3,2,1,103
552342649,24,3,2,1,30
552349840,13,3,2,1,19
552356323,164,19,86,57,326
552359878,46,21,2,22,91
552360873,88,20,61,18,187
552362803,119,3,2,14,138
552369098,41,3,2,1,47
552377064,74,48,2,3,127
552384089,11,5,12,4,32
552399801,35,28,17,26,106
552405686,81,20,17,3,121
552417764,102,33,28,1,164
552432188,56,3,2,1,62
552449635,45,3,2,3,53
552450468,81,3,2,1,87
552452128,16,3,2,1,22
552485904,82,46,45,3,176
552490693,114,43,24,20,201
552493239,19,3,2,1,25
552498758,96,15,84,17,212
552509094,125,3,56,14,198
552522462,24,16,2,1,43
552523015,48,18,2,5,73
552523796,61,3,2,2,68
552529128,40,64,2,1,107
552529923,20,21,23,3,67
552536054,24,39,9,6,78
552543374,27,3,2,5,37
552554552,101,3,2,6,112
552555150,22,3,2,2,29
552589791,86,7,3,106,202
552602237,11,3,2,1,17
552610341,98,13,30,25,166
552624211,26,3,2,6,37
552627473,103,3,2,1,109
552643274,130,39,92,17,278
552664737,12,3,2,1,18
552674485,57,29,2,1,89
552688921,31,35,5,30,101
552689936,44,3,2,1,50
552704886,59,36,3,4,102
552709706,22,3,2,1,28
552714362,40,3,2,1,46
552720527,43,46,2,3,94
552734921,53,4,8,1,66
552735299,81,21,44,72,218
552769379,326,3,2,2,333
552806236,26,60,20,3,109
552808933,13,14,2,1,30
552821493,10,8,2,1,21
552830553,20,8,2,1,31
552837484,67,31,9,5,112
552846488,16,47,6,2,71
552849017,132,3,2,2,139
552858803,31,9,2,5,47
552883362,10,5,2,1,18
552894276,18,4,4,1,27
552908470,10,6,2,1,19
552912974,64,22,2,1,89
552927019,44,3,2,1,50
552938972,80,11,27,1,119
552947356,13,26,2,1,42
552965512,64,40,2,2,108
552971307,50,20,56,2,128
552996484,109,52,10,3,174
553000729,44,38,2,2,86
553004265,47,16,5,14,82
553008269,145,72,2,1,220
553013429,43,23,2,1,69
553043158,45,27,36,2,110
553056645,39,3,2,1,45
553086612,31,3,2,1,37
553098073,36,53,30,11,130
553105986,31,27,19,1,78
553116540,88,12,14,1,115
553128698,32,3,2,2,39
553129995,107,33,45,42,227
553131372,100,3,2,4,109
553135615,16,24,2,1,43
553139448,82,23,3,1,109
553141703,43,25,2,13,83
553144131,62,3,2,3,70
553148566,49,4,2,21,76
553171440,13,16,4,1,34
553184596,136,73,2,14,225
553193817,17,3,2,1,23
553193932,39,48,2,21,110
553206087,10,6,2,1,19
553208075,17,4,3,2,26
553222790,14,3,2,1,20
553235838,192,3,2,7,204
553240570,93,29,13,1,136
553241212,65,62,2,48,177
553252542,11,7,2,6,26
553255020,129,3,2,6,140
553257125,63,3,2,1,69
553265570,190,5,7,3,205
553279990,88,15,3,6,112
553290569,162,3,2,15,182
553308965,18,9,2,6,35
553310081,13,23,16,7,59
553313352,10,22,2,1,35
553314194,74,3,2,1,80
553323717,163,16,2,11,192
553326163,111,3,95,12,221
553326329,76,5,2,1,84
553330645,113,17,2,33,165
553332776,68,17,5,13,103
553353676,35,16,2,1,54
553379266,24,22,2,1,49
553380730,86,82,60,3,231
553384963,63,26,12,21,122
553390216,14,7,2,1,24
553390670,23,38,4,2,67
553399972,11,16,2,1,30
553413743,73,26,5,6,110
553418634,60,22,47,11,140
553419804,272,3,2,24,301
553422373,34,71,19,9,133
553431426,46,3,2,1,52
553451249,20,3,2,1,26
553451728,68,33,28,24,153
553458193,94,85,2,3,184
553467661,44,23,2,1,70
553470368,61,31,15,16,123
553473785,93,25,3,14,135
553477170,132,3,2,51,188
553478548,19,3,2,2,26
553485040,115,3,2,2,122
553489358,42,95,2,1,140
553515229,24,10,13,1,48
553517643,130,7,2,1,140
553520641,25,3,2,1,31
553535724,52,68,6,2,128
553566328,124,3,2,4,133
553567156,121,34,2,1,158
553576818,75,14,2,2,93
553577052,64,3,2,2,71
553596056,38,3,2,1,44
553611873,31,3,2,1,37
553625205,13,3,2,1,19
553640962,57,11,2,2,72
553645820,13,3,2,1,19
553660335,117,3,2,1,123
553672182,13,36,2,1,52
553675568,104,41,91,11,247
553679729,13,3,2,3,21
553684818,95,3,2,1,101
553692885,95,3,2,1,101
553704813,39,21,2,1,63
553717020,40,5,8,1,54
553721180,60,80,2,9,151
553721825,40,17,2,1,60
553729071,56,47,38,4,145
553751356,50,59,2,4,115
553761486,74,3,2,1,80
553762190,49,24,9,2,84
553777617,128,3,2,1,134
553811521,12,3,2,1,18
553822794,114,15,2,1,132
553823866,52,5,14,24,95
553825050,28,7,8,1,44
553861818,84,41,37,1,163
553869692,37,20,2,4,63
553874147,10,4,2,1,17
553891604,15,6,2,2,25
553920198,97,69,2,19,187
553921712,11,3,2,1,17
553923745,50,22,32,2,106
553931152,51,3,11,1,66
553941310,44,6,33,1,84
553944020,79,3,2,1,85
553944797,151,3,2,1,157
553964855,131,3,2,3,139
553998812,42,3,2,7,54
554000416,113,3,2,4,122
554024237,66,22,2,5,95
554044042,97,51,104,7,259
554048677,30,3,2,7,42
554051751,69,4,2,1,76
554076867,19,6,2,1,28
554078061,82,23,2,6,113
554090223,11,3,2,1,17
554091145,33,19,2,2,56
554103914,19,3,2,2,26
554108050,124,21,11,48,204
554129478,37,3,6,1,47
554139432,36,57,33,5,131
554141069,57,3,2,13,75
554177849,56,3,2,3,64
554199755,97,23,29,1,150
554201787,106,17,3,2,128
554208900,74,8,30,1,113
554225124,11,3,2,1,17
554226026,67,48,6,1,122
554228057,34,3,2,1,40
554233616,33,46,16,1,96
554237241,73,3,2,1,79
554238502,39,3,2,9,53
554251593,149,3,2,19,173
554268254,83,20,2,1,106
554273985,11,3,2,2,18
554305568,19,19,9,14,61
554305880,117,3,2,2,124
554306195,24,15,20,7,66
554317772,10,4,2,2,18
554324963,16,10,2,1,29
554329004,68,32,34,17,151
554338179,127,17,2,3,149
554343574,44,12,2,1,59
554352219,60,11,2,5,78
554368273,98,3,2,2,105
554374070,78,10,12,7,107
554383102,80,22,18,8,128
554383497,22,79,2,1,104
554393179,107,66,9,15,197
554416057,18,23,3,1,45
554451817,19,3,2,1,25
554453476,123,3,2,2,130
554467535,110,19,2,1,132
554468216,30,19,27,34,110
554473212,206,71,59,3,339
554476656,125,47,3,18,193
554501075,58,24,4,4,90
554504555,15,32,2,10,59
554512536,11,6,2,2,21
554528495,165,18,36,22,241
554533237,11,9,2,1,23
554533937,20,16,7,1,44
554537467,10,3,4,1,18
554541291,21,22,2,1,46
554552314,74,3,2,1,80
554555829,53,21,2,1,77
554566133,11,24,12,5,52
554568083,47,11,2,3,63
554573878,94,3,2,1,100
554589313,33,7,16,8,64
554594605,33,3,2,5,43
554602770,110,21,2,64,197
554604908,32,36,21,1,90
554626308,98,43,6,3,150
554637714,17,52,32,1,102
554652253,89,3,2,1,95
554657458,24,29,3,1,57
554674598,158,12,4,5,179
554681307,57,18,79,29,183
554688799,11,4,2,1,18
554698803,69,21,42,1,133
554699409,52,3,2,1,58
554708522,14,9,10,2,35
554713310,62,5,20,1,88
554715634,45,19,2,2,68
554718519,46,3,2,1,52
554718688,40,16,2,5,63
554721042,66,60,20,5,151
554726252,154,67,10,22,253
554735104,98,3,2,1,104
554757708,43,71,9,8,131
554759118,39,29,20,21,109
554771940,99,3,2,13,117
554773117,50,46,2,12,110
554792730,109,3,2,1,115
554798366,66,47,2,21,136
554805247,38,3,2,3,46
554807263,77,11,31,16,135
554818895,90,59,7,8,164
554819514,138,15,2,1,156
554820007,25,3,2,6,36
554853507,20,13,2,1,36
554860664,78,4,2,8,92
554868262,341,3,2,94,440
554871077,60,39,45,4,148
554883259,23,3,2,2,30
554909329,57,44,3,4,108
554911417,50,27,12,1,90
554931158,108,21,53,33,215
554949920,45,3,2,1,51
554985360,11,3,2,2,18
554992635,56,13,2,2,73
554994327,48,3,2,1,54
554996392,30,3,2,3,38
555004167,15,8,2,1,26
555021111,94,3,2,1,100
555038022,46,23,57,17,143
555039426,53,27,4,2,86
555068963,16,3,2,1,22
555073518,90,21,2,6,119
555075751,168,3,2,8,181
555078412,74,31,34,2,141
555080066,13,3,2,1,19
555095450,40,19,20,3,82
555097355,79,27,47,2,155
555098165,162,4,61,11,238
555129017,133,6,2,2,143
555129591,22,27,2,3,54
555132780,28,16,5,1,50
555133702,27,18,2,1,48
555137136,56,92,118,23,289
555138270,13,3,2,1,19
555138432,41,20,46,1,108
555147008,114,3,2,11,130
555171912,36,4,2,1,43
555173686,38,40,31,10,119
555178984,23,49,3,1,76
555182186,44,3,2,1,50
555182769,10,5,2,4,21
555183948,117,41,3,4,165
555194293,34,8,2,2,46
555200316,42,3,2,1,48
555204871,45,44,63,2,154
555210938,13,12,2,1,28
555224010,56,38,4,4,102
555241581,152,110,42,14,318
555255106,20,87,8,2,117
555262569,34,35,64,8,141
555270884,28,4,2,59,93
555273833,50,3,2,3,58
555275891,55,52,2,7,116
555280875,130,20,2,4,156
555288452,156,3,2,1,162
555289096,33,38,10,8,89
555289271,35,5,5,2,47
555289545,13,9,2,1,25
555295788,44,3,2,11,60
555300678,50,3,2,2,57
555334742,17,41,2,1,61
555340440,69,3,2,1,75
555347345,79,3,2,1,85
555353466,59,3,2,1,65
555360595,16,40,5,1,62
555367328,11,3,2,1,17
555369782,83,3,2,1,89
555376618,45,25,2,18,90
555379264,11,3,2,1,17
555384596,35,40,8,29,112
555390271,100,18,6,2,126
555392588,10,4,2,1,17
555402795,29,10,2,1,42
555405393,24,3,2,2,31
555414195,68,3,2,1,74
555423386,13,6,47,30,96
555455344,98,3,2,1,104
555474779,83,18,23,3,127
555476477,104,3,2,1,110
555487434,18,6,2,1,27
555496199,29,17,4,2,52
555501880,136,8,2,8,154
555502280,16,3,2,1,22
555512129,19,3,2,1,25
555537548,69,3,2,1,75
555543157,122,56,78,9,265
555552154,59,38,45,6,148
555552946,53,46,23,3,125
555555181,68,3,2,2,75
555560482,18,3,2,1,24
555564237,114,33,12,14,173
555567625,18,6,2,3,29
555567689,114,23,96,3,236
555570006,69,7,2,5,83
555577810,63,41,4,5,113
555580849,119,49,20,4,192
555592727,23,3,2,5,33
555596642,135,22,3,17,177
555597732,114,3,2,7,126
555612249,81,3,2,1,87
555616011,15,23,5,3,46
555618835,51,32,2,3,88
555619345,40,21,2,1,64
555621566,85,23,2,2,112
555623507,71,35,2,1,109
555628880,10,6,2,2,20
555639125,10,6,2,1,19
555647524,53,32,27,48,160
555658221,13,3,3,1,20
555667793,122,43,4,8,177
555685359,83,15,17,3,118
555702256,115,9,2,1,127
555709887,190,16,2,2,210
555717238,16,31,2,1,50
555725369,10,3,2,3,18
555742193,25,3,2,2,32
555743638,43,16,2,13,74
555754687,14,3,2,1,20
555759774,25,3,2,2,32
555776141,75,66,3,17,161
555782818,150,3,2,1,156
555786237,10,4,2,1,17
555792731,36,37,31,3,107
555794255,134,47,40,21,242
555824708,54,11,3,1,69
555825399,184,24,5,19,232
555833625,67,27,30,1,125
555835202,16,3,2,1,22
555840451,13,21,2,1,37
555846915,211,3,2,1,217
555853554,85,31,2,1,119
555875249,96,23,17,5,141
555885894,26,53,12,5,96
555909543,170,3,2,1,176
555911443,23,3,2,1,29
555914470,140,19,5,8,172
555923715,14,16,2,7,39
555937730,153,3,2,1,159
555939283,81,3,2,4,90
555952187,69,51,2,2,124
555960953,12,10,2,1,25
555961968,85,37,7,49,178
555963841,234,3,2,1,240
555976833,66,49,2,5,122
555992605,50,55,13,12,130
555999525,12,3,2,1,18
556005524,72,3,2,1,78
556017769,105,3,2,1,111
556022455,77,16,11,3,107
556029634,10,41,4,1,56
556033380,21,17,2,1,41
556041844,50,16,32,1,99
556072234,148,27,28,9,212
556077253,56,5,2,5,68
556078664,97,3,2,1,103
556085752,137,3,2,1,143
556109029,525,3,2,15,545
556113224,38,5,2,10,55
556114623,161,15,62,1,239
556124491,70,31,9,3,113
556154622,48,47,2,30,127
556163892,44,3,2,21,70
556167713,25,3,2,1,31
556179994,10,9,2,1,22
556186300,107,3,2,1,113
556190196,46,35,22,60,163
556190543,192,43,48,26,309
556201645,52,3,2,1,58
556209509,194,80,4,1,279
556236367,59,22,22,9,112
556261147,119,3,2,1,125
556268130,14,3,2,1,20
556270763,111,30,2,1,144
556283301,127,3,2,13,145
556302623,46,3,2,17,68
556336605,40,31,4,12,87
556343891,69,17,9,1,96
556346803,64,10,4,9,87
556350942,20,8,2,1,31
556356503,226,40,2,5,273
556376379,46,3,2,1,52
556395716,25,22,11,8,66
556412270,79,73,2,1,155
556415815,171,3,2,1,177
556418443,42,3,2,1,48
556421892,65,3,2,3,73
556433438,48,8,2,2,60
556440457,72,21,5,1,99
556451166,14,33,9,6,62
556495623,13,3,2,1,19
556507751,56,9,4,13,82
556518448,32,27,2,1,62
556538379,37,39,37,22,135
556539176,19,3,2,2,26
556542913,116,25,71,10,222
556554626,17,3,2,1,23
556561733,11,6,2,1,20
556566681,204,23,2,13,242
556567668,21,3,2,1,27
556574394,90,20,50,12,172
556576819,169,6,21,7,203
556577685,57,26,2,34,119
556578635,51,15,6,6,78
556579826,62,32,50,9,153
556589538,180,45,21,4,250
556596080,57,3,2,3,65
556608063,117,23,2,1,143
556625927,80,25,18,2,125
556634303,95,38,12,21,166
556652411,13,11,2,1,27
556679862,31,4,83,1,119
556699697,99,7,3,15,124
556710908,21,3,2,1,27
556712101,10,49,2,1,62
556733628,25,15,75,4,119
556757071,149,3,2,15,169
556758913,50,159,19,7,235
556760515,141,9,11,3,164
556774607,86,3,2,3,94
556787289,117,4,2,7,130
556791419,82,15,18,1,116
556807496,20,3,2,1,26
556843845,71,10,9,18,108
556849675,174,16,55,24,269
556875099,73,3,2,2,80
556877382,114,4,4,6,128
556895021,10,4,2,1,17
556909065,162,30,35,23,250
556915709,56,3,2,78,139
556922350,16,6,2,2,26
556925887,45,3,2,1,51
556930543,99,22,51,7,179
556936760,16,6,2,1,25
556938190,57,9,2,1,69
556943574,61,14,42,1,118
556949150,13,3,2,1,19
556964621,158,27,2,14,201
556980692,10,8,2,1,21
556982873,46,164,6,2,218
556996204,16,44,2,1,63
557000300,61,31,22,4,118
557008500,113,12,2,1,128
557009097,119,11,66,15,211
557014787,83,20,3,12,118
557031283,51,3,2,2,58
557035425,40,11,2,3,56
557041481,47,14,22,2,85
557059748,47,24,3,1,75
557065177,35,31,5,9,80
557067688,56,3,2,1,62
557068416,22,3,2,4,31
557069057,64,32,4,1,101
557070062,261,3,2,2,268
557072569,87,11,2,1,101
557078519,101,32,26,4,163
557110180,45,24,4,2,75
557112688,42,57,4,1,104
557113856,70,73,31,5,179
557113985,71,3,2,1,77
557121011,66,3,2,5,76
557125529,70,6,2,1,79
557130092,76,30,68,1,175
557131164,10,4,2,4,20
557133070,55,3,2,4,64
557150799,91,27,2,2,122
557177192,73,23,2,12,110
557182404,352,3,2,15,372
557187615,39,3,2,1,45
557198305,44,42,6,43,135
557209873,107,3,2,1,113
557226332,198,3,2,4,207
557258452,11,3,2,1,17
557286099,35,68,6,8,117
557294817,36,9,9,14,68
557317418,66,3,2,2,73
557318972,116,17,4,5,142
557325702,83,3,2,4,92
557346526,149,3,21,2,175
557369186,60,3,2,1,66
557375233,95,9,2,1,107
557375527,14,3,2,1,20
557392152,36,25,2,1,64
557396544,43,27,4,5,79
557427472,16,10,2,1,29
557432545,91,32,43,2,168
557450068,54,28,2,1,85
557501810,30,3,2,1,36
557503507,38,25,2,1,66
557522645,23,3,2,1,29
557522768,23,12,12,1,48
557531628,35,3,2,8,48
557552874,35,4,2,1,42
557556147,12,3,2,1,18
557560138,81,61,11,21,174
557575842,922,3,2,75,1002
557576690,46,3,2,1,52
557584738,513,3,2,2,520
557615618,40,3,2,1,46
557619997,13,3,2,1,19
557646244,24,16,3,8,51
557649769,61,12,2,1,76
557659817,50,21,2,40,113
557665777,77,34,27,2,140
557668004,224,3,2,4,233
557672474,63,3,2,1,69
557679913,62,3,2,9,76
557686895,100,3,2,1,106
557687214,95,18,47,4,164
557692960,38,68,2,1,109
557706721,120,3,2,12,137
557710714,109,30,54,27,220
557711104,94,51,3,22,170
557714627,54,25,19,17,115
557728224,167,34,67,4,272
557729812,55,40,2,5,102
557731344,155,68,16,8,247
557755394,49,10,8,2,69
557796691,64,3,2,9,78
557818267,161,45,2,25,233
557819005,20,43,2,14,79
557828413,38,16,49,1,104
557832621,78,34,2,3,117
557836515,42,35,8,4,89
557843325,11,3,2,1,17
557847201,13,20,2,1,36
557876515,29,22,32,1,84
557880603,46,3,2,1,52
557883032,41,3,2,1,47
557894645,20,46,2,25,93
557924168,35,38,84,32,189
557929240,59,17,23,1,100
557942042,206,6,2,11,225
557945779,45,34,3,3,85
557956987,15,5,2,2,24
557964518,112,3,2,2,119
557966749,13,14,13,1,41
557971235,15,3,2,2,22
557973207,242,49,6,57,354
557976357,90,17,2,1,110
557977122,11,57,2,1,71
557988686,133,25,65,12,235
558012527,71,23,2,1,97
558019178,25,3,2,1,31
558028977,35,59,57,1,152
558036968,195,50,46,40,331
558055498,122,37,8,13,180
558061906,29,17,4,5,55
558063190,27,3,2,1,33
558081724,16,30,25,1,72
558090573,108,26,19,22,175
558091196,88,3,2,1,94
558102505,132,26,58,2,218
558110829,36,3,2,3,44
558114250,139,3,2,1,145
558120471,127,45,67,18,257
558139304,14,3,2,3,22
558154047,67,37,9,6,119
558161568,14,3,2,1,20
558184825,37,34,2,3,76
558194590,87,3,2,19,111
558199213,149,15,2,1,167
558201247,23,25,2,3,53
558217916,176,3,9,1,189
558218685,18,11,2,1,32
558220892,68,3,2,2,75
558224329,109,37,2,8,156
558236022,43,31,24,2,100
558242906,24,3,2,3,32
558247425,71,66,41,7,185
558248990,170,3,2,1,176
558252703,42,33,71,38,184
558285720,139,9,65,18,231
558291614,20,3,2,1,26
558305099,37,15,13,8,73
558306285,11,3,2,1,17
558323612,97,20,2,1,120
558328664,100,45,3,4,152
558330244,67,55,4,31,157
558332610,40,23,5,11,79
558336364,91,26,2,1,120
558338474,39,39,24,13,115
558353178,66,3,2,1,72
558364703,75,35,2,15,127
558374247,107,57,33,8,205
558382328,55,36,2,2,95
558389011,48,65,18,21,152
558393426,167,53,11,7,238
558416334,114,53,22,34,223
558420767,58,23,2,6,89
558423293,55,13,24,1,93
558426225,104,52,39,3,198
558431596,71,3,2,4,80
558441963,22,91,2,1,116
558444194,40,37,11,15,103
558449381,19,15,10,1,45
558455709,62,16,3,12,93
558463773,84,7,7,3,101
558478097,101,59,66,37,263
558487279,49,3,6,7,65
558496014,12,3,2,1,18
558502030,107,39,15,1,162
558509768,73,16,3,9,101
558512820,34,61,26,45,166
558514216,55,73,2,4,134
558535785,33,27,12,3,75
558537795,52,15,7,1,75
558538368,66,30,27,18,141
558550780,88,3,2,1,94
558554113,74,3,2,8,87
558555663,53,3,3,11,70
558557498,34,82,24,2,142
558557978,34,3,2,2,41
558561019,103,3,2,1,109
558583938,95,3,2,1,101
558594498,39,33,42,6,120
558597396,197,3,2,3,205
558609148,36,3,3,15,57
558613276,82,3,2,3,90
558617301,16,24,2,1,43
558638145,160,66,11,6,243
558645940,70,42,31,1,144
558646815,91,5,20,14,130
558654489,20,28,4,1,53
558665286,130,28,8,1,167
558677105,47,11,15,5,78
558690671,22,17,2,1,42
558692999,212,40,2,1,255
558699600,38,4,2,1,45
558714897,95,35,3,1,134
558721497,90,50,31,12,183
558722095,10,4,16,1,31
558734664,58,15,2,3,78
558745649,141,21,22,16,200
558747384,31,8,2,4,45
558754610,127,36,7,12,182
558774262,90,35,2,1,128
558775708,63,41,18,3,125
558788759,75,20,3,1,99
558808236,79,43,19,9,150
558814801,28,8,2,1,39
558816759,27,6,2,7,42
558817779,20,3,2,1,26
558821871,16,3,2,3,24
558826217,12,3,2,1,18
558830641,36,23,2,3,64
558831733,20,24,3,8,55
558833199,52,7,90,31,180
558837898,241,3,2,6,252
558851265,27,26,2,1,56
558853213,119,68,10,14,211
558854420,15,8,2,1,26
558868472,21,3,2,1,27
558872982,54,18,2,1,75
558875618,16,3,2,1,22
558878558,107,6,72,1,186
558886326,50,13,2,5,70
558923870,36,10,5,15,66
558932724,54,3,2,1,60
558943713,18,3,2,1,24
558948749,26,13,6,14,59
558949721,93,72,30,3,198
558949940,122,7,6,2,137
558957624,20,4,2,10,36
558990615,22,34,4,1,61
558990698,77,32,2,1,112
558996108,79,3,2,4,88
558999680,11,3,2,1,17
559002859,41,3,2,4,50
559005050,55,15,2,1,73
559012722,105,12,15,5,137
559013985,11,3,2,1,17
559052773,15,3,2,1,21
559055255,12,3,2,1,18
559060177,92,10,2,1,105
559065722,98,5,23,6,132
559070478,13,3,2,1,19
559073338,43,105,47,1,196
559073499,162,115,30,301,608
559075448,19,3,2,1,25
559082594,387,3,2,2,394
559092542,17,35,3,8,63
559105485,16,3,2,1,22
559114344,58,25,40,18,141
559127276,13,25,2,1,41
559142635,27,33,2,3,65
559142801,51,16,2,2,71
559167536,36,46,2,6,90
559188992,56,6,51,1,114
559211400,184,33,6,12,235
559244862,64,80,207,50,401
559252831,26,3,2,6,37
559257880,102,14,2,6,124
559271724,27,43,15,4,89
559272457,12,21,2,1,36
559286081,45,3,2,3,53
559316526,37,13,2,1,53
559328120,58,33,2,9,102
559336159,123,27,2,2,154
559346438,127,51,2,23,203
559357894,90,3,2,10,105
559437770,94,20,47,3,164
559441660,15,3,2,1,21
559463391,97,26,5,26,154
559474844,65,3,2,4,74
559479559,121,16,3,30,170
559481984,135,21,3,20,179
559483959,135,167,11,46,359
559536137,14,3,2,1,20
559537468,137,23,9,16,185
559539021,31,44,2,1,78
559539503,50,19,2,1,72
559540944,61,41,42,10,154
559541992,176,10,3,19,208
559542460,86,24,21,2,133
559549711,56,9,21,1,87
559552911,13,3,2,2,20
559558545,56,8,21,4,89
559565727,85,29,71,3,188
559594324,205,38,2,6,251
559595380,30,7,2,4,43
559603503,159,66,42,46,313
559604222,13,9,2,1,25
559623582,10,3,2,2,17
559629875,33,30,43,7,113
559638324,15,16,13,4,48
559641996,20,3,2,3,28
559651001,104,3,2,1,110
559651256,57,59,38,11,165
559654947,16,3,2,1,22
559655435,94,3,2,3,102
559657336,43,68,21,3,135
559662444,15,3,2,3,23
559669873,39,40,26,1,106
559688046,129,3,2,3,137
559697982,11,3,2,32,48
559708716,11,3,2,1,17
559716559,121,44,2,12,179
559726680,44,3,2,1,50
559728388,146,3,2,34,185
559733088,149,5,52,32,238
559769232,67,24,3,12,106
559782045,12,28,2,16,58
559830042,145,18,5,7,175
559839230,23,10,2,1,36
559850869,123,44,7,18,192
559918314,221,6,54,7,288
559918929,115,24,3,1,143
559927411,10,5,2,1,18
559928766,10,4,2,1,17
559929512,38,19,2,1,60
559934057,13,3,2,1,19
559957611,12,3,2,1,18
559975307,35,18,12,3,68
559976088,87,77,106,22,292
559982598,26,19,33,23,101
559997861,44,67,47,29,187
559998289,27,17,2,20,66
559998561,22,15,3,1,41
560048178,11,3,2,1,17
560050341,194,17,41,1,253
560061518,149,31,37,23,240
560064473,67,3,2,1,73
560093611,91,18,2,3,114
560095807,117,3,2,1,123
560096965,63,3,2,1,69
560097116,69,7,7,2,85
560103447,55,33,21,15,124
560111081,50,16,2,23,91
560120302,74,7,2,1,84
560128185,52,23,7,8,90
560149116,10,6,2,1,19
560155763,75,18,21,8,122
560157114,1103,82,2,19,1206
560162998,217,3,2,115,337
560169835,17,14,2,1,34
560171050,21,3,2,1,27
560176411,57,44,42,5,148
560199786,108,3,2,1,114
560199840,150,55,100,12,317
560209437,145,66,2,1,214
560220989,53,45,4,2,104
560225896,100,24,18,10,152
560229773,26,7,2,1,36
560235788,10,51,18,1,80
560237185,36,7,2,6,51
560239980,45,3,2,1,51
560240345,69,6,2,3,80
560244447,10,6,2,1,19
560274552,75,12,8,13,108
560274997,67,17,2,1,87
560282887,52,3,2,1,58
560295750,120,33,3,2,158
560297127,80,20,16,9,125
560320179,66,3,2,20,91
560332294,16,58,33,1,108
560332598,143,3,2,1,149
560335973,124,26,136,15,301
560350133,10,17,21,1,49
560362336,129,25,52,4,210
560365143,13,3,2,1,19
560377125,72,22,29,15,138
560377824,49,82,82,1,214
560390956,67,18,4,8,97
560398788,63,3,2,3,71
560400515,87,15,32,5,139
560403141,119,3,2,9,133
560408976,12,3,2,1,18
560419147,244,3,2,1,250
560426479,13,10,2,7,32
560430598,239,36,44,42,361
560454096,10,7,2,1,20
560456894,97,3,2,1,103
560469780,193,18,69,8,288
560492053,25,10,9,23,67
560506416,159,41,41,2,243
560512054,12,3,2,1,18
560518966,41,28,8,14,91
560521962,25,29,11,3,68
560525901,190,8,3,27,228
560534697,15,13,2,1,31
560542023,151,41,50,2,244
560542569,35,34,4,8,81
560542965,44,3,2,3,52
560543266,14,3,2,1,20
560547721,45,3,5,2,55
560560489,52,3,2,19,76
560592131,48,14,2,9,73
560599695,76,3,2,6,87
560607535,43,3,2,1,49
560611349,13,9,4,6,32
560624678,83,3,2,1,89
560643859,75,9,31,3,118
560652342,34,16,2,4,56
560659128,26,63,2,3,94
560660250,10,5,2,1,18
560684487,90,24,2,3,119
560686665,184,3,2,34,223
560697746,135,24,2,4,165
560707032,29,29,12,6,76
560714006,85,19,3,4,111
560715989,79,18,17,1,115
560716414,10,8,2,1,21
560717526,28,3,2,1,34
560729411,48,3,2,3,56
560732332,80,68,54,41,243
560732418,30,25,2,1,58
560734044,69,5,2,1,77
560734506,12,3,2,1,18
560740823,62,7,9,5,83
560757903,11,3,2,1,17
560763770,29,12,2,1,44
560791791,426,3,2,2,433
560813660,11,3,2,1,17
560846421,51,4,2,2,59
560851642,85,3,2,3,93
560853175,88,3,2,1,94
560856452,91,3,2,1,97
560859042,61,3,3,1,68
560866891,198,36,2,2,238
560884508,26,3,2,11,42
560892174,23,5,2,7,37
560893934,43,29,6,1,79
560901623,177,26,14,7,224
560949575,16,3,2,1,22
560954849,102,3,2,13,120
560965160,184,3,2,2,191
560970284,177,41,3,8,229
560970897,99,34,19,1,153
560979435,14,8,2,14,38
560987567,25,22,4,1,52
560991616,25,49,83,14,171
561003868,13,23,5,5,46
561008067,43,45,5,29,122
561017027,12,18,2,1,33
561024952,62,3,2,1,68
561030144,141,23,71,2,237
561048644,65,3,2,1,71
561050725,45,3,2,1,51
561052546,63,20,2,1,86
561055606,72,29,4,2,107
561062194,22,3,2,3,30
561062563,127,21,27,13,188
561068871,52,48,3,1,104
561077510,78,44,3,1,126
561126657,150,26,26,3,205
561136518,52,56,42,7,157
561149518,75,3,2,1,81
561154860,137,80,52,29,298
561155624,212,68,23,23,326
561161460,152,3,2,2,159
561164802,69,37,4,14,124
561170840,123,14,2,3,142
561173676,801,3,2,4,810
561204350,99,84,84,13,280
561205176,92,21,2,3,118
561212376,73,45,42,19,179
561223089,138,75,16,4,233
561230233,11,10,2,2,25
561263312,234,19,2,6,261
561272862,554,3,2,51,610
561281402,95,39,18,10,162
561283701,45,17,15,2,79
561288290,54,3,2,1,60
561293111,46,91,9,1,147
561300802,12,11,2,1,26
561330881,41,28,6,5,80
561332270,110,57,7,1,175
561357913,36,52,34,1,123
561361723,55,23,15,1,94
561380868,79,13,10,35,137
561381120,77,3,2,1,83
561381652,24,32,12,9,77
561384171,14,6,2,1,23
561395644,34,30,2,1,67
561396198,69,3,2,1,75
561412702,40,12,4,3,59
561416240,69,58,8,1,136
561425548,56,3,2,1,62
561429015,76,36,41,28,181
561430419,94,15,74,1,184
561437893,64,17,29,2,112
561460770,10,3,2,3,18
561462441,92,58,2,3,155
561462656,57,53,8,9,127
561467799,33,22,2,1,58
561481338,11,4,2,2,19
561490851,37,21,27,7,92
561491964,87,3,2,6,98
561492882,11,10,2,1,24
561495202,46,17,5,3,71
561496072,41,11,5,1,58
561500207,12,3,2,1,18
561518020,65,31,37,18,151
561520504,38,12,2,1,53
561523914,13,3,2,1,19
561542672,34,36,33,7,110
561543972,35,53,9,2,99
561548638,35,19,4,9,67
561558327,42,45,69,3,159
561563202,20,4,5,4,33
561575828,90,3,2,7,102
561583804,30,21,2,1,54
561614597,50,3,2,7,62
561618237,11,4,2,1,18
561626686,27,27,2,1,57
561650275,21,3,2,3,29
561671282,70,3,2,1,76
561674481,37,32,2,8,79
561709309,95,3,2,1,101
561709564,128,32,21,19,200
561710027,48,37,32,55,172
561760459,145,11,2,1,159
561761845,27,19,2,1,49
561793560,27,41,2,1,71
561805059,20,44,8,1,73
561808111,55,3,6,1,65
561811749,27,58,4,2,91
561819156,76,26,2,1,105
561820726,19,3,2,1,25
561827941,168,19,5,1,193
561833710,80,46,5,2,133
561835399,27,4,2,1,34
561835524,17,3,2,1,23
561841258,26,20,2,1,49
561857882,22,6,3,1,32
561870871,64,3,2,1,70
561875038,20,12,2,1,35
561887355,113,5,103,2,223
561902536,149,49,33,24,255
561906692,17,3,2,1,23
561926900,11,3,2,1,17
561942408,25,7,27,2,61
561946894,24,18,9,1,52
561951102,43,53,79,26,201
561979295,11,16,2,1,30
561982393,33,27,2,1,63
561987310,184,3,2,1,190
562052825,47,3,2,1,53
562058401,84,20,39,2,145
562061103,35,3,2,2,42
562065891,35,25,2,4,66
562076726,33,3,2,5,43
562089762,106,7,2,2,117
562102676,31,3,2,4,40
562118772,155,3,2,7,167
562118938,125,39,98,4,266
562138357,14,32,15,1,62
562142839,43,15,26,2,86
562149881,51,60,26,2,139
562157004,38,14,2,21,75
562164949,13,3,2,1,19
562168886,63,8,2,3,76
562177130,104,42,15,1,162
562182723,35,3,2,1,41
562188160,79,27,2,1,109
562227686,152,23,11,1,187
562246108,72,38,15,71,196
562252006,10,60,2,1,73
562258411,35,22,21,15,93
562267373,144,3,2,1,150
562277887,35,14,6,1,56
562312293,18,3,2,1,24
562318296,302,3,2,2,309
562327715,16,3,2,5,26
562363449,30,21,4,2,57
562364460,72,28,47,10,157
562372231,23,3,2,1,29
562377754,10,4,2,1,17
562383039,16,23,2,1,42
562383919,25,3,2,2,32
562387729,90,3,2,2,97
562417324,50,4,10,1,65
562422474,127,15,2,2,146
562445042,104,3,2,10,119
562445932,55,43,96,1,195
562448698,12,3,2,1,18
562456335,25,3,2,1,31
562467809,13,17,11,7,48
562469940,11,3,2,1,17
562471011,105,3,2,1,111
562474565,70,42,2,8,122
562478869,153,3,2,1,159
562479897,236,9,64,2,311
562480514,15,15,5,2,37
562486921,301,3,2,7,313
562489081,94,40,6,4,144
562501556,64,3,2,1,70
562502211,59,16,18,2,95
562509836,13,3,2,1,19
562524557,46,7,2,1,56
562530179,10,5,2,1,18
562531348,28,31,2,3,64
562536087,98,28,56,5,187
562536482,181,29,44,1,255
562558538,107,3,2,15,127
562570703,19,20,12,1,52
562573438,34,23,3,2,62
562576520,170,6,24,2,202
562580722,149,22,8,5,184
562598906,12,19,2,1,34
562604887,10,7,2,1,20
562605989,78,3,2,24,107
562611301,65,31,8,19,123
562627740,16,10,2,1,29
562631060,107,18,2,3,130
562632699,16,3,2,1,22
562634841,108,3,2,1,114
562638398,181,58,2,5,246
562644635,39,24,8,7,78
562659761,28,37,11,5,81
562660244,119,13,3,7,142
562661424,55,32,2,5,94
562669503,123,31,7,26,187
562718416,84,6,12,2,104
562732546,10,20,2,1,33
562736261,88,3,2,1,94
562738057,49,3,2,1,55
562738086,12,9,2,2,25
562739737,35,22,15,2,74
562741247,30,4,2,1,37
562744863,40,3,2,1,46
562752330,60,3,85,1,149
562771987,86,18,4,3,111
562780874,78,47,44,25,194
562785081,66,3,25,1,95
562793956,20,14,2,1,37
562794175,48,3,6,16,73
562800833,17,3,2,1,23
562809380,33,18,2,1,54
562813270,14,11,2,1,28
562819203,31,67,16,5,119
562823904,11,3,2,1,17
562828800,55,3,2,1,61
562836139,71,10,22,2,105
562839966,88,20,21,30,159
562891215,153,3,2,1,159
562894698,18,3,2,1,24
562895240,188,3,2,1,194
562907595,123,35,31,41,230
562911815,117,3,2,3,125
562922708,21,4,2,2,29
562924433,96,10,2,2,110
562931256,96,3,2,13,114
562932005,53,30,19,24,126
562942887,56,16,4,8,84
562953552,109,49,2,5,165
562966529,23,48,2,12,85
562967438,12,28,2,2,44
562973002,10,7,3,4,24
562983023,11,3,2,1,17
562996136,44,16,33,11,104
563003955,117,34,16,5,172
563017889,120,62,101,1,284
563021594,17,3,2,2,24
563023743,62,56,65,5,188
563040382,43,16,3,2,64
563042982,114,3,2,1,120
563044595,259,26,3,44,332
563056282,124,3,2,1,130
563057759,45,6,2,1,54
563066474,71,55,2,8,136
563075044,11,6,2,1,20
563099760,149,12,2,1,164
563111007,23,3,2,1,29
563111098,52,21,23,20,116
563119388,102,3,2,1,108
563122915,123,62,2,5,192
563127864,154,3,2,7,166
563151950,55,12,2,1,70
563157317,20,41,8,3,72
563161555,241,3,2,67,313
563162281,146,3,2,1,152
563165334,10,10,2,2,24
563176180,99,3,2,2,106
563179028,48,3,2,1,54
563186216,38,13,6,6,63
563190652,63,18,2,1,84
563195099,11,3,2,1,17
563195748,28,40,30,6,104
563199797,57,33,6,2,98
563205269,24,23,19,2,68
563217491,25,3,4,3,35
563226318,16,5,2,1,24
563240021,50,25,31,10,116
563245086,20,21,3,1,45
563250661,82,3,9,1,95
563275276,72,3,2,2,79
563276054,42,3,2,1,48
563306217,17,3,2,1,23
563315594,18,29,6,1,54
563320594,165,46,36,57,304
563331706,26,3,2,1,32
563348271,29,10,2,7,48
563379404,16,3,2,2,23
563380518,12,3,2,9,26
563392104,118,3,2,7,130
563395609,82,23,5,9,119
563410633,18,8,2,1,29
563420182,16,4,2,1,23
563424066,47,23,4,5,79
563426492,32,70,24,1,127
563435444,25,3,2,2,32
563445356,34,100,55,2,191
563452857,15,3,2,1,21
563460285,169,47,31,1,248
563461439,55,17,2,1,75
563463290,15,7,2,1,25
563490151,38,44,38,5,125
563503881,29,3,2,1,35
563503981,89,5,2,1,97
563529413,86,20,2,1,109
563543925,287,3,2,16,308
563545793,27,35,2,6,70
563547906,33,23,2,6,64
563548777,26,23,2,1,52
563567883,151,213,24,5,393
563570334,52,20,20,34,126
563580291,77,10,3,5,95
563585804,88,17,38,2,145
563591900,35,3,2,1,41
563612160,13,43,102,1,159
563621352,17,3,2,1,23
563670052,149,35,2,4,190
563679768,41,6,29,46,122
563687723,16,31,2,1,50
563691200,43,51,13,4,111
563693264,55,5,2,6,68
563697189,16,3,2,1,22
563700578,14,3,2,1,20
563704276,113,77,69,9,268
563706512,48,23,2,2,75
563714910,12,3,2,1,18
563718810,155,38,72,17,282
563724948,40,3,2,1,46
563725549,13,11,2,1,27
563729425,33,37,2,1,73
563737487,297,3,2,3,305
563814229,22,11,2,1,36
563818985,11,3,2,1,17
563819255,98,12,2,16,128
563838506,10,5,2,1,18
563839035,18,3,2,1,24
563841048,18,3,2,1,24
563855259,86,41,50,28,205
563875294,137,3,2,1,143
563880872,26,47,2,2,77
563898306,72,6,2,4,84
563904941,72,3,2,4,81
563910113,115,20,15,4,154
563929722,40,122,7,11,180
563933370,72,64,5,7,148
563936494,135,23,14,40,212
563937233,45,14,7,5,71
563945953,74,20,15,10,119
563948156,13,34,2,1,50
563950762,14,16,9,1,40
563954030,28,32,2,1,63
563954900,162,3,2,6,173
563956301,36,11,2,5,54
563968343,84,29,32,41,186
563976777,56,7,3,38,104
563977217,19,11,37,2,69
563988245,30,15,2,2,49
563988921,12,3,2,2,19
563990355,14,3,14,47,78
563992176,19,3,2,1,25
563994560,15,3,2,1,21
563999576,154,84,72,1,311
564007268,112,39,20,11,182
564008963,10,8,2,1,21
564016832,52,21,25,10,108
564017075,160,8,2,4,174
564026415,10,8,2,5,25
564031970,31,3,2,1,37
564040982,134,31,2,2,169
564055957,46,10,2,1,59
564059583,46,33,14,13,106
564061129,10,8,2,1,21
564089975,78,45,17,4,144
564099414,32,25,2,5,64
564135361,14,4,2,3,23
564145013,91,30,16,1,138
564148707,61,39,21,2,123
564153777,16,3,2,1,22
564154860,66,32,6,4,108
564154933,144,3,2,1,150
564159991,525,55,2,4,586
564174601,14,5,2,1,22
564181441,25,8,2,4,39
564199521,42,23,18,23,106
564213130,98,17,2,2,119
564218360,101,78,2,21,202
564221151,78,3,2,1,84
564225104,27,22,10,5,64
564234399,143,3,2,5,153
564260370,96,21,3,1,121
564261977,189,14,2,16,221
564263069,10,5,12,3,30
564263660,14,3,2,1,20
564276416,15,37,2,1,55
564285639,38,19,56,5,118
564316106,101,17,5,2,125
564328736,72,14,22,1,109
564343917,100,3,2,2,107
564362373,11,3,2,3,19
564367304,130,11,2,21,164
564408732,53,35,5,2,95
564417814,10,32,2,2,46
564423833,213,3,2,1,219
564432280,72,9,2,3,86
564452779,65,29,56,1,151
564457546,60,18,6,4,88
564457965,35,37,84,1,157
564487351,87,38,120,1,246
564489481,86,3,2,9,100
564491103,71,27,34,7,139
564493037,64,18,2,2,86
564518156,12,5,2,1,20
564520757,24,20,2,6,52
564522005,56,3,2,1,62
564522902,70,46,3,1,120
564550958,34,31,14,14,93
564556239,162,3,2,3,170
564601966,45,54,4,4,107
564603506,120,56,3,11,190
564604625,118,8,16,6,148
564613142,32,10,2,10,54
564646164,114,3,2,1,120
564651862,160,20,2,6,188
564652952,95,26,18,5,144
564665235,18,5,2,1,26
564670480,12,35,2,2,51
564693915,100,3,2,9,114
564714045,29,21,8,15,73
564728409,113,64,39,29,245
564741095,116,22,19,8,165
564751487,41,12,5,1,59
564776273,56,12,3,6,77
564779672,223,13,2,4,242
564793145,79,52,31,7,169
564793783,142,3,2,2,149
564800425,19,3,2,2,26
564802303,20,13,2,5,40
564806652,14,3,2,1,20
564807505,26,3,2,1,32
564816142,108,27,2,3,140
564829436,69,11,2,43,125
564838730,14,30,3,3,50
564839479,10,10,2,1,23
564854611,11,3,2,1,17
564858166,112,22,14,5,153
564858385,134,27,2,1,164
564861680,92,40,64,16,212
564865523,97,23,15,56,191
564871777,79,16,2,2,99
564889811,94,3,2,1,100
564895199,30,4,3,9,46
564896188,20,3,2,1,26
564904419,19,14,2,1,36
564905231,39,14,65,1,119
564907245,69,3,2,1,75
564911202,33,9,2,10,54
564919335,23,3,2,1,29
564923859,57,27,12,3,99
564931489,174,49,4,7,234
564943921,11,5,2,1,19
564946746,159,120,2,1,282
564948896,37,5,2,1,45
564952376,58,19,29,10,116
564959796,54,10,9,7,80
564962314,33,3,2,3,41
564978330,96,17,64,2,179
564993793,142,3,2,1,148
564997661,24,46,2,35,107
565002883,79,6,8,1,94
565033279,199,19,2,1,221
565033363,27,3,2,1,33
565039458,49,4,2,18,73
565063300,79,18,3,8,108
565086473,77,24,61,2,164
565088839,13,7,3,2,25
565103038,11,3,2,12,28
565105439,10,4,2,1,17
565106963,97,3,37,1,138
565124509,40,13,10,1,64
565158133,51,24,2,1,78
565174215,93,3,2,1,99
565180312,81,17,2,7,107
565183288,106,3,2,12,123
565184371,10,12,2,1,25
565185697,74,3,2,1,80
565186882,92,3,2,1,98
565204929,296,87,2,17,402
565217673,47,24,4,2,77
565222967,33,27,2,1,63
565225018,85,13,72,15,185
565242103,33,31,69,8,141
565250689,101,3,2,5,111
565268974,94,12,4,23,133
565276393,43,6,2,1,52
565282870,55,7,20,12,94
565284523,88,3,2,1,94
565307054,85,21,10,4,120
565308650,60,27,14,1,102
565323672,224,3,2,5,234
565329217,26,3,2,2,33
565357685,221,3,2,1,227
565360965,10,4,2,2,18
565371624,21,3,2,1,27
565380322,10,4,2,1,17
565382849,79,15,15,2,111
565391987,19,10,2,2,33
565415794,96,38,8,4,146
565422243,10,4,2,1,17
565422398,25,4,2,2,33
565427920,24,11,2,1,38
565457022,98,6,19,8,131
565460211,87,23,16,1,127
565472847,15,5,2,2,24
565473882,33,12,2,19,66
565474750,77,18,2,1,98
565509246,39,8,2,1,50
565520241,224,43,2,1,270
565530790,108,28,27,1,164
565539227,15,8,2,1,26
565541208,13,67,2,1,83
565550711,40,25,2,1,68
565558310,74,24,2,1,101
565583305,70,8,3,5,86
565595455,73,3,2,3,81
565602003,49,10,2,7,68
565624454,60,18,5,1,84
565630214,120,50,39,1,210
565634959,50,34,7,9,100
565637091,160,27,2,4,193
565649752,35,47,26,4,112
565663686,138,20,2,7,167
565665696,182,78,37,13,310
565665955,65,3,2,1,71
565674794,112,25,2,1,140
565679248,47,27,3,39,116
565681382,12,3,2,1,18
565690483,45,11,10,1,67
565691255,63,3,2,1,69
565691571,29,37,2,2,70
565705936,77,10,2,1,90
565736681,91,15,21,1,128
565753584,18,22,5,3,48
565761488,67,14,4,1,86
565762694,75,8,22,1,106
565764355,76,6,4,3,89
565789799,54,22,2,4,82
565795332,142,50,77,5,274
565795864,192,3,2,18,215
565804791,144,46,74,1,265
565805848,20,123,11,2,156
565810640,81,15,10,2,108
565823792,37,26,9,1,73
565824505,14,3,2,1,20
565836967,44,48,12,19,123
565838365,19,3,2,1,25
565847573,23,3,2,6,34
565862424,18,4,2,1,25
565864694,35,86,4,2,127
565881529,34,43,4,1,82
565901990,198,56,19,6,279
565919014,73,3,2,1,79
565924612,75,15,2,2,94
565926837,74,5,9,2,90
565932040,343,3,2,9,357
565936733,141,3,2,1,147
565953179,68,13,5,4,90
565956754,93,27,51,3,174
565969200,98,16,2,1,117
565979671,39,14,20,1,74
565980092,82,3,2,6,93
565994937,58,15,3,1,77
565998400,17,5,2,1,25
566010431,11,3,2,1,17
566014463,102,22,129,24,277
566018402,13,3,2,2,20
566020539,13,3,2,1,19
566023383,264,3,2,6,275
566037677,11,3,2,1,17
566058258,77,45,3,10,135
566066547,73,7,2,1,83
566068560,38,32,16,31,117
566085322,12,6,2,1,21
566105990,78,31,2,1,112
566106575,55,3,2,1,61
566108335,44,40,36,1,121
566118693,42,38,19,2,101
566122088,17,3,2,1,23
566148529,13,3,2,1,19
566159443,104,5,2,7,118
566181854,29,3,2,7,41
566195173,131,3,3,1,138
566201834,84,15,31,15,145
566210434,65,3,2,5,75
566212690,59,10,17,3,89
566218451,32,25,25,1,83
566221331,145,62,2,19,228
566253260,82,18,8,8,116
566260778,90,18,50,1,159
566275496,111,3,2,1,117
566286996,75,25,2,4,106
566292501,56,3,13,2,74
566297939,17,8,2,7,34
566302578,147,34,35,6,222
566305001,125,49,53,3,230
566314320,32,36,3,1,72
566325408,15,5,2,1,23
566336429,44,3,2,1,50
566366744,18,3,2,1,24
566369103,67,54,58,53,232
566370133,69,18,29,2,118
566378834,104,19,2,6,131
566393330,21,9,2,1,33
566404595,17,21,2,1,41
566405346,117,3,2,9,131
566407468,55,30,90,2,177
566412804,102,11,2,1,116
566420084,33,32,12,17,94
566422068,39,75,9,14,137
566422597,14,3,2,1,20
566424951,17,5,2,1,25
566462314,100,24,23,2,149
566463140,11,3,2,1,17
566476725,31,12,3,3,49
566479346,20,3,2,1,26
566485304,72,8,2,1,83
566496370,110,19,50,2,181
566496862,12,3,2,1,18
566513899,59,23,37,3,122
566563267,108,46,5,14,173
566568550,42,3,2,1,48
566569960,161,42,13,12,228
566572940,141,3,2,8,154
566592046,24,42,3,17,86
566601737,16,19,2,16,53
566612011,11,3,2,2,18
566617639,17,15,5,1,38
566634387,71,19,16,37,143
566640538,32,53,2,8,95
566640553,50,16,52,20,138
566641242,37,26,3,33,99
566648339,24,49,52,5,130
566650324,16,3,2,1,22
566660287,93,3,5,10,111
566675549,10,18,2,1,31
566684238,10,3,2,2,17
566687339,45,24,3,1,73
566697989,103,19,240,5,367
566700810,161,3,2,5,171
566718884,41,16,2,2,61
566719682,71,21,14,12,118
566732120,16,4,2,1,23
566736626,120,3,2,4,129
566750655,63,13,4,8,88
566752437,201,3,2,3,209
566763006,63,34,6,33,136
566771372,29,13,2,5,49
566774749,14,6,2,1,23
566795991,85,19,35,1,140
566813785,128,30,2,1,161
566818515,11,6,2,1,20
566820642,50,16,2,1,69
566851170,1053,3,2,45,1103
566855507,99,3,2,4,108
566890930,10,8,2,1,21
566895080,175,105,21,13,314
566895893,15,3,2,1,21
566923454,19,3,2,1,25
566925603,46,91,38,1,176
566926557,166,38,5,2,211
566927749,88,20,15,9,132
566930658,65,15,7,11,98
566935644,115,38,25,11,189
566939024,34,3,2,1,40
566944449,63,3,2,1,69
566946902,10,4,2,1,17
566950349,69,7,6,10,92
566968324,100,3,2,1,106
566972806,62,26,30,5,123
566975471,76,75,4,7,162
566988551,65,6,2,2,75
566989023,10,4,2,1,17
566993818,19,3,2,1,25
567000299,72,3,2,86,163
567015026,10,3,2,16,31
567016226,74,8,16,2,100
567020571,140,65,2,10,217
567030196,36,116,53,15,220
567032281,23,19,10,5,57
567054319,24,3,2,1,30
567059527,48,29,7,1,85
567072401,18,74,3,21,116
567075880,26,5,20,13,64
567076403,68,48,2,1,119
567101216,13,3,2,1,19
567118118,36,3,2,1,42
567129416,139,10,2,2,153
567130699,831,3,2,8,844
567138232,32,3,2,1,38
567146970,144,3,2,1,150
567154380,14,3,2,1,20
567176896,29,54,47,1,131
567193857,317,3,2,21,343
567194492,30,33,12,2,77
567222028,15,7,3,1,26
567242914,155,31,2,1,189
567250441,137,25,4,1,167
567250543,14,12,2,1,29
567251877,51,3,2,1,57
567254033,35,38,23,15,111
567277578,26,14,7,7,54
567282366,52,3,2,1,58
567284077,216,13,25,3,257
567289098,90,3,2,1,96
567292619,56,3,2,1,62
567311887,48,33,2,11,94
567345737,18,47,9,1,75
567348996,194,3,2,2,201
567351840,45,4,6,7,62
567362057,94,40,60,5,199
567366745,21,3,2,1,27
567379672,96,3,2,2,103
567383601,134,30,55,2,221
567403026,15,14,2,1,32
567404412,53,12,27,61,153
567450445,173,4,22,5,204
567453767,11,3,2,1,17
567465086,163,7,5,2,177
567468057,30,3,2,6,41
567468530,10,4,2,1,17
567472529,10,3,2,2,17
567478848,19,38,3,2,62
567501138,74,27,13,19,133
567505681,52,3,2,1,58
567506078,71,24,2,21,118
567506359,62,35,14,5,116
567507472,65,28,32,7,132
567511832,125,3,2,1,131
567523848,12,3,2,1,18
567538339,65,29,5,1,100
567538391,21,3,2,2,28
567567122,18,3,2,6,29
567588953,11,6,6,1,24
567595426,68,11,16,16,111
567632217,35,3,2,1,41
567640063,94,29,2,5,130
567644461,11,3,2,1,17
567646853,51,41,14,1,107
567647338,24,11,2,33,70
567653151,17,3,2,1,23
567657211,102,20,73,4,199
567657974,85,20,4,1,110
567663968,48,3,2,2,55
567664978,19,3,2,3,27
567670293,10,12,2,1,25
567675731,47,28,36,27,138
567681321,47,38,21,5,111
567689227,49,3,2,1,55
567692247,29,40,18,2,89
567695872,121,19,2,25,167
567707133,23,6,99,2,130
567708847,21,63,2,3,89
567728819,121,27,11,59,218
567737328,17,33,2,1,53
567741503,11,3,2,1,17
567758289,34,3,2,3,42
567777853,12,4,2,1,19
567779205,16,3,2,1,22
567785845,25,3,2,1,31
567791540,80,37,172,7,296
567792448,13,9,2,1,25
567799584,82,7,2,7,98
567821677,39,27,10,24,100
567821827,29,65,38,2,134
567827132,14,3,2,3,22
567835180,18,16,16,1,51
567836405,77,3,2,1,83
567842145,103,3,2,1,109
567855539,75,33,12,12,132
567859052,101,3,2,7,113
567864503,67,3,2,1,73
567872502,16,4,2,1,23
567885565,108,3,2,4,117
567889044,40,11,6,15,72
567890717,70,27,4,1,102
567896836,34,11,2,15,62
567916376,10,16,2,1,29
567923570,10,3,3,1,17
567925382,35,16,2,19,72
567931974,128,38,3,8,177
567935556,240,15,2,8,265
567944535,137,37,4,2,180
567955980,115,46,136,1,298
567957769,115,22,2,1,140
567965421,195,3,2,7,207
567969357,79,3,2,3,87
567982583,173,39,22,4,238
567988043,12,3,2,1,18
568003849,77,64,49,8,198
568011432,43,37,7,1,88
568013104,27,3,2,5,37
568016423,130,3,2,1,136
568019033,23,36,13,4,76
568044655,119,17,35,7,178
568051329,46,33,2,3,84
568052796,51,3,2,1,57
568067469,59,38,19,19,135
568069231,376,3,2,2,383
568069588,130,58,24,1,213
568071994,109,28,2,8,147
568072280,27,67,13,6,113
568073280,53,16,2,1,72
568075313,11,3,2,1,17
568077116,30,18,2,1,51
568085321,11,30,2,1,44
568086317,21,10,5,1,37
568086867,49,35,30,11,125
568088857,16,3,2,1,22
568106420,68,18,25,37,148
568112093,27,26,2,1,56
568124667,50,36,21,28,135
568125917,43,15,21,1,80
568144552,96,55,45,2,198
568162195,12,3,2,1,18
568170693,140,23,8,7,178
568173459,96,13,12,15,136
568185729,54,37,9,1,101
568203597,10,3,2,10,25
568205750,88,18,3,1,110
568206936,151,17,9,2,179
568207972,10,17,10,7,44
568210872,10,19,2,1,32
568221614,32,25,8,21,86
568224276,34,20,17,1,72
568232250,150,33,8,9,200
568254827,120,3,2,1,126
568265446,17,8,2,1,28
568269898,32,3,2,1,38
568278126,114,12,14,16,156
568280637,37,7,2,1,47
568295690,52,39,11,15,117
568299993,108,12,18,20,158
568306085,99,19,15,1,134
568316045,523,6,2,10,541
568318361,64,15,7,1,87
568318940,24,51,3,1,79
568325692,17,3,2,14,36
568327277,28,3,2,1,34
568329216,77,6,2,1,86
568331234,48,47,26,5,126
568360492,77,35,21,29,162
568371441,141,30,2,2,175
568373673,10,3,2,3,18
568376452,142,32,3,1,178
568382574,42,8,11,3,64
568391640,46,19,29,16,110
568396421,41,26,26,4,97
568403571,91,34,4,4,133
568420372,40,17,2,1,60
568441227,140,25,2,5,172
568443218,92,3,2,1,98
568451965,121,9,2,1,133
568472822,94,42,9,1,146
568493107,40,34,7,1,82
568500311,236,24,3,17,280
568501295,94,3,2,1,100
568503533,16,3,2,1,22
568506094,39,3,2,3,47
568511399,19,25,2,1,47
568522840,13,24,2,6,45
568531799,109,3,2,4,118
568536009,49,16,55,1,121
568545461,111,12,5,4,132
568547650,137,3,2,1,143
568556955,130,3,2,7,142
568568843,82,34,93,55,264
568584908,10,4,2,1,17
568588826,23,3,2,1,29
568592365,18,29,2,1,50
568600337,47,46,11,8,112
568607478,122,3,2,1,128
568608511,101,16,33,9,159
568609455,135,13,3,1,152
568651457,450,3,2,11,466
568662745,42,32,30,8,112
568710646,77,14,2,2,95
568712245,16,3,2,1,22
568716593,38,24,11,18,91
568729984,60,3,2,1,66
568736341,56,3,2,1,62
568737294,81,20,8,1,110
568765854,35,33,2,6,76
568782298,12,3,2,1,18
568783468,40,30,51,10,131
568791908,75,33,29,20,157
568800784,50,3,2,1,56
568802066,71,3,2,1,77
568811793,21,3,2,1,27
568832238,200,41,16,1,258
568833405,56,3,2,1,62
568833432,135,3,2,4,144
568842510,52,3,2,9,66
568853740,36,3,2,1,42
568854602,12,3,2,1,18
568855226,117,3,2,9,131
568898178,164,24,8,3,199
568911006,143,37,56,1,237
568926897,11,4,2,1,18
568932288,93,4,14,1,112
568942211,123,3,2,2,130
568959195,41,9,2,1,53
568967208,23,3,2,6,34
568971847,29,17,19,1,66
568975092,48,25,12,2,87
568991435,60,3,2,1,66
568995223,10,14,2,1,27
569005650,12,3,2,1,18
569010020,85,10,2,4,101
569016008,104,21,2,4,131
569033235,18,4,2,17,41
569039675,32,15,2,10,59
569039709,124,29,135,2,290
569040383,23,14,2,1,40
569059839,26,3,2,1,32
569072284,51,35,27,1,114
569109336,12,3,2,1,18
569129371,56,18,2,2,78
569130748,39,24,37,11,111
569142599,19,9,7,1,36
569154623,10,4,2,1,17
569170187,68,19,28,4,119
569175325,99,3,2,2,106
569178363,81,75,24,23,203
569191351,11,15,2,1,29
569205093,10,6,2,1,19
569212897,90,31,2,1,124
569225710,28,19,2,1,50
569236251,53,40,14,18,125
569246407,82,21,28,25,156
569248827,17,25,2,7,51
569260265,18,9,2,3,32
569262830,85,25,2,1,113
569283288,15,3,2,1,21
569286682,136,75,3,1,215
569287981,74,31,10,6,121
569300665,29,38,2,3,72
569316385,79,3,2,1,85
569349189,65,3,2,2,72
569370534,18,5,3,7,33
569379120,72,35,44,2,153
569385285,84,22,2,5,113
569389200,107,4,20,10,141
569405680,13,10,2,9,34
569409457,27,34,32,8,101
569428137,22,3,2,1,28
569429187,23,23,17,6,69
569434592,70,80,3,11,164
569440507,47,83,2,6,138
569461021,37,3,2,1,43
569463866,98,9,2,1,110
569479639,10,7,6,7,30
569490997,38,3,2,16,59
569494305,45,111,2,4,162
569507166,19,16,17,1,53
569515014,23,6,2,1,32
569535491,74,3,2,1,80
569553232,18,3,2,3,26
569557706,65,83,31,1,180
569560156,10,4,2,1,17
569575091,46,3,2,1,52
569575793,196,3,38,5,242
569576437,64,37,61,16,178
569588067,18,3,2,2,25
569591932,12,3,2,1,18
569608339,46,3,2,3,54
569609140,11,3,2,1,17
569615853,109,37,44,55,245
569619031,27,6,2,4,39
569628795,43,89,24,1,157
569631813,90,7,2,38,137
569638767,32,20,48,1,101
569642261,173,25,3,7,208
569659282,66,58,33,24,181
569675225,11,3,2,1,17
569691145,11,3,2,1,17
569692222,11,3,2,1,17
569695490,51,11,2,2,66
569699300,77,45,10,7,139
569699381,12,22,2,1,37
569702709,19,25,2,1,47
569712381,98,20,85,21,224
569716017,70,23,54,6,153
569726018,15,6,2,2,25
569738405,57,55,3,4,119
569741864,10,5,2,4,21
569746297,115,12,2,3,132
569761025,53,43,29,28,153
569763450,45,36,48,3,132
569766740,89,9,3,3,104
569768051,21,3,2,1,27
569768180,74,9,2,7,92
569774500,12,7,2,1,22
569781408,66,17,2,19,104
569790253,95,3,2,1,101
569794613,19,3,2,2,26
569805840,121,5,2,3,131
569826600,57,9,9,1,76
569838045,14,3,2,1,20
569843081,95,41,2,1,139
569860010,28,5,2,3,38
569866851,11,8,2,1,22
569872640,75,28,8,1,112
569877596,51,14,11,12,88
569879805,17,3,2,1,23
569883649,53,3,2,1,59
569886005,52,35,8,3,98
569900414,23,11,20,1,55
569904159,12,5,2,1,20
569922934,112,29,33,4,178
569951392,69,74,8,8,159
569952828,96,3,3,6,108
569953873,48,7,2,1,58
569966338,103,22,17,1,143
569968162,103,11,2,45,161
569970141,210,19,3,6,238
569985809,26,19,59,1,105
569988318,16,109,6,1,132
570012258,105,44,2,9,160
570018233,44,29,19,55,147
570035472,115,3,2,1,121
570039238,73,25,51,1,150
570040882,41,18,3,18,80
570044701,42,38,2,3,85
570050980,92,3,2,3,100
570056554,49,10,4,1,64
570058004,78,25,5,41,149
570075734,248,37,7,4,296
570097399,15,72,13,2,102
570118703,159,39,3,21,222
570140524,13,20,2,1,36
570155670,87,8,2,2,99
570172486,15,3,2,1,21
570173306,47,53,4,24,128
570200659,40,3,2,7,52
570209217,125,3,2,7,137
570226947,11,52,2,1,66
570228379,151,3,2,3,159
570233417,21,3,2,1,27
570273089,52,3,2,1,58
570277882,46,12,17,5,80
570284683,105,82,22,9,218
570288620,12,25,2,1,40
570294826,27,33,4,1,65
570307961,26,17,3,9,55
570315553,40,32,48,3,123
570331414,72,16,2,1,91
570334817,36,19,10,1,66
570350337,94,44,3,19,160
570357447,80,42,2,16,140
570370594,283,85,29,10,407
570378874,188,30,2,10,230
570379370,47,28,53,14,142
570382406,118,3,2,28,151
570382831,150,3,2,3,158
570403592,16,18,7,2,43
570405332,13,3,2,1,19
570406535,51,3,2,2,58
570418298,15,8,2,1,26
570418312,49,3,2,10,64
570418429,32,27,5,1,65
570423403,28,15,3,4,50
570446664,95,61,81,13,250
570453162,14,53,2,1,70
570461537,84,24,4,15,127
570475967,76,9,2,2,89
570479695,37,3,2,5,47
570482491,56,4,2,8,70
570497365,97,27,11,1,136
570515630,42,23,37,4,106
570518958,105,7,50,1,163
570529542,31,3,2,1,37
570558541,175,3,2,2,182
570568848,81,28,34,3,146
570573967,11,3,2,1,17
570583960,16,3,2,2,23
570595172,10,4,2,1,17
570609286,104,17,7,3,131
570622023,12,3,2,1,18
570643930,11,3,2,2,18
570645958,47,107,34,34,222
570664795,102,31,61,30,224
570675083,19,7,2,4,32
570683874,12,6,2,1,21
570692163,20,7,2,1,30
570699018,38,7,2,1,48
570699489,358,41,2,8,409
570718181,154,36,3,1,194
570719119,11,3,2,1,17
570725973,20,72,100,30,222
570727292,136,72,24,1,233
570733601,13,10,2,3,28
570740298,10,3,2,3,18
570757069,32,12,4,1,49
570758651,11,3,2,4,20
570761910,11,3,2,1,17
570777445,67,18,2,6,93
570786708,199,17,2,4,222
570799052,12,3,2,1,18
570801242,52,25,2,4,83
570819008,10,3,2,2,17
570832091,43,9,5,8,65
570845417,11,4,2,2,19
570853343,12,15,16,1,44
570856036,121,45,48,1,215
570862463,56,61,9,3,129
570876054,114,29,3,1,147
570883136,119,3,2,2,126
570889403,30,20,2,1,53
570894414,180,16,2,1,199
570897895,129,10,2,2,143
570899362,40,15,25,11,91
570912515,143,17,4,8,172
570919488,42,40,25,12,119
570920112,14,34,2,1,51
570929438,24,32,14,2,72
570940577,42,37,3,6,88
570947205,25,3,2,1,31
570950120,13,6,2,4,25
570958934,28,51,4,7,90
570967940,13,4,2,1,20
570985624,87,14,2,1,104
570991071,52,3,2,1,58
570995162,31,32,6,1,70
570995727,15,9,2,2,28
571003912,107,4,2,2,115
571009278,19,9,2,2,32
571010385,32,14,5,1,52
571014430,26,40,3,3,72
571017372,21,13,2,2,38
571018772,52,3,2,2,59
571018996,99,46,2,8,155
571020206,72,43,28,11,154
571020562,26,5,2,1,34
571023037,82,18,2,1,103
571040292,13,3,2,2,20
571046769,89,31,30,18,168
571053093,10,5,2,2,19
571063881,23,12,12,2,49
571085965,29,5,6,3,43
571086610,10,15,2,1,28
571089437,29,3,2,6,40
571095692,61,3,2,5,71
571099508,114,3,2,1,120
571107980,67,44,2,9,122
571111703,290,22,20,1,333
571115282,46,44,37,6,133
571117191,73,17,52,1,143
571117715,18,3,2,5,28
571157511,12,3,2,2,19
571164902,88,13,26,84,211
571187998,12,54,54,6,126
571212874,31,19,12,3,65
571232234,50,46,4,2,102
571238507,142,29,3,29,203
571264924,52,49,2,5,108
571269283,70,15,2,3,90
571283360,10,3,2,2,17
571290024,63,3,6,8,80
571296597,27,3,2,1,33
571296914,10,34,2,1,47
571297130,26,3,2,1,32
571297942,12,18,2,1,33
571299983,139,96,68,9,312
571313160,120,47,6,1,174
571317971,44,3,2,5,54
571354143,25,3,2,1,31
571360166,75,10,2,4,91
571373106,100,4,2,15,121
571381921,17,3,2,1,23
571397293,108,3,2,1,114
571397703,86,3,2,5,96
571407848,122,42,40,49,253
571408882,153,56,4,20,233
571415807,50,3,2,1,56
571424413,10,3,2,2,17
571434066,193,8,2,3,206
571457988,45,43,7,7,102
571476832,87,17,6,3,113
571481465,15,22,2,10,49
571484320,46,18,37,1,102
571487477,118,41,62,2,223
571491353,90,3,2,2,97
571516319,14,4,2,1,21
571533875,26,61,10,4,101
571553217,77,30,6,4,117
571558104,85,53,2,1,141
571563782,23,5,2,1,31
571566201,481,3,2,1,487
571572119,11,17,2,1,31
571581519,45,21,8,1,75
571584466,106,3,2,4,115
571585179,115,30,12,44,201
571596504,97,48,34,24,203
571603390,13,3,2,1,19
571614166,33,16,2,1,52
571627459,11,3,2,1,17
571640678,44,13,2,8,67
571645026,370,12,2,15,399
571656408,125,19,2,1,147
571656774,39,69,8,16,132
571662003,123,11,3,17,154
571678879,93,12,5,1,111
571690851,22,4,2,1,29
571691618,42,22,2,1,67
571694384,12,6,2,1,21
571703159,84,3,2,1,90
571709648,82,37,8,3,130
571712130,81,3,2,2,88
571714838,20,56,6,8,90
571741963,16,3,2,2,23
571752786,81,3,2,6,92
571759114,13,3,2,2,20
571785294,63,22,9,73,167
571788556,119,10,2,5,136
571797469,104,38,19,14,175
571807692,193,64,98,27,382
571812292,20,21,9,1,51
571818950,61,4,11,1,77
571823769,73,24,2,1,100
571828505,11,3,2,1,17
571835061,49,21,76,17,163
571841471,13,44,2,1,60
571844415,31,9,2,4,46
571862837,67,8,3,1,79
571863404,31,19,4,4,58
571867042,36,8,2,1,47
571869813,55,29,15,1,100
571880788,16,12,3,1,32
571891225,22,3,2,2,29
571905912,62,74,80,50,266
571910487,80,6,3,3,92
571918489,11,3,12,1,27
571940522,20,3,2,1,26
571974206,21,17,3,1,42
571975310,59,34,24,5,122
571976021,51,3,2,1,57
571985976,10,8,2,1,21
572007275,18,21,4,3,46
572012728,65,67,46,2,180
572025636,16,51,2,1,70
572029935,91,3,2,1,97
572035807,26,18,2,6,52
572046761,33,39,2,1,75
572068030,25,52,21,5,103
572070081,130,22,11,6,169
572078963,10,4,2,2,18
572084964,48,3,2,2,55
572085813,29,17,2,1,49
572112540,265,3,2,27,297
572113392,11,3,2,1,17
572114569,30,24,28,1,83
572120440,303,26,46,35,410
572140473,26,3,2,1,32
572140775,28,31,45,1,105
572142001,39,3,17,3,62
572148877,83,27,2,3,115
572152879,108,3,2,2,115
572171605,30,13,2,3,48
572175050,106,3,2,1,112
572178558,46,39,20,9,114
572193311,11,6,5,5,27
572198279,87,18,24,25,154
572202087,10,14,3,2,29
572208073,39,4,2,1,46
572208462,53,3,2,53,111
572211280,22,16,8,1,47
572242915,10,34,10,1,55
572257153,29,16,2,1,48
572277679,56,11,2,1,70
572312739,21,148,29,3,201
572322727,24,3,2,2,31
572330715,10,3,2,2,17
572341859,82,5,12,1,100
572342524,19,6,2,4,31
572344540,11,3,2,1,17
572373735,123,37,55,30,245
572378300,30,3,2,1,36
572380622,40,13,12,4,69
572387934,133,11,2,2,148
572390767,13,50,2,1,66
572409912,48,3,2,3,56
572425487,63,26,2,1,92
572433635,15,8,2,1,26
572443132,18,3,2,1,24
572452509,34,22,2,1,59
572453858,48,18,26,42,134
572454485,303,83,16,4,406
572455124,10,9,2,1,22
572469120,12,3,2,1,18
572481080,11,3,2,1,17
572482370,31,3,2,1,37
572483150,32,9,2,1,44
572485199,88,20,4,25,137
572487064,32,11,2,1,46
572494839,440,7,2,9,458
572496029,45,28,10,2,85
572503953,13,3,2,1,19
572522871,15,3,2,1,21
572551198,148,16,37,5,206
572555615,151,3,2,1,157
572560649,23,3,2,18,46
572570349,21,5,2,1,29
572588252,43,24,2,5,74
572594115,66,109,10,2,187
572596552,27,3,2,4,36
572602847,218,59,66,181,524
572626990,16,3,2,1,22
572632963,38,3,2,1,44
572637079,44,37,15,18,114
572641543,60,63,16,4,143
572641821,69,6,2,2,79
572643763,46,40,2,3,91
572647985,25,43,32,1,101
572657625,172,16,17,43,248
572675086,15,15,2,1,33
572685988,128,31,2,1,162
572691437,13,7,2,1,23
572695710,111,3,2,1,117
572699704,106,31,19,1,157
572700410,13,3,2,1,19
572706664,50,36,79,2,167
572722141,25,26,73,13,137
572733106,38,30,2,1,71
572740443,17,8,2,1,28
572746051,117,30,53,1,201
572751401,49,3,2,4,58
572763429,50,6,17,7,80
572773519,38,6,2,17,63
572790632,58,39,3,15,115
572831441,91,3,2,1,97
572839026,35,59,17,1,112
572851884,46,17,12,4,79
572858374,37,20,8,1,66
572861523,65,3,2,1,71
572862515,11,6,2,1,20
572867427,273,3,2,2,280
572879087,41,3,2,1,47
572886084,39,3,11,1,54
572891175,69,48,2,15,134
572898600,89,85,37,4,215
572909142,217,3,2,18,240
572914192,64,8,2,19,93
572926711,12,3,2,1,18
572930685,89,47,2,1,139
572933865,133,48,3,6,190
572942787,22,29,16,1,68
572949733,83,35,26,47,191
572966972,167,3,2,2,174
572985073,12,24,2,4,42
572989514,97,32,52,18,199
572990102,68,40,47,42,197
572997957,12,3,2,3,20
572998441,95,3,2,1,101
573006678,10,5,2,1,18
573006722,39,11,5,1,56
573029903,171,6,4,6,187
573037358,65,21,2,1,89
573037565,17,10,2,1,30
573046115,21,3,2,1,27
573052809,50,3,2,1,56
573061972,34,35,12,4,85
573072130,103,6,2,2,113
573079328,66,3,2,5,76
573080847,33,16,2,1,52
573095002,83,18,4,18,123
573095016,64,3,2,1,70
573098204,12,3,2,1,18
573100713,24,3,2,1,30
573150218,30,3,2,1,36
573159634,156,3,2,1,162
573163583,144,28,7,9,188
573164818,102,19,12,11,144
573176480,64,12,5,3,84
573187196,50,8,7,18,83
573239215,99,3,2,2,106
573248158,50,102,18,2,172
573250301,41,22,7,2,72
573271821,19,3,2,1,25
573276922,71,36,5,5,117
573278220,41,35,45,1,122
573282563,165,18,2,1,186
573286400,45,54,53,6,158
573294931,10,6,2,1,19
573297677,127,3,2,1,133
573337162,31,11,13,1,56
573344474,13,3,2,3,21
573352901,16,3,2,1,22
573386207,30,18,12,3,63
573392657,34,17,4,5,60
573437072,10,9,2,1,22
573445188,21,3,2,1,27
573447440,26,15,2,2,45
573470064,27,3,2,6,38
573481458,159,36,4,33,232
573481627,37,23,2,1,63
573485961,19,35,5,1,60
573507900,94,3,2,1,100
573509737,12,3,2,1,18
573521621,17,4,2,1,24
573522586,104,31,9,3,147
573526817,86,43,26,23,178
573530136,10,11,2,1,24
573537207,48,4,10,4,66
573537340,142,18,2,2,164
573551631,87,50,18,2,157
573556312,17,3,2,1,23
573560492,16,3,2,1,22
573667623,43,17,6,2,68
573683374,85,3,3,10,101
573687263,15,3,2,1,21
573717304,30,37,2,1,70
573734995,10,13,2,1,26
573742535,25,3,2,3,33
573750132,82,54,3,1,140
573765495,10,5,2,1,18
573771125,27,3,2,9,41
573779012,33,30,4,3,70
573786943,17,10,2,3,32
573787106,80,15,3,1,99
573791745,82,21,15,1,119
573793984,22,3,2,1,28
573805128,25,83,2,8,118
573808522,72,28,5,19,124
573819728,207,55,41,58,361
573825016,16,7,2,4,29
573829953,115,27,25,11,178
573836793,13,5,2,1,21
573861300,21,8,2,1,32
573892835,30,31,8,3,72
573902359,23,23,16,1,63
573918604,42,16,12,1,71
573924426,67,3,6,2,78
573935121,66,25,19,12,122
573943831,119,3,2,1,125
573948960,18,33,2,5,58
573964159,115,18,44,4,181
573982386,30,3,2,10,45
573984166,44,3,2,1,50
574011747,60,3,2,1,66
574012842,11,3,2,1,17
574017862,76,3,2,4,85
574018095,241,3,2,18,264
574019013,26,3,2,1,32
574024989,45,7,2,4,58
574050896,75,43,28,8,154
574054471,87,21,2,2,112
574062568,88,85,26,3,202
574066034,12,3,2,2,19
574073752,90,3,2,2,97
574105412,10,4,2,1,17
574110950,46,3,2,1,52
574113878,98,12,94,3,207
574119111,16,3,2,1,22
574122286,15,3,2,1,21
574124741,104,30,4,48,186
574135734,11,3,2,1,17
574136087,22,40,2,7,71
574144405,44,50,48,42,184
574149535,82,21,13,8,124
574157470,40,13,2,1,56
574161550,39,7,2,2,50
574163696,30,50,16,15,111
574164750,152,3,2,1,158
574185221,35,19,24,34,112
574193866,31,33,2,1,67
574195416,19,3,2,1,25
574202339,19,3,2,1,25
574205255,39,36,13,4,92
574210928,15,3,2,2,22
574215432,42,19,24,1,86
574224104,39,13,2,1,55
574237427,82,22,2,4,110
574245122,131,3,2,1,137
574251014,32,60,42,8,142
574261796,22,3,2,1,28
574265135,80,36,64,4,184
574266147,14,3,2,1,20
574266774,186,3,2,2,193
574288627,96,32,17,71,216
574289056,61,20,5,1,87
574299931,16,3,2,2,23
574314869,28,3,2,1,34
574315165,21,3,2,2,28
574324742,124,45,142,9,320
574327661,100,5,2,9,116
574336896,38,3,2,5,48
574340010,15,29,2,1,47
574340211,33,3,2,4,42
574347201,27,33,30,1,91
574348347,29,15,11,1,56
574363626,71,8,2,1,82
574374214,67,35,2,4,108
574384380,24,21,2,6,53
574386666,10,11,2,1,24
574387512,27,25,11,52,115
574389053,129,26,85,3,243
574399163,54,23,26,5,108
574423213,46,17,11,9,83
574425324,83,30,15,9,137
574427551,25,3,2,1,31
574432490,107,3,2,3,115
574451904,223,65,98,30,416
574457525,77,35,8,11,131
574458029,95,6,66,3,170
574460393,153,53,61,3,270
574461479,59,10,2,10,81
574466338,49,3,2,1,55
574481658,13,14,2,1,30
574513309,85,20,114,1,220
574517900,82,3,2,1,88
574517957,34,53,7,2,96
574519786,13,3,2,1,19
574530869,101,5,2,9,117
574536264,61,3,2,1,67
574536418,19,47,2,1,69
574536755,12,3,2,1,18
574551560,10,9,2,1,22
574554668,57,71,48,2,178
574554936,43,45,3,3,94
574556962,24,5,5,3,37
574566425,37,3,2,4,46
574573966,96,3,2,9,110
574575133,23,3,2,1,29
574578892,117,14,2,1,134
574581498,55,3,2,1,61
574587243,20,31,2,1,54
574588395,144,50,19,36,249
574593081,16,3,2,1,22
574594388,94,42,2,1,139
574618489,167,25,2,10,204
574622299,32,20,8,1,61
574636830,10,13,2,1,26
574640288,97,36,7,1,141
574641330,62,15,7,1,85
574645133,50,29,15,13,107
574671143,85,24,7,1,117
574672376,199,8,107,6,320
574687309,11,3,2,1,17
574688258,48,5,6,1,60
574689233,61,8,54,14,137
574691679,40,22,15,23,100
574695883,85,3,2,9,99
574699435,104,56,25,9,194
574711943,78,51,22,26,177
574722542,79,55,34,5,173
574729608,13,16,2,1,32
574734453,50,3,2,5,60
574736794,108,16,7,20,151
574745105,17,7,2,2,28
574748105,34,119,20,3,176
574762606,31,18,2,10,61
574763411,15,5,2,1,23
574774829,312,7,6,8,333
574793922,62,65,54,20,201
574806905,54,69,83,8,214
574810060,53,37,26,4,120
574810221,86,17,2,2,107
574815545,33,42,5,2,82
574830867,94,32,2,1,129
574831443,104,3,2,2,111
574836244,81,40,36,20,177
574837174,31,18,68,1,118
574839784,42,18,10,36,106
574842413,85,46,18,13,162
574850522,15,22,3,1,41
574850859,19,3,2,2,26
574856828,16,20,2,1,39
574860045,146,39,2,1,188
574866344,154,3,2,2,161
574868272,16,3,2,1,22
574872528,76,34,7,1,118
574880918,10,3,2,10,25
574881215,14,3,2,1,20
574894078,335,52,2,4,393
574900910,44,16,2,1,63
574905081,70,17,9,12,108
574921691,67,44,20,4,135
574931281,32,11,2,8,53
574945538,75,19,4,3,101
574950458,106,3,2,3,114
574951428,42,34,11,1,88
574957754,11,6,2,1,20
574975675,99,3,2,11,115
574979667,11,3,2,1,17
574984234,59,6,2,10,77
574986544,11,3,2,1,17
574989177,23,3,2,3,31
574993841,100,13,3,11,127
574997311,10,4,2,1,17
575004634,14,3,2,1,20
575019823,71,3,2,1,77
575020760,96,3,2,1,102
575028755,29,42,5,1,77
575045036,18,4,2,1,25
575052541,18,28,2,2,50
575064241,18,6,2,9,35
575077063,27,3,2,1,33
575087015,10,5,2,1,18
575094968,58,60,6,3,127
575095606,48,18,12,3,81
575106512,34,27,3,1,65
575129019,10,19,2,1,32
575130256,16,21,2,1,40
575130595,136,25,2,21,184
575131530,17,3,2,3,25
575131638,12,4,2,1,19
575137358,79,38,35,22,174
575152258,10,3,2,2,17
575164462,59,6,2,1,68
575164705,13,14,2,1,30
575168929,19,26,2,1,48
575176286,116,21,54,8,199
575184226,83,3,2,2,90
575190746,125,92,62,1,280
575221242,86,61,24,8,179
575223794,62,13,2,7,84
575238010,55,18,2,20,95
575241739,18,3,2,1,24
575247451,10,3,2,3,18
575258129,12,3,2,1,18
575260553,22,41,14,7,84
575270132,18,3,2,1,24
575286243,36,23,33,8,100
575289413,12,3,2,1,18
575293984,26,29,3,15,73
575305720,32,10,2,1,45
575309622,14,3,2,1,20
575321725,21,3,2,1,27
575328417,14,3,2,1,20
575339178,43,6,2,41,92
575361389,14,3,2,1,20
575364518,10,3,2,2,17
575367491,87,41,43,11,182
575375627,55,48,23,1,127
575382759,31,9,14,1,55
575383081,10,10,2,1,23
575388967,39,3,2,1,45
575389530,242,3,2,5,252
575397422,73,3,2,1,79
575404143,81,18,4,2,105
575405215,54,7,13,7,81
575406297,138,8,2,4,152
575415971,28,8,2,1,39
575429999,79,20,4,1,104
575434116,54,7,3,17,81
575436615,107,41,140,7,295
575442624,57,5,6,1,69
575444198,70,21,3,42,136
575444700,61,28,3,1,93
575458710,74,20,2,9,105
575460156,91,28,14,27,160
575463827,37,37,93,23,190
575499085,120,3,2,2,127
575509658,11,3,2,1,17
575518051,36,39,8,12,95
575527423,88,3,2,22,115
575539420,153,45,42,39,279
575541505,43,29,58,1,131
575543318,60,28,3,8,99
575543472,13,6,2,1,22
575559060,47,29,3,16,95
575578177,32,29,2,5,68
575583586,135,3,2,1,141
575591276,60,14,4,11,89
575599388,11,3,2,1,17
575612061,79,90,28,15,212
575625801,62,3,2,3,70
575626628,86,30,2,1,119
575630022,150,24,3,5,182
575631290,42,11,3,1,57
575631681,49,55,4,18,126
575648378,75,16,44,1,136
575681702,101,20,8,6,135
575692977,60,18,39,11,128
575729703,67,10,40,1,118
575730826,63,20,2,7,92
575741053,15,12,2,1,30
575743068,73,36,102,19,230
575758080,161,3,2,3,169
575786318,54,75,59,12,200
575787573,39,15,2,9,65
575790906,41,3,2,1,47
575792461,12,3,2,1,18
575808178,38,9,2,1,50
575812248,204,8,2,82,296
575813080,16,3,2,1,22
575819575,97,15,36,42,190
575836196,96,24,14,59,193
575839405,39,24,5,2,70
575842585,27,3,2,1,33
575861166,78,5,2,1,86
575861613,204,15,63,5,287
575865879,63,30,2,1,96
575885032,29,34,2,4,69
575888064,14,8,2,1,25
575889935,139,3,3,29,174
575898676,18,3,2,1,24
575903569,23,3,2,24,52
575924388,14,3,2,1,20
575926733,55,3,2,1,61
575929106,95,12,46,11,164
575935832,31,3,2,2,38
575946674,46,5,2,1,54
575949839,27,7,2,1,37
575964428,91,65,54,20,230
575975200,29,29,2,1,61
575985706,40,72,6,2,120
575988929,125,33,2,3,163
575992940,26,3,2,1,32
575994348,48,4,11,4,67
576003509,36,3,2,3,44
576003754,15,3,2,1,21
576009433,26,3,3,3,35
576017270,27,29,19,8,83
576031814,26,23,2,2,53
576032148,56,29,6,1,92
576033716,193,40,7,3,243
576037685,10,5,2,1,18
576045151,64,3,2,1,70
576048218,59,56,43,17,175
576050054,16,3,2,1,22
576051491,192,63,50,6,311
576051615,36,4,2,1,43
576054287,87,3,2,1,93
576065035,43,8,2,1,54
576078553,14,22,8,2,46
576079135,23,13,13,3,52
576081753,56,3,2,1,62
576083397,33,102,62,1,198
576086971,92,50,56,20,218
576112797,203,3,2,8,216
576113397,59,3,2,3,67
576115130,93,3,2,5,103
576141032,138,5,2,7,152
576147878,151,3,6,3,163
576168555,192,23,15,19,249
576170252,22,39,68,2,131
576170647,29,3,2,1,35
576178262,38,3,2,1,44
576194302,136,17,8,1,162
576202972,12,3,2,1,18
576236065,130,3,2,5,140
576243410,14,3,2,1,20
576243846,54,92,2,13,161
576244748,245,3,2,6,256
576245369,45,23,2,2,72
576254310,38,17,2,3,60
576254646,100,21,2,2,125
576254852,80,50,44,1,175
576260015,60,3,4,1,68
576279650,51,37,2,3,93
576288110,30,16,29,13,88
576289044,33,3,2,22,60
576294231,11,3,2,1,17
576294949,93,33,36,9,171
576299647,484,25,2,3,514
576306699,98,11,11,11,131
576309281,87,25,9,3,124
576312740,29,5,2,1,37
576318088,114,30,2,2,148
576321353,37,3,2,1,43
576333438,172,22,59,1,254
576347607,48,34,27,12,121
576357044,79,51,27,19,176
576361884,63,53,3,8,127
576371210,119,23,46,7,195
576374052,31,13,2,4,50
576380005,16,23,2,1,42
576398038,11,15,2,1,29
576401877,129,74,30,6,239
576405035,19,20,2,1,42
576405800,44,20,43,11,118
576409259,12,4,2,4,22
576417877,44,22,13,2,81
576422051,62,8,3,1,74
576422625,15,6,2,1,24
576424177,11,3,2,1,17
576424446,15,3,2,1,21
576436195,160,6,35,1,202
576445740,36,3,2,1,42
576486293,26,79,3,3,111
576497243,62,3,51,1,117
576498587,18,10,4,1,33
576511171,52,17,16,1,86
576512366,31,35,24,4,94
576514000,37,4,4,1,46
576520005,36,37,2,1,76
576528179,157,5,3,8,173
576530343,53,3,2,1,59
576555859,223,52,31,31,337
576566832,31,16,4,1,52
576573564,128,24,16,22,190
576577584,102,3,2,1,108
576596520,47,17,2,16,82
576620931,49,9,19,4,81
576621805,12,21,2,6,41
576633819,16,26,4,7,53
576650650,125,48,45,34,252
576651699,18,3,2,1,24
576652159,29,18,2,5,54
576672424,16,8,2,1,27
576673205,11,3,2,1,17
576694279,50,3,2,1,56
576696991,68,8,2,4,82
576708500,21,3,2,2,28
576712868,21,28,2,1,52
576718370,44,4,2,1,51
576737859,142,49,2,21,214
576738985,145,3,2,1,151
576746019,11,3,2,1,17
576762792,10,26,2,1,39
576766512,37,7,11,1,56
576776352,76,34,16,1,127
576784721,123,55,7,4,189
576785471,38,12,6,1,57
576787914,46,32,4,1,83
576788975,79,52,8,12,151
576809097,165,9,4,1,179
576809549,37,33,10,1,81
576809714,40,3,2,1,46
576828319,50,13,5,38,106
576840652,77,12,2,3,94
576849193,184,33,9,11,237
576857440,181,3,2,22,208
576858884,10,3,2,2,17
576883216,129,4,2,1,136
576894672,28,3,2,1,34
576911342,30,17,16,1,64
576923742,10,14,2,1,27
576925663,42,27,3,3,75
576931783,37,47,14,1,99
576936202,108,3,2,1,114
576942520,81,3,2,1,87
576945597,32,17,3,2,54
576964614,13,3,2,1,19
576965050,40,5,7,1,53
576975889,86,51,16,6,159
576984901,126,32,22,1,181
576985684,193,36,24,11,264
576995835,62,17,28,1,108
577001092,20,6,2,1,29
577006585,115,3,2,1,121
577009794,21,4,2,1,28
577016301,71,3,2,2,78
577020358,34,3,2,8,47
577020633,72,13,5,28,118
577035956,65,41,16,2,124
577036006,10,4,2,1,17
577056187,84,3,2,1,90
577061167,76,3,2,6,87
577062452,49,29,2,3,83
577076734,129,5,13,4,151
577084231,89,3,2,1,95
577095637,70,10,2,1,83
577095904,135,30,59,8,232
577104351,14,6,2,3,25
577110186,69,21,5,6,101
577110606,19,16,43,1,79
577123505,36,3,2,1,42
577131212,56,3,2,5,66
577135517,157,27,99,1,284
577145261,182,9,2,4,197
577174811,97,9,19,39,164
577176922,20,3,2,1,26
577177271,54,49,10,21,134
577196898,48,72,2,6,128
577220112,72,44,19,3,138
577220301,15,3,2,1,21
577224083,64,5,2,5,76
577230186,235,66,17,63,381
577231994,19,3,2,1,25
577248802,176,15,18,1,210
577262027,33,49,21,3,106
577269369,14,5,4,2,25
577290421,167,3,2,9,181
577303316,27,9,2,1,39
577308846,104,64,31,27,226
577313418,12,3,2,2,19
577315656,82,3,2,39,126
577318161,131,86,3,16,236
577327544,68,20,139,4,231
577338607,10,4,2,5,21
577340036,10,8,2,1,21
577353836,42,52,37,38,169
577365559,108,3,2,3,116
577399098,17,43,2,5,67
577405640,33,35,2,1,71
577407008,41,8,2,1,52
577410505,90,32,2,12,136
577418292,51,48,28,1,128
577420075,56,16,5,2,79
577420133,82,53,70,3,208
577423216,36,17,2,3,58
577423558,102,5,2,2,111
577433267,39,25,4,1,69
577434221,36,89,12,27,164
577438305,12,28,2,2,44
577448030,19,3,2,1,25
577473499,39,25,2,1,67
577482634,22,3,2,1,28
577490417,13,87,21,1,122
577492074,72,56,28,19,175
577503074,73,12,3,5,93
577506874,12,4,2,1,19
577508902,122,23,36,6,187
577509159,23,14,2,1,40
577521769,44,15,3,1,63
577539337,35,13,5,2,55
577548619,35,26,15,35,111
577553108,101,3,2,4,110
577555955,76,36,29,44,185
577556533,21,3,2,3,29
577569135,65,43,9,7,124
577572378,45,17,54,4,120
577578637,43,13,38,31,125
577599747,52,8,6,23,89
577601072,67,12,2,1,82
577609782,103,55,2,31,191
577613195,19,12,25,1,57
577616074,82,41,2,6,131
577635267,29,14,6,3,52
577636769,26,41,73,1,141
577640760,11,3,2,1,17
577648080,92,18,5,14,129
577656803,160,49,13,1,223
577684801,39,3,2,4,48
577705657,118,27,41,28,214
577706597,14,3,2,1,20
577724950,135,31,23,51,240
577727265,75,6,2,1,84
577770966,11,3,2,1,17
577785340,18,19,8,7,52
577787020,78,58,2,27,165
577790822,22,16,2,1,41
577791911,93,34,42,6,175
577825943,33,8,2,7,50
577831178,10,3,2,9,24
577831779,120,9,2,8,139
577851538,16,11,2,1,30
577859096,35,3,2,1,41
577859737,86,11,2,1,100
577869319,11,4,2,1,18
577882489,50,38,5,1,94
577907008,65,25,2,2,94
577911889,20,27,3,5,55
577914699,183,48,62,1,294
577929500,40,56,27,7,130
577942898,74,18,2,4,98
577956208,20,5,2,2,29
577956791,181,30,5,3,219
577956819,96,3,2,1,102
577959965,20,3,2,1,26
577969394,40,22,9,9,80
577995761,35,46,7,1,89
578029150,58,17,24,14,113
578032629,458,3,62,35,558
578034752,144,29,50,3,226
578039624,113,20,11,1,145
578047494,16,30,2,1,49
578063491,153,24,2,1,180
578064865,106,3,2,2,113
578069493,118,3,2,2,125
578069794,35,3,2,4,44
578136541,29,3,2,4,38
578137740,19,17,70,1,107
578141717,72,45,16,11,144
578145147,114,121,11,7,253
578151961,10,6,2,1,19
578174634,99,23,81,15,218
578200072,23,3,2,1,29
578222583,29,3,2,1,35
578247031,159,18,12,1,190
578251835,153,52,7,12,224
578261032,36,4,2,14,56
578263118,132,21,4,11,168
578275236,14,3,2,1,20
578286520,55,27,20,1,103
578290249,11,3,2,1,17
578294824,11,3,2,1,17
578295467,22,3,2,1,28
578315033,190,29,19,1,239
578318082,384,3,2,3,392
578334709,221,14,2,1,238
578387667,28,30,2,3,63
578396973,32,51,43,2,128
578409453,39,37,67,1,144
578412313,20,30,2,14,66
578424406,86,3,2,3,94
578425602,10,5,2,1,18
578427622,103,16,3,8,130
578429787,88,31,11,17,147
578438772,79,3,2,1,85
578440002,26,26,28,1,81
578462783,23,65,2,1,91
578497097,93,8,29,16,146
578501712,10,11,2,2,25
578512605,13,3,2,6,24
578528550,93,3,2,1,99
578532636,57,3,2,1,63
578533906,32,9,2,3,46
578535671,59,6,37,1,103
578571055,18,9,2,4,33
578600978,52,24,94,1,171
578602067,20,10,37,1,68
578611649,20,3,2,1,26
578611929,17,3,2,1,23
578616090,90,3,2,1,96
578616384,76,13,26,8,123
578617829,13,29,2,1,45
578630061,42,14,2,2,60
578631321,11,3,2,1,17
578633731,55,46,6,28,135
578634728,11,3,2,2,18
578641215,35,26,3,1,65
578660690,77,7,29,1,114
578680033,79,10,10,3,102
578683475,43,32,9,3,87
578699822,36,19,6,7,68
578703651,19,3,2,1,25
578745985,276,3,2,1,282
578758238,146,48,45,26,265
578761792,11,3,2,1,17
578766296,61,75,17,19,172
578771863,43,59,10,9,121
578782184,90,4,2,9,105
578782253,22,3,2,1,28
578792112,10,3,2,2,17
578793327,23,6,2,7,38
578798637,13,3,2,1,19
578799732,13,3,2,1,19
578807622,21,3,2,1,27
578809952,211,3,2,13,229
578814549,57,31,2,2,92
578815062,76,42,29,4,151
578826053,18,3,2,1,24
578827164,21,97,29,1,148
578836227,31,32,30,26,119
578839348,64,17,2,1,84
578839888,186,26,2,1,215
578848258,21,3,2,1,27
578856270,59,36,2,1,98
578873720,66,50,41,15,172
578876247,94,12,32,2,140
578878398,23,31,2,2,58
578892868,49,28,23,13,113
578898885,12,56,2,17,87
578910175,17,45,89,7,158
578929702,133,42,21,19,215
578933064,53,3,2,1,59
578945487,73,35,20,11,139
578948168,12,52,2,1,67
578948183,94,77,37,38,246
578961963,53,75,2,26,156
578968426,31,11,2,1,45
578972860,53,6,2,1,62
578973275,79,10,70,1,160
578974194,11,3,2,4,20
578992931,101,23,35,5,164
578994194,10,8,2,1,21
579000547,12,3,2,1,18
579011895,281,3,2,1,287
579013446,16,19,21,5,61
579028695,23,38,2,1,64
579031491,57,29,46,10,142
579054843,574,3,2,6,585
579078466,76,19,2,15,112
579079353,11,3,2,1,17
579081644,24,3,2,2,31
579083730,17,6,2,1,26
579091496,93,11,33,11,148
579093912,13,3,2,1,19
579096778,232,3,3,1,239
579096876,119,12,2,2,135
579101195,175,3,2,1,181
579106162,62,21,2,5,90
579116809,77,55,23,9,164
579117097,59,23,2,5,89
579143260,54,57,35,2,148
579146504,14,3,2,1,20
579163315,38,22,51,1,112
579171185,25,3,2,1,31
579178083,133,3,2,1,139
579183952,26,36,3,1,66
579194915,13,6,2,1,22
579197350,10,3,2,2,17
579221321,121,3,2,13,139
579226959,64,52,12,1,129
579247645,51,3,2,1,57
579251056,52,28,2,1,83
579260979,134,29,12,5,180
579263753,205,73,74,47,399
579270975,12,3,2,1,18
579280350,123,3,2,1,129
579280732,16,10,2,2,30
579281723,164,19,15,1,199
579296386,39,3,23,36,101
579298551,121,25,2,6,154
579308272,90,25,2,5,122
579309811,13,3,2,1,19
579322605,57,49,21,86,213
579328723,82,9,2,10,103
579329559,113,10,3,2,128
579344895,95,3,2,1,101
579347695,75,3,2,36,116
579351452,68,45,52,2,167
579357136,11,11,2,1,25
579364978,41,13,44,17,115
579365990,31,43,23,2,99
579367581,15,3,2,1,21
579377023,138,19,21,40,218
579378028,103,61,13,30,207
579380405,40,24,9,1,74
579388334,61,26,46,1,134
579393454,15,3,2,1,21
579397967,65,3,2,1,71
579408507,20,3,2,1,26
579420404,83,96,2,11,192
579430854,108,3,2,1,114
579449853,30,16,11,2,59
579453836,85,20,2,9,116
579463044,86,12,2,28,128
579468753,90,24,3,7,124
579486950,18,3,2,4,27
579489850,26,3,2,4,35
579495557,13,3,2,1,19
579499537,125,27,3,1,156
579509204,98,3,4,2,107
579525713,18,21,2,1,42
579530230,78,3,2,1,84
579532752,54,36,7,22,119
579538059,74,22,4,24,124
579546539,36,19,22,8,85
579559242,78,20,2,1,101
579567760,17,3,2,7,29
579577782,64,5,2,19,90
579582673,62,28,7,1,98
579587486,58,65,46,3,172
579609476,166,22,8,1,197
579611924,11,3,2,3,19
579616849,27,26,2,16,71
579618185,66,3,2,1,72
579619993,11,3,2,1,17
579631499,51,24,2,1,78
579640430,18,9,2,1,30
579664468,14,7,2,1,24
579672239,14,3,2,1,20
579687847,38,20,28,1,87
579693240,23,53,22,1,99
579699981,22,3,2,2,29
579706648,19,3,2,1,25
579711678,12,3,2,1,18
579737881,22,3,2,1,28
579741701,14,10,2,1,27
579749850,11,3,2,1,17
579751339,38,4,3,1,46
579767093,12,3,2,1,18
579777207,93,47,4,1,145
579783773,28,28,49,3,108
579791532,203,14,2,6,225
579798157,30,8,7,2,47
579800539,65,4,8,2,79
579807801,24,3,2,2,31
579820794,76,13,94,1,184
579822777,47,64,2,17,130
579836865,29,36,6,5,76
579847192,26,22,11,14,73
579851225,20,7,30,17,74
579869828,313,28,20,33,394
579873916,70,17,2,1,90
579873991,54,23,2,1,80
579907181,37,3,2,1,43
579924618,119,4,2,3,128
579925216,18,29,6,1,54
579927665,10,15,2,1,28
579929820,87,12,39,24,162
579932791,44,24,9,25,102
579945232,11,3,2,1,17
579967545,64,3,2,1,70
579972808,132,3,2,13,150
579973017,16,7,2,1,26
579978710,30,3,2,8,43
579991679,57,21,10,2,90
579992649,21,97,3,6,127
579993186,56,20,21,2,99
580004928,17,5,2,1,25
580021976,31,18,18,1,68
580038936,10,8,2,1,21
580048670,21,3,2,1,27
580053958,14,8,2,1,25
580061378,49,3,5,1,58
580075240,75,16,4,4,99
580091290,17,39,2,1,59
580113515,91,34,16,16,157
580134388,84,3,2,1,90
580135369,10,6,2,1,19
580149956,35,34,2,7,78
580151754,25,7,2,1,35
580152286,70,81,4,3,158
580153290,203,3,2,3,211
580164865,202,34,41,3,280
580177705,12,3,2,1,18
580179787,133,11,3,1,148
580190662,324,12,2,1,339
580199795,20,9,6,1,36
580200770,16,12,2,1,31
580207299,35,66,2,1,104
580210550,40,14,9,10,73
580214694,10,4,2,1,17
580220561,29,4,2,1,36
580222355,21,89,2,11,123
580222611,121,35,42,1,199
580247309,51,3,2,1,57
580247975,53,63,61,4,181
580256135,45,20,2,4,71
580264863,66,18,2,2,88
580278779,13,10,2,1,26
580280714,26,47,2,1,76
580298023,154,9,2,2,167
580309745,52,20,4,4,80
580314154,11,3,2,2,18
580334785,15,3,2,1,21
580346262,12,3,2,1,18
580360076,51,32,6,8,97
580361505,12,3,2,1,18
580363457,110,34,27,2,173
580363512,183,3,2,19,207
580367639,41,3,2,1,47
580376470,120,52,2,1,175
580380465,146,11,32,4,193
580388041,85,32,2,1,120
580400124,73,21,2,1,97
580400956,15,3,2,9,29
580416788,10,19,2,1,32
580443279,61,5,2,1,69
580447123,89,3,2,4,98
580476153,27,3,2,1,33
580484463,35,84,2,1,122
580488373,145,10,13,2,170
580490648,69,7,69,4,149
580501117,79,27,2,3,111
580505346,58,69,18,2,147
580536130,45,19,3,10,77
580537919,12,5,2,1,20
580546779,78,15,36,32,161
580573713,56,31,10,4,101
580590904,83,3,2,1,89
580593578,24,3,2,1,30
580594853,45,22,7,2,76
580596269,23,22,9,6,60
580598329,76,18,2,34,130
580610853,125,34,13,18,190
580629137,90,20,76,1,187
580638634,17,3,2,3,25
580646436,75,12,2,11,100
580647411,37,3,3,2,45
580650810,81,18,40,109,248
580662505,14,4,2,1,21
580672083,108,3,2,1,114
580682405,3315,3,2,48,3368
580687889,135,3,2,1,141
580690263,10,5,2,1,18
580694722,26,35,12,17,90
580707793,38,10,10,1,59
580721846,94,13,2,11,120
580722031,63,3,2,1,69
580731815,35,53,3,6,97
580742964,106,35,2,3,146
580753094,47,3,2,1,53
580755062,10,9,2,4,25
580763336,17,3,2,1,23
580771972,79,31,25,14,149
580772437,10,9,14,1,34
580779732,105,33,2,2,142
580779773,47,3,2,1,53
580795366,13,35,2,1,51
580800541,69,12,2,1,84
580801326,10,16,2,1,29
580805079,20,3,2,1,26
580820979,11,7,2,1,21
580830902,23,3,5,3,34
580845390,34,23,29,1,87
580852213,10,3,2,7,22
580855490,13,3,2,1,19
580863217,33,49,10,1,93
580872527,19,3,2,1,25
580876860,100,3,2,4,109
580881980,55,19,2,2,78
580884381,24,3,2,1,30
580899638,11,3,2,1,17
580921551,62,3,2,9,76
580922216,89,3,2,1,95
580933360,27,113,32,11,183
580944097,83,3,2,1,89
580946510,46,6,5,1,58
580949239,134,3,2,1,140
580949435,41,26,24,3,94
580962572,66,3,2,1,72
580970338,61,49,4,6,120
580970588,202,4,2,1,209
580981235,86,3,2,6,97
580987258,71,39,5,14,129
580993048,65,29,36,1,131
580996861,59,6,2,9,76
581000140,12,17,6,4,39
581003494,25,23,15,1,64
581007900,26,11,7,1,45
581018709,131,10,2,5,148
581024858,73,25,5,1,104
581027624,64,3,2,3,72
581032892,37,3,2,1,43
581037480,59,21,34,3,117
581039381,52,3,2,1,58
581041931,78,10,49,29,166
581044941,139,3,2,12,156
581056461,30,17,2,10,59
581059757,31,14,43,16,104
581061347,107,63,5,2,177
581067110,16,19,9,1,45
581090384,12,3,2,2,19
581091042,57,13,2,1,73
581092156,98,98,114,9,319
581092930,65,4,56,3,128
581093530,138,18,2,2,160
581117429,65,42,7,4,118
581137182,28,38,31,7,104
581164339,34,3,2,1,40
581181693,81,41,19,5,146
581187318,27,18,3,8,56
581188819,84,3,2,5,94
581204908,23,3,2,1,29
581215340,11,19,2,1,33
581217814,45,25,21,1,92
581230282,37,3,2,1,43
581240054,39,3,2,2,46
581244640,12,5,2,4,23
581246925,33,46,2,11,92
581258903,38,25,9,4,76
581259379,34,21,26,3,84
581262524,39,44,2,3,88
581263956,104,3,2,1,110
581269940,11,3,6,1,21
581271927,36,13,2,2,53
581284181,25,9,2,1,37
581290647,62,3,2,1,68
581298651,92,3,2,1,98
581298744,24,57,28,1,110
581301365,99,52,18,6,175
581307928,104,50,12,4,170
581310688,135,68,86,51,340
581312203,75,42,73,39,229
581320997,26,19,26,1,72
581327744,54,8,9,7,78
581328601,38,28,16,9,91
581333109,12,5,2,1,20
581336799,44,42,4,4,94
581345131,196,3,2,61,262
581345138,14,3,2,2,21
581363546,54,12,2,5,73
581405105,13,3,2,1,19
581418487,78,15,10,1,104
581423514,11,15,2,3,31
581426962,67,3,2,2,74
581429437,47,36,8,10,101
581454747,45,3,2,4,54
581455468,31,30,2,1,64
581483338,62,20,3,6,91
581487338,103,33,2,4,142
581493086,72,3,2,1,78
581507739,202,40,5,9,256
581509304,125,3,2,4,134
581512931,18,22,2,20,62
581521331,76,14,10,123,223
581573026,68,3,2,1,74
581597727,40,43,5,10,98
581610877,47,21,3,2,73
581612681,139,46,4,6,195
581614958,96,30,52,21,199
581624463,125,12,2,6,145
581627078,11,17,2,1,31
581633105,248,3,2,2,255
581641209,137,4,2,1,144
581643060,18,12,2,1,33
581651785,29,3,2,3,37
581661120,37,38,46,29,150
581664291,83,3,56,3,145
581666299,11,3,2,1,17
581672816,16,10,2,1,29
581679647,93,3,2,2,100
581681288,17,6,2,1,26
581689216,19,3,2,2,26
581696450,175,3,14,8,200
581700954,10,15,2,1,28
581703102,13,3,2,2,20
581710140,13,27,4,1,45
581712708,248,14,8,4,274
581714217,18,13,3,1,35
581728532,57,39,18,1,115
581739311,95,14,4,1,114
581755766,161,3,2,1,167
581758420,11,3,2,1,17
581764480,64,23,36,60,183
581773091,98,12,9,9,128
581773639,30,62,2,1,95
581785499,153,3,2,3,161
581818374,21,16,2,1,40
581833518,115,42,2,1,160
581834373,62,30,73,2,167
581840096,29,25,17,3,74
581843396,188,24,42,6,260
581853218,119,29,37,57,242
581860614,51,18,18,1,88
581890086,116,3,2,1,122
581905814,161,27,2,2,192
581911378,65,3,2,1,71
581921901,30,20,18,3,71
581930451,347,3,2,2,354
581940702,40,3,2,1,46
581965563,56,7,2,1,66
581965693,103,3,2,1,109
581987910,13,39,2,1,55
582006544,76,3,2,37,118
582007007,66,39,47,34,186
582009217,61,23,2,13,99
582028187,107,3,2,8,120
582028445,10,5,2,1,18
582031291,28,13,2,1,44
582036704,54,24,28,1,107
582037741,91,20,4,1,116
582050721,59,3,2,1,65
582053526,44,40,21,25,130
582061937,27,40,69,60,196
582069603,35,94,28,1,158
582123441,38,16,3,3,60
582157856,34,42,47,1,124
582169280,88,34,20,6,148
582189672,68,9,86,2,165
582203899,123,3,2,1,129
582218766,166,3,2,33,204
582231234,201,29,21,4,255
582255110,25,37,2,1,65
582261872,51,3,2,8,64
582262670,61,3,2,3,69
582293435,55,21,48,4,128
582294098,123,28,27,43,221
582297223,14,9,2,1,26
582298356,82,14,3,4,103
582307871,77,3,2,1,83
582309584,92,92,2,2,188
582312443,17,21,2,1,41
582315947,161,36,2,4,203
582316262,15,8,2,1,26
582326065,63,4,2,4,73
582326819,13,5,2,1,21
582332600,56,24,11,1,92
582336012,180,67,2,18,267
582349430,53,3,2,5,63
582351729,23,3,2,5,33
582357119,70,8,41,1,120
582357218,12,3,3,1,19
582357998,69,3,2,1,75
582371851,96,37,7,7,147
582375265,65,11,6,11,93
582376137,22,25,10,1,58
582385176,92,19,2,1,114
582395863,26,49,2,1,78
582399987,56,29,2,2,89
582404557,49,15,2,2,68
582416062,12,9,2,2,25
582422000,66,21,13,4,104
582424290,40,64,27,10,141
582432586,34,6,2,2,44
582437816,11,3,2,1,17
582444110,69,32,7,9,117
582444819,27,14,3,7,51
582446342,29,21,2,1,53
582450340,49,3,2,1,55
582453399,16,3,2,1,22
582491663,90,37,15,1,143
582493709,10,4,2,1,17
582499946,157,62,9,2,230
582531435,168,10,4,3,185
582539273,27,33,20,16,96
582540081,167,8,68,1,244
582542997,16,3,2,1,22
582547913,174,3,2,14,193
582548932,109,7,2,3,121
582549402,22,3,2,1,28
582550532,17,36,2,1,56
582553307,89,28,22,8,147
582556627,55,3,2,1,61
582572943,86,18,2,4,110
582578827,37,3,2,3,45
582581526,12,3,2,1,18
582582797,118,14,56,15,203
582583085,131,17,31,18,197
582596025,108,3,13,1,125
582614267,10,5,2,1,18
582621961,190,3,2,4,199
582648333,96,4,2,1,103
582657025,14,3,2,1,20
582658762,10,5,2,1,18
582660217,22,62,3,1,88
582664200,11,24,2,2,39
582673374,86,18,180,4,288
582680701,10,3,2,4,19
582686900,14,3,2,6,25
582689956,16,15,2,1,34
582699509,62,3,2,1,68
582701425,76,3,2,2,83
582703920,38,22,2,4,66
582709999,81,6,2,1,90
582721216,37,42,21,11,111
582737978,12,3,2,1,18
582741388,41,28,18,4,91
582758603,10,11,2,6,29
582761600,85,16,30,9,140
582761623,18,7,2,3,30
582784978,10,4,2,1,17
582792519,43,23,12,1,79
582797651,67,19,37,12,135
582802920,75,3,2,1,81
582812299,77,11,2,1,91
582816909,74,3,2,1,80
582824412,63,16,2,4,85
582826359,83,80,11,16,190
582829516,145,45,4,9,203
582841815,14,3,2,4,23
582853284,124,3,2,19,148
582876985,90,3,2,2,97
582877922,17,16,2,1,36
582879395,84,31,94,52,261
582889980,34,3,2,1,40
582902090,77,26,61,1,165
582902361,51,3,2,1,57
582911716,43,3,2,1,49
582912236,189,3,2,1,195
582916885,101,28,3,4,136
582926469,144,3,2,1,150
582932595,39,28,2,1,70
582941831,134,33,45,2,214
582943409,84,8,5,1,98
582946237,14,14,6,7,41
582965059,75,40,96,11,222
582965724,22,35,2,7,66
582972949,56,3,2,10,71
582973939,27,14,15,2,58
582977705,54,32,21,23,130
582988529,259,3,2,9,273
582994582,93,34,3,10,140
582999550,10,8,2,1,21
583001192,12,3,2,3,20
583016849,19,66,7,4,96
583023264,54,3,2,1,60
583024628,97,7,2,1,107
583030477,14,33,2,8,57
583030748,99,3,2,5,109
583041511,217,3,2,3,225
583057520,46,33,20,1,100
583077573,22,3,3,2,30
583091756,18,24,2,11,55
583096833,92,10,2,8,112
583098966,11,3,2,2,18
583105823,14,8,2,1,25
583107543,50,3,2,1,56
583113044,29,22,12,4,67
583113439,12,3,2,5,22
583114683,100,3,2,1,106
583123681,147,10,2,6,165
583126528,69,51,22,20,162
583132667,11,5,2,1,19
583135529,97,29,33,9,168
583143758,101,35,2,1,139
583153160,26,3,2,1,32
583156446,10,4,2,2,18
583161725,68,3,2,4,77
583173275,23,24,4,2,53
583181274,52,55,11,31,149
583208145,43,25,33,60,161
583210178,68,19,37,1,125
583215483,131,67,111,10,319
583223179,46,4,2,2,54
583224475,45,42,7,2,96
583226563,17,17,3,2,39
583233655,163,20,13,10,206
583280663,106,3,2,3,114
583282462,24,7,2,1,34
583288690,13,8,2,2,25
583293316,79,45,5,7,136
583299057,28,59,13,8,108
583299848,61,20,92,1,174
583303441,97,32,2,1,132
583308596,41,31,2,5,79
583318563,109,49,3,7,168
583326973,138,3,2,1,144
583327118,33,4,2,1,40
583330555,75,39,66,1,181
583335556,88,3,2,10,103
583336602,33,32,33,1,99
583347608,24,3,2,1,30
583358025,178,6,2,16,202
583360990,293,3,2,1,299
583419397,11,3,2,1,17
583431189,37,8,2,1,48
583437383,91,25,2,15,133
583453823,62,54,2,2,120
583464599,13,33,2,1,49
583472619,49,10,2,2,63
583477131,15,3,2,1,21
583480122,76,36,24,5,141
583481145,166,18,10,4,198
583482309,91,5,2,1,99
583483007,94,8,30,4,136
583489231,40,44,7,1,92
583498341,11,5,2,1,19
583499338,14,3,2,1,20
583499574,42,23,2,1,68
583505452,181,3,2,31,217
583516734,21,3,4,6,34
583520686,71,31,3,1,106
583539409,50,79,74,24,227
583542387,56,31,2,1,90
583551219,88,53,55,1,197
583556491,14,3,2,1,20
583604073,130,47,8,62,247
583610233,80,21,28,2,131
583617988,28,9,2,2,41
583620807,28,7,2,10,47
583621789,95,7,2,2,106
583623517,63,110,25,5,203
583632781,58,24,2,15,99
583634823,61,35,14,20,130
583658790,50,49,2,2,103
583662561,87,18,31,23,159
583663463,85,3,2,1,91
583686523,81,7,2,2,92
583701064,11,20,2,6,39
583713961,75,41,14,3,133
583722358,73,11,10,6,100
583732134,95,28,39,21,183
583738766,81,18,2,1,102
583753766,12,3,2,1,18
583755974,76,15,2,1,94
583784617,53,10,44,1,108
583785307,21,3,2,1,27
583785789,48,10,2,3,63
583786927,67,3,2,2,74
583787293,58,28,13,27,126
583789117,13,3,2,1,19
583819314,44,40,13,1,98
583847640,204,7,4,16,231
583850856,148,38,11,11,208
583856970,18,13,2,1,34
583863741,32,54,2,3,91
583864885,10,8,2,1,21
583868695,59,30,2,1,92
583887780,44,49,3,1,97
583900293,50,6,19,1,76
583921275,22,3,2,1,28
583939396,61,27,2,20,110
583956725,108,21,2,3,134
583980155,29,33,17,17,96
583993438,10,8,2,1,21
584005533,10,3,2,3,18
584015785,67,27,2,2,98
584020770,66,5,40,46,157
584023196,45,4,14,1,64
584026690,87,12,107,12,218
584038419,64,19,9,3,95
584043538,168,9,2,10,189
584045486,44,3,2,1,50
584046855,17,26,6,1,50
584050730,24,43,2,1,70
584051553,82,12,40,12,146
584054807,61,4,33,1,99
584067041,18,12,2,1,33
584085458,135,3,2,11,151
584105455,29,5,38,1,73
584107837,21,11,2,3,37
584117093,47,57,47,2,153
584149020,80,24,12,5,121
584153679,20,22,43,1,86
584158574,143,3,17,2,165
584170305,20,43,2,10,75
584177227,44,3,2,1,50
584177922,14,6,2,1,23
584178297,41,38,10,1,90
584186604,23,15,5,1,44
584193293,40,15,3,1,59
584193618,92,47,8,6,153
584197526,11,3,2,1,17
584202010,27,3,2,1,33
584211259,328,3,2,5,338
584212722,12,16,2,1,31
584234802,73,23,23,4,123
584237095,14,3,2,1,20
584239727,29,18,13,2,62
584243700,46,3,2,1,52
584248766,72,47,11,14,144
584252858,62,70,2,1,135
584257318,13,3,2,1,19
584264239,93,49,72,4,218
584264321,15,3,5,2,25
584270935,34,13,49,17,113
584281236,81,92,123,8,304
584297520,97,13,7,5,122
584304336,17,3,2,1,23
584308285,22,3,2,1,28
584326421,79,37,28,75,219
584330648,25,3,2,1,31
584348797,60,18,2,1,81
584356133,81,24,2,1,108
584370303,11,3,2,1,17
584371247,26,14,2,3,45
584386132,85,3,2,4,94
584393484,45,18,7,17,87
584396219,19,3,2,1,25
584397126,36,13,73,1,123
584404993,91,3,2,3,99
584410063,96,24,31,7,158
584421927,43,3,2,1,49
584425859,25,3,2,1,31
584427831,13,3,2,3,21
584429599,16,28,2,8,54
584433449,85,69,2,104,260
584436872,25,3,2,1,31
584442287,61,12,33,2,108
584467992,81,22,47,3,153
584469375,28,12,2,8,50
584514662,30,44,15,7,96
584539607,49,16,5,1,71
584545032,18,3,2,1,24
584546134,25,18,2,1,46
584561255,64,4,13,3,84
584610499,14,3,2,1,20
584616266,25,3,2,5,35
584623481,22,3,2,1,28
584632344,44,62,2,1,109
584636489,22,25,4,1,52
584640082,743,3,2,6,754
584674830,12,3,2,1,18
584701445,205,38,35,2,280
584715723,13,3,2,1,19
584730426,132,46,27,3,208
584754998,39,3,2,1,45
584767789,72,3,2,6,83
584770613,20,42,13,1,76
584777984,147,3,2,13,165
584779421,61,41,2,3,107
584779483,102,3,2,5,112
584807224,78,23,156,12,269
584820587,52,53,31,8,144
584821776,144,3,2,5,154
584831395,14,3,2,2,21
584837881,34,3,2,3,42
584840686,32,9,2,9,52
584843246,28,69,3,4,104
584852394,119,35,12,9,175
584852834,111,16,46,4,177
584866820,41,7,2,1,51
584872397,132,16,2,1,151
584882272,52,3,2,1,58
584902699,56,47,26,3,132
584904012,13,11,2,1,27
584910822,12,3,2,3,20
584929219,32,21,13,8,74
584930730,20,13,2,8,43
584950915,109,47,13,1,170
584954270,23,3,2,1,29
584955897,17,33,8,16,74
584970981,17,15,2,1,35
584976897,57,54,49,11,171
584986772,27,27,2,1,57
584987148,78,9,16,24,127
585009548,63,3,2,1,69
585021193,74,12,2,2,90
585035092,41,10,4,1,56
585040836,31,15,2,1,49
585061970,13,18,42,1,74
585075691,33,56,2,3,94
585079886,88,36,15,26,165
585090775,28,53,16,1,98
585096356,10,6,2,1,19
585100181,15,3,2,1,21
585105118,123,29,32,16,200
585107585,80,32,16,2,130
585108165,28,3,2,4,37
585111232,19,3,2,3,27
585124869,14,41,11,1,67
585141573,88,3,2,11,104
585143325,54,4,2,12,72
585177923,36,70,32,3,141
585181672,23,21,41,1,86
585182792,37,21,4,2,64
585191283,68,9,45,17,139
585209942,104,20,26,2,152
585237047,14,3,2,1,20
585238177,68,15,3,1,87
585243220,109,81,2,1,193
585245028,14,3,2,1,20
585249324,136,36,2,7,181
585250376,27,8,2,1,38
585251410,55,5,36,57,153
585268857,89,19,3,3,114
585274282,50,32,53,1,136
585284831,55,29,17,5,106
585292135,45,3,2,1,51
585294725,114,22,3,1,140
585299888,40,40,27,6,113
585301640,74,53,2,4,133
585302092,58,16,2,1,77
585306499,11,3,2,1,17
585309591,30,62,5,1,98
585319581,17,14,2,1,34
585363567,47,11,8,2,68
585368609,13,4,2,1,20
585370637,216,3,2,2,223
585377254,71,16,52,3,142
585380693,24,26,5,6,61
585392603,32,16,2,1,51
585398763,13,5,2,1,21
585400177,21,13,2,1,37
585400192,49,63,125,1,238
585400950,61,57,7,3,128
585406195,32,15,2,4,53
585407932,160,3,2,1,166
585439801,191,35,3,1,230
585452236,56,55,74,12,197
585462119,39,18,2,4,63
585475466,78,11,4,5,98
585479353,59,37,2,28,126
585479462,11,3,2,1,17
585492864,23,28,3,13,67
585500161,110,35,19,4,168
585502568,24,22,3,1,50
585503839,110,59,54,2,225
585508516,11,7,2,1,21
585511338,22,3,2,2,29
585511964,104,20,60,1,185
585526449,12,44,2,1,59
585528584,50,3,2,3,58
585535690,197,61,27,11,296
585542576,11,6,2,3,22
585546628,70,40,17,15,142
585563064,112,25,2,5,144
585564485,32,45,3,6,86
585568283,132,11,3,4,150
585573327,64,3,2,2,71
585606034,73,3,2,1,79
585607176,140,15,71,1,227
585612748,74,43,31,31,179
585617312,97,25,3,10,135
585617862,55,33,19,6,113
585627955,20,3,2,1,26
585634421,13,3,2,1,19
585635957,11,3,2,2,18
585644174,10,6,2,2,20
585652482,12,26,2,1,41
585662761,31,3,2,3,39
585668635,69,21,25,3,118
585684986,133,35,5,1,174
585691137,70,29,68,18,185
585692871,267,34,3,8,312
585711065,140,41,2,12,195
585713448,33,21,2,1,57
585738359,40,31,32,39,142
585750350,13,3,2,3,21
585751709,98,20,2,19,139
585764247,29,3,2,4,38
585787257,173,3,2,10,188
585790394,249,3,2,26,280
585793995,55,14,4,13,86
585801148,99,12,29,4,144
585801502,70,9,3,1,83
585802626,144,16,3,1,164
585821118,80,116,44,11,251
585821253,10,3,2,2,17
585837605,35,9,2,1,47
585850994,119,22,4,9,154
585861678,41,33,3,1,78
585869418,70,8,2,14,94
585873472,11,7,2,1,21
585892083,64,3,2,1,70
585903539,21,68,2,1,92
585904935,102,16,2,1,121
585908688,54,4,2,1,61
585918771,47,5,2,10,64
585920391,27,37,2,4,70
585954623,18,51,2,1,72
585980366,96,6,2,1,105
585990073,76,45,28,10,159
585999185,113,58,8,4,183
586016815,112,5,4,4,125
586020798,22,3,2,2,29
586025560,75,27,9,11,122
586057343,68,4,3,2,77
586060259,11,3,2,2,18
586063596,50,26,3,20,99
586065476,100,21,4,30,155
586069319,64,3,2,1,70
586074043,243,13,22,3,281
586124394,83,15,6,5,109
586128010,67,3,2,1,73
586135620,80,27,16,18,141
586138923,70,9,2,5,86
586139435,53,3,2,1,59
586146537,77,57,49,1,184
586154114,87,3,2,1,93
586159372,149,3,2,4,158
586161982,61,3,2,1,67
586185209,72,38,6,4,120
586186213,96,7,2,2,107
586186962,217,11,2,19,249
586187498,11,6,2,1,20
586193112,154,15,11,20,200
586204947,53,3,2,3,61
586205044,37,5,2,1,45
586217866,13,3,2,1,19
586220911,222,40,135,61,458
586227345,104,23,4,4,135
586236332,140,194,17,3,354
586238646,81,40,2,24,147
586246818,16,9,2,2,29
586249849,126,45,2,3,176
586252692,75,8,34,4,121
586253073,11,26,2,24,63
586257370,59,21,6,13,99
586283083,12,3,2,2,19
586286701,14,3,2,1,20
586294234,81,3,2,9,95
586294852,92,3,2,3,100
586296726,59,57,84,6,206
586304320,17,3,2,1,23
586309900,13,3,2,1,19
586310928,60,14,4,32,110
586322226,53,40,2,22,117
586338136,35,10,2,13,60
586343356,146,72,2,19,239
586345626,67,30,2,10,109
586353384,63,3,2,3,71
586363500,61,39,36,5,141
586378830,56,3,2,1,62
586395033,59,16,57,5,137
586396070,21,3,2,1,27
586396573,50,3,2,5,60
586397864,15,28,2,1,46
586400707,11,10,2,2,25
586412915,20,6,2,5,33
586417440,252,3,8,17,280
586424942,26,47,2,5,80
586439271,69,49,45,7,170
586442192,49,23,6,3,81
586443320,58,65,11,15,149
586445317,163,44,119,30,356
586445723,47,25,5,1,78
586458447,54,22,2,12,90
586458509,101,64,201,51,417
586462161,206,3,2,16,227
586465946,12,3,2,1,18
586468478,68,31,2,5,106
586486208,89,12,2,4,107
586492074,103,19,28,5,155
586496257,55,11,7,1,74
586505580,54,3,2,56,115
586523121,43,50,3,2,98
586533029,11,26,3,9,49
586534699,148,19,20,17,204
586541094,16,3,2,1,22
586550218,57,35,5,1,98
586557310,21,3,2,1,27
586568313,153,16,2,5,176
586595515,14,5,4,1,24
586607690,29,3,2,4,38
586607703,103,40,24,32,199
586633650,14,3,2,1,20
586637566,121,8,2,4,135
586642216,42,5,47,10,104
586658219,15,3,2,1,21
586670151,31,77,12,32,152
586703809,27,3,2,1,33
586713692,91,70,3,37,201
586725883,23,31,11,1,66
586726329,43,42,31,4,120
586732375,96,60,37,3,196
586733075,17,3,2,1,23
586734253,78,10,11,8,107
586737756,80,52,6,1,139
586758671,176,26,32,10,244
586765069,11,3,2,2,18
586769357,80,12,4,13,109
586782557,63,48,2,1,114
586784201,29,74,8,3,114
586785268,104,40,16,21,181
586789300,60,42,24,9,135
586798379,71,21,4,4,100
586817819,121,3,2,7,133
586826369,10,4,2,1,17
586836464,83,45,82,3,213
586837440,101,17,2,2,122
586854458,66,38,29,12,145
586862383,21,8,2,1,32
586862831,11,3,2,1,17
586873404,11,3,2,1,17
586875290,58,16,45,6,125
586884510,21,29,2,8,60
586906542,108,3,2,1,114
586918310,24,5,2,3,34
586919837,17,3,2,2,24
586922162,25,37,2,9,73
586924573,90,15,2,12,119
586927300,19,3,2,1,25
586931325,73,31,17,12,133
586936617,16,11,13,7,47
586945998,42,5,11,3,61
586950617,731,3,2,235,971
586955319,113,20,26,16,175
586963084,67,44,10,7,128
586971040,77,9,6,12,104
586974494,90,64,52,3,209
586996554,26,11,53,2,92
587000032,37,36,23,3,99
587019172,11,4,2,1,18
587025107,19,3,2,1,25
587039974,32,82,22,7,143
587044418,37,3,2,1,43
587047289,34,46,8,2,90
587048198,46,3,2,10,61
587050886,12,3,2,1,18
587052806,125,3,2,1,131
587053869,93,39,6,6,144
587060267,31,3,2,1,37
587064714,67,3,2,6,78
587076411,14,3,2,1,20
587089482,14,3,2,1,20
587090819,84,30,68,3,185
587091670,26,8,4,1,39
587093903,25,4,2,1,32
587095586,48,24,4,2,78
587120036,16,33,27,1,77
587121665,11,3,2,1,17
587122659,116,49,2,1,168
587134010,45,40,2,1,88
587138256,20,11,2,2,35
587141617,31,56,18,1,106
587161572,285,3,2,31,321
587193246,78,3,2,1,84
587208213,61,3,126,1,191
587224399,25,9,3,1,38
587233217,13,4,2,1,20
587253354,12,25,2,2,41
587259759,65,5,27,3,100
587263151,15,16,2,1,34
587273109,71,62,35,43,211
587283658,55,13,2,4,74
587301277,68,3,2,8,81
587310266,32,38,4,12,86
587322911,14,3,2,1,20
587331786,80,24,7,11,122
587341260,29,26,8,6,69
587342227,87,5,2,1,95
587348142,93,30,17,1,141
587360842,142,3,2,36,183
587361583,133,43,2,2,180
587363941,149,9,4,1,163
587364285,223,50,2,4,279
587389715,46,3,2,1,52
587397977,203,36,50,10,299
587406996,67,52,33,1,153
587410026,112,15,133,13,273
587410069,60,25,4,12,101
587410746,38,15,14,1,68
587414456,28,7,2,4,41
587415431,77,22,70,1,170
587419243,71,12,2,1,86
587442242,242,30,6,7,285
587443783,11,3,2,1,17
587446534,220,3,2,18,243
587447848,57,3,2,1,63
587448045,10,9,2,1,22
587459495,36,60,17,49,162
587466263,99,5,2,30,136
587472512,73,16,42,1,132
587478741,13,33,2,1,49
587479630,53,3,2,1,59
587491682,76,3,32,25,136
587496033,42,16,78,6,142
587498894,479,3,2,4,488
587502701,10,14,2,1,27
587515444,42,3,2,2,49
587517396,47,18,3,1,69
587526488,88,11,12,1,112
587527859,98,15,35,1,149
587533674,64,3,2,1,70
587544563,11,3,2,1,17
587545594,805,3,2,7,817
587566500,136,3,2,6,147
587566567,199,7,6,6,218
587568947,53,29,5,8,95
587575720,50,32,19,1,102
587576268,23,3,2,1,29
587581042,68,20,25,6,119
587590298,96,15,4,1,116
587609179,114,18,2,45,179
587615553,61,24,15,5,105
587616773,85,52,30,64,231
587620050,45,3,2,1,51
587621036,64,26,2,11,103
587621630,11,4,2,1,18
587641313,12,3,2,1,18
587646945,15,4,2,1,22
587647406,42,4,2,1,49
587658061,85,78,3,1,167
587674864,113,58,28,1,200
587692622,17,44,2,14,77
587694949,120,5,2,23,150
587699748,57,66,16,17,156
587706351,61,67,2,5,135
587715902,12,7,3,1,23
587718902,68,21,20,39,148
587725228,144,25,2,10,181
587751773,11,3,2,1,17
587756077,24,32,14,1,71
587757326,10,4,2,1,17
587759556,99,16,54,20,189
587775114,162,11,2,6,181
587797525,36,32,8,10,86
587818375,86,26,25,1,138
587825633,11,3,2,1,17
587826865,23,3,2,1,29
587830409,33,12,2,6,53
587830573,22,3,2,6,33
587874196,10,8,2,1,21
587886185,82,32,22,16,152
587892104,69,33,17,24,143
587909333,18,17,15,1,51
587917527,33,42,51,4,130
587936100,118,31,3,30,182
587940471,16,8,2,1,27
587944080,50,27,7,2,86
587947191,20,10,3,3,36
587947356,20,31,13,6,70
587948243,124,3,2,6,135
587951114,43,31,23,2,99
587974319,35,21,2,1,59
587974320,129,3,2,1,135
587982707,72,16,7,1,96
587993542,29,20,27,7,83
587996122,44,3,2,8,57
588000589,19,4,2,1,26
588000729,60,3,2,3,68
588013283,16,28,11,1,56
588021611,84,16,69,12,181
588032868,51,15,2,7,75
588050171,70,15,2,1,88
588051030,223,17,25,3,268
588054567,68,3,2,1,74
588057461,103,38,2,13,156
588063936,122,3,2,1,128
588071174,57,3,2,1,63
588087997,61,3,2,1,67
588095794,44,13,2,9,68
588097037,115,37,2,1,155
588097807,16,3,2,1,22
588101672,43,23,20,69,155
588105900,34,3,2,1,40
588107229,16,49,3,1,69
588110572,60,27,14,1,102
588112601,94,48,60,14,216
588114680,53,44,6,1,104
588117405,119,3,2,1,125
588135522,64,13,16,1,94
588146901,56,27,21,1,105
588160836,92,47,35,17,191
588176215,65,53,31,46,195
588179648,23,20,9,2,54
588225501,12,13,2,1,28
588227356,63,34,71,2,170
588240927,41,49,21,1,112
588244430,11,6,2,1,20
588252903,23,41,2,1,67
588253050,33,8,26,15,82
588256353,10,3,2,5,20
588269130,135,30,3,3,171
588271831,61,3,2,1,67
588273974,66,10,20,11,107
588277020,89,26,42,55,212
588285106,12,5,4,4,25
588288627,81,3,2,1,87
588296246,56,11,3,1,71
588317278,11,4,2,10,27
588318896,72,18,2,4,96
588327342,128,3,2,6,139
588328713,212,23,2,1,238
588329737,79,3,2,7,91
588344451,10,31,2,1,44
588344661,53,22,6,2,83
588358575,11,16,2,1,30
588360033,109,31,2,4,146
588360999,25,3,2,5,35
588389121,133,3,2,6,144
588391858,48,23,2,4,77
588409245,168,43,26,36,273
588423500,96,36,17,6,155
588437127,74,15,37,5,131
588442371,106,15,6,1,128
588445683,129,52,3,40,224
588454650,38,3,2,1,44
588461967,120,59,24,25,228
588468747,29,37,6,1,73
588470579,54,36,25,13,128
588475307,79,53,41,4,177
588480816,136,3,2,4,145
588497534,25,3,2,1,31
588499488,39,41,6,11,97
588503839,34,3,2,1,40
588513620,44,3,2,4,53
588516228,70,7,2,5,84
588525238,36,15,2,1,54
588543938,113,3,2,23,141
588556598,54,8,4,8,74
588556766,37,31,4,6,78
588562358,63,26,2,11,102
588573312,73,22,27,4,126
588594129,1482,3,2,16,1503
588606057,23,3,2,1,29
588621158,16,19,2,1,38
588632522,15,8,2,1,26
588637474,118,103,15,13,249
588638463,23,8,2,1,34
588643864,13,3,2,1,19
588674328,89,3,2,5,99
588678373,126,34,11,26,197
588678728,124,3,2,8,137
588696298,26,628,124,83,861
588701990,18,22,3,10,53
588724004,23,14,2,1,40
588724273,10,3,2,3,18
588724604,122,16,105,1,244
588741228,56,3,2,10,71
588754280,142,3,2,17,164
588755092,107,3,2,3,115
588755499,226,19,3,16,264
588763001,13,3,2,1,19
588768506,32,8,2,1,43
588782399,13,45,2,26,86
588785242,18,3,2,1,24
588786826,47,41,7,6,101
588796203,84,7,2,1,94
588796334,161,35,4,68,268
588798700,185,20,2,3,210
588814452,72,3,2,1,78
588817829,72,20,2,1,95
588818973,167,41,10,9,227
588829550,107,18,34,31,190
588832436,103,23,43,1,170
588832763,18,28,2,1,49
588846655,87,11,17,1,116
588854154,100,3,2,1,106
588856147,10,3,2,2,17
588858911,71,22,5,1,99
588881816,105,12,2,7,126
588883637,24,24,2,1,51
588884723,333,104,8,1,446
588887675,49,11,6,5,71
588891389,110,3,2,1,116
588895735,92,37,25,26,180
588899715,66,3,2,2,73
588901418,69,44,33,101,247
588912069,132,5,2,1,140
588917626,37,3,2,1,43
588920425,66,10,4,2,82
588924163,96,33,33,30,192
588928990,13,6,2,3,24
588929566,25,20,2,1,48
588931195,96,103,74,4,277
588933193,141,37,3,2,183
588947679,99,12,13,11,135
588956240,14,3,2,7,26
588961570,17,3,8,6,34
588973677,45,30,3,5,83
588985841,28,13,2,5,48
588988657,94,61,59,33,247
589007732,93,9,20,3,125
589021216,104,3,2,1,110
589021562,121,31,13,5,170
589023541,26,3,2,3,34
589033151,12,3,2,1,18
589042879,53,11,5,1,70
589048739,53,17,3,1,74
589068723,36,20,7,1,64
589071912,39,7,5,1,52
589075405,35,12,2,1,50
589078484,200,62,2,24,288
589080040,201,22,66,5,294
589116820,113,3,2,1,119
589121599,243,3,2,1,249
589126045,14,3,2,2,21
589130913,17,9,2,1,29
589141755,60,20,18,3,101
589143365,48,3,2,3,56
589145538,48,38,3,3,92
589146023,24,18,2,1,45
589147089,161,28,16,6,211
589157391,22,3,4,2,31
589173345,89,3,5,13,110
589190515,53,27,27,33,140
589191194,55,10,2,1,68
589197983,250,3,2,1,256
589199695,46,3,2,14,65
589205012,101,5,27,2,135
589208317,145,15,2,1,163
589211825,93,66,108,22,289
589213366,47,3,2,1,53
589215260,23,44,29,8,104
589217123,35,8,20,7,70
589224326,71,39,4,2,116
589233260,33,14,10,2,59
589239599,53,29,16,19,117
589254846,172,45,43,9,269
589266471,63,17,13,3,96
589275511,21,69,24,5,119
589278172,62,3,2,1,68
589283957,17,4,2,1,24
589290790,11,3,2,1,17
589304174,70,3,2,6,81
589313337,98,6,5,5,114
589317424,143,3,2,2,150
589320910,144,51,98,7,300
589330376,85,13,10,10,118
589333830,23,24,2,4,53
589345278,50,3,2,1,56
589349427,39,19,2,1,61
589349685,138,25,87,58,308
589355991,30,39,2,2,73
589359386,89,3,2,1,95
589361219,10,48,2,17,77
589363743,236,36,97,63,432
589371437,190,47,21,1,259
589374599,86,3,2,2,93
589392216,48,18,5,13,84
589393937,92,28,2,2,124
589432012,109,16,56,10,191
589432700,62,9,13,1,85
589448665,110,30,3,1,144
589457483,37,49,8,8,102
589461593,36,13,7,16,72
589469996,17,11,2,1,31
589471088,61,28,3,3,95
589472549,13,12,2,2,29
589480330,62,36,50,24,172
589480820,74,3,2,10,89
589482541,60,11,9,1,81
589490594,31,13,7,3,54
589494313,127,3,2,4,136
589494545,23,3,2,3,31
589495560,251,3,2,18,274
589504564,54,10,2,1,67
589507892,136,12,3,1,152
589511752,221,60,14,26,321
589525528,62,14,2,1,79
589525954,80,48,17,1,146
589540623,62,29,2,1,94
589545547,46,3,2,1,52
589549315,17,3,2,1,23
589551706,195,38,20,10,263
589556459,13,14,2,1,30
589557241,22,35,3,1,61
589560965,200,17,6,5,228
589564901,52,7,2,3,64
589572317,81,4,2,3,90
589578385,120,43,2,9,174
589582265,18,29,2,1,50
589584650,25,3,2,1,31
589587970,51,3,2,2,58
589590865,142,22,4,11,179
589597294,32,27,2,1,62
589602917,132,3,2,12,149
589604429,24,3,2,8,37
589612489,67,21,3,4,95
589628546,20,11,2,1,34
589630602,97,3,2,2,104
589660338,64,17,6,2,89
589669504,96,3,2,8,109
589679971,100,12,49,8,169
589681183,27,29,2,16,74
589682047,203,3,2,13,221
589683948,12,3,2,1,18
589693098,57,49,47,8,161
589697894,230,18,3,8,259
589715201,40,18,2,1,61
589717524,98,16,28,4,146
589718312,58,66,17,4,145
589747377,81,3,2,1,87
589757515,66,7,2,2,77
589761715,19,28,2,1,50
589781356,14,3,2,1,20
589794177,115,40,78,21,254
589799729,51,3,2,6,62
589840015,65,3,2,1,71
589845554,27,3,2,7,39
589865092,73,28,13,4,118
589875345,87,3,2,2,94
589888518,17,3,2,1,23
589894799,53,11,2,15,81
589924082,13,3,2,1,19
589937187,122,3,2,2,129
589944043,52,11,21,1,85
589947807,128,3,13,21,165
589957113,177,44,32,19,272
589957715,122,3,2,72,199
589958682,29,47,45,1,122
589960781,67,32,2,4,105
589969989,106,35,14,3,158
589995626,47,102,5,12,166
590027100,115,4,2,8,129
590041788,233,3,2,7,245
590049895,21,3,2,3,29
590052745,40,3,2,1,46
590061931,16,3,2,2,23
590077152,82,73,113,5,273
590085873,11,3,2,1,17
590091622,17,15,2,1,35
590095514,212,30,43,16,301
590095860,85,17,4,1,107
590115570,111,32,12,14,169
590127316,14,3,2,1,20
590133383,42,12,22,13,89
590138786,32,3,2,6,43
590141879,66,3,2,1,72
590158182,12,3,2,1,18
590159172,20,3,2,3,28
590170384,29,3,2,1,35
590176936,63,24,17,3,107
590181113,110,3,2,1,116
590183636,37,13,3,9,62
590192204,30,4,2,2,38
590192851,13,12,2,1,28
590198736,195,3,2,2,202
590199705,30,26,3,1,60
590210258,32,85,8,1,126
590213720,78,3,2,5,88
590215443,45,9,2,1,57
590230418,122,19,6,1,148
590242785,13,17,8,2,40
590255289,12,3,2,1,18
590269391,10,31,2,1,44
590293004,58,13,17,7,95
590296109,21,6,10,1,38
590297775,67,32,25,2,126
590302300,56,5,42,14,117
590313361,182,52,16,8,258
590323941,111,16,23,18,168
590325464,18,46,2,1,67
590332529,25,54,51,15,145
590335447,12,10,2,1,25
590336650,151,3,2,3,159
590344222,66,42,36,81,225
590344256,18,17,2,1,38
590359071,13,3,2,1,19
590364669,49,13,9,8,79
590372947,13,3,2,1,19
590375956,37,5,2,3,47
590376641,89,20,23,1,133
590389787,11,3,2,1,17
590394105,12,17,2,1,32
590402273,86,3,2,1,92
590404847,231,3,2,9,245
590420465,12,6,2,1,21
590422417,11,3,2,1,17
590425512,11,52,5,1,69
590428051,52,10,47,2,111
590428305,11,3,2,1,17
590444570,149,3,2,18,172
590448892,10,4,2,1,17
590449261,152,4,2,8,166
590450759,31,5,2,7,45
590454842,12,3,2,1,18
590457624,22,3,2,1,28
590461807,63,33,29,10,135
590468870,36,5,2,3,46
590480656,30,10,2,1,43
590494295,116,3,2,9,130
590501195,92,16,71,8,187
590502835,58,113,2,21,194
590503370,80,7,2,3,92
590565143,44,3,2,3,52
590573790,19,3,2,4,28
590576744,56,28,4,10,98
590586619,160,27,17,6,210
590589058,14,11,2,1,28
590592823,73,3,2,1,79
590595287,31,37,8,23,99
590603355,16,3,2,1,22
590632684,28,18,20,2,68
590638413,114,5,9,10,138
590641033,60,16,2,1,79
590664244,172,20,2,3,197
590679170,52,17,4,10,83
590681711,20,7,2,1,30
590703256,27,34,26,34,121
590708309,43,27,2,1,73
590712119,61,7,3,2,73
590721389,127,71,11,22,231
590729974,16,11,2,2,31
590745941,90,3,2,2,97
590752146,133,3,2,9,147
590752169,21,32,2,1,56
590754140,17,4,4,2,27
590766108,15,3,2,1,21
590779978,20,4,2,1,27
590788809,127,73,105,4,309
590824082,23,39,9,1,72
590834662,97,4,2,3,106
590837341,113,10,2,12,137
590840257,107,47,37,16,207
590843050,48,14,64,7,133
590846435,34,24,31,3,92
590849383,66,34,17,26,143
590866389,177,30,2,6,215
590892750,29,3,2,1,35
590894982,19,3,2,1,25
590896377,19,9,11,1,40
590903016,41,31,15,25,112
590909201,61,3,2,2,68
590938355,78,29,79,8,194
590973644,67,3,2,1,73
590975527,55,8,2,1,66
590980227,111,6,2,1,120
591011923,31,28,18,40,117
591018757,19,3,2,1,25
591026964,79,3,2,2,86
591033397,22,3,2,3,30
591051219,73,56,112,9,250
591077965,13,36,21,1,71
591085481,80,18,2,2,102
591099091,128,3,2,5,138
591100158,65,10,14,2,91
591103762,20,3,2,1,26
591103776,50,108,29,4,191
591117627,12,3,2,1,18
591122613,74,3,2,1,80
591130347,89,20,2,2,113
591131998,11,3,2,1,17
591132606,103,3,2,1,109
591142911,67,25,2,1,95
591143058,205,3,2,7,217
591152499,104,21,39,33,197
591160405,23,42,18,2,85
591161375,16,12,2,1,31
591166741,69,42,34,10,155
591174849,55,61,2,1,119
591175208,22,15,2,5,44
591176525,18,21,2,1,42
591201991,11,3,2,1,17
591206351,87,15,28,4,134
591226873,25,48,64,38,175
591234096,232,50,68,23,373
591236164,32,6,9,15,62
591244424,20,21,22,1,64
591251381,82,30,15,15,142
591300391,45,14,3,14,76
591301985,26,42,9,7,84
591306446,55,95,14,19,183
591307371,101,28,15,16,160
591309682,10,3,2,5,20
591314669,78,3,2,1,84
591314868,21,8,3,2,34
591323551,92,28,4,2,126
591337059,97,30,13,11,151
591349061,95,12,2,7,116
591352751,98,19,2,11,130
591354106,61,10,2,1,74
591357095,226,73,8,2,309
591361663,56,5,6,10,77
591362700,56,9,11,9,85
591369795,110,6,2,5,123
591373882,42,42,2,1,87
591392383,73,3,2,1,79
591392977,189,7,2,4,202
591404218,39,114,4,8,165
591415521,1628,3,2,14,1647
591432289,53,32,137,2,224
591432997,16,3,2,1,22
591441724,61,3,2,1,67
591449542,84,11,24,7,126
591456548,10,3,2,2,17
591460454,86,89,30,5,210
591462633,49,3,2,5,59
591465524,55,16,2,1,74
591469971,54,21,4,6,85
591481384,13,3,2,1,19
591484524,12,3,2,1,18
591485436,91,19,24,21,155
591487012,119,13,24,1,157
591501121,10,5,2,1,18
591520132,102,29,62,1,194
591526554,158,3,24,6,191
591530579,93,66,3,42,204
591536305,242,3,2,2,249
591545835,71,55,11,4,141
591554864,38,3,2,2,45
591556301,15,16,2,1,34
591564166,111,40,24,1,176
591566977,48,52,37,25,162
591572106,96,21,20,2,139
591577054,41,3,2,2,48
591579622,105,34,2,1,142
591581282,60,22,5,6,93
591587187,20,16,2,15,53
591596996,158,3,2,3,166
591599237,38,19,37,3,97
591608228,40,29,16,8,93
591615273,25,3,2,1,31
591616707,69,3,2,14,88
591629905,62,64,17,4,147
591639989,119,65,57,9,250
591653259,41,3,2,2,48
591656068,307,3,2,7,319
591675395,143,3,2,1,149
591677861,48,10,2,5,65
591704122,39,9,3,1,52
591705621,94,10,93,4,201
591715222,123,35,47,31,236
591729220,58,18,2,1,79
591752684,40,4,2,3,49
591755702,20,8,2,3,33
591782806,99,3,2,9,113
591792000,104,18,3,2,127
591793444,130,3,2,7,142
591796712,11,9,2,1,23
591833949,21,5,2,1,29
591837308,10,5,2,1,18
591857960,78,24,2,1,105
591862711,34,29,18,1,82
591867730,78,39,47,9,173
591873247,132,3,2,21,158
591874990,111,46,48,2,207
591888208,108,9,4,30,151
591930373,42,101,2,1,146
591939489,12,4,2,1,19
591971281,108,20,26,4,158
591978056,95,39,3,13,150
591989595,114,42,30,5,191
591995576,83,20,2,1,106
592001879,10,3,2,3,18
592003234,93,3,2,1,99
592009389,97,3,2,1,103
592013248,52,27,31,14,124
592027768,54,14,22,28,118
592032547,21,4,2,5,32
592045290,102,3,2,16,123
592051622,10,3,2,5,20
592060857,56,31,2,1,90
592069176,82,34,4,3,123
592091837,122,3,2,4,131
592096834,46,40,2,1,89
592099066,87,65,2,4,158
592104729,90,16,2,12,120
592105919,22,10,3,7,42
592109465,105,32,14,18,169
592113177,29,12,8,5,54
592114065,10,19,2,1,32
592116912,139,13,2,1,155
592119341,141,3,2,1,147
592138252,114,20,2,4,140
592140056,11,3,2,1,17
592141166,103,29,5,82,219
592146606,14,11,2,1,28
592149209,13,10,2,1,26
592150803,69,28,6,2,105
592156282,61,29,26,2,118
592164043,11,3,2,1,17
592166824,58,21,3,4,86
592169707,78,22,28,1,129
592207595,67,71,45,8,191
592207714,49,48,3,9,109
592213786,183,25,20,5,233
592219580,23,14,2,2,41
592232971,151,22,57,18,248
592234359,97,11,61,2,171
592243788,109,13,2,3,127
592254952,37,28,35,26,126
592292839,88,31,20,37,176
592299596,58,25,2,1,86
592327635,49,7,2,5,63
592346168,108,13,80,1,202
592349820,69,37,4,42,152
592381332,29,42,6,1,78
592384339,49,3,2,1,55
592384700,25,31,12,2,70
592390489,22,19,2,6,49
592395479,11,3,2,1,17
592396803,47,50,2,9,108
592419003,12,3,2,1,18
592420439,84,10,2,1,97
592423523,22,16,2,1,41
592424001,183,17,42,22,264
592430068,58,28,26,32,144
592434322,32,3,2,1,38
592448013,67,3,2,1,73
592460200,182,15,24,4,225
592463799,14,3,2,1,20
592473381,75,25,2,6,108
592480772,11,3,2,1,17
592480891,137,15,2,1,155
592500657,38,14,4,2,58
592503106,109,27,29,5,170
592520164,1196,77,2,8,1283
592522108,69,78,29,16,192
592524967,10,5,2,1,18
592526014,15,9,2,1,27
592536596,54,8,2,6,70
592554528,65,30,2,9,106
592602262,67,35,54,1,157
592605952,181,21,68,19,289
592606065,22,10,5,8,45
592617299,40,7,2,1,50
592635429,26,3,2,1,32
592644243,89,11,14,6,120
592646087,27,32,2,1,62
592648133,110,7,2,7,126
592650270,36,9,2,1,48
592662489,26,25,13,11,75
592663498,47,30,48,25,150
592666358,26,7,3,3,39
592666549,87,3,2,5,97
592680733,11,3,2,1,17
592681476,59,9,55,1,124
592685964,44,6,2,1,53
592694788,55,9,3,6,73
592702879,93,3,2,1,99
592704058,39,3,2,2,46
592708265,47,3,2,1,53
592710821,55,29,32,22,138
592713499,92,18,5,1,116
592722932,14,3,2,1,20
592723820,77,21,54,1,153
592729626,49,41,10,18,118
592731125,60,24,2,4,90
592737922,113,53,71,1,238
592753870,11,3,2,1,17
592776576,64,3,24,1,92
592784127,115,84,112,5,316
592791824,19,57,2,1,79
592793369,11,5,2,1,19
592824470,11,3,2,1,17
592828991,13,18,2,1,34
592830864,10,5,2,1,18
592848909,68,3,2,1,74
592851433,42,3,2,2,49
592853125,100,59,2,1,162
592876466,64,3,2,1,70
592876914,20,37,2,2,61
592880506,20,10,2,1,33
592883461,128,54,24,5,211
592887924,225,3,2,37,267
592894206,80,3,2,2,87
592894295,244,28,2,6,280
592912338,52,10,21,4,87
592915114,38,37,22,31,128
592941909,42,3,2,1,48
592947942,37,46,27,72,182
592964463,34,59,3,1,97
592970872,10,6,2,1,19
592988943,95,69,136,23,323
593002798,61,38,68,1,168
593004116,62,30,2,11,105
593026542,53,3,2,1,59
593030458,10,22,2,1,35
593033802,69,36,30,2,137
593040172,185,27,2,48,262
593045687,452,3,2,52,509
593048376,189,28,27,1,245
593054680,102,19,2,2,125
593054819,45,19,10,2,76
593082518,10,3,2,2,17
593083597,53,9,2,21,85
593086631,78,3,2,3,86
593098043,49,14,2,5,70
593119498,38,3,2,1,44
593122646,11,3,2,1,17
593145505,81,3,2,1,87
593147338,160,47,2,1,210
593154749,81,16,11,5,113
593155663,107,3,2,25,137
593157215,301,3,2,11,317
593158891,177,35,2,2,216
593164637,56,9,77,1,143
593184903,82,11,3,10,106
593197867,24,3,3,5,35
593201235,52,18,6,2,78
593209076,140,15,2,14,171
593224467,31,3,2,1,37
593228838,45,3,2,3,53
593264201,66,14,14,18,112
593271329,41,28,63,8,140
593277117,77,14,2,3,96
593279363,15,46,10,6,77
593325971,48,73,114,5,240
593346277,50,56,5,3,114
593348329,22,25,2,1,50
593381637,91,4,54,5,154
593381908,94,24,37,3,158
593391688,39,13,15,1,68
593399481,16,3,2,1,22
593403881,87,3,2,1,93
593410879,12,3,2,1,18
593421319,10,25,2,2,39
593429504,109,3,2,1,115
593440534,141,27,25,6,199
593446290,35,32,2,16,85
593456270,93,3,2,10,108
593460037,61,44,21,3,129
593472550,13,8,2,1,24
593476399,96,3,2,6,107
593488375,27,15,3,1,46
593500398,56,6,2,13,77
593501930,33,21,13,1,68
593517504,27,43,11,8,89
593525972,24,36,6,3,69
593529628,33,58,32,3,126
593536537,10,5,2,1,18
593542362,17,3,2,2,24
593553959,28,53,51,17,149
593577287,10,6,2,1,19
593583027,120,22,4,31,177
593594626,18,37,61,47,163
593598623,17,17,2,1,37
593624058,90,23,2,4,119
593636454,20,15,4,6,45
593644145,12,3,2,11,28
593650996,79,3,2,3,87
593658353,203,4,3,1,211
593660341,32,17,8,3,60
593686766,71,3,2,3,79
593719009,74,4,2,1,81
593724347,84,32,28,37,181
593743749,18,4,5,1,28
593744715,11,34,2,1,48
593771200,70,86,107,3,266
593773972,52,10,2,7,71
593782418,98,80,29,39,246
593796798,126,145,4,50,325
593803644,34,35,2,4,75
593805815,102,33,2,1,138
593809125,16,6,2,1,25
593810362,23,60,2,2,87
593814436,10,4,2,1,17
593820031,49,28,43,1,121
593820355,117,18,71,48,254
593825230,66,3,2,1,72
593825596,44,3,2,2,51
593830657,200,10,3,16,229
593831135,82,12,3,2,99
593836511,21,35,2,3,61
593837307,102,3,2,1,108
593852400,22,3,2,8,35
593852619,45,3,2,1,51
593854835,24,7,3,1,35
593875903,134,3,2,1,140
593885323,13,11,2,2,28
593887152,11,3,2,1,17
593906060,79,3,3,1,86
593909197,11,9,2,2,24
593922729,94,66,18,1,179
593923298,20,28,2,1,51
593937413,72,32,44,5,153
593947087,73,3,2,13,91
593952371,32,12,2,1,47
593971608,18,7,19,10,54
594002120,109,23,25,13,170
594002469,115,4,2,3,124
594010608,52,3,61,14,130
594015961,90,27,18,18,153
594019734,205,45,10,58,318
594036560,53,72,2,8,135
594049070,76,24,34,15,149
594051937,11,5,5,2,23
594052035,46,5,2,8,61
594053177,53,22,6,9,90
594055912,111,17,2,1,131
594093136,13,3,2,1,19
594107013,112,12,2,2,128
594126385,23,16,2,1,42
594128846,113,14,3,15,145
594135970,38,3,2,3,46
594138313,17,28,13,1,59
594141544,93,44,29,1,167
594154367,28,15,15,4,62
594160124,53,5,2,20,80
594161159,16,6,2,1,25
594161631,11,3,2,1,17
594182317,25,3,2,5,35
594182941,263,8,2,59,332
594189281,142,9,2,1,154
594191263,26,30,4,34,94
594199404,11,3,2,1,17
594200466,12,3,2,2,19
594200894,53,3,2,4,62
594201967,75,3,2,1,81
594202470,24,3,2,1,30
594223593,71,36,11,43,161
594241943,41,61,5,3,110
594245757,54,5,4,2,65
594246769,91,5,2,7,105
594269027,16,3,2,1,22
594272323,47,103,150,13,313
594274563,100,19,92,13,224
594275744,79,28,2,3,112
594288986,91,17,2,1,111
594289673,35,22,6,3,66
594296513,15,46,2,1,64
594304562,35,53,9,1,98
594320861,33,30,2,1,66
594346992,53,15,48,1,117
594350519,48,35,2,3,88
594352520,80,66,28,11,185
594371224,116,19,31,1,167
594386086,46,23,19,1,89
594399316,40,31,2,3,76
594406392,54,21,5,8,88
594413665,117,3,2,29,151
594440659,37,80,3,2,122
594452809,217,53,9,10,289
594456223,144,62,62,13,281
594467379,233,22,21,1,277
594475285,13,3,2,1,19
594500742,17,21,2,1,41
594505022,81,20,43,1,145
594508981,17,18,2,1,38
594521849,68,10,9,1,88
594522807,16,3,2,1,22
594538019,110,18,3,5,136
594540987,13,3,2,1,19
594558406,41,22,9,3,75
594561716,60,6,2,1,69
594574107,77,42,58,6,183
594582228,39,20,2,6,67
594608926,14,3,2,1,20
594618512,38,7,2,6,53
594623447,132,36,14,3,185
594629443,39,3,2,2,46
594631583,16,3,2,1,22
594633278,131,23,7,8,169
594635400,18,55,2,1,76
594636597,74,8,9,11,102
594652938,105,3,2,1,111
594654718,22,19,2,1,44
594668715,64,30,33,16,143
594685750,24,3,2,10,39
594698724,11,11,3,1,26
594701918,68,7,2,8,85
594715521,34,3,2,8,47
594726976,68,3,2,1,74
594728953,34,3,2,1,40
594743891,38,16,6,24,84
594758382,21,6,2,1,30
594763283,15,29,4,5,53
594779305,22,5,2,1,30
594782100,39,57,33,24,153
594805592,35,52,17,1,105
594809111,18,15,2,1,36
594825707,18,14,7,5,44
594844037,63,3,2,1,69
594855051,57,3,44,3,107
594865343,45,55,14,80,194
594874955,119,25,2,9,155
594892427,13,3,2,1,19
594901174,26,4,3,1,34
594905505,51,14,2,3,70
594917441,102,50,48,6,206
594940000,55,21,2,1,79
594940276,127,29,3,6,165
594950617,16,15,2,1,34
594958259,301,35,115,2,453
594958817,77,3,2,1,83
594963955,25,5,2,1,33
594972244,16,3,2,4,25
594991016,20,3,2,1,26
594995823,107,33,17,11,168
595000981,96,36,26,8,166
595032177,47,3,2,1,53
595050849,29,8,6,1,44
595072485,140,8,128,1,277
595079139,34,22,9,1,66
595087137,72,10,9,1,92
595093112,72,13,2,8,95
595095837,98,25,2,25,150
595096436,12,40,4,2,58
595106956,16,3,2,1,22
595134789,198,3,2,3,206
595135997,153,33,2,1,189
595137839,264,3,2,2,271
595143006,70,53,2,1,126
595161981,66,50,41,13,170
595171099,15,9,2,2,28
595177586,86,49,2,3,140
595179957,59,7,2,51,119
595183273,46,48,43,14,151
595188577,15,3,2,1,21
595210642,80,10,2,6,98
595212461,19,22,18,1,60
595223455,94,36,58,20,208
595231601,64,28,2,10,104
595234436,147,9,3,2,161
595236967,40,19,8,1,68
595244005,49,27,5,1,82
595247004,19,7,2,1,29
595255787,73,27,7,34,141
595256920,20,33,8,26,87
595276378,138,3,2,1,144
595281286,72,3,2,1,78
595289714,25,20,2,2,49
595293280,60,21,2,1,84
595315344,68,38,84,19,209
595326869,56,3,35,1,95
595338672,38,3,2,4,47
595340643,73,90,8,65,236
595361970,22,5,12,1,40
595364020,48,31,5,4,88
595366399,202,32,20,17,271
595378243,10,9,2,4,25
595386728,88,27,46,1,162
595387422,14,24,3,1,42
595388845,37,23,22,1,83
595395768,22,38,2,1,63
595401745,29,5,2,8,44
595408545,108,45,37,7,197
595409811,189,3,2,1,195
595417543,91,16,87,27,221
595424259,10,5,2,1,18
595426855,121,3,2,1,127
595429915,304,47,3,1,355
595431841,64,14,32,11,121
595438956,138,30,2,6,176
595445709,11,9,2,4,26
595451707,12,5,2,1,20
595456241,11,9,2,2,24
595464048,19,5,3,1,28
595475905,107,66,57,14,244
595478581,10,5,2,1,18
595488244,59,59,35,9,162
595522598,149,10,38,8,205
595523041,70,3,2,37,112
595528362,116,93,61,1,271
595534226,62,25,24,6,117
595539006,40,3,2,1,46
595547329,21,3,2,1,27
595554813,114,16,3,1,134
595556955,15,3,2,1,21
595557429,263,45,9,19,336
595568317,91,3,2,5,101
595581427,13,5,2,3,23
595587440,157,3,2,6,168
595590871,208,6,2,4,220
595619040,58,24,34,14,130
595627200,14,11,2,1,28
595637328,91,32,2,2,127
595641479,52,36,4,6,98
595644424,32,67,13,11,123
595659908,134,9,2,5,150
595677976,10,11,2,2,25
595689148,132,30,71,15,248
595694599,69,22,22,48,161
595707175,113,17,39,4,173
595734932,66,10,21,13,110
595742846,113,29,2,1,145
595774751,168,3,2,1,174
595776340,41,52,54,19,166
595779255,66,3,6,7,82
595781879,66,35,2,2,105
595784053,62,9,18,1,90
595792051,72,7,13,2,94
595794183,76,13,2,12,103
595825476,16,3,2,1,22
595826914,24,30,2,7,63
595829311,117,33,2,3,155
595836868,13,11,12,70,106
595864131,39,32,49,3,123
595866762,180,16,4,1,201
595875689,92,3,2,2,99
595882598,36,51,42,1,130
595882828,187,14,39,113,353
595891414,35,6,2,1,44
595931443,13,22,2,1,38
595937774,55,117,32,25,229
595938882,99,3,9,3,114
595939560,44,28,2,5,79
595949999,27,55,3,8,93
595960606,35,28,15,1,79
595962701,221,36,2,3,262
595971132,95,3,2,2,102
595974374,15,21,2,1,39
595978169,77,3,2,2,84
595978193,86,108,17,44,255
596018642,63,24,40,2,129
596019289,266,10,5,9,290
596020049,54,17,2,35,108
596025889,141,29,40,13,223
596031584,25,4,2,6,37
596033592,65,34,36,5,140
596034760,52,3,2,1,58
596051479,29,3,2,1,35
596067571,42,3,16,3,64
596072527,64,3,2,13,82
596075496,23,24,2,5,54
596089362,75,35,36,8,154
596095485,10,4,2,1,17
596096109,99,3,2,1,105
596098561,91,30,19,6,146
596103935,135,118,24,16,293
596143617,107,11,3,9,130
596150150,65,18,111,10,204
596157011,98,5,31,6,140
596158210,23,26,4,3,56
596158502,108,3,2,7,120
596166249,129,4,7,7,147
596169380,41,26,7,1,75
596189696,48,43,2,22,115
596210835,38,61,44,6,149
596212730,90,17,2,4,113
596215962,19,27,2,3,51
596220544,78,3,2,1,84
596221900,25,3,2,1,31
596225421,45,20,35,1,101
596244596,42,31,58,6,137
596244937,34,6,2,1,43
596252284,53,12,2,1,68
596253926,89,24,8,1,122
596258004,17,3,2,1,23
596261182,21,16,2,1,40
596281612,39,4,4,11,58
596292341,122,7,48,24,201
596292688,71,3,34,4,112
596295662,21,7,2,2,32
596298605,214,12,10,15,251
596312262,50,3,2,2,57
596317457,83,34,18,47,182
596324014,19,14,2,1,36
596330110,75,3,2,2,82
596336542,45,42,2,1,90
596341668,22,57,2,2,83
596345543,136,21,2,17,176
596347989,93,3,2,1,99
596362307,113,3,2,17,135
596387238,197,3,2,1,203
596412935,117,26,55,22,220
596418584,136,16,6,14,172
596420005,15,7,2,1,25
596443278,18,30,38,2,88
596453026,86,28,10,8,132
596457411,10,7,2,1,20
596487710,98,13,45,3,159
596493366,52,18,3,4,77
596496173,110,79,9,63,261
596514447,12,3,2,1,18
596523911,92,3,2,1,98
596531001,56,3,2,1,62
596539555,83,24,17,6,130
596541267,16,5,2,1,24
596551385,29,22,4,2,57
596557144,98,70,2,1,171
596570016,13,3,2,1,19
596574310,63,69,55,24,211
596586654,35,14,4,1,54
596587381,84,3,2,1,90
596598894,157,7,5,5,174
596599882,146,6,2,1,155
596630448,14,28,2,1,45
596662303,89,3,2,29,123
596670694,209,3,2,14,228
596684066,169,25,2,1,197
596703255,10,9,2,1,22
596715319,86,3,8,2,99
596719258,105,3,2,1,111
596737715,39,19,2,1,61
596760772,24,3,2,4,33
596764113,89,23,58,18,188
596764168,94,10,13,26,143
596765229,11,3,2,1,17
596766881,106,16,2,2,126
596769606,14,3,2,1,20
596773352,11,26,2,1,40
596777321,10,7,2,1,20
596791704,47,41,2,9,99
596792717,75,25,69,25,194
596808234,177,41,9,9,236
596838677,90,5,2,20,117
596844134,120,3,2,1,126
596848918,10,4,2,1,17
596849246,21,31,25,1,78
596849932,16,4,2,1,23
596862930,13,5,2,1,21
596884352,150,32,6,9,197
596893524,62,47,8,1,118
596933775,93,3,2,3,101
596941218,775,3,2,9,789
596973229,58,36,19,5,118
596979623,11,20,2,1,34
596981271,59,3,2,28,92
596994350,22,3,2,1,28
597000357,80,11,3,1,95
597009335,36,25,3,2,66
597016565,44,3,2,1,50
597018812,14,16,2,1,33
597021757,23,3,2,1,29
597023590,20,3,2,1,26
597042304,106,90,51,29,276
597058655,146,33,2,18,199
597059609,58,13,10,15,96
597062569,129,53,14,1,197
597066035,43,31,13,1,88
597067513,10,5,2,5,22
597080469,104,3,2,1,110
597096054,14,43,2,1,60
597096340,18,4,2,2,26
597104174,37,67,37,19,160
597111257,20,3,2,1,26
597114669,12,3,2,1,18
597125485,62,7,2,1,72
597125607,17,17,6,4,44
597136722,10,25,2,1,38
597140737,33,25,67,9,134
597171441,11,17,2,1,31
597185249,35,3,2,1,41
597187959,21,3,3,2,29
597195231,50,3,2,2,57
597201084,168,27,73,22,290
597204272,60,34,32,1,127
597210761,68,10,34,3,115
597213776,29,72,2,1,104
597219239,113,8,3,8,132
597219792,37,32,17,2,88
597221243,112,12,9,5,138
597231279,67,24,2,14,107
597254525,14,3,2,2,21
597265590,72,46,15,21,154
597282062,84,6,2,13,105
597284070,25,48,2,5,80
597323446,62,32,9,1,104
597326092,93,5,2,2,102
597348347,87,45,59,19,210
597352120,31,28,3,1,63
597365000,50,11,3,8,72
597367546,15,4,2,1,22
597374421,11,3,2,2,18
597377855,92,35,2,6,135
597381644,11,3,2,1,17
597384800,63,35,19,24,141
597406125,95,3,2,1,101
597420618,111,9,2,12,134
597425123,52,20,4,5,81
597427157,26,3,2,1,32
597435465,41,3,2,5,51
597440319,74,11,27,16,128
597445438,29,41,2,1,73
597469556,140,32,14,4,190
597472319,36,33,35,28,132
597473698,60,14,14,42,130
597512532,102,48,2,3,155
597525521,40,3,2,9,54
597531256,15,4,2,3,24
597550557,77,57,2,12,148
597557812,13,5,2,1,21
597557837,15,6,2,1,24
597570962,56,16,2,7,81
597573386,35,3,2,7,47
597584877,26,19,14,13,72
597587185,13,3,2,3,21
597587305,68,19,18,1,106
597594008,31,15,2,2,50
597597605,12,3,2,1,18
597610686,54,9,2,1,66
597612332,31,38,2,5,76
597620959,188,3,2,8,201
597622164,122,8,26,1,157
597628539,42,3,2,3,50
597651544,29,36,2,1,68
597652029,94,10,3,7,114
597687967,70,25,7,8,110
597689546,160,67,2,1,230
597697022,35,34,7,1,77
597702933,20,15,10,4,49
597722676,30,3,2,1,36
597732853,17,82,43,6,148
597734537,92,32,40,41,205
597737347,28,72,2,2,104
597738167,11,3,2,1,17
597751315,83,9,2,2,96
597756150,11,9,17,1,38
597759791,132,49,2,49,232
597763214,71,3,2,1,77
597814130,12,33,2,1,48
597818938,50,3,10,1,64
597828776,40,21,56,27,144
597832641,91,19,2,1,113
597849304,24,3,2,1,30
597851288,15,3,2,1,21
597852702,10,37,2,1,50
597855159,12,4,2,7,25
597857699,24,3,2,1,30
597862367,80,30,12,1,123
597870121,84,3,2,17,106
597870298,59,59,61,8,187
597881281,128,44,45,1,218
597889059,71,25,51,9,156
597903148,21,9,2,1,33
597907403,37,50,2,1,90
597913515,56,3,4,9,72
597913614,10,3,2,4,19
597914532,121,14,2,1,138
597925782,36,3,2,3,44
597934109,33,22,7,4,66
597950799,63,30,12,15,120
597952936,28,12,5,12,57
597955214,10,19,2,3,34
597955721,81,20,2,2,105
597966298,19,3,2,1,25
597966824,92,3,2,14,111
597972636,18,19,2,1,40
597980080,156,3,2,3,164
597984810,74,3,2,1,80
597985371,13,3,2,1,19
597996934,74,12,2,17,105
598010947,10,3,2,2,17
598018459,71,21,2,14,108
598026895,69,25,18,3,115
598028272,101,19,4,8,132
598030047,18,17,2,3,40
598031180,108,16,4,11,139
598039799,32,3,2,2,39
598052492,24,15,2,1,42
598054736,141,45,12,49,247
598090182,21,3,2,2,28
598092066,69,38,15,23,145
598112177,47,3,2,1,53
598135004,153,26,37,3,219
598138224,157,24,5,19,205
598141541,33,25,46,4,108
598143177,91,3,2,1,97
598153755,230,4,52,2,288
598158659,13,3,2,2,20
598169850,29,26,19,2,76
598203284,82,12,2,3,99
598213508,26,3,2,1,32
598217321,14,3,2,6,25
598239372,27,10,10,3,50
598259190,20,22,2,1,45
598261893,76,38,3,34,151
598269935,160,81,48,13,302
598282446,71,38,2,1,112
598284873,64,10,4,2,80
598297430,18,3,2,1,24
598299341,13,3,2,1,19
598316762,220,6,2,27,255
598322714,35,56,2,9,102
598323116,45,3,2,5,55
598326130,47,3,2,1,53
598342509,75,29,50,7,161
598344395,30,54,26,2,112
598347807,12,10,2,1,25
598358927,32,13,2,1,48
598380073,107,9,2,1,119
598386890,40,3,2,1,46
598399106,18,3,2,1,24
598401674,35,60,28,49,172
598413059,80,21,2,1,104
598415247,41,29,2,3,75
598431315,44,25,5,32,106
598431353,12,6,2,1,21
598431569,58,3,2,54,117
598435857,94,30,22,11,157
598449129,63,3,2,4,72
598460632,17,3,2,1,23
598466608,172,3,2,1,178
598468354,15,3,2,1,21
598482566,16,3,2,1,22
598484907,123,3,2,4,132
598494463,29,21,2,12,64
598515069,62,10,2,1,75
598515434,296,3,2,18,319
598519009,283,101,3,18,405
598522400,52,27,13,3,95
598529985,154,25,17,26,222
598545112,34,16,28,10,88
598550645,11,3,2,1,17
598551332,11,3,5,1,20
598556651,14,3,2,1,20
598558868,78,12,89,6,185
598566255,36,3,2,4,45
598567893,55,3,2,1,61
598569184,43,12,2,3,60
598593252,45,3,2,4,54
598606759,43,17,2,1,63
598608116,114,52,66,10,242
598632010,73,9,2,1,85
598642878,21,13,6,1,41
598646061,57,15,4,23,99
598647147,50,3,2,1,56
598650884,99,3,2,2,106
598657524,103,30,2,83,218
598672280,23,3,2,6,34
598685261,114,6,28,41,189
598695879,11,4,2,1,18
598701878,20,3,2,1,26
598719986,175,40,15,17,247
598745482,92,35,71,3,201
598745719,48,25,2,1,76
598752098,24,3,2,1,30
598793289,70,18,9,1,98
598794441,119,28,3,1,151
598811770,32,25,35,1,93
598814043,134,40,46,5,225
598821373,16,3,2,1,22
598823284,84,12,45,46,187
598826585,103,3,2,18,126
598830945,47,55,2,4,108
598831286,169,3,2,13,187
598833733,40,26,9,1,76
598852539,127,23,2,1,153
598856894,31,10,25,26,92
598868993,29,56,2,6,93
598883375,64,70,32,2,168
598887282,183,34,38,18,273
598916851,53,22,14,2,91
598928090,110,23,35,5,173
598945202,43,44,32,10,129
598949066,67,32,60,4,163
598950221,31,10,2,1,44
598953973,436,3,2,22,463
598957202,82,3,2,3,90
598960590,11,5,2,1,19
598962714,17,3,2,1,23
598964677,73,3,2,2,80
598980246,97,30,31,10,168
598992235,19,3,2,1,25
598994245,16,18,2,8,44
599003437,257,3,2,34,296
599012967,69,40,7,2,118
599022151,19,3,2,1,25
599043227,13,3,2,1,19
599047029,50,3,2,1,56
599047299,77,16,13,3,109
599054083,121,3,2,5,131
599065600,64,59,17,35,175
599082099,71,39,5,1,116
599083348,26,12,14,49,101
599087250,12,3,2,1,18
599087844,92,15,2,1,110
599108249,100,25,47,21,193
599115951,15,8,2,4,29
599123053,216,3,2,17,238
599131347,87,3,2,1,93
599145688,159,3,2,2,166
599149477,68,49,2,20,139
599152347,12,3,2,1,18
599154065,119,3,2,1,125
599158101,224,74,2,1,301
599161507,30,23,2,1,56
599163457,36,118,7,1,162
599163513,120,3,2,1,126
599167246,51,3,2,3,59
599191573,27,11,2,1,41
599197171,22,17,2,3,44
599210898,103,68,15,2,188
599214595,217,3,2,3,225
599240345,15,23,75,26,139
599248513,46,22,72,20,160
599249028,65,11,26,4,106
599271220,11,76,2,23,112
599271449,120,36,37,8,201
599274373,143,3,2,7,155
599283350,57,31,26,4,118
599290049,43,40,3,1,87
599300396,95,58,33,27,213
599314276,57,3,2,1,63
599315263,57,6,2,3,68
599339647,57,25,9,1,92
599345522,436,3,2,3,444
599354174,104,17,2,1,124
599355963,15,8,2,1,26
599358002,81,16,2,9,108
599377144,140,4,3,20,167
599377512,75,3,2,13,93
599385562,68,10,2,1,81
599395552,151,4,2,8,165
599399507,12,15,2,2,31
599431142,10,14,2,1,27
599441110,16,3,2,7,28
599451071,362,76,11,22,471
599461406,32,5,2,3,42
599461493,33,5,22,2,62
599480911,42,15,12,2,71
599481439,36,54,14,14,118
599490197,22,5,2,2,31
599496463,37,23,42,1,103
599511181,124,29,2,9,164
599528944,110,39,55,24,228
599540980,96,28,8,3,135
599549558,31,8,2,5,46
599552926,40,3,2,1,46
599558904,53,24,4,24,105
599566995,76,31,38,12,157
599568296,36,20,3,9,68
599599263,13,4,2,5,24
599609437,58,70,32,1,161
599611007,100,41,2,1,144
599614868,30,21,12,2,65
599617214,145,10,2,3,160
599620068,873,3,2,9,887
599624560,134,31,36,2,203
599649218,43,17,19,1,80
599668125,17,59,2,1,79
599682181,15,13,2,6,36
599683858,78,25,2,1,106
599689327,37,41,3,13,94
599696737,35,3,2,1,41
599704972,55,33,16,55,159
599706249,16,3,2,1,22
599714549,16,19,2,2,39
599717252,19,3,2,1,25
599742275,46,97,8,4,155
599743746,65,6,55,4,130
599748389,15,20,4,1,40
599757726,16,8,2,2,28
599762378,96,25,33,18,172
599767789,24,9,2,1,36
599775423,10,9,2,1,22
599784951,126,10,2,1,139
599797064,42,32,4,1,79
599803665,72,37,3,18,130
599805926,25,3,2,1,31
599807097,93,21,2,1,117
599813723,114,3,2,2,121
599826112,17,68,20,1,106
599831265,10,13,8,1,32
599833730,23,18,11,4,56
599839453,61,25,21,3,110
599847730,84,3,2,6,95
599853647,69,49,3,3,124
599875136,267,14,2,20,303
599877948,109,16,12,1,138
599880157,50,3,2,3,58
599882782,155,14,2,13,184
599892815,142,20,10,2,174
599913268,11,3,2,5,21
599936671,107,3,21,65,196
599938009,100,9,6,4,119
599944537,31,37,2,17,87
599948013,16,12,2,1,31
599981012,491,10,25,18,544
599981903,66,8,9,10,93
600002169,198,3,2,2,205
600022465,10,4,2,1,17
600037242,69,16,19,1,105
600037358,27,3,2,3,35
600056349,48,3,2,1,54
600059258,14,3,2,3,22
600062174,124,3,2,1,130
600063550,129,3,2,5,139
600073612,98,19,42,7,166
600074071,29,17,2,13,61
600075011,147,3,12,1,163
600092394,15,3,2,2,22
600095187,93,55,24,3,175
600098146,89,7,17,2,115
600110882,19,3,2,1,25
600124867,166,41,2,15,224
600138330,46,3,2,4,55
600141894,10,3,2,2,17
600143695,106,37,8,27,178
600165775,78,3,2,3,86
600180065,59,10,2,4,75
600184676,65,35,2,1,103
600192878,10,4,2,1,17
600195766,109,65,2,1,177
600225010,23,13,2,1,39
600226056,26,9,7,1,43
600237903,10,21,4,1,36
600239291,21,4,8,5,38
600250936,18,38,2,1,59
600271704,168,29,152,18,367
600288195,50,32,39,1,122
600292836,161,17,2,3,183
600292846,55,3,2,2,62
600299435,105,9,4,1,119
600302141,29,53,11,18,111
600307915,61,51,63,13,188
600315707,81,28,62,20,191
600317586,84,15,23,8,130
600329229,39,27,3,22,91
600350431,11,3,2,1,17
600351261,79,30,95,2,206
600360618,26,36,2,1,65
600364357,137,84,5,5,231
600366910,150,31,99,5,285
600367740,23,50,2,1,76
600370190,16,3,2,3,24
600374142,110,43,64,9,226
600388019,20,31,2,1,54
600390199,144,17,14,4,179
600398155,161,3,2,14,180
600410594,32,11,2,2,47
600459215,44,16,6,1,67
600460791,67,9,2,4,82
600462462,33,24,5,41,103
600470403,45,49,3,1,98
600485282,49,11,2,3,65
600488083,87,3,2,13,105
600509797,16,14,3,6,39
600525207,57,3,2,2,64
600533540,105,9,4,4,122
600539676,145,34,2,3,184
600539677,51,21,5,14,91
600540682,19,3,2,1,25
600541777,136,8,17,3,164
600549492,11,3,2,1,17
600555916,56,34,15,6,111
600579358,91,3,2,1,97
600614528,62,20,12,1,95
600618182,29,13,2,1,45
600643276,248,3,2,1,254
600652540,61,14,2,7,84
600656028,13,3,2,1,19
600659804,27,43,22,1,93
600671202,234,55,41,2,332
600716775,71,15,58,1,145
600734533,38,3,2,4,47
600746893,10,3,2,3,18
600801741,122,3,2,1,128
600808645,66,26,70,1,163
600809302,20,3,2,1,26
600809311,11,3,2,1,17
600809679,38,31,4,7,80
600832557,53,3,2,1,59
600848964,72,26,18,3,119
600871564,51,26,36,1,114
600913566,102,45,9,12,168
600914423,14,3,2,4,23
600929737,62,5,17,7,91
600948481,48,14,24,3,89
600956455,60,3,2,1,66
600991542,23,5,2,3,33
601005849,102,3,2,2,109
601021561,12,3,2,1,18
601023612,78,16,3,1,98
601029347,176,21,36,36,269
601031743,29,55,16,18,118
601047407,27,49,29,21,126
601053022,23,3,2,1,29
601053586,135,17,152,1,305
601055825,188,3,2,1,194
601062198,92,31,2,5,130
601067796,192,3,2,1,198
601097587,57,58,7,49,171
601108463,24,3,2,1,30
601110353,54,6,27,2,89
601117770,43,22,15,3,83
601122097,11,3,2,2,18
601127914,178,23,2,31,234
601130386,104,30,5,16,155
601133962,150,15,5,1,171
601145156,92,57,53,5,207
601153664,82,25,11,12,130
601156714,34,8,4,6,52
601179790,51,4,5,7,67
601186929,63,38,2,75,178
601191027,163,45,17,10,235
601221310,12,5,2,1,20
601226313,71,14,18,19,122
601227049,75,8,2,11,96
601228032,10,3,2,3,18
601248894,107,26,29,2,164
601253028,26,3,2,1,32
601262342,63,31,15,59,168
601264192,50,3,2,1,56
601267065,60,3,2,1,66
601271060,25,42,2,6,75
601271808,32,3,2,4,41
601282235,28,25,2,1,56
601311306,109,53,45,16,223
601311720,37,31,5,2,75
601352627,15,3,2,1,21
601360753,90,20,50,1,161
601372259,167,33,6,21,227
601392230,180,3,2,1,186
601394809,58,11,2,4,75
601412456,22,55,2,1,80
601422676,176,17,2,1,196
601436577,46,19,5,5,75
601445038,24,3,2,3,32
601451180,37,20,2,1,60
601463116,89,36,4,4,133
601463679,48,3,2,1,54
601477300,15,46,20,2,83
601488463,180,11,2,1,194
601525178,121,3,2,1,127
601538635,93,5,2,1,101
601539694,10,8,2,7,27
601541091,34,3,2,1,40
601555738,24,26,2,1,53
601558446,13,9,2,3,27
601575014,165,3,2,1,171
601590069,56,34,3,1,94
601591062,140,106,22,15,283
601592155,81,26,16,3,126
601621178,51,57,33,5,146
601631973,48,6,2,1,57
601639301,35,22,4,9,70
601640386,70,37,24,5,136
601640862,71,9,2,2,84
601664960,39,3,2,5,49
601680263,28,12,14,2,56
601696664,46,19,8,2,75
601698744,62,12,2,3,79
601703760,138,31,3,1,173
601716601,128,23,5,50,206
601720996,165,48,105,13,331
601722541,55,14,8,17,94
601725496,113,31,40,8,192
601728544,21,7,2,1,31
601736265,16,6,2,10,34
601746050,63,96,2,1,162
601755378,21,3,2,1,27
601771260,26,48,27,21,122
601778835,126,26,2,3,157
601783194,396,3,2,28,429
601784138,25,3,2,1,31
601784559,100,12,38,3,153
601814509,10,7,2,1,20
601816723,18,49,5,1,73
601835982,88,38,18,1,145
601837406,16,16,2,1,35
601839598,22,47,26,16,111
601845278,33,27,5,9,74
601848339,14,3,2,1,20
601873295,91,3,2,1,97
601876769,12,3,2,1,18
601887645,100,3,2,1,106
601892744,37,36,5,9,87
601920385,61,3,2,5,71
601939356,182,58,2,28,270
601966353,93,27,3,1,124
601980806,77,24,5,14,120
601980891,412,3,2,1,418
601989403,28,7,2,2,39
601990471,21,5,3,1,30
601994472,11,4,2,1,18
601994831,51,14,2,6,73
601998862,96,3,2,1,102
602004923,59,3,2,1,65
602022671,99,75,8,2,184
602037775,18,38,4,2,62
602049591,45,30,39,1,115
602071225,136,49,7,3,195
602073519,54,13,12,7,86
602080271,30,22,4,4,60
602082612,113,16,55,1,185
602083140,216,3,2,21,242
602085726,64,37,58,50,209
602086291,18,9,2,1,30
602088622,47,3,2,3,55
602108986,70,18,2,4,94
602112243,23,6,2,1,32
602124819,11,3,2,1,17
602146896,120,42,14,13,189
602173106,41,33,3,1,78
602186509,75,3,2,1,81
602199629,10,25,2,1,38
602201961,104,16,66,9,195
602205452,25,5,2,1,33
602216379,11,4,2,1,18
602245847,75,3,2,3,83
602252610,51,17,2,18,88
602281615,88,3,2,5,98
602288639,200,26,63,8,297
602310112,66,10,35,4,115
602317461,93,3,2,2,100
602318732,31,3,2,10,46
602336446,190,30,28,64,312
602339844,50,46,2,3,101
602339961,13,3,2,1,19
602343442,82,6,2,7,97
602347032,150,22,5,65,242
602349344,72,23,41,1,137
602350093,34,3,2,1,40
602357086,206,3,2,1,212
602369178,29,40,72,8,149
602373025,115,3,20,1,139
602376730,77,3,2,3,85
602378612,65,124,61,6,256
602383241,10,3,2,4,19
602389099,132,29,64,44,269
602395286,46,14,2,3,65
602415573,63,5,2,1,71
602416083,127,19,13,25,184
602427504,51,22,13,16,102
602432312,58,3,49,1,111
602436945,15,3,2,1,21
602447756,55,78,29,3,165
602449482,141,3,2,15,161
602457161,77,3,6,4,90
602462507,43,12,2,8,65
602469358,38,9,21,10,78
602475577,46,96,14,15,171
602476394,42,39,14,3,98
602481972,93,18,51,2,164
602484816,55,4,8,1,68
602484922,174,18,6,55,253
602497144,16,3,2,1,22
602499591,145,3,2,1,151
602503101,97,45,2,7,151
602509612,17,24,2,1,44
602518089,79,13,2,1,95
602529110,30,17,2,2,51
602530131,91,3,2,9,105
602558987,39,3,2,2,46
602564213,59,36,4,3,102
602573248,118,6,2,2,128
602578212,21,17,4,32,74
602579380,23,6,2,5,36
602599540,72,3,2,1,78
602614323,145,8,2,1,156
602618467,168,41,47,29,285
602623266,140,3,2,1,146
602627816,23,5,2,1,31
602632639,10,11,2,1,24
602636416,128,46,83,2,259
602640092,10,3,2,3,18
602641216,33,3,2,1,39
602643402,11,3,2,1,17
602652478,14,17,2,2,35
602666301,113,12,115,9,249
602673833,119,15,2,7,143
602711512,12,3,2,1,18
602716383,78,3,2,8,91
602723155,22,14,2,1,39
602743432,20,37,2,1,60
602755894,22,3,2,1,28
602756806,71,11,24,1,107
602774797,57,3,2,1,63
602775951,64,38,23,2,127
602798095,41,67,17,5,130
602799623,73,7,2,2,84
602814052,76,15,2,3,96
602821277,35,11,2,1,49
602827470,111,22,26,46,205
602835500,59,20,26,6,111
602839463,61,3,2,17,83
602845340,125,39,3,1,168
602853627,13,12,2,1,28
602872426,19,3,2,13,37
602878684,30,3,2,1,36
602881460,34,19,30,6,89
602885241,40,3,2,1,46
602885401,62,3,2,1,68
602890903,234,3,2,4,243
602897805,10,6,2,1,19
602899934,41,3,2,7,53
602901824,105,3,2,4,114
602908820,69,4,2,3,78
602916019,14,5,2,1,22
602919190,30,3,2,1,36
602951443,155,3,2,11,171
602961522,139,32,21,8,200
602966740,42,3,2,1,48
602971356,55,30,4,14,103
602972148,76,3,2,1,82
602987921,14,28,2,1,45
602993616,172,20,76,4,272
602999857,58,3,24,1,86
603003772,63,32,10,35,140
603008694,64,21,8,7,100
603019939,11,3,2,3,19
603028006,34,3,2,1,40
603052959,379,3,2,2,386
603071952,16,3,2,1,22
603086814,18,9,2,4,33
603095337,20,4,7,1,32
603106224,116,25,9,1,151
603106750,110,3,3,1,117
603108185,28,18,3,1,50
603128651,88,16,70,1,175
603144425,58,3,2,8,71
603144627,121,10,16,26,173
603145069,25,110,38,3,176
603148295,12,3,2,16,33
603151174,34,38,2,6,80
603152938,11,3,2,1,17
603162926,50,4,2,3,59
603172243,39,3,2,3,47
603183503,94,17,2,1,114
603186190,33,7,2,12,54
603188199,19,9,2,2,32
603206450,231,12,21,36,300
603227419,58,42,15,8,123
603230910,251,10,3,4,268
603237812,36,39,2,3,80
603240652,77,15,32,3,127
603253759,117,4,9,1,131
603255119,155,27,38,1,221
603276444,88,9,17,2,116
603283704,14,9,2,1,26
603286958,26,3,2,10,41
603287704,30,10,2,1,43
603301566,24,18,2,1,45
603303376,14,3,2,1,20
603308506,45,18,2,1,66
603312985,33,42,59,6,140
603320766,28,6,6,1,41
603328355,17,11,2,1,31
603346300,30,36,2,2,70
603350826,25,48,2,1,76
603358995,14,3,2,1,20
603378126,101,3,2,1,107
603379037,21,18,2,2,43
603394177,11,3,2,1,17
603396592,25,3,2,1,31
603405149,98,25,82,2,207
603405211,48,6,2,1,57
603409511,14,19,2,5,40
603409576,30,37,2,1,70
603423259,11,3,2,3,19
603426120,64,48,5,10,127
603426192,10,4,2,1,17
603436419,160,30,2,13,205
603438461,18,3,2,5,28
603454104,110,9,2,1,122
603487755,14,8,2,1,25
603490961,43,30,8,3,84
603494956,154,3,2,2,161
603501027,18,3,2,2,25
603505013,17,24,2,3,46
603516110,65,5,2,5,77
603528693,41,3,2,1,47
603529093,154,14,5,4,177
603530485,30,33,17,6,86
603557054,13,3,2,1,19
603562661,137,3,53,53,246
603569257,16,9,2,1,28
603570526,129,8,83,3,223
603570715,81,84,2,3,170
603573811,175,3,2,13,193
603575414,97,3,2,29,131
603590098,74,14,5,1,94
603593633,63,3,2,1,69
603602025,137,6,3,3,149
603603312,519,7,2,1,529
603618284,71,22,2,12,107
603618438,24,3,2,1,30
603629326,18,3,2,2,25
603631613,27,19,2,3,51
603633313,84,41,17,1,143
603645434,16,3,2,6,27
603648149,17,3,2,5,27
603650617,136,15,5,2,158
603667093,41,20,2,1,64
603688447,151,59,136,4,350
603692642,37,3,2,1,43
603705304,48,29,4,1,82
603706830,11,3,2,1,17
603709549,111,3,2,1,117
603717030,35,3,2,3,43
603726297,28,27,2,1,58
603727663,10,11,2,1,24
603729655,101,7,2,1,111
603732559,63,3,2,6,74
603736791,92,22,2,1,117
603737046,135,13,4,12,164
603739550,55,3,2,1,61
603747068,35,81,18,6,140
603762363,70,3,2,3,78
603777443,10,23,6,2,41
603780371,47,36,4,1,88
603784167,67,3,2,1,73
603791477,62,3,2,5,72
603795286,82,3,2,4,91
603800399,123,3,2,1,129
603822489,11,3,2,1,17
603828284,48,61,172,1,282
603859696,53,65,7,1,126
603864543,120,5,24,1,150
603880003,14,5,2,1,22
603897961,176,3,2,6,187
603916351,49,3,2,1,55
603929272,13,3,2,1,19
603935078,19,3,2,1,25
603939055,12,3,7,2,24
603949225,69,13,2,23,107
603966215,64,5,2,1,72
603969016,11,3,2,1,17
603981620,93,37,44,1,175
603983788,19,18,2,1,40
603984223,62,10,4,10,86
604011629,29,5,2,1,37
604019848,12,3,2,2,19
604021987,134,13,98,10,255
604027095,2062,3,2,150,2217
604032884,38,49,9,16,112
604037405,52,12,15,3,82
604037889,64,46,10,32,152
604070369,77,19,2,1,99
604079237,39,37,2,1,79
604101095,81,21,49,9,160
604101634,239,28,61,1,329
604108482,25,3,2,1,31
604133576,159,25,87,1,272
604167688,32,42,17,19,110
604171285,118,25,3,1,147
604171889,36,57,2,4,99
604192340,21,3,2,3,29
604192928,14,3,2,1,20
604225418,102,118,64,1,285
604230451,38,20,3,15,76
604231531,11,4,2,6,23
604235710,54,24,34,2,114
604246424,53,38,3,1,95
604253704,50,23,2,1,76
604255272,69,3,2,1,75
604266964,132,19,2,1,154
604271815,50,3,2,1,56
604278702,73,17,2,2,94
604284404,44,3,2,7,56
604287652,69,40,18,26,153
604287969,131,16,2,7,156
604288313,33,37,7,1,78
604289704,13,3,2,1,19
604297192,58,29,13,1,101
604306798,69,18,14,1,102
604307046,103,3,2,9,117
604309545,79,13,2,3,97
604310189,76,59,3,2,140
604311320,98,14,12,3,127
604312946,66,3,2,1,72
604317564,66,29,100,8,203
604320685,32,15,2,1,50
604322057,82,13,4,1,100
604322232,47,11,2,2,62
604329934,15,14,2,1,32
604332179,15,3,2,1,21
604341563,147,3,2,1,153
604350016,14,3,2,1,20
604386471,79,3,2,1,85
604397339,50,3,2,1,56
604398280,151,3,2,10,166
604404812,10,4,2,1,17
604407509,181,20,52,16,269
604408777,21,20,2,1,44
604412711,67,35,11,1,114
604426294,62,8,6,54,130
604437379,72,37,71,30,210
604442410,132,3,2,1,138
604445601,42,59,4,8,113
604453220,43,3,2,1,49
604466868,147,3,4,16,170
604472635,11,3,2,1,17
604477881,74,4,2,1,81
604480728,54,21,2,5,82
604484212,99,86,16,25,226
604496694,186,24,2,7,219
604497347,116,44,138,15,313
604501730,31,37,2,1,71
604504773,56,3,2,2,63
604508954,95,3,2,1,101
604513975,52,12,2,2,68
604522539,204,20,5,2,231
604526829,69,22,3,4,98
604548886,33,4,18,3,58
604561143,73,19,33,12,137
604569864,38,13,8,6,65
604570263,11,3,2,1,17
604584451,11,3,2,1,17
604588573,17,3,2,1,23
604601601,332,9,13,1,355
604617832,94,23,87,2,206
604618541,74,3,2,1,80
604621713,45,19,2,1,67
604622378,172,17,5,5,199
604623634,43,47,59,24,173
604627507,85,19,2,1,107
604630559,49,39,6,1,95
604631679,60,15,3,2,80
604635433,77,3,2,1,83
604644125,101,45,11,2,159
604651940,122,31,22,9,184
604656645,95,10,13,1,119
604660797,144,35,33,14,226
604667520,78,3,2,1,84
604675449,23,3,2,1,29
604677544,89,3,2,13,107
604679317,73,67,33,6,179
604681569,127,25,2,1,155
604687737,25,13,11,10,59
604695204,59,3,2,1,65
604706888,73,18,3,1,95
604721707,102,17,30,8,157
604741966,199,24,2,8,233
604773382,21,26,2,1,50
604783908,632,3,2,6,643
604786756,42,5,2,1,50
604793340,85,3,2,6,96
604807620,104,3,2,2,111
604810061,82,5,2,1,90
604821987,81,17,10,21,129
604838522,121,11,7,1,140
604843613,48,50,9,4,111
604845782,13,3,2,1,19
604854802,17,3,2,1,23
604855325,40,15,6,1,62
604863854,10,4,2,1,17
604866774,83,25,52,12,172
604875886,25,10,6,1,42
604880104,46,4,23,3,76
604886817,27,3,2,1,33
604888497,127,8,2,1,138
604889936,80,39,31,16,166
604891590,120,40,84,5,249
604895301,23,19,2,2,46
604905361,16,3,2,1,22
604920558,146,45,16,45,252
604927591,228,11,2,9,250
604950553,67,82,5,11,165
604957250,49,22,2,1,74
604963225,27,24,2,4,57
604970538,10,3,2,3,18
604978952,138,74,13,1,226
604990066,69,3,2,5,79
604990111,19,8,2,14,43
605007276,62,60,5,7,134
605010778,86,3,2,3,94
605025600,25,18,2,21,66
605032082,11,3,2,1,17
605035645,10,9,2,1,22
605075692,56,19,2,1,78
605076366,74,37,2,1,114
605083839,21,17,4,6,48
605084852,50,25,71,1,147
605087412,56,22,11,9,98
605123980,78,29,30,16,153
605143304,36,25,10,1,72
605153520,120,13,2,5,140
605154248,56,15,2,1,74
605162103,83,43,25,2,153
605168576,35,32,9,3,79
605168806,41,3,2,1,47
605172900,10,14,2,1,27
605179807,65,72,38,12,187
605187567,18,3,2,1,24
605195822,66,6,2,5,79
605197773,15,8,2,1,26
605198311,98,44,26,33,201
605212677,11,18,2,10,41
605223446,204,57,4,8,273
605227681,75,33,19,5,132
605233460,175,23,2,2,202
605235297,26,6,2,3,37
605239282,12,4,2,1,19
605239873,143,62,144,64,413
605248166,66,34,16,2,118
605271430,55,27,6,5,93
605279112,52,49,11,4,116
605310055,25,3,2,1,31
605328172,36,9,2,15,62
605330135,93,20,19,15,147
605338210,125,24,3,37,189
605341960,22,3,2,2,29
605342207,63,38,17,5,123
605346385,88,11,118,1,218
605349298,13,3,2,6,24
605353560,193,25,18,2,238
605362008,115,23,33,11,182
605365315,118,3,2,2,125
605380866,85,3,2,1,91
605390317,120,3,30,2,155
605395177,140,28,15,22,205
605397411,50,50,9,2,111
605418232,91,3,2,10,106
605428290,57,87,46,5,195
605433082,146,3,2,1,152
605433905,100,17,15,7,139
605442123,10,9,2,1,22
605448829,132,49,2,8,191
605454133,10,10,2,1,23
605458868,33,23,7,1,64
605460780,10,4,2,1,17
605467806,194,45,40,32,311
605470606,261,10,2,13,286
605472761,10,3,2,5,20
605480428,48,85,2,41,176
605483147,132,19,23,3,177
605498286,66,9,2,1,78
605500465,83,3,2,1,89
605521211,60,3,2,1,66
605525508,40,19,16,22,97
605537130,38,25,41,1,105
605543891,42,72,66,4,184
605550849,57,3,2,1,63
605563118,54,25,28,1,108
605567381,40,18,7,1,66
605573897,12,3,2,1,18
605604446,14,3,2,5,24
605613835,47,3,4,20,74
605628128,38,26,40,9,113
605629697,55,47,3,1,106
605639620,56,3,2,1,62
605656871,169,3,2,9,183
605660106,11,3,2,1,17
605687339,12,3,2,1,18
605687761,78,9,24,1,112
605697651,23,3,2,1,29
605698534,57,12,5,1,75
605708661,46,3,2,1,52
605718908,81,6,2,6,95
605750193,58,3,2,1,64
605759227,18,15,4,1,38
605759501,14,19,2,1,36
605762126,88,42,2,10,142
605764585,101,25,7,3,136
605766168,118,3,2,2,125
605768268,71,7,2,1,81
605790296,77,29,23,4,133
605796536,55,8,14,22,99
605823841,64,3,2,7,76
605836107,11,3,2,1,17
605836123,49,90,42,26,207
605859241,13,3,2,1,19
605872893,15,3,2,1,21
605873886,11,7,2,12,32
605879032,85,20,2,1,108
605897277,16,3,2,1,22
605909326,17,3,2,1,23
605914413,34,3,2,1,40
605924730,27,21,2,1,51
605925040,50,10,2,15,77
605954840,24,6,2,2,34
605959494,56,3,2,1,62
605966213,203,3,2,4,212
605970014,15,3,2,1,21
605978059,19,6,2,1,28
605989568,100,82,2,6,190
606005616,36,22,2,1,61
606032503,40,14,2,2,58
606040035,17,22,8,2,49
606054609,16,7,2,1,26
606072025,43,3,2,1,49
606091753,15,3,2,4,24
606100042,15,3,2,8,28
606100410,89,27,2,5,123
606107890,11,3,2,1,17
606118548,95,18,26,36,175
606126411,51,3,2,1,57
606130372,10,6,2,1,19
606133472,71,29,34,3,137
606133763,567,3,2,76,648
606134833,117,47,2,2,168
606138042,49,12,3,10,74
606151018,46,3,2,1,52
606163787,34,11,37,19,101
606164194,83,3,21,1,108
606167713,62,3,2,11,78
606175335,18,8,10,2,38
606177284,119,51,3,1,174
606185190,28,63,11,2,104
606190343,81,27,128,26,262
606199475,46,46,24,11,127
606203911,114,3,2,1,120
606203956,125,72,84,2,283
606204577,11,3,2,1,17
606210336,10,11,2,1,24
606219976,46,32,4,1,83
606223221,36,47,2,1,86
606233905,47,17,13,8,85
606235459,58,10,2,1,71
606247545,19,8,2,1,30
606250596,16,15,2,1,34
606252376,98,18,17,15,148
606254077,31,26,38,3,98
606258822,78,20,10,1,109
606276422,138,41,76,11,266
606293542,174,49,10,43,276
606298974,63,34,2,41,140
606300507,68,11,2,4,85
606300914,10,8,2,1,21
606307722,13,3,2,1,19
606313853,220,7,2,4,233
606317103,18,7,2,1,28
606318096,72,3,2,1,78
606322522,46,6,3,2,57
606350789,62,7,2,6,77
606354611,216,8,2,14,240
606356523,23,25,10,2,60
606358158,68,15,2,6,91
606358653,51,19,2,8,80
606362372,67,25,10,1,103
606372973,17,12,8,4,41
606379871,193,3,2,4,202
606383176,24,7,35,1,67
606407075,13,16,2,1,32
606414487,45,38,27,25,135
606415285,97,3,2,12,114
606417355,94,22,6,1,123
606422063,134,3,2,15,154
606426358,52,3,2,1,58
606443633,58,21,12,1,92
606500595,35,5,2,1,43
606500984,19,14,2,1,36
606501019,106,3,7,8,124
606504681,357,3,2,27,389
606528924,76,3,21,1,101
606529312,22,3,2,4,31
606533916,81,3,2,1,87
606534123,105,35,17,9,166
606543899,130,10,5,1,146
606558754,79,6,9,1,95
606563614,34,13,9,4,60
606573938,105,5,3,2,115
606575273,79,9,25,6,119
606578516,90,25,3,4,122
606589429,128,43,38,18,227
606589536,39,38,3,3,83
606590393,11,3,2,1,17
606600178,18,4,3,18,43
606604696,49,8,7,1,65
606607823,29,56,16,1,102
606608853,116,3,3,1,123
606609285,37,4,3,2,46
606610510,88,31,42,2,163
606623303,10,19,7,1,37
606624428,11,3,2,1,17
606657768,178,105,26,23,332
606663407,26,5,2,1,34
606667220,103,65,5,32,205
606677148,50,16,107,1,174
606679609,166,43,21,15,245
606693540,79,13,28,11,131
606702599,100,18,2,1,121
606706859,48,44,19,44,155
606713672,35,3,2,1,41
606717197,102,39,6,6,153
606729054,104,10,6,1,121
606733271,56,3,2,1,62
606757971,723,16,2,19,760
606766378,273,3,10,1,287
606771500,11,3,2,1,17
606773564,128,85,7,73,293
606783664,119,56,35,14,224
606796568,52,29,2,3,86
606799881,15,3,2,2,22
606830032,12,3,2,1,18
606842706,26,30,2,1,59
606845600,136,6,114,2,258
606847548,35,3,2,1,41
606848862,26,3,2,1,32
606867121,25,35,3,50,113
606874984,11,3,2,2,18
606883440,64,45,8,6,123
606885359,62,14,9,2,87
606912657,39,35,5,2,81
606946078,14,3,2,1,20
606970799,64,8,2,19,93
606976033,11,3,2,1,17
606982509,19,54,2,1,76
606985476,17,3,2,1,23
606991268,16,3,2,3,24
607012647,65,15,2,2,84
607016377,39,18,4,56,117
607022671,57,15,2,1,75
607023381,71,37,62,35,205
607028202,12,39,33,1,85
607030179,11,3,2,1,17
607034064,81,3,2,1,87
607042878,61,25,3,13,102
607053396,79,3,2,1,85
607069520,27,8,7,3,45
607078756,66,3,2,2,73
607084484,85,67,78,21,251
607090849,36,59,26,35,156
607098996,115,12,31,1,159
607099058,51,32,9,17,109
607118403,56,25,2,1,84
607128127,57,3,2,2,64
607132898,11,3,2,1,17
607158463,12,3,2,1,18
607159232,19,5,2,1,27
607162299,111,3,2,1,117
607164615,127,62,31,74,294
607176172,47,3,2,1,53
607203561,151,61,2,9,223
607205943,44,27,23,23,117
607206722,20,3,4,1,28
607220115,13,3,2,1,19
607223113,55,40,29,5,129
607236106,112,3,2,1,118
607239506,146,43,5,3,197
607242622,142,32,29,15,218
607259459,84,3,2,15,104
607275249,63,3,2,1,69
607279432,12,3,2,1,18
607306804,514,15,10,14,553
607307814,11,3,2,1,17
607309792,61,3,2,1,67
607314837,19,12,10,5,46
607326888,61,31,2,1,95
607335728,92,3,74,1,170
607340360,131,10,2,1,144
607343446,30,18,4,8,60
607348207,31,3,2,1,37
607353556,50,12,3,1,66
607364462,73,20,12,4,109
607369755,33,24,10,1,68
607381223,54,21,7,1,83
607404724,19,13,2,1,35
607440170,130,5,2,24,161
607443054,119,46,18,18,201
607444591,267,4,23,3,297
607447911,254,13,2,2,271
607455006,96,17,26,2,141
607456076,70,23,5,6,104
607462183,50,33,64,16,163
607463721,52,6,17,13,88
607468810,61,3,2,1,67
607483044,121,4,2,24,151
607491265,45,3,2,2,52
607516141,62,33,2,1,98
607537668,26,68,13,4,111
607544150,14,40,2,1,57
607553930,64,20,23,10,117
607553980,10,6,2,1,19
607574905,128,3,2,18,151
607586758,85,3,15,1,104
607605127,121,3,2,2,128
607608401,97,6,2,1,106
607621605,139,44,122,20,325
607624369,62,21,2,24,109
607630177,51,3,2,3,59
607631993,36,11,2,2,51
607638610,13,3,2,1,19
607640282,487,3,2,9,501
607654044,59,61,55,1,176
607655965,102,3,43,1,149
607661534,106,17,2,4,129
607664205,10,5,3,2,20
607666983,93,116,2,1,212
607667903,26,3,2,1,32
607672761,71,3,2,2,78
607674863,74,26,11,25,136
607699825,13,6,2,1,22
607701996,68,3,2,1,74
607702253,14,3,2,2,21
607705989,149,51,33,29,262
607707602,33,3,2,1,39
607716593,41,39,8,1,89
607742284,128,21,30,2,181
607762196,14,3,2,4,23
607766524,13,3,2,1,19
607774709,195,43,2,16,256
607779442,211,57,43,37,348
607784284,138,33,3,5,179
607788893,10,3,2,2,17
607810075,49,10,28,1,88
607820476,90,8,2,1,101
607838488,67,5,2,3,77
607839382,229,3,2,2,236
607863176,104,12,23,10,149
607907127,32,3,2,4,41
607908235,19,3,2,1,25
607916971,62,3,41,12,118
607947063,83,9,19,10,121
607956794,14,3,2,1,20
607968210,122,50,2,2,176
607977856,36,11,2,5,54
607983333,13,3,2,1,19
607990114,38,50,65,14,167
608004898,81,3,2,1,87
608008237,22,9,2,1,34
608022333,42,3,2,2,49
608030175,87,3,2,2,94
608045885,68,81,27,24,200
608054124,53,10,2,5,70
608058151,26,3,2,1,32
608062277,62,3,2,1,68
608065832,193,3,2,8,206
608068610,11,40,2,4,57
608070779,14,3,2,1,20
608071112,46,3,2,2,53
608072568,77,21,27,18,143
608075145,86,24,15,14,139
608076314,35,3,3,1,42
608091793,53,3,2,1,59
608095835,41,13,2,3,59
608106099,13,17,2,6,38
608111473,78,29,14,24,145
608134837,123,25,23,9,180
608152124,100,12,2,12,126
608164992,41,34,2,15,92
608175675,145,82,44,75,346
608178661,22,3,2,1,28
608194306,19,20,2,1,42
608201656,61,3,2,4,70
608202887,145,3,2,1,151
608204300,48,21,19,8,96
608211042,82,3,2,1,88
608223032,16,3,2,3,24
608244261,103,23,32,17,175
608267701,34,3,2,1,40
608271980,47,21,33,3,104
608272342,97,3,2,1,103
608273943,273,45,2,2,322
608285388,37,33,65,4,139
608286795,54,3,2,1,60
608295637,13,3,2,1,19
608341509,21,150,10,7,188
608367069,40,29,2,1,72
608385360,55,3,2,1,61
608408204,112,99,93,34,338
608408567,23,3,2,8,36
608424372,47,18,5,1,71
608427414,38,86,28,29,181
608438616,60,19,40,20,139
608444096,100,39,3,5,147
608446394,21,3,2,2,28
608454741,71,37,46,28,182
608462549,165,3,2,5,175
608462619,185,26,26,2,239
608473318,32,3,2,1,38
608493239,385,3,2,19,409
608496943,245,3,3,2,253
608499694,55,3,2,2,62
608512488,65,21,2,3,91
608523089,12,57,8,1,78
608532560,58,3,2,1,64
608539529,41,3,2,1,47
608541844,37,15,4,3,59
608547696,12,3,2,1,18
608551849,32,21,2,4,59
608554087,58,46,59,1,164
608565906,83,45,17,9,154
608569661,22,18,2,1,43
608602596,127,28,68,29,252
608605275,31,39,7,2,79
608617892,35,26,25,2,88
608619059,84,39,27,32,182
608621130,71,25,5,3,104
608628953,121,45,4,4,174
608629413,76,3,2,1,82
608644068,50,59,82,65,256
608658426,81,23,48,17,169
608662686,41,8,2,2,53
608665429,51,20,4,14,89
608668842,71,22,24,12,129
608679789,41,21,2,1,65
608684948,61,14,2,2,79
608690237,18,3,2,2,25
608696098,27,30,30,1,88
608697478,63,19,42,12,136
608705891,190,3,2,1,196
608711426,104,9,2,1,116
608721715,101,19,4,12,136
608722670,27,3,2,1,33
608728044,60,3,2,1,66
608733315,10,11,2,1,24
608745414,161,15,19,1,196
608746658,10,3,2,2,17
608748719,46,33,2,11,92
608753412,107,17,2,1,127
608757590,132,3,2,1,138
608782220,10,5,2,1,18
608792573,19,29,2,1,51
608820879,33,3,2,18,56
608825637,80,110,55,42,287
608830998,101,20,3,3,127
608840492,52,20,2,2,76
608847788,21,65,12,1,99
608850883,59,8,4,1,72
608858594,66,3,2,1,72
608861924,79,22,25,4,130
608865859,158,3,2,1,164
608881555,80,3,2,1,86
608882174,24,3,2,1,30
608891080,16,4,2,1,23
608898954,34,76,12,2,124
608905362,144,21,80,61,306
608908218,85,32,2,4,123
608920662,18,4,2,3,27
608925917,16,3,2,1,22
608931604,19,9,2,1,31
608938054,19,9,4,2,34
608939007,351,3,2,9,365
608939799,185,9,2,13,209
608950564,19,3,2,1,25
608954335,19,53,24,3,99
608955020,66,23,23,15,127
608957357,11,3,2,1,17
608962967,125,38,2,1,166
608962978,17,21,2,1,41
608966545,10,5,2,1,18
608967051,42,20,2,9,73
608967713,41,15,2,5,63
608967846,193,49,2,12,256
608971031,15,23,2,1,41
608972862,65,41,71,100,277
608991662,100,33,31,31,195
608992079,11,3,2,1,17
608994682,35,3,2,1,41
609002559,36,30,2,29,97
609007286,16,5,2,1,24
609020551,84,24,2,2,112
609022232,104,7,2,2,115
609039544,104,10,2,2,118
609058863,18,3,2,4,27
609066777,21,13,2,1,37
609078308,57,3,46,1,107
609087874,13,3,2,1,19
609088340,40,3,2,1,46
609110069,12,6,2,2,22
609114168,56,10,2,1,69
609117921,78,20,10,1,109
609128009,24,22,2,1,49
609129008,57,34,22,3,116
609129016,33,18,27,1,79
609129940,51,7,51,3,112
609145003,28,12,2,3,45
609145307,138,22,7,6,173
609152299,12,3,2,1,18
609156283,47,4,2,12,65
609163590,28,3,2,2,35
609166099,11,4,2,1,18
609166764,47,41,19,2,109
609181516,62,12,30,1,105
609190213,87,35,2,14,138
609212903,29,24,30,1,84
609222839,86,17,3,2,108
609225425,22,3,2,1,28
609235729,45,9,5,5,64
609245143,47,25,2,1,75
609255870,151,18,18,22,209
609257205,147,78,2,7,234
609304216,92,36,36,1,165
609321963,16,3,2,1,22
609328402,68,9,24,1,102
609334010,30,3,2,1,36
609345564,37,43,9,7,96
609355965,15,24,3,4,46
609368592,15,3,2,1,21
609372570,118,42,3,3,166
609377485,32,8,5,8,53
609388308,25,22,2,1,50
609404768,20,14,15,2,51
609412319,50,17,2,1,70
609424894,132,3,2,1,138
609459933,12,10,2,1,25
609464077,36,7,2,1,46
609467355,129,66,24,12,231
609478426,146,32,2,10,190
609502286,53,3,2,1,59
609505804,19,3,2,2,26
609506430,26,4,2,2,34
609511795,27,4,2,3,36
609517620,114,6,2,12,134
609519771,26,16,17,11,70
609521294,39,7,2,1,49
609531127,10,5,2,1,18
609540567,91,38,63,1,193
609563724,52,22,5,3,82
609593417,31,37,13,3,84
609594945,32,13,2,1,48
609608420,96,5,4,1,106
609612390,10,40,2,1,53
609634949,45,96,11,14,166
609636113,123,10,77,24,234
609636827,13,5,2,1,21
609638638,10,35,2,4,51
609645018,35,49,21,38,143
609663051,74,5,62,76,217
609665061,28,3,2,1,34
609668917,86,25,2,3,116
609674986,12,3,2,1,18
609680614,42,5,70,3,120
609686083,53,12,2,1,68
609688897,26,39,2,1,68
609698794,60,23,35,8,126
609699571,12,26,2,1,41
609709283,114,34,2,1,151
609720571,13,3,2,1,19
609724201,31,3,2,1,37
609726542,62,23,2,1,88
609728311,75,114,59,87,335
609729721,45,3,2,1,51
609730406,59,3,2,5,69
609736435,109,3,2,1,115
609739829,11,3,2,1,17
609759185,16,9,2,1,28
609770951,118,34,68,3,223
609771265,50,42,17,8,117
609774684,40,5,2,3,50
609797208,107,10,15,7,139
609809439,21,6,2,2,31
609819470,108,35,11,5,159
609824244,98,3,2,2,105
609836931,27,26,2,5,60
609837152,22,7,2,1,32
609852868,12,3,2,1,18
609882919,159,3,2,2,166
609893818,21,34,9,4,68
609899445,14,3,2,1,20
609903596,99,3,2,3,107
609903994,115,10,2,1,128
609909338,62,3,2,1,68
609910088,21,41,2,3,67
609917471,71,26,50,1,148
609924541,20,4,11,1,36
609930881,14,3,2,1,20
609942285,15,7,2,1,25
609954262,11,3,2,1,17
609956907,41,8,3,2,54
609967309,12,3,2,1,18
609970097,107,3,2,1,113
609994862,55,53,34,1,143
610001990,70,53,42,4,169
610009086,98,37,31,2,168
610019723,59,3,2,1,65
610020876,38,18,6,1,63
610029414,31,3,2,1,37
610039104,23,3,2,3,31
610050937,33,23,2,1,59
610053392,13,47,2,3,65
610072412,10,8,2,1,21
610081982,15,23,2,1,41
610085204,89,19,2,8,118
610088716,153,38,30,1,222
610097405,50,5,3,5,63
610104610,10,11,2,1,24
610114051,23,14,2,3,42
610116911,92,6,4,6,108
610172569,243,3,2,9,257
610182350,45,45,5,1,96
610186768,50,3,2,7,62
610193314,11,3,2,1,17
610214558,12,5,2,1,20
610225303,45,3,2,1,51
610236198,28,6,2,6,42
610242889,70,12,21,11,114
610255263,71,11,5,1,88
610257860,53,30,4,31,118
610270577,31,19,51,1,102
610304035,110,22,2,17,151
610316776,60,28,3,9,100
610334092,72,3,2,16,93
610335124,11,3,2,1,17
610340968,14,8,2,1,25
610344535,113,16,49,5,183
610353104,36,5,2,2,45
610360367,208,69,16,5,298
610365029,145,56,19,1,221
610380138,72,51,47,34,204
610382287,93,3,2,1,99
610391038,49,32,50,8,139
610411292,15,9,2,1,27
610416987,107,31,5,51,194
610418198,19,16,3,12,50
610418982,47,4,13,1,65
610423613,32,8,2,2,44
610429592,65,49,15,6,135
610439728,40,48,15,12,115
610443936,13,29,2,1,45
610448940,66,3,2,3,74
610474536,92,10,2,2,106
610475228,54,4,3,4,65
610488097,72,15,2,5,94
610489319,19,13,2,1,35
610504622,12,3,2,1,18
610518742,24,29,2,1,56
610518862,58,9,19,2,88
610538320,259,9,2,15,285
610554535,34,89,22,1,146
610571792,72,3,2,1,78
610573102,45,51,41,19,156
610579566,57,14,2,2,75
610588617,19,65,10,6,100
610599418,70,7,38,1,116
610617032,34,10,3,5,52
610623471,14,7,3,2,26
610632667,59,67,2,1,129
610641316,10,3,2,3,18
610646455,30,64,36,7,137
610647939,49,3,2,3,57
610653812,82,3,2,3,90
610659314,10,3,2,2,17
610685182,11,3,2,1,17
610689682,40,9,2,1,52
610695880,55,77,45,1,178
610702803,75,26,14,3,118
610704020,36,3,2,1,42
610709233,88,13,2,6,109
610721968,140,13,2,7,162
610737807,60,18,26,21,125
610750430,84,79,51,30,244
610752202,128,56,10,20,214
610756919,29,3,2,1,35
610758543,52,30,26,55,163
610778902,53,14,2,1,70
610791826,53,3,2,7,65
610798309,54,44,60,2,160
610821148,52,3,2,4,61
610828790,57,37,9,22,125
610829929,81,5,2,1,89
610838252,81,34,2,29,146
610839885,54,84,35,1,174
610852134,11,3,2,1,17
610861982,59,22,2,1,84
610862193,51,3,2,1,57
610865277,576,7,2,2,587
610873475,14,3,2,1,20
610876232,73,11,5,24,113
610889451,20,20,4,5,49
610900727,35,15,2,2,54
610906309,85,37,11,1,134
610919630,457,3,2,1,463
610923146,116,9,2,8,135
610951131,101,3,2,1,107
610957227,39,3,2,1,45
610962000,85,3,2,3,93
610970128,52,37,7,4,100
610982259,27,39,17,2,85
611016725,14,4,2,1,21
611019276,10,11,2,1,24
611020895,44,56,22,3,125
611029681,56,3,2,6,67
611052691,71,74,50,4,199
611053479,212,3,2,1,218
611064869,55,38,2,1,96
611067383,66,11,7,1,85
611078530,32,52,3,44,131
611078866,39,8,2,2,51
611080340,11,3,2,1,17
611084180,86,23,7,1,117
611099541,39,33,2,1,75
611116438,126,27,10,14,177
611129640,214,40,10,1,265
611132551,42,40,12,2,96
611132608,18,3,2,1,24
611132785,12,5,3,3,23
611145959,39,11,2,7,59
611147878,83,3,2,84,172
611154425,62,4,5,8,79
611176116,91,4,58,14,167
611176370,51,34,44,21,150
611178353,22,18,10,7,57
611197116,64,35,11,2,112
611200353,14,6,2,2,24
611209919,91,58,16,48,213
611213237,19,15,2,1,37
611216297,11,3,2,1,17
611222911,19,3,2,1,25
611226213,22,3,2,4,31
611228894,34,33,2,2,71
611250166,59,5,2,1,67
611255551,63,46,21,9,139
611258687,56,21,25,2,104
611262893,147,30,23,14,214
611286945,44,3,2,15,64
611287675,122,15,2,2,141
611301618,19,26,4,5,54
611306084,88,12,27,2,129
611314676,10,13,2,1,26
611321879,234,26,2,14,276
611348182,15,6,2,3,26
611350468,44,17,2,1,64
611354440,56,3,2,1,62
611365461,164,4,2,1,171
611366927,14,19,15,1,49
611376226,10,7,2,1,20
611381821,37,13,2,6,58
611389056,136,38,14,19,207
611394708,26,3,2,1,32
611401867,17,14,2,1,34
611423765,70,50,131,1,252
611442689,60,3,2,2,67
611444313,64,9,56,7,136
611459632,27,3,2,1,33
611465179,58,23,10,1,92
611471493,19,3,2,1,25
611499904,86,8,2,11,107
611500497,37,3,2,1,43
611519937,28,46,61,11,146
611522087,154,28,25,1,208
611526037,159,8,4,2,173
611545055,147,34,33,1,215
611546516,41,3,2,2,48
611547334,10,6,2,1,19
611550494,29,12,4,2,47
611568579,67,3,2,1,73
611580654,29,3,2,1,35
611594621,28,39,2,1,70
611596514,122,14,2,2,140
611604341,10,3,2,2,17
611609215,56,3,2,2,63
611632355,62,3,2,1,68
611640265,112,25,21,5,163
611670040,34,26,2,1,63
611679893,30,3,2,8,43
611691751,49,39,6,5,99
611692987,38,3,2,1,44
611700564,95,17,2,8,122
611703109,90,29,12,1,132
611704726,47,3,2,2,54
611712018,58,47,4,5,114
611718068,16,3,2,1,22
611722934,55,20,2,1,78
611723995,105,6,78,2,191
611736139,177,3,2,1,183
611753176,162,3,2,3,170
611762650,65,20,8,13,106
611798503,19,3,2,8,32
611804840,73,14,43,4,134
611808676,49,64,2,1,116
611811925,19,3,2,1,25
611814133,32,25,5,4,66
611816518,84,33,36,1,154
611817409,53,28,11,7,99
611832247,45,89,2,1,137
611843707,12,3,2,1,18
611846441,22,15,2,19,58
611867344,106,3,2,64,175
611902882,26,70,37,15,148
611910104,30,3,2,1,36
611922931,26,11,2,14,53
611939096,66,3,2,2,73
611943572,82,19,2,8,111
611946754,85,29,64,1,179
611948650,51,29,18,5,103
611956507,78,31,108,1,218
611957453,61,69,4,3,137
611970472,89,14,3,1,107
611972030,138,81,2,3,224
611980049,75,11,57,1,144
611988076,41,47,3,13,104
612006925,28,63,2,6,99
612008514,84,19,33,14,150
612013382,52,3,10,1,66
612015537,42,3,2,1,48
612023519,13,14,2,4,33
612026629,30,3,2,1,36
612029716,26,24,35,2,87
612031870,14,3,2,1,20
612041780,35,14,2,5,56
612042376,29,19,50,1,99
612058000,83,6,2,3,94
612059154,19,3,2,1,25
612066900,146,3,2,38,189
612067704,35,30,3,10,78
612074393,83,3,2,1,89
612077994,379,37,25,40,481
612109666,12,5,2,2,21
612111513,10,25,2,1,38
612115252,29,26,39,9,103
612121163,41,16,2,4,63
612125069,51,3,2,1,57
612146796,228,4,62,1,295
612151218,90,15,46,2,153
612157274,28,23,16,31,98
612157506,35,4,2,1,42
612177379,58,50,43,12,163
612196268,54,18,5,1,78
612201603,61,30,2,2,95
612237824,83,13,2,2,100
612245071,27,22,6,5,60
612250230,52,22,2,5,81
612251318,43,43,24,7,117
612256262,109,21,2,7,139
612270654,118,38,2,4,162
612280823,157,17,29,6,209
612301762,22,17,2,5,46
612302353,593,3,2,4,602
612306294,42,17,2,2,63
612313575,82,10,2,1,95
612317315,30,38,13,6,87
612319379,22,10,2,1,35
612359786,34,31,26,14,105
612361419,100,3,2,32,137
612363400,109,47,52,1,209
612366592,126,41,8,5,180
612390994,52,3,2,1,58
612392876,10,3,2,2,17
612401768,148,9,2,1,160
612402118,11,3,2,1,17
612422912,34,3,2,1,40
612426700,16,3,2,1,22
612469523,57,3,2,1,63
612469946,48,40,14,15,117
612480657,98,28,2,1,129
612503744,11,3,2,1,17
612515558,13,3,2,14,32
612534383,13,3,2,1,19
612551938,55,3,2,2,62
612556301,10,9,2,1,22
612573418,108,32,51,4,195
612583615,30,3,2,1,36
612586937,47,5,2,2,56
612591170,223,3,2,4,232
612606805,11,3,7,1,22
612610473,60,28,87,1,176
612635076,65,20,16,4,105
612645994,44,5,48,2,99
612650095,58,64,11,11,144
612656228,13,3,2,1,19
612657683,78,74,3,12,167
612658304,19,13,6,14,52
612667411,11,3,2,1,17
612673104,43,21,2,1,67
612676149,67,64,20,5,156
612685085,10,16,2,2,30
612692930,107,5,5,1,118
612701984,64,20,53,5,142
612716263,182,34,104,4,324
612717687,11,10,2,2,25
612722944,12,37,2,1,52
612723057,80,3,2,1,86
612730936,67,19,3,3,92
612742121,24,3,2,1,30
612748766,10,14,2,1,27
612750054,57,3,2,2,64
612758959,313,3,2,2,320
612770799,213,23,28,1,265
612771794,40,18,22,1,81
612776078,74,11,2,1,88
612784672,113,18,36,4,171
612798360,16,31,2,1,50
612808415,83,39,18,1,141
612828141,94,8,2,1,105
612832417,12,3,2,2,19
612834477,67,43,2,32,144
612843478,70,3,2,2,77
612851377,56,22,11,12,101
612864884,64,41,11,21,137
612872523,126,36,23,1,186
612872702,15,14,2,5,36
612874078,29,35,5,2,71
612893204,61,39,8,60,168
612894603,305,3,2,2,312
612908006,39,3,2,1,45
612912705,142,55,30,14,241
612922100,11,3,2,1,17
612924589,45,23,49,3,120
612928427,15,3,2,2,22
612928776,10,7,2,1,20
612948572,61,20,40,6,127
612953531,144,15,81,1,241
612954986,70,38,5,1,114
612957782,22,31,2,1,56
612961735,91,3,2,1,97
612999990,37,23,7,4,71
613003160,99,18,2,16,135
613005070,43,118,100,12,273
613006278,18,3,2,5,28
613010447,30,3,2,1,36
613012641,16,3,2,1,22
613013754,140,3,2,1,146
613014790,97,3,2,5,107
613018882,45,13,21,8,87
613029546,21,3,2,1,27
613035112,92,29,59,5,185
613041677,113,22,56,2,193
613043021,213,3,2,4,222
613049992,12,6,2,1,21
613051626,101,3,2,4,110
613065038,10,3,2,3,18
613071569,25,14,2,1,42
613083579,32,70,34,4,140
613097606,84,5,2,1,92
613132854,69,36,118,1,224
613174069,134,55,67,13,269
613179256,169,3,2,1,175
613183585,19,30,2,5,56
613196294,31,32,27,2,92
613196633,59,50,17,6,132
613197843,12,3,2,1,18
613220813,63,19,40,8,130
613226229,23,15,10,47,95
613247863,127,13,15,2,157
613268448,71,3,2,6,82
613271525,70,68,22,10,170
613279676,82,3,7,2,94
613288195,44,26,2,3,75
613299311,75,3,2,1,81
613306290,24,8,2,18,52
613309576,52,18,2,6,78
613315138,16,37,2,1,56
613324974,195,9,170,8,382
613325404,63,3,2,1,69
613325634,19,30,2,1,52
613340235,18,3,2,1,24
613351919,58,30,4,4,96
613356464,45,3,2,2,52
613358025,54,31,2,7,94
613358446,77,8,2,1,88
613374658,103,58,40,27,228
613408404,44,43,12,2,101
613421374,102,3,2,7,114
613423582,99,37,32,7,175
613433134,23,95,28,1,147
613452081,58,23,7,1,89
613456862,158,70,2,1,231
613458903,33,8,2,1,44
613467345,43,21,3,1,68
613472285,17,3,2,3,25
613479157,129,47,8,3,187
613485808,38,13,2,2,55
613494765,40,125,3,57,225
613505157,24,3,2,1,30
613516764,171,3,2,3,179
613521445,12,16,2,1,31
613521902,118,13,2,2,135
613530130,31,11,2,2,46
613537769,51,12,104,2,169
613541121,55,3,2,1,61
613546461,94,3,2,4,103
613568931,31,14,2,1,48
613570661,47,27,3,1,78
613573788,93,17,3,6,119
613585618,101,31,11,20,163
613605297,214,69,6,2,291
613608307,35,3,2,1,41
613618017,19,3,2,1,25
613698191,45,3,2,2,52
613702000,16,3,2,6,27
613711142,13,3,2,1,19
613714903,26,7,13,2,48
613719908,44,39,3,8,94
613723813,36,15,2,3,56
613737872,19,36,2,1,58
613743870,14,7,2,1,24
613763293,96,3,2,1,102
613777838,84,3,2,1,90
613784472,39,3,16,1,59
613785740,108,3,2,4,117
613800611,70,20,4,1,95
613807716,21,4,7,8,40
613813029,55,16,42,1,114
613815234,75,3,2,1,81
613816076,91,3,2,2,98
613831911,66,3,2,1,72
613833193,36,6,2,9,53
613846356,37,11,2,1,51
613853783,104,3,2,1,110
613864295,46,5,2,1,54
613873470,18,65,9,1,93
613878560,17,3,2,1,23
613881843,78,9,2,1,90
613887669,60,13,2,1,76
613887756,55,56,6,1,118
613891934,277,263,2,21,563
613904018,34,3,2,1,40
613908181,18,3,2,7,30
613917430,11,3,2,1,17
613938202,105,14,3,12,134
613938215,54,16,2,7,79
613939128,19,39,27,5,90
613948825,61,4,2,4,71
613952402,44,49,2,2,97
613962434,13,45,2,1,61
613966916,43,34,76,6,159
613969057,85,34,4,7,130
613991878,100,29,9,48,186
614022800,78,17,2,1,98
614036730,57,48,12,15,132
614040219,22,3,2,2,29
614043425,97,51,25,27,200
614058325,11,3,2,1,17
614080709,31,13,2,1,47
614080871,84,15,2,13,114
614085416,90,32,2,9,133
614097721,98,3,2,1,104
614099606,60,3,2,1,66
614101259,79,12,26,1,118
614116057,41,23,2,9,75
614136658,50,21,2,2,75
614140164,48,20,6,1,75
614141309,35,22,19,1,77
614144143,29,11,2,2,44
614159765,12,3,2,1,18
614159969,21,3,2,1,27
614162308,15,3,2,1,21
614173619,26,3,2,1,32
614174918,67,37,7,19,130
614189663,118,21,2,17,158
614198190,38,34,2,21,95
614200055,48,14,2,6,70
614207373,11,3,2,2,18
614219261,15,5,2,4,26
614223269,14,6,2,1,23
614225955,19,5,2,1,27
614231974,14,3,2,1,20
614239011,39,53,3,17,112
614259594,33,3,2,1,39
614260596,42,44,2,2,90
614291066,220,3,2,3,228
614311993,81,14,30,56,181
614317633,87,27,111,8,233
614323010,35,19,5,40,99
614329941,110,3,2,1,116
614338047,15,3,2,4,24
614341875,13,3,2,1,19
614344097,22,61,3,1,87
614359754,81,12,2,5,100
614382890,44,37,18,2,101
614384431,84,43,60,14,201
614384962,54,13,22,1,90
614392907,11,3,2,1,17
614398978,22,31,9,1,63
614402165,63,15,7,16,101
614410716,114,33,56,2,205
614414142,15,3,2,1,21
614439456,10,3,2,3,18
614447154,75,22,5,4,106
614461864,65,3,2,1,71
614462612,11,18,2,1,32
614488557,41,29,7,13,90
614492105,22,16,7,88,133
614492560,100,34,19,4,157
614497364,104,21,44,1,170
614502857,10,17,2,1,30
614524557,108,42,8,2,160
614532087,77,16,8,14,115
614534685,31,12,113,9,165
614543135,37,3,2,1,43
614547750,130,112,32,35,309
614549337,85,15,2,3,105
614553816,51,25,6,6,88
614574742,10,9,2,1,22
614597404,79,35,15,45,174
614619816,45,3,2,1,51
614620630,65,3,2,1,71
614620872,10,16,23,4,53
614635124,88,69,2,2,161
614641776,92,4,3,1,100
614644553,28,3,2,1,34
614646073,206,42,17,4,269
614653421,55,3,2,4,64
614656559,11,3,2,1,17
614663039,56,36,3,1,96
614663221,14,3,2,1,20
614666490,243,3,2,22,270
614669412,83,3,2,19,107
614682843,29,34,5,16,84
614686810,81,13,2,1,97
614694575,29,5,3,9,46
614694866,64,25,35,43,167
614695501,44,5,8,20,77
614702179,63,18,28,1,110
614710982,79,93,51,56,279
614714591,11,3,4,1,19
614716545,28,29,3,1,61
614724463,72,19,2,16,109
614726435,71,13,2,1,87
614752608,240,3,2,1,246
614755555,122,15,25,7,169
614775090,95,8,7,1,111
614836776,449,3,2,11,465
614856519,31,24,2,4,61
614856784,62,23,13,3,101
614859253,11,4,2,1,18
614861409,102,19,2,3,126
614861483,40,3,2,1,46
614862398,41,9,2,1,53
614869548,94,13,2,1,110
614904890,18,3,2,1,24
614910930,56,37,42,4,139
614921349,65,27,5,12,109
614944695,80,17,2,1,100
614949295,16,3,2,1,22
614953392,121,37,117,28,303
614969313,79,15,7,6,107
614983284,16,3,2,1,22
614989592,27,30,30,1,88
614999870,28,17,2,1,48
615012412,19,17,2,1,39
615013964,42,26,11,16,95
615022279,10,30,2,2,44
615025275,47,41,3,5,96
615029060,70,7,6,4,87
615037919,20,3,2,1,26
615043196,16,3,2,2,23
615044545,145,5,4,5,159
615046278,162,13,19,1,195
615049349,25,3,2,1,31
615061860,52,28,14,16,110
615069252,46,3,2,1,52
615086554,96,14,4,1,115
615098142,148,61,2,2,213
615103331,16,4,2,1,23
615116936,17,31,2,1,51
615122550,26,49,8,3,86
615153850,49,21,3,2,75
615155462,73,3,2,4,82
615156976,40,44,62,1,147
615162921,67,57,8,10,142
615171493,48,54,3,2,107
615175906,54,57,2,4,117
615206348,11,3,2,1,17
615208419,43,3,2,1,49
615225374,109,30,2,8,149
615231071,61,3,2,1,67
615233379,79,5,15,1,100
615247617,126,9,11,9,155
615251806,22,13,19,1,55
615254379,19,29,23,5,76
615254627,49,28,4,1,82
615270207,33,70,16,12,131
615280009,101,3,2,4,110
615284269,66,11,81,2,160
615292844,97,25,6,18,146
615293653,18,3,2,1,24
615295340,25,23,2,3,53
615295363,62,20,10,10,102
615298820,49,3,2,1,55
615303270,72,42,2,7,123
615303628,105,9,3,9,126
615311915,54,16,2,1,73
615314155,154,25,22,12,213
615325791,59,30,74,28,191
615328004,70,41,67,4,182
615332435,22,4,2,1,29
615337269,19,3,2,1,25
615343425,72,31,33,23,159
615344309,29,21,24,8,82
615352520,87,51,24,1,163
615354631,29,47,7,14,97
615355435,19,3,2,1,25
615365082,13,3,2,1,19
615375869,88,19,4,10,121
615392816,25,3,2,2,32
615398826,46,46,50,2,144
615408383,20,5,2,1,28
615421584,27,3,2,1,33
615435138,127,50,10,17,204
615440149,125,36,26,46,233
615442439,14,16,2,1,33
615446241,71,3,2,19,95
615446837,81,13,33,7,134
615450387,83,41,17,1,142
615454587,12,3,2,1,18
615477617,14,12,2,4,32
615480268,60,52,120,12,244
615482888,11,18,2,1,32
615495171,119,3,2,3,127
615497595,99,3,2,1,105
615498859,17,14,2,1,34
615511827,15,46,2,5,68
615513841,11,3,2,3,19
615517369,24,3,2,5,34
615517649,139,47,4,5,195
615520026,56,3,2,1,62
615522670,11,3,2,9,25
615541525,10,14,2,1,27
615551418,17,3,2,1,23
615554203,47,6,2,8,63
615555965,78,15,2,1,96
615558688,131,3,2,1,137
615579583,109,3,2,34,148
615586933,58,4,2,10,74
615593578,38,4,20,1,63
615595954,31,10,2,9,52
615622589,66,23,2,5,96
615631893,91,3,2,4,100
615647415,109,21,13,33,176
615687359,49,68,82,59,258
615690611,103,18,71,24,216
615701936,95,3,2,2,102
615702997,17,3,2,1,23
615717732,25,28,28,2,83
615725465,189,62,155,13,419
615726041,50,39,47,49,185
615726610,23,3,2,1,29
615754057,10,5,2,2,19
615770896,81,30,5,31,147
615783960,15,3,2,1,21
615788006,22,3,2,1,28
615793136,55,17,10,1,83
615805491,76,37,3,3,119
615810150,31,15,2,1,49
615810687,50,22,7,5,84
615818689,61,65,6,3,135
615825518,79,24,29,10,142
615826109,42,32,20,24,118
615839021,148,4,13,15,180
615844410,131,8,2,55,196
615851025,34,42,2,1,79
615865748,46,31,5,1,83
615871042,37,3,2,1,43
615871459,221,87,32,90,430
615871738,66,8,4,1,79
615874153,44,3,2,9,58
615875065,132,9,2,9,152
615896898,135,5,2,1,143
615902683,11,10,2,1,24
615924272,13,3,2,1,19
615927756,81,30,19,6,136
615932696,17,3,2,1,23
615939517,64,72,55,6,197
615941873,71,3,2,1,77
615943065,46,61,26,14,147
615955125,69,13,35,1,118
615955384,12,3,2,1,18
615960150,14,34,9,2,59
615967218,101,26,85,22,234
615967920,62,20,31,4,117
615995857,83,3,2,1,89
616007281,50,22,39,7,118
616007776,27,3,2,1,33
616008469,70,35,2,4,111
616031702,86,26,33,36,181
616083244,135,3,2,1,141
616089632,49,25,23,15,112
616095309,60,38,35,13,146
616100319,27,20,7,1,55
616101907,121,6,2,2,131
616102231,30,31,2,2,65
616110844,257,24,16,5,302
616119379,80,45,2,1,128
616123267,89,66,2,1,158
616124999,58,8,44,1,111
616135638,26,52,12,2,92
616141320,55,21,4,1,81
616168673,136,18,43,5,202
616186047,35,26,8,1,70
616212517,17,3,2,1,23
616227576,25,3,2,1,31
616229235,39,3,2,1,45
616231251,49,93,2,8,152
616252308,17,3,2,1,23
616254635,29,18,3,9,59
616268954,16,3,2,15,36
616279510,82,3,2,7,94
616292499,65,15,2,1,83
616313667,43,12,2,1,58
616327410,81,21,33,2,137
616365352,52,25,39,2,118
616381212,41,5,2,1,49
616385408,204,3,2,19,228
616391627,38,13,26,55,132
616400775,16,3,2,2,23
616401153,11,3,2,1,17
616401363,86,33,118,7,244
616404907,18,36,2,1,57
616426166,24,3,2,1,30
616433825,76,4,2,1,83
616452954,18,3,2,1,24
616484498,50,23,2,3,78
616491142,10,6,2,1,19
616492797,25,58,2,1,86
616495480,26,3,2,6,37
616504992,26,12,2,3,43
616518733,41,3,2,1,47
616528983,85,48,8,6,147
616537427,43,3,2,1,49
616538677,90,36,20,77,223
616542948,11,3,2,5,21
616544796,36,49,63,87,235
616562588,128,11,100,3,242
616569856,57,3,2,3,65
616571597,55,34,8,1,98
616604295,28,69,5,1,103
616613938,1138,3,2,7,1150
616616650,44,28,3,7,82
616624247,97,10,2,2,111
616629761,10,3,2,3,18
616633829,59,40,36,1,136
616654748,169,33,2,9,213
616663378,98,3,2,3,106
616691051,17,3,2,1,23
616711542,62,3,2,1,68
616713190,54,45,2,5,106
616714241,49,115,19,34,217
616714410,113,3,2,1,119
616751344,13,23,2,5,43
616753949,136,34,84,22,276
616754403,45,3,2,1,51
616765769,122,23,2,6,153
616775979,14,3,2,1,20
616803760,113,3,2,1,119
616813613,41,8,7,2,58
616838157,58,14,5,3,80
616843256,22,13,7,3,45
616848138,51,39,25,18,133
616861009,122,31,41,5,199
616872006,47,40,28,8,123
616880906,154,19,2,21,196
616889770,30,3,2,1,36
616903262,18,14,3,6,41
616927004,152,27,43,11,233
616927408,60,3,2,1,66
616934601,43,49,2,3,97
616959262,62,3,2,5,72
616963774,15,3,2,1,21
616972697,78,3,2,1,84
616977140,12,3,2,1,18
616980868,76,16,5,9,106
616993390,10,5,2,1,18
616994649,28,3,2,1,34
617006832,40,17,4,4,65
617022842,22,3,17,46,88
617024197,42,11,7,4,64
617031015,114,3,2,1,120
617041438,17,3,2,1,23
617042341,58,3,11,1,73
617054205,25,3,2,1,31
617068169,58,14,17,4,93
617086204,18,74,8,7,107
617091473,23,34,32,2,91
617110487,10,3,2,8,23
617111301,41,5,2,2,50
617113066,27,3,2,1,33
617117249,61,6,2,29,98
617128347,42,31,2,4,79
617138175,11,3,2,1,17
617145869,20,3,2,2,27
617150344,55,20,2,3,80
617177485,11,3,2,1,17
617188845,63,3,2,3,71
617195821,30,31,8,1,70
617207620,60,70,42,4,176
617208247,66,3,2,1,72
617221887,75,33,11,20,139
617225748,183,54,69,2,308
617240335,20,3,2,4,29
617242054,12,9,2,3,26
617245794,98,12,2,4,116
617248478,92,3,2,55,152
617263328,12,3,2,1,18
617267967,38,30,39,39,146
617273055,82,18,2,1,103
617280579,10,9,2,1,22
617288124,12,3,2,3,20
617306687,41,3,2,1,47
617315616,105,48,40,16,209
617319889,76,3,2,2,83
617341366,60,19,47,3,129
617342125,40,3,2,7,52
617343635,94,32,7,13,146
617349926,13,9,2,1,25
617367575,71,34,97,13,215
617411924,61,183,70,22,336
617421333,41,48,6,9,104
617434887,98,13,33,7,151
617447746,74,34,17,46,171
617452890,119,21,2,2,144
617453656,44,17,4,1,66
617454851,60,68,4,25,157
617466286,10,5,2,1,18
617470768,67,37,17,19,140
617481537,43,5,2,1,51
617487354,49,3,24,1,77
617487690,93,19,44,7,163
617492376,63,24,2,10,99
617497750,62,5,11,11,89
617508783,83,24,2,1,110
617514778,112,17,37,9,175
617524694,110,39,83,37,269
617525589,14,3,2,1,20
617535413,20,3,2,1,26
617535468,45,4,2,1,52
617537188,105,12,2,1,120
617544302,17,3,2,1,23
617547227,31,3,2,4,40
617547332,23,28,32,2,85
617548043,146,3,2,6,157
617553313,71,3,2,2,78
617556040,68,59,68,36,231
617558010,10,3,2,2,17
617559597,33,3,2,9,47
617574992,17,38,2,1,58
617594261,89,19,31,7,146
617623000,45,27,12,1,85
617639308,54,47,42,8,151
617645887,61,24,45,6,136
617650177,501,3,2,7,513
617672865,36,44,2,6,88
617675204,25,3,2,1,31
617678228,157,17,59,23,256
617681634,103,70,103,21,297
617693057,130,33,8,12,183
617730346,27,3,2,1,33
617735036,67,3,2,1,73
617752466,23,29,12,1,65
617761974,16,10,2,6,34
617786576,101,36,2,2,141
617788363,21,4,2,1,28
617789020,31,16,8,13,68
617789122,10,11,7,1,29
617796067,148,27,47,55,277
617800601,109,3,2,3,117
617816177,48,16,11,14,89
617835944,15,3,2,1,21
617843833,29,32,7,10,78
617846730,14,9,2,1,26
617858226,220,25,11,11,267
617864962,39,27,27,4,97
617868645,112,3,2,6,123
617874538,12,3,2,1,18
617875425,78,3,2,1,84
617911823,42,4,2,1,49
617915378,47,29,11,4,91
617923115,31,31,6,6,74
617923478,11,37,2,1,51
617932733,99,12,6,22,139
617936231,87,22,33,8,150
617951105,57,55,3,4,119
617960071,97,3,3,1,104
617966112,64,25,2,4,95
617981994,11,8,14,4,37
617985138,14,3,2,1,20
617990487,114,11,2,8,135
618011077,52,59,2,1,114
618033458,22,37,24,2,85
618044573,11,3,2,1,17
618048794,71,14,39,14,138
618064450,71,27,4,1,103
618068836,42,8,2,2,54
618072802,48,7,2,4,61
618091827,21,24,2,1,48
618105302,29,79,2,1,111
618110011,10,4,2,1,17
618119834,243,59,6,5,313
618124573,25,3,2,1,31
618128865,28,11,7,1,47
618136014,141,59,36,3,239
618140332,102,7,6,10,125
618141693,29,35,22,8,94
618145597,44,15,2,2,63
618153800,13,43,3,1,60
618165915,31,60,2,8,101
618186065,85,56,66,18,225
618204215,115,4,5,1,125
618210881,36,29,26,20,111
618220629,17,10,2,1,30
618226016,103,42,158,1,304
618233136,15,23,20,5,63
618235148,257,3,2,7,269
618249087,76,74,59,132,341
618252315,52,35,25,10,122
618256352,80,3,2,7,92
618276430,75,3,3,1,82
618296827,14,3,2,1,20
618297243,17,3,2,1,23
618298553,27,15,11,8,61
618310024,64,15,2,1,82
618314305,13,3,2,1,19
618325407,12,3,2,1,18
618330017,45,39,7,4,95
618355037,10,5,2,1,18
618367913,11,15,2,1,29
618370103,56,26,34,4,120
618377952,29,5,2,1,37
618385556,59,6,2,3,70
618387993,12,3,2,6,23
618427434,10,7,2,1,20
618461093,152,3,2,2,159
618463638,28,3,2,3,36
618468884,49,57,2,2,110
618482607,15,3,2,1,21
618503663,59,33,54,10,156
618509796,123,17,16,1,157
618514674,62,3,2,1,68
618527356,82,10,2,3,97
618533389,116,33,42,3,194
618549821,70,9,5,2,86
618552732,43,42,39,27,151
618563955,124,17,49,11,201
618565024,94,24,84,1,203
618567737,82,3,2,2,89
618572199,19,3,2,1,25
618580678,69,69,3,5,146
618583679,35,24,26,1,86
618597421,35,21,17,4,77
618599925,149,30,2,31,212
618618760,16,3,3,1,23
618621600,10,13,2,1,26
618621883,27,41,2,2,72
618628677,97,3,2,3,105
618642752,117,17,10,9,153
618646893,28,3,2,4,37
618647024,117,14,54,9,194
618647958,50,11,5,3,69
618659669,31,28,4,1,64
618670902,33,18,2,1,54
618679624,40,35,26,16,117
618685019,71,3,2,2,78
618686015,10,25,2,1,38
618704607,129,74,26,5,234
618706290,31,3,2,1,37
618733760,54,92,11,31,188
618767999,12,10,2,2,26
618768579,39,5,3,1,48
618769067,79,3,2,2,86
618775002,40,28,2,1,71
618782694,56,11,8,53,128
618785816,32,141,13,3,189
618795426,91,41,40,5,177
618805019,108,20,2,7,137
618814040,104,47,27,6,184
618832021,207,18,26,9,260
618837816,48,3,2,1,54
618840603,50,79,17,16,162
618844143,107,9,3,1,120
618855516,35,7,2,1,45
618866668,118,17,2,1,138
618868557,23,3,2,1,29
618883872,146,63,47,84,340
618891055,28,3,2,1,34
618893495,102,19,2,1,124
618895279,12,3,2,2,19
618899285,11,3,2,1,17
618913372,29,3,2,1,35
618914499,51,42,5,1,99
618920423,51,3,2,5,61
618932247,70,25,3,1,99
618956363,113,3,2,1,119
618959094,32,56,15,1,104
618963233,115,25,68,2,210
618976738,33,6,2,14,55
618984026,21,15,10,18,64
618986463,129,61,2,18,210
618997881,56,16,57,29,158
619004774,15,9,3,4,31
619032496,58,28,3,1,90
619039165,60,20,3,10,93
619045022,48,48,106,32,234
619049976,53,55,4,2,114
619069729,90,27,27,3,147
619091347,60,13,10,1,84
619092645,11,26,2,9,48
619096862,12,4,3,7,26
619103398,22,11,2,1,36
619110725,86,14,31,6,137
619112379,13,20,2,1,36
619113952,57,10,9,3,79
619116489,17,8,2,1,28
619122115,70,32,2,7,111
619138804,47,22,51,1,121
619158471,16,13,2,1,32
619192689,104,5,2,2,113
619205556,74,11,2,1,88
619207816,121,3,2,12,138
619213928,121,3,2,7,133
619217126,37,3,2,1,43
619236491,51,3,2,2,58
619252526,36,82,17,3,138
619253805,53,3,2,1,59
619262344,123,3,2,15,143
619262387,87,119,14,7,227
619265795,110,15,5,8,138
619269121,131,37,23,25,216
619282638,15,9,2,2,28
619305558,54,3,2,3,62
619335368,20,6,9,5,40
619340357,111,36,5,8,160
619346219,10,6,2,1,19
619353165,16,3,2,1,22
619359671,133,3,2,1,139
619367775,10,8,2,1,21
619368329,10,8,2,1,21
619386877,103,42,85,4,234
619388682,38,3,2,7,50
619391057,11,3,2,2,18
619392265,106,23,18,1,148
619397106,12,44,3,1,60
619398877,49,3,2,13,67
619402671,70,83,2,3,158
619406765,40,23,10,4,77
619415034,143,34,4,7,188
619457007,16,4,2,1,23
619471936,91,16,64,21,192
619486083,89,3,2,1,95
619490568,29,8,2,3,42
619526544,43,37,37,16,133
619546879,24,20,2,1,47
619557206,92,20,3,28,143
619558429,164,18,2,40,224
619567247,11,3,2,1,17
619582944,29,12,2,2,45
619583925,65,61,2,2,130
619591654,43,29,7,1,80
619602763,10,3,2,3,18
619604111,122,4,2,2,130
619635824,72,3,2,10,87
619637205,63,3,2,1,69
619649163,36,93,24,8,161
619652544,88,14,5,12,119
619681665,115,14,2,6,137
619692658,73,3,2,1,79
619696124,47,48,10,4,109
619704025,59,31,21,10,121
619743117,18,3,2,1,24
619744989,45,5,2,1,53
619758495,13,3,2,1,19
619763067,132,8,3,5,148
619763262,34,11,2,1,48
619771478,42,11,4,1,58
619789553,86,28,2,1,117
619799124,18,4,2,1,25
619807479,52,16,5,6,79
619811835,70,95,8,4,177
619817887,60,34,2,3,99
619863195,29,3,2,1,35
619865266,11,26,2,1,40
619868083,26,27,19,9,81
619887278,10,3,2,12,27
619906007,87,9,26,1,123
619906255,10,3,2,4,19
619907810,29,7,2,1,39
619909773,43,3,2,1,49
619919905,19,4,2,1,26
619923298,13,3,2,1,19
619931558,17,9,2,4,32
619945530,10,3,2,2,17
619960849,61,23,2,11,97
619966122,47,20,3,4,74
619967855,48,39,53,4,144
619984857,44,9,2,1,56
619985403,12,3,2,1,18
620002049,50,36,25,19,130
620005363,11,3,2,1,17
620014129,175,64,38,14,291
620014870,12,25,5,1,43
620024516,112,3,2,8,125
620042073,57,19,28,9,113
620054479,13,3,2,1,19
620056371,89,17,10,46,162
620059582,44,122,2,1,169
620074071,30,15,5,3,53
620077763,71,11,37,8,127
620083674,70,7,11,11,99
620100023,41,23,29,2,95
620105739,75,5,2,1,83
620116582,71,3,2,5,81
620125322,65,3,2,2,72
620137883,25,3,2,2,32
620145440,29,46,5,3,83
620147684,17,7,2,1,27
620153814,70,3,2,5,80
620160148,64,11,4,3,82
620200804,98,3,2,1,104
620204334,45,47,2,1,95
620219382,74,12,7,1,94
620219447,57,40,25,17,139
620222844,24,6,2,1,33
620230980,130,14,2,1,147
620231152,41,3,2,13,59
620232828,117,3,2,23,145
620234821,131,3,2,2,138
620258949,13,3,2,1,19
620264381,66,28,13,2,109
620266266,203,18,91,92,404
620272442,55,62,29,30,176
620292265,150,16,2,2,170
620299761,13,3,2,1,19
620312357,27,15,2,1,45
620312647,93,3,2,1,99
620317226,37,23,8,13,81
620334151,51,6,2,1,60
620338122,59,122,27,3,211
620350165,28,20,13,6,67
620369247,12,3,2,7,24
620377757,46,3,2,9,60
620378488,10,5,2,1,18
620381724,86,14,6,1,107
620386801,71,33,2,5,111
620390280,14,5,2,1,22
620402713,13,14,2,1,30
620405919,22,29,2,1,54
620411677,85,28,2,11,126
620420991,50,12,50,13,125
620434383,17,9,2,1,29
620450319,80,3,12,2,97
620451486,127,11,72,27,237
620456375,21,13,29,2,65
620456917,29,32,6,6,73
620458301,72,16,3,2,93
620458362,24,3,2,1,30
620468839,42,11,17,13,83
620472833,69,8,9,5,91
620480870,111,32,4,5,152
620481451,11,3,2,1,17
620506170,56,8,2,10,76
620513404,23,26,2,1,52
620514927,125,3,2,2,132
620515989,26,3,2,12,43
620537747,118,32,29,2,181
620540965,16,3,2,2,23
620550358,116,3,2,6,127
620554608,24,3,2,1,30
620560237,11,3,2,1,17
620569612,68,93,2,4,167
620578062,49,3,2,1,55
620579213,83,75,58,35,251
620590710,33,3,8,1,45
620597875,88,22,19,1,130
620602769,112,3,2,9,126
620607766,86,46,4,6,142
620616728,109,38,12,10,169
620616861,91,41,38,1,171
620641790,79,3,4,2,88
620651748,30,6,22,2,60
620652714,18,3,2,3,26
620657095,97,55,11,6,169
620672653,47,3,2,1,53
620677259,39,32,2,1,74
620726450,67,3,2,1,73
620754781,112,4,23,3,142
620766951,119,25,2,6,152
620767340,64,3,2,1,70
620781398,32,11,2,3,48
620786836,63,3,2,1,69
620793479,46,3,2,8,59
620796635,20,3,2,1,26
620796990,112,31,87,1,231
620809237,103,41,2,13,159
620810648,37,14,14,2,67
620811134,23,3,2,1,29
620815812,64,69,19,2,154
620823656,38,3,2,1,44
620825938,106,59,44,3,212
620829306,133,23,2,6,164
620847958,27,11,2,4,44
620859888,51,23,17,2,93
620883411,64,8,2,1,75
620896821,17,7,3,5,32
620928358,94,63,35,38,230
620939086,143,18,2,8,171
620941715,11,4,2,1,18
620962158,40,29,70,22,161
620969821,76,30,27,2,135
620983243,22,34,19,5,80
620985700,63,5,8,1,77
621003179,49,21,17,1,88
621015383,25,37,2,2,66
621026642,29,25,2,2,58
621029392,157,8,2,1,168
621037506,108,5,2,1,116
621050895,96,3,2,1,102
621054041,20,10,2,4,36
621065636,37,4,2,9,52
621070072,57,11,4,8,80
621079260,12,5,7,1,25
621079462,62,9,11,1,83
621101927,16,35,7,5,63
621103907,43,3,2,22,70
621114132,93,97,29,2,221
621121356,24,4,3,22,53
621134799,11,3,2,1,17
621136817,112,38,48,4,202
621146213,38,31,3,28,100
621150338,49,22,93,16,180
621152518,36,32,11,1,80
621169364,22,11,2,1,36
621173369,61,12,12,9,94
621177464,151,3,2,1,157
621178741,42,3,2,2,49
621179028,11,3,2,1,17
621181614,135,3,2,30,170
621198091,152,33,4,2,191
621199006,128,3,2,3,136
621200034,12,3,2,5,22
621214367,158,64,2,8,232
621214627,24,3,2,1,30
621216083,23,61,24,15,123
621229540,15,3,2,1,21
621232100,38,41,38,5,122
621233309,94,3,2,3,102
621238281,10,5,2,2,19
621241816,64,3,2,5,74
621246436,45,39,38,17,139
621256649,16,51,2,1,70
621276408,38,10,3,22,73
621292054,11,6,2,1,20
621304263,51,19,15,9,94
621306639,57,23,13,4,97
621319294,12,3,2,2,19
621321308,32,31,45,1,109
621330269,40,39,16,7,102
621332382,242,39,2,8,291
621341045,38,16,8,18,80
621349812,172,17,11,12,212
621350827,32,12,2,2,48
621365860,71,58,14,31,174
621368517,84,12,2,15,113
621373356,88,73,4,9,174
621375266,127,24,13,2,166
621380773,27,7,2,4,40
621408550,152,111,41,125,429
621419573,99,34,8,1,142
621438023,53,46,6,16,121
621441176,24,22,16,1,63
621446465,12,3,2,1,18
621455303,14,6,2,1,23
621456921,27,7,2,1,37
621466330,12,13,9,1,35
621469181,92,29,2,1,124
621474738,12,46,2,1,61
621477527,59,31,6,4,100
621478082,39,24,2,1,66
621480876,21,3,2,2,28
621482820,18,19,4,1,42
621484824,16,3,2,1,22
621487740,33,3,2,1,39
621498584,25,29,4,2,60
621507689,103,19,4,27,153
621509813,23,14,2,1,40
621524435,13,14,2,1,30
621534063,163,23,2,1,189
621543640,97,29,29,2,157
621558750,32,18,2,3,55
621569307,185,40,32,13,270
621570009,68,23,2,7,100
621578319,63,42,32,1,138
621592308,44,21,2,2,69
621598608,330,20,23,23,396
621603535,12,49,23,1,85
621605545,68,31,11,19,129
621613083,32,53,43,5,133
621630931,48,3,2,2,55
621632828,48,67,4,1,120
621641687,140,21,37,10,208
621648583,76,41,46,10,173
621649518,50,42,31,6,129
621651559,10,20,2,12,44
621660095,29,5,2,1,37
621662143,10,23,2,2,37
621674974,119,8,10,2,139
621677744,89,36,2,2,129
621702269,102,3,2,6,113
621703703,25,3,2,1,31
621705588,19,5,2,2,28
621711925,61,19,2,2,84
621713663,53,47,22,1,123
621714438,28,5,2,1,36
621715163,90,3,2,1,96
621717159,80,12,11,6,109
621728550,229,35,64,18,346
621739340,25,23,4,11,63
621753417,35,21,24,14,94
621764400,160,58,3,73,294
621783157,15,3,2,1,21
621785701,73,7,29,3,112
621791847,50,14,2,3,69
621801800,205,30,9,29,273
621804876,19,10,2,5,36
621808458,15,3,11,2,31
621825182,61,32,9,28,130
621849615,11,6,2,1,20
621852573,94,21,2,1,118
621852976,39,37,2,1,79
621854875,144,8,29,23,204
621859244,64,43,94,19,220
621874164,10,6,2,1,19
621902752,56,3,2,1,62
621914683,40,30,2,9,81
621920713,78,37,2,4,121
621935087,47,7,46,13,113
621941078,86,22,2,4,114
621962431,12,3,2,1,18
621979061,75,29,4,3,111
622002488,52,28,2,3,85
622007738,16,28,15,1,60
622007819,46,32,2,12,92
622016768,16,3,2,1,22
622022593,53,45,30,17,145
622038730,33,4,2,4,43
622041267,12,3,2,1,18
622041719,80,16,26,13,135
622047057,28,16,2,1,47
622052268,14,4,2,9,29
622055935,69,27,65,21,182
622081371,1807,3,2,1,1813
622090968,36,25,19,15,95
622093802,85,3,2,3,93
622097547,18,3,2,1,24
622107298,31,37,9,7,84
622128150,35,11,16,2,64
622138829,69,19,3,1,92
622142658,51,8,11,4,74
622151840,10,6,2,1,19
622193380,34,24,21,10,89
622197920,71,3,3,1,78
622201619,44,51,3,15,113
622221798,23,10,38,3,74
622223426,10,27,2,1,40
622223630,18,11,2,1,32
622233301,26,3,2,1,32
622246956,81,28,38,1,148
622255184,34,38,3,8,83
622255883,125,64,35,9,233
622266710,59,4,2,1,66
622270011,157,73,90,133,453
622278076,138,38,2,3,181
622290655,101,55,31,19,206
622292740,91,3,2,4,100
622293352,79,42,19,20,160
622307493,81,16,2,1,100
622334983,78,56,16,3,153
622335941,75,3,2,4,84
622339789,121,19,2,7,149
622346829,12,3,2,1,18
622352360,110,41,29,52,232
622363973,78,30,2,18,128
622373838,41,27,29,25,122
622383948,16,3,2,1,22
622385915,12,4,2,9,27
622396651,43,15,6,2,66
622397797,23,43,29,1,96
622401996,183,3,2,1,189
622408484,11,3,2,1,17
622413663,67,12,4,1,84
622424045,41,3,3,1,48
622434091,24,21,13,1,59
622445836,166,34,2,13,215
622450694,49,4,2,10,65
622453903,45,15,2,3,65
622478425,40,16,2,3,61
622496699,75,17,24,25,141
622496951,16,18,2,1,37
622506829,68,3,2,3,76
622516060,258,87,2,28,375
622519242,35,5,2,1,43
622543862,22,6,3,6,37
622551733,76,35,2,7,120
622553282,75,23,41,11,150
622572079,11,3,2,1,17
622575405,29,5,2,1,37
622579592,15,7,2,1,25
622584150,19,3,2,1,25
622585800,121,13,55,2,191
622611771,92,39,18,1,150
622626380,20,3,2,1,26
622627168,50,29,9,1,89
622642211,18,18,2,1,39
622645031,18,30,2,1,51
622651228,77,59,4,8,148
622652458,36,3,2,7,48
622667004,51,3,2,5,61
622699859,73,3,2,1,79
622727032,91,4,12,1,108
622745140,24,21,2,1,48
622780366,81,23,2,11,117
622821435,17,39,3,1,60
622832342,172,3,2,3,180
622839055,81,33,15,2,131
622839357,45,8,4,2,59
622849912,100,33,3,1,137
622851151,46,85,7,27,165
622862538,55,25,2,2,84
622863861,28,43,35,8,114
622885136,32,3,2,1,38
622918347,65,37,2,1,105
622920029,15,22,10,1,48
622925527,65,19,2,3,89
622928041,11,3,2,1,17
622945565,47,15,2,1,65
622951457,33,38,2,5,78
622968035,12,30,2,1,45
622970533,188,3,2,1,194
622973490,23,4,2,6,35
622980211,87,23,9,1,120
622985172,54,25,2,1,82
622985358,41,52,2,2,97
622992974,214,56,102,8,380
623019528,32,3,2,1,38
623050250,123,3,2,1,129
623052548,18,3,2,2,25
623056472,17,38,2,1,58
623058547,10,20,2,1,33
623059142,46,15,2,2,65
623090529,69,3,2,17,91
623134680,14,32,16,2,64
623135965,111,3,2,7,123
623163936,66,3,2,1,72
623185047,64,3,2,1,70
623187277,12,3,2,1,18
623195588,32,3,2,1,38
623196787,16,3,2,1,22
623198081,136,3,2,59,200
623242886,46,3,2,1,52
623260675,22,45,69,5,141
623266124,210,3,2,4,219
623268658,164,12,2,5,183
623271501,60,49,30,5,144
623271758,86,61,91,15,253
623288769,18,34,2,1,55
623293466,159,24,14,40,237
623310420,13,8,14,1,36
623324442,77,51,8,38,174
623340804,172,3,2,1,178
623366231,233,33,38,1,305
623378299,28,18,2,1,49
623387074,13,43,5,1,62
623391248,30,10,2,4,46
623408969,63,3,2,1,69
623413662,206,16,14,2,238
623448084,51,40,7,7,105
623448639,58,21,32,1,112
623451675,200,63,17,5,285
623460292,65,3,4,8,80
623463873,88,13,29,3,133
623468897,44,3,2,1,50
623476672,24,3,2,1,30
623485662,10,4,2,1,17
623498741,64,3,12,5,84
623500387,14,23,2,5,44
623507189,41,39,55,2,137
623516604,53,18,4,1,76
623522542,120,13,9,3,145
623528489,18,4,2,1,25
623528989,92,3,2,2,99
623537443,31,3,15,10,59
623551219,143,31,32,24,230
623551958,54,68,22,14,158
623563066,94,17,9,6,126
623565106,66,14,2,3,85
623573172,78,24,14,1,117
623575421,475,24,3,6,508
623581063,111,35,4,186,336
623633536,21,9,2,1,33
623636975,79,36,67,1,183
623658131,15,14,2,7,38
623668388,26,3,2,1,32
623669594,30,30,9,4,73
623681809,124,21,7,6,158
623691603,51,19,3,6,79
623692481,18,11,2,1,32
623695953,46,29,9,1,85
623706790,65,8,14,2,89
623712589,111,39,4,7,161
623721766,10,9,2,1,22
623721958,116,82,54,18,270
623726433,56,28,19,3,106
623739026,113,41,15,24,193
623741210,101,3,2,1,107
623744622,13,52,2,1,68
623751473,63,28,13,22,126
623754480,19,24,2,8,53
623766938,28,16,12,7,63
623779041,46,17,2,1,66
623782503,77,77,43,8,205
623785562,268,3,2,38,311
623796671,12,15,2,1,30
623805139,40,44,36,29,149
623832051,23,12,2,3,40
623842711,18,69,5,1,93
623867226,209,3,2,6,220
623872959,14,30,2,1,47
623875930,22,3,2,14,41
623878242,10,6,2,1,19
623904584,12,3,2,7,24
623908396,57,55,27,2,141
623909143,27,4,2,1,34
623914475,54,3,2,1,60
623915495,31,12,17,1,61
623925623,86,3,2,1,92
623933204,54,19,38,1,112
623934121,167,3,2,22,194
623939998,34,3,2,1,40
623942700,23,12,4,9,48
623947682,106,3,2,1,112
623966337,18,7,2,4,31
623975672,110,4,2,1,117
623981751,42,13,2,2,59
623983176,15,3,2,1,21
623991293,48,50,7,5,110
623995105,206,3,35,15,259
623997015,30,8,2,11,51
624008675,38,37,12,4,91
624020584,166,23,37,18,244
624023097,49,18,3,3,73
624026693,337,20,5,8,370
624030283,132,3,2,1,138
624031388,52,7,20,1,80
624041453,210,31,6,2,249
624063313,74,26,4,6,110
624065349,117,27,3,2,149
624074481,20,31,3,7,61
624078266,22,3,2,9,36
624082525,10,7,2,1,20
624086308,80,4,2,8,94
624092609,37,9,2,6,54
624093479,274,16,98,58,446
624093974,13,3,2,4,22
624116264,17,3,2,1,23
624119477,279,3,2,1,285
624123849,88,3,4,1,96
624125355,23,7,15,1,46
624143586,48,52,20,24,144
624145652,23,6,2,1,32
624176392,26,32,20,1,79
624183832,18,40,2,2,62
624187242,20,12,10,2,44
624189282,43,20,6,8,77
624190779,152,127,119,17,415
624197103,75,45,35,42,197
624199374,87,18,19,1,125
624223130,63,3,5,1,72
624227296,62,69,65,2,198
624229457,200,12,3,5,220
624238077,10,4,2,1,17
624247492,78,17,2,1,98
624254402,28,3,2,5,38
624257411,57,3,2,1,63
624274507,41,57,3,2,103
624280151,41,60,3,1,105
624286425,36,13,2,20,71
624286850,93,33,27,18,171
624289904,10,6,2,1,19
624298503,18,5,11,8,42
624301823,68,39,2,1,110
624305336,66,3,2,1,72
624316810,19,3,2,1,25
624318160,70,49,14,1,134
624321185,113,26,10,2,151
624328504,17,6,2,1,26
624333635,90,8,3,1,102
624333999,31,42,23,35,131
624342353,46,40,35,15,136
624346806,33,14,2,1,50
624348777,101,33,18,11,163
624353394,21,3,2,3,29
624364349,34,35,2,1,72
624373053,74,36,11,2,123
624378144,33,3,2,1,39
624382726,76,18,16,15,125
624383833,80,29,59,75,243
624389987,12,3,2,3,20
624396929,11,3,2,2,18
624404205,14,3,2,1,20
624421188,47,8,2,5,62
624427848,105,78,50,13,246
624430393,50,3,2,68,123
624439611,23,69,4,14,110
624452043,14,3,2,1,20
624458274,14,3,2,3,22
624463740,33,5,2,8,48
624465865,60,50,29,1,140
624468294,267,3,2,3,275
624474155,139,3,2,2,146
624474594,11,3,2,1,17
624476573,154,45,15,18,232
624480459,11,3,2,1,17
624489936,83,3,2,1,89
624508488,25,40,12,2,79
624511223,14,24,20,1,59
624524014,30,3,2,1,36
624531122,11,4,2,1,18
624538144,65,8,2,1,76
624539844,42,3,3,1,49
624549318,47,3,2,6,58
624552938,34,13,5,3,55
624552944,69,44,16,29,158
624584290,70,3,2,1,76
624585831,131,3,2,7,143
624586162,42,6,2,10,60
624615723,10,3,2,3,18
624624123,63,29,2,3,97
624635527,10,85,2,2,99
624638625,50,50,72,63,235
624667879,108,3,2,1,114
624672757,48,23,2,7,80
624696562,11,3,2,1,17
624698977,22,33,2,15,72
624703834,58,3,2,1,64
624712908,51,22,6,6,85
624720745,28,3,2,1,34
624725479,140,41,2,14,197
624734769,11,5,2,1,19
624739512,17,3,2,7,29
624756250,67,22,21,3,113
624764803,10,6,2,1,19
624773904,47,25,7,1,80
624793954,54,21,14,6,95
624802760,20,55,28,1,104
624818092,50,38,11,1,100
624827043,70,6,65,5,146
624829042,48,3,2,1,54
624847176,13,3,2,1,19
624854497,12,5,2,1,20
624860611,20,21,2,1,44
624870905,78,3,3,1,85
624878717,38,54,21,13,126
624883444,15,19,2,1,37
624893047,104,3,2,1,110
624894644,79,19,2,1,101
624894849,21,3,2,1,27
624898718,102,10,2,1,115
624909456,25,11,3,1,40
624910788,23,3,2,1,29
624915366,134,22,44,2,202
624941813,19,41,17,1,78
624956103,12,5,2,16,35
624966556,64,3,3,10,80
624992455,103,31,62,1,197
625001750,47,17,3,3,70
625009090,16,5,2,1,24
625014193,154,9,2,9,174
625015692,80,3,2,1,86
625023374,27,45,39,1,112
625024545,158,3,2,2,165
625030877,39,3,2,1,45
625034942,101,13,26,7,147
625037784,201,20,2,3,226
625037794,34,33,2,1,70
625072981,134,3,2,1,140
625085899,49,30,2,2,83
625097760,134,5,2,2,143
625103461,45,3,2,10,60
625110214,63,3,2,1,69
625118343,40,95,74,9,218
625135504,93,23,21,8,145
625142619,80,36,2,48,166
625143339,24,16,24,1,65
625145024,26,3,2,3,34
625164139,11,3,2,1,17
625176712,132,42,162,4,340
625178430,37,9,2,10,58
625182730,22,3,2,1,28
625185356,34,23,50,1,108
625186224,55,3,2,1,61
625195730,89,21,27,2,139
625196000,42,47,5,4,98
625226358,11,49,12,1,73
625231513,155,43,14,2,214
625235005,68,20,2,1,91
625239565,61,15,3,1,80
625239928,68,3,2,1,74
625268841,45,3,2,1,51
625273000,18,3,2,1,24
625283087,61,45,14,9,129
625284524,41,25,45,5,116
625285450,30,3,2,6,41
625288836,223,32,3,38,296
625301142,93,46,17,68,224
625302173,50,33,6,9,98
625310996,15,10,2,1,28
625313453,31,3,2,1,37
625316873,75,28,2,1,106
625324280,84,23,3,29,139
625328176,28,3,2,1,34
625328371,275,3,2,2,282
625331640,39,11,2,1,53
625341919,28,43,13,1,85
625359203,30,3,2,1,36
625387349,12,3,2,1,18
625432023,56,27,3,6,92
625445010,13,3,2,11,29
625465275,44,12,2,1,59
625476331,40,25,3,8,76
625482976,38,21,3,6,68
625488386,182,26,2,18,228
625495959,13,5,2,8,28
625497506,58,39,11,16,124
625499276,238,3,2,1,244
625515749,132,56,10,1,199
625529449,44,5,12,20,81
625542569,30,32,2,1,65
625597150,16,19,2,1,38
625613544,14,3,2,1,20
625616465,10,10,2,1,23
625621038,10,48,2,1,61
625624645,102,14,2,1,119
625651978,66,3,2,1,72
625656773,16,3,2,1,22
625671344,214,3,2,6,225
625709112,103,33,2,3,141
625709506,41,22,3,1,67
625716473,112,12,2,1,127
625717613,126,33,7,1,167
625729272,28,7,5,4,44
625736649,16,3,2,3,24
625752985,29,8,2,1,40
625756133,42,5,2,2,51
625775957,12,3,2,1,18
625782062,21,41,2,1,65
625788369,104,39,2,1,146
625803987,128,34,41,42,245
625804998,45,20,11,1,77
625806485,13,3,2,1,19
625814150,120,28,92,23,263
625814669,15,29,2,1,47
625815052,140,41,2,1,184
625816114,219,107,2,11,339
625840408,11,3,2,1,17
625840706,40,28,5,3,76
625851334,170,3,2,3,178
625875600,48,8,2,1,59
625876629,10,8,2,1,21
625882623,77,23,5,2,107
625902273,111,23,3,4,141
625937052,107,22,20,58,207
625938530,83,40,34,14,171
625960311,66,3,2,25,96
625990542,190,30,2,2,224
625997273,121,42,11,3,177
626002302,20,39,2,8,69
626027379,61,3,2,4,70
626031739,76,104,2,1,183
626036496,93,26,4,3,126
626047502,13,6,2,1,22
626063437,19,3,2,1,25
626068276,65,20,2,1,88
626085431,56,3,2,1,62
626086867,59,35,49,10,153
626092105,12,3,2,1,18
626103283,13,13,2,2,30
626103977,63,3,2,1,69
626127325,24,12,5,2,43
626133615,15,3,2,1,21
626148657,166,3,2,26,197
626156208,46,27,2,9,84
626159980,54,32,2,5,93
626160879,11,4,2,3,20
626175130,56,3,2,6,67
626177231,54,3,2,7,66
626205206,55,51,2,1,109
626209273,67,3,2,1,73
626211877,61,13,2,3,79
626222808,26,3,2,1,32
626225153,27,88,10,1,126
626235679,89,7,2,22,120
626240800,30,5,2,1,38
626255513,75,32,56,10,173
626259355,37,4,2,1,44
626285127,110,10,2,9,131
626288324,10,9,2,6,27
626294684,96,14,2,2,114
626300060,225,61,3,2,291
626314365,179,3,2,7,191
626321857,42,3,2,1,48
626323386,18,7,2,1,28
626326621,14,3,2,2,21
626328957,17,3,2,2,24
626342841,129,33,44,48,254
626343681,14,3,2,1,20
626343764,38,40,2,1,81
626349891,43,3,2,1,49
626350423,11,13,2,3,29
626351720,14,3,2,1,20
626355115,72,8,2,1,83
626360325,32,29,7,5,73
626361441,115,21,9,2,147
626377084,78,3,2,9,92
626395254,44,49,12,3,108
626395678,11,3,2,1,17
626404513,14,3,2,3,22
626409313,70,28,68,10,176
626411685,293,39,2,64,398
626415632,159,3,2,10,174
626416188,20,3,2,1,26
626425461,233,3,2,1,239
626444517,112,3,2,1,118
626448327,44,11,41,1,97
626466267,98,19,4,1,122
626475754,13,3,2,1,19
626498649,22,3,2,1,28
626500274,184,4,2,15,205
626502637,30,14,3,1,48
626502664,125,15,2,2,144
626517862,139,40,17,6,202
626522545,78,3,2,7,90
626543760,14,3,2,1,20
626551926,81,72,94,97,344
626572457,70,3,7,18,98
626586379,76,48,18,1,143
626621263,63,5,2,1,71
626621818,27,70,5,26,128
626635715,38,3,2,1,44
626662797,83,41,48,1,173
626663695,20,7,2,1,30
626686117,50,24,30,19,123
626688137,24,23,18,14,79
626710268,67,3,2,2,74
626711493,129,19,102,37,287
626739168,42,7,2,2,53
626740787,22,37,2,1,62
626745228,56,3,2,1,62
626755799,99,18,2,24,143
626759130,67,29,2,1,99
626770448,19,13,2,3,37
626781432,50,49,5,2,106
626789940,77,29,7,1,114
626791358,27,3,2,1,33
626796605,62,23,13,12,110
626800699,81,10,2,4,97
626804005,84,10,2,9,105
626815885,12,3,2,1,18
626821778,37,24,10,7,78
626826652,43,3,2,4,52
626841542,22,36,2,1,61
626858027,103,3,2,18,126
626858248,67,9,4,1,81
626868626,17,4,5,1,27
626895084,18,3,2,1,24
626896052,171,58,5,18,252
626902374,15,3,2,1,21
626917278,34,44,25,1,104
626928621,61,3,2,1,67
626942270,28,16,2,1,47
626954228,133,28,81,51,293
626980827,54,33,2,15,104
627002386,64,3,2,5,74
627007596,110,3,2,1,116
627009910,77,35,7,104,223
627020250,40,4,2,2,48
627030864,39,16,2,4,61
627042929,92,9,3,2,106
627042952,135,3,2,1,141
627067835,302,3,110,12,427
627071168,146,3,2,1,152
627071737,100,3,2,28,133
627078353,177,20,35,6,238
627114194,166,3,2,32,203
627159227,109,17,2,1,129
627159855,50,20,3,6,79
627181304,85,29,2,1,117
627185399,30,23,13,10,76
627185460,20,33,41,9,103
627186323,10,4,2,1,17
627195590,144,3,2,1,150
627199527,19,3,2,1,25
627203210,26,9,7,9,51
627218868,48,19,4,2,73
627265359,60,23,17,13,113
627266314,58,19,2,6,85
627269311,35,75,24,8,142
627274451,57,9,7,2,75
627283193,98,39,13,9,159
627320530,45,26,2,8,81
627325206,16,5,2,1,24
627336555,13,3,2,1,19
627340224,11,3,2,1,17
627340523,126,3,2,1,132
627361427,113,9,2,1,125
627376267,33,19,2,1,55
627391808,11,23,4,6,44
627394821,63,32,13,2,110
627399145,22,6,3,4,35
627399550,13,3,2,1,19
627404254,23,3,2,1,29
627404797,20,3,2,1,26
627407050,61,3,2,3,69
627420663,28,10,2,1,41
627423240,226,60,14,4,304
627426646,11,6,2,1,20
627439020,29,22,39,31,121
627439691,36,24,37,18,115
627451866,46,46,62,22,176
627458188,53,21,16,1,91
627465682,35,22,25,1,83
627488455,16,22,2,1,41
627490182,21,16,2,1,40
627497668,62,30,3,1,96
627509406,86,29,2,12,129
627523371,21,37,2,2,62
627537058,68,73,2,6,149
627540040,34,8,5,1,48
627544192,154,40,2,30,226
627552251,14,3,2,1,20
627552260,69,6,2,2,79
627556080,23,5,2,1,31
627558090,78,111,13,22,224
627564661,92,3,2,3,100
627570053,165,3,2,4,174
627582025,11,3,2,1,17
627590859,84,3,49,1,137
627603275,13,3,2,2,20
627607658,11,3,2,1,17
627632730,101,3,2,3,109
627634601,37,32,53,2,124
627639907,43,3,2,5,53
627664426,26,23,4,1,54
627684322,31,29,8,1,69
627688566,21,37,2,1,61
627697208,38,4,2,26,70
627701185,17,3,2,1,23
627705750,123,3,19,1,146
627706735,29,3,2,1,35
627711278,105,5,15,7,132
627725637,51,45,93,9,198
627730024,63,38,9,1,111
627746962,123,15,2,1,141
627749949,16,27,25,1,69
627755084,63,13,2,28,106
627757482,16,3,2,1,22
627788493,121,39,58,48,266
627789074,52,3,2,5,62
627793288,25,3,2,1,31
627802971,156,7,2,6,171
627816963,24,3,2,1,30
627833445,10,25,6,1,42
627856652,58,17,12,27,114
627865457,54,42,9,6,111
627874617,29,14,2,1,46
627876197,82,50,39,1,172
627896270,16,3,2,1,22
627897375,25,3,2,20,50
627907784,12,3,2,1,18
627915147,11,5,2,1,19
627926106,24,51,2,2,79
627940256,44,45,22,4,115
627942950,78,56,31,6,171
627943503,73,10,52,44,179
627943538,61,3,2,1,67
627946002,44,66,33,3,146
627949396,51,3,2,1,57
627952506,65,3,2,3,73
627955039,37,14,16,4,71
627966914,111,26,23,37,197
627967184,36,3,2,1,42
627979148,57,29,31,10,127
627990097,57,26,4,5,92
628001618,79,22,75,10,186
628012731,61,61,18,1,141
628021951,49,11,4,9,73
628023836,19,6,16,1,42
628024097,15,25,3,1,44
628032757,47,3,2,1,53
628032807,139,34,3,1,177
628034869,126,19,29,1,175
628037999,38,32,22,7,99
628060402,89,16,2,1,108
628074582,13,20,2,1,36
628084464,24,3,2,20,49
628103814,59,33,60,13,165
628123977,12,3,2,1,18
628131139,28,3,2,4,37
628134536,36,5,5,3,49
628143132,22,86,5,9,122
628168676,114,7,7,8,136
628179839,97,34,2,7,140
628179898,39,3,4,1,47
628187179,12,4,2,1,19
628188884,87,31,33,19,170
628191438,28,8,2,4,42
628207518,12,3,2,3,20
628235456,14,3,2,1,20
628257218,93,6,36,1,136
628273470,42,18,16,1,77
628277995,23,30,15,15,83
628285951,42,10,23,28,103
628301865,392,3,2,6,403
628303240,40,17,2,1,60
628308185,110,79,12,10,211
628314777,26,3,2,3,34
628322997,129,51,115,3,298
628327828,20,34,12,7,73
628351398,31,10,29,6,76
628368339,76,22,2,1,101
628405167,115,40,28,42,225
628407399,13,3,2,1,19
628415891,33,80,20,4,137
628421988,51,3,2,14,70
628430393,218,11,28,2,259
628432466,33,8,2,2,45
628438605,63,47,21,17,148
628439837,15,6,2,2,25
628453160,36,3,2,1,42
628464546,88,3,2,1,94
628477310,132,29,2,5,168
628481031,103,7,3,20,133
628501057,11,4,2,1,18
628501953,53,58,9,12,132
628502109,95,36,14,3,148
628510269,99,32,9,15,155
628536125,63,3,2,1,69
628536289,45,41,2,16,104
628552479,160,4,2,1,167
628553211,25,12,15,5,57
628563412,54,8,4,2,68
628563798,166,3,2,6,177
628588016,11,4,2,1,18
628589128,19,3,2,1,25
628591369,33,3,2,1,39
628594750,21,10,2,5,38
628600739,162,35,3,1,201
628606997,51,14,13,22,100
628613759,11,3,2,1,17
628614513,26,32,10,3,71
628635288,23,24,5,9,61
628635730,132,17,2,3,154
628650416,42,3,2,1,48
628663661,16,9,2,1,28
628689352,76,3,2,1,82
628717880,48,3,2,1,54
628718303,12,18,2,1,33
628720616,218,3,2,17,240
628739014,79,72,50,12,213
628747227,35,14,2,1,52
628757906,11,3,2,1,17
628760680,39,26,9,16,90
628765151,43,3,2,3,51
628767998,32,3,2,1,38
628768379,54,46,5,2,107
628771296,119,5,9,4,137
628792814,52,6,22,1,81
628800972,96,12,6,4,118
628801055,74,38,50,14,176
628802738,191,3,2,2,198
628807422,13,3,2,1,19
628812429,12,47,2,1,62
628813285,43,3,2,1,49
628825631,51,3,2,1,57
628826241,39,5,2,1,47
628830746,74,43,7,26,150
628839481,25,35,12,72,144
628852189,63,3,2,1,69
628873541,44,19,4,1,68
628875062,72,40,36,11,159
628878606,27,11,2,4,44
628880295,16,23,2,3,44
628883580,55,13,27,11,106
628919760,38,17,2,1,58
628932613,401,3,2,10,416
628947293,96,11,2,1,110
628948990,165,3,2,4,174
628951468,16,3,2,3,24
628970754,160,35,14,66,275
628975852,90,3,3,2,98
628987743,30,3,2,1,36
628994109,90,32,30,2,154
628996110,57,3,2,2,64
629014602,105,3,11,1,120
629018922,56,63,13,12,144
629020643,21,3,2,1,27
629042564,76,15,35,1,127
629047308,45,21,49,2,117
629051079,87,3,2,1,93
629055085,36,67,47,4,154
629057906,79,3,10,1,93
629066692,42,25,2,1,70
629067276,89,21,69,1,180
629071715,12,3,2,1,18
629078035,101,42,40,13,196
629085172,13,3,2,1,19
629090248,61,23,26,34,144
629095191,35,11,2,1,49
629096550,121,3,2,2,128
629102752,142,3,2,1,148
629121719,65,14,2,1,82
629126166,112,36,21,12,181
629145901,115,3,2,1,121
629156338,52,40,14,2,108
629158642,30,4,2,1,37
629162141,89,23,41,20,173
629170717,173,3,2,8,186
629177338,212,32,5,7,256
629178206,65,65,28,18,176
629178248,34,15,9,1,59
629181107,11,19,5,2,37
629186044,69,23,13,4,109
629187457,79,66,59,22,226
629194779,112,4,2,14,132
629197869,34,6,2,1,43
629200565,10,6,2,2,20
629203610,72,12,2,1,87
629210737,12,3,2,1,18
629212594,70,16,20,1,107
629217033,22,3,2,1,28
629235962,124,55,55,16,250
629239228,81,34,16,1,132
629245273,76,3,2,7,88
629245997,67,35,17,3,122
629259660,51,12,2,2,67
629295667,44,26,2,2,74
629297221,94,4,8,1,107
629297436,93,104,89,17,303
629303348,50,10,6,1,67
629308789,36,3,30,1,70
629348798,52,20,16,1,89
629353407,68,3,2,1,74
629384624,137,17,2,2,158
629386796,57,38,32,53,180
629387470,133,12,20,1,166
629407889,11,13,98,4,126
629428364,17,18,2,1,38
629439600,81,35,22,1,139
629442637,19,5,2,3,29
629451467,38,26,3,2,69
629451525,32,13,27,1,73
629453510,24,3,2,1,30
629458240,101,11,41,12,165
629500370,92,15,27,3,137
629519646,154,14,2,2,172
629539408,11,3,2,1,17
629547279,10,7,2,1,20
629564478,94,5,42,4,145
629567269,12,5,2,1,20
629572956,83,4,4,2,93
629575214,142,3,2,10,157
629577789,72,31,39,77,219
629581756,61,3,2,8,74
629589369,86,11,5,9,111
629590784,23,27,2,1,53
629598406,19,13,2,1,35
629601408,13,3,2,2,20
629608228,11,3,2,1,17
629608614,51,44,5,2,102
629621448,71,3,2,1,77
629628792,36,8,2,2,48
629641055,62,38,2,7,109
629642251,53,66,42,1,162
629655036,87,9,2,14,112
629667235,94,3,2,1,100
629672776,15,3,2,1,21
629673012,64,9,5,4,82
629676022,64,7,41,4,116
629696400,63,32,2,1,98
629704158,38,4,15,4,61
629707229,37,50,5,1,93
629707419,10,3,2,3,18
629707443,20,3,2,1,26
629713168,10,70,2,1,83
629715689,11,3,2,1,17
629726513,15,3,2,1,21
629744304,149,3,2,18,172
629746109,15,3,2,1,21
629753278,57,51,25,5,138
629753848,28,23,2,5,58
629771112,10,6,2,1,19
629775558,88,23,60,12,183
629776472,113,15,3,9,140
629779793,130,25,22,2,179
629782785,41,9,28,6,84
629783694,19,3,2,5,29
629787146,28,6,10,6,50
629788718,42,5,2,9,58
629793659,123,28,2,3,156
629802299,55,3,2,1,61
629804463,56,4,2,4,66
629820152,25,3,2,1,31
629826343,183,33,2,4,222
629829958,101,12,2,16,131
629846491,10,5,2,1,18
629862823,193,43,3,6,245
629873340,563,3,2,26,594
629893680,31,13,2,2,48
629908124,121,3,2,79,205
629928405,21,14,2,1,38
629930007,59,7,4,4,74
629941703,50,3,2,2,57
629948904,14,6,2,1,23
629953479,15,3,2,1,21
629955130,98,3,2,7,110
629960070,144,64,36,27,271
629986505,11,11,2,1,25
629987670,65,8,26,1,100
629992693,42,3,2,1,48
630008019,54,31,38,6,129
630012022,87,3,24,5,119
630012647,68,17,2,6,93
630013533,115,65,140,51,371
630023953,48,29,53,4,134
630028481,15,10,3,1,29
630041200,12,3,2,1,18
630047201,26,3,2,1,32
630048966,41,12,2,1,56
630049893,174,3,2,1,180
630091633,34,38,14,6,92
630092189,55,111,23,2,191
630099378,32,23,50,10,115
630099875,11,16,2,1,30
630104126,162,3,2,1,168
630104696,56,41,5,8,110
630129531,37,13,4,2,56
630132329,108,57,43,32,240
630142019,33,3,2,1,39
630152589,13,3,2,1,19
630154165,21,8,2,6,37
630164498,62,3,2,3,70
630170751,55,14,2,5,76
630181756,106,61,107,15,289
630199886,137,3,14,2,156
630213066,10,4,2,1,17
630213255,62,11,15,22,110
630215272,11,3,2,1,17
630215290,52,7,2,1,62
630242905,46,30,12,2,90
630254112,34,3,2,3,42
630255324,144,30,13,46,233
630255521,15,3,2,1,21
630260886,74,20,27,6,127
630288227,115,57,65,6,243
630288981,49,41,18,3,111
630301391,56,4,4,3,67
630305873,104,3,2,19,128
630319065,59,29,44,23,155
630319351,13,27,2,1,43
630321835,92,20,54,10,176
630326955,39,54,35,5,133
630333377,43,67,26,10,146
630343893,41,3,2,4,50
630344409,17,3,2,1,23
630350394,33,11,30,1,75
630364091,68,5,4,8,85
630387030,277,3,2,9,291
630388403,42,3,2,11,58
630392800,34,22,2,1,59
630395874,39,41,5,1,86
630406746,53,16,6,7,82
630419133,115,90,17,9,231
630425969,47,3,2,8,60
630428204,12,3,2,2,19
630446532,70,6,2,1,79
630454962,124,21,3,2,150
630457634,47,36,11,21,115
630462554,15,3,2,1,21
630465828,10,6,2,1,19
630470315,43,3,2,1,49
630470473,12,3,2,3,20
630490781,43,26,2,2,73
630491225,149,20,23,1,193
630493536,65,46,49,8,168
630494099,95,3,2,7,107
630495030,24,23,8,1,56
630500838,46,15,2,3,66
630500969,162,16,7,1,186
630508778,32,27,12,1,72
630516766,34,24,24,1,83
630540753,10,4,2,3,19
630548777,55,3,2,2,62
630552445,66,68,21,1,156
630555782,13,9,2,1,25
630561447,19,3,2,2,26
630561726,23,3,2,1,29
630570306,28,24,4,6,62
630580290,172,3,2,5,182
630589691,87,41,125,46,299
630590161,117,3,73,1,194
630605404,10,3,2,8,23
630622714,39,58,17,13,127
630626741,65,4,2,8,79
630627780,77,3,2,2,84
630631594,105,40,19,23,187
630632741,72,3,2,9,86
630638086,42,3,2,1,48
630639050,69,3,2,8,82
630653004,36,21,56,2,115
630659686,66,65,3,20,154
630671104,72,3,2,1,78
630671650,77,36,2,1,116
630672234,34,44,11,2,91
630672499,77,14,8,17,116
630675962,10,21,2,1,34
630686991,117,3,2,1,123
630694792,91,7,2,5,105
630698538,83,3,4,1,91
630705572,29,6,2,1,38
630713774,10,3,2,2,17
630715233,25,62,54,4,145
630728371,86,5,2,3,96
630733717,28,3,2,1,34
630742620,40,37,5,7,89
630745155,36,3,2,1,42
630747020,50,55,30,28,163
630797265,203,46,27,3,279
630807413,13,3,2,1,19
630808031,59,11,59,1,130
630808232,97,3,2,1,103
630818548,116,32,2,1,151
630819809,135,12,2,1,150
630821088,14,4,2,2,22
630841150,13,3,2,1,19
630843717,56,10,3,4,73
630851445,29,16,22,2,69
630859623,152,10,2,1,165
630870203,43,35,55,5,138
630874241,127,31,10,12,180
630874510,26,66,2,32,126
630899270,40,18,2,1,61
630906852,217,74,4,14,309
630911489,87,24,5,18,134
630912530,150,42,4,98,294
630913127,94,3,2,2,101
630917196,28,48,54,1,131
630934069,111,11,10,12,144
630934142,10,10,6,1,27
630942720,32,3,2,8,45
630943720,13,3,2,1,19
630961314,49,14,2,3,68
630970754,10,3,2,3,18
630975186,10,3,2,2,17
630975858,97,14,2,1,114
630977424,407,3,2,1,413
630978168,33,17,11,4,65
630984578,49,8,35,1,93
630992290,36,10,2,2,50
631002553,13,3,2,1,19
631003006,103,15,2,55,175
631008654,24,3,2,1,30
631015480,79,83,16,23,201
631022913,76,24,2,4,106
631029080,126,3,2,1,132
631029979,107,3,2,9,121
631032357,49,19,7,3,78
631049344,44,37,27,22,130
631056232,84,3,2,1,90
631060954,14,3,2,5,24
631067948,14,3,2,1,20
631074312,11,5,2,2,20
631083820,26,21,2,3,52
631085737,40,19,7,56,122
631089297,55,23,7,5,90
631091230,118,12,2,14,146
631100213,12,3,2,1,18
631107985,20,16,2,1,39
631149177,19,3,2,1,25
631168122,56,41,2,1,100
631185780,47,3,2,6,58
631200693,11,3,2,1,17
631201273,15,3,2,1,21
631206778,11,3,2,1,17
631210950,37,29,2,52,120
631215325,33,80,64,1,178
631228322,115,27,2,1,145
631250023,33,3,2,3,41
631254722,41,3,2,1,47
631278453,18,3,2,2,25
631289479,42,11,2,1,56
631322258,60,36,45,22,163
631325920,21,3,2,3,29
631332459,11,8,2,1,22
631342885,31,12,2,7,52
631345458,91,3,2,5,101
631347409,187,3,2,1,193
631348530,102,3,2,1,108
631348818,162,15,82,4,263
631358089,28,3,2,7,40
631358852,31,3,2,6,42
631371869,99,114,24,1,238
631400056,161,3,2,1,167
631404742,111,3,2,1,117
631415709,15,3,2,1,21
631435106,41,3,2,1,47
631435135,83,42,27,10,162
631440668,34,13,3,4,54
631458196,10,5,2,1,18
631465076,59,3,2,1,65
631469230,54,30,5,66,155
631470352,10,4,2,1,17
631472164,99,64,14,6,183
631477238,16,4,2,6,28
631482955,147,75,69,12,303
631489892,51,29,8,1,89
631489949,76,15,3,13,107
631490615,77,61,18,24,180
631492814,47,24,9,3,83
631500033,13,4,2,5,24
631512599,12,4,2,1,19
631515953,14,29,2,2,47
631520626,12,3,2,1,18
631524830,101,3,2,1,107
631529938,70,3,2,1,76
631538393,31,5,2,1,39
631540201,69,3,2,1,75
631552825,43,8,2,5,58
631554388,20,10,2,3,35
631554536,86,9,3,2,100
631562108,65,14,5,3,87
631574591,37,3,2,1,43
631575510,25,18,3,14,60
631602080,18,4,2,9,33
631615634,110,3,2,2,117
631627691,20,3,2,2,27
631631539,26,43,20,1,90
631634818,38,33,24,1,96
631648732,126,28,2,1,157
631664589,28,19,2,5,54
631669103,80,3,2,1,86
631679742,65,30,26,1,122
631682989,78,42,53,14,187
631702019,107,23,2,4,136
631702474,33,3,2,1,39
631713156,36,21,4,1,62
631715245,53,13,6,4,76
631721430,38,7,22,1,68
631724157,46,34,68,2,150
631735027,28,3,2,1,34
631737996,61,3,2,4,70
631738857,65,35,7,7,114
631774384,102,9,2,6,119
631776359,160,20,2,11,193
631784558,48,3,34,1,86
631785763,89,21,2,1,113
631797089,51,33,10,1,95
631825557,43,3,2,1,49
631832768,21,27,10,1,59
631836445,270,5,2,5,282
631849158,15,3,2,1,21
631861836,59,3,2,1,65
631867034,91,6,2,1,100
631886920,160,3,2,2,167
631889592,126,88,11,40,265
631897941,26,9,2,1,38
631905207,68,26,16,10,120
631913553,124,29,30,13,196
631960751,33,30,3,3,69
631971970,27,53,2,23,105
631982456,16,14,2,1,33
631987548,42,26,16,6,90
631993615,144,3,2,1,150
632004549,173,6,25,9,213
632005991,84,39,5,130,258
632011731,171,3,2,3,179
632013446,41,34,41,31,147
632021636,24,5,2,16,47
632027088,101,19,2,1,123
632028273,71,3,2,1,77
632033935,40,3,3,4,50
632050889,40,36,17,8,101
632053559,351,3,2,9,365
632055639,49,28,2,1,80
632061078,12,18,2,1,33
632068986,71,10,38,1,120
632084578,101,3,2,1,107
632088519,17,4,2,1,24
632097396,56,24,28,1,109
632102341,11,10,2,1,24
632104306,63,24,18,5,110
632105355,17,21,2,2,42
632114871,76,10,2,2,90
632142253,75,9,4,1,89
632147657,60,14,63,1,138
632165340,84,3,2,4,93
632166015,18,29,3,2,52
632166740,170,22,5,38,235
632172346,11,3,2,1,17
632174866,52,17,3,1,73
632176113,23,13,2,1,39
632176156,50,56,6,13,125
632180248,89,25,2,6,122
632180428,122,23,10,30,185
632191578,25,5,2,1,33
632208350,47,39,29,1,116
632226313,18,36,2,1,57
632234524,81,16,7,2,106
632242947,55,9,2,1,67
632245926,17,3,2,1,23
632255082,32,55,2,2,91
632257350,45,29,56,3,133
632259183,14,3,2,1,20
632261692,91,3,2,5,101
632276594,23,3,2,1,29
632279482,138,7,2,10,157
632282105,159,3,2,35,199
632288891,79,38,2,34,153
632292329,18,3,2,1,24
632305472,100,43,44,1,188
632309512,50,30,17,12,109
632310845,56,21,2,1,80
632311484,26,14,10,1,51
632312873,10,6,2,1,19
632328489,60,20,12,1,93
632336805,68,55,53,6,182
632340882,64,13,2,3,82
632341094,159,3,2,1,165
632351907,66,3,2,1,72
632377748,81,39,32,9,161
632386165,36,38,49,8,131
632391418,44,5,22,10,81
632396504,37,3,2,6,48
632398640,191,34,5,7,237
632406211,26,29,9,1,65
632414398,60,31,2,1,94
632433180,13,5,2,1,21
632434747,43,10,4,1,58
632438680,14,17,2,2,35
632444580,35,3,2,17,57
632454857,25,15,5,2,47
632455864,34,3,2,1,40
632457373,53,3,2,1,59
632481110,208,137,4,32,381
632483013,61,53,14,9,137
632488603,103,59,2,1,165
632493815,10,10,2,1,23
632496673,179,3,2,1,185
632507918,141,50,2,6,199
632522827,60,27,5,1,93
632524341,64,14,8,1,87
632527675,81,15,2,11,109
632537978,30,14,18,1,63
632557871,40,25,2,1,68
632570575,27,3,4,6,40
632581508,36,39,2,3,80
632600472,12,6,2,1,21
632604803,39,6,3,5,53
632607507,22,3,2,1,28
632608579,12,4,2,1,19
632622778,37,5,2,1,45
632623239,50,22,2,3,77
632626207,85,3,2,1,91
632626864,19,69,2,1,91
632658772,126,3,2,1,132
632661324,44,36,24,1,105
632661686,33,3,2,4,42
632665022,19,10,2,2,33
632740570,74,23,9,8,114
632751878,34,11,2,9,56
632770025,72,3,2,4,81
632777624,19,11,2,1,33
632793571,15,3,2,5,25
632807079,19,10,7,24,60
632814386,73,20,2,2,97
632816872,38,32,2,1,73
632821753,77,22,2,2,103
632831199,160,44,66,3,273
632849060,50,3,2,3,58
632849354,42,3,2,6,53
632855327,72,36,7,23,138
632884756,32,34,53,2,121
632885615,68,18,8,8,102
632897909,33,17,8,3,61
632908242,44,3,2,2,51
632909089,58,37,14,6,115
632909225,31,10,2,1,44
632924029,138,3,2,13,156
632934137,53,38,12,22,125
632958769,20,3,2,2,27
632980879,41,3,2,1,47
632982695,10,3,2,2,17
632994994,94,29,35,2,160
633003862,37,4,2,3,46
633014230,161,47,54,214,476
633017970,11,3,2,1,17
633018591,121,26,43,20,210
633022726,39,19,7,2,67
633023528,23,71,36,3,133
633049728,24,26,13,2,65
633061245,11,3,2,1,17
633061648,208,3,2,1,214
633063978,65,20,2,1,88
633079197,100,30,16,6,152
633083121,11,16,6,1,34
633107738,56,3,2,1,62
633128352,12,4,2,1,19
633132224,96,15,3,19,133
633136048,51,9,2,23,85
633145823,11,3,2,1,17
633162562,119,3,2,5,129
633163655,66,12,17,1,96
633192823,79,47,35,2,163
633199345,113,45,85,8,251
633206800,22,60,25,8,115
633217392,50,3,2,2,57
633232828,122,37,19,26,204
633236998,11,3,2,1,17
633245042,43,3,2,1,49
633250279,48,34,2,3,87
633267557,11,4,2,1,18
633268933,159,7,45,1,212
633269853,56,19,2,4,81
633270245,111,24,2,26,163
633273980,55,3,52,2,112
633279408,19,3,2,1,25
633294616,10,16,2,1,29
633311441,73,3,2,2,80
633312040,179,3,2,1,185
633320927,103,4,2,3,112
633322664,172,3,2,1,178
633325754,17,37,2,4,60
633326689,61,24,2,7,94
633343403,47,21,57,3,128
633353717,87,3,2,4,96
633361524,135,24,32,3,194
633403324,67,6,2,9,84
633409295,80,27,5,4,116
633413992,188,69,7,6,270
633414095,40,3,2,1,46
633418463,49,32,20,1,102
633427149,211,67,90,15,383
633431080,73,7,2,6,88
633431543,50,39,20,2,111
633433579,16,3,2,1,22
633435753,36,34,84,1,155
633435847,38,41,12,15,106
633446595,13,3,2,1,19
633449908,152,55,44,5,256
633453279,14,3,2,2,21
633459477,26,16,3,2,47
633463566,107,12,3,6,128
633470123,16,3,2,3,24
633487315,64,8,19,1,92
633493246,121,23,22,1,167
633495356,78,33,3,4,118
633499780,21,23,15,1,60
633504063,34,9,2,1,46
633546707,67,3,2,1,73
633551113,98,40,41,6,185
633552019,168,18,2,65,253
633554731,33,11,2,1,47
633555967,106,25,79,4,214
633561686,154,58,67,2,281
633565327,11,5,2,1,19
633565700,90,29,3,2,124
633567515,11,3,2,1,17
633570195,65,14,36,13,128
633578718,68,44,35,1,148
633585078,29,8,5,8,50
633600205,26,21,19,3,69
633604553,35,23,25,1,84
633606230,19,68,2,1,90
633637186,111,17,124,16,268
633637635,122,3,2,1,128
633640183,63,3,3,2,71
633647164,32,23,2,1,58
633649665,13,3,2,1,19
633653356,49,21,33,2,105
633668453,18,12,2,1,33
633671085,176,21,33,9,239
633671165,10,19,2,2,33
633684098,98,19,2,2,121
633694773,26,8,22,4,60
633696160,78,4,2,22,106
633701977,29,19,36,1,85
633706729,68,15,17,5,105
633707405,34,36,60,5,135
633717344,16,6,2,1,25
633745921,22,12,2,3,39
633758265,125,31,6,2,164
633771581,18,9,2,1,30
633781939,16,31,3,1,51
633796951,49,9,8,13,79
633811358,50,24,14,19,107
633813095,172,18,17,6,213
633824124,55,3,2,2,62
633825358,106,46,42,5,199
633833602,123,29,41,12,205
633854674,16,3,2,1,22
633854951,16,3,2,1,22
633873419,112,23,2,37,174
633879009,34,23,26,26,109
633902808,52,59,5,2,118
633911601,160,3,2,3,168
633930675,106,13,2,13,134
633942952,32,3,2,1,38
633947149,54,3,2,1,60
633947381,45,3,2,1,51
633957110,52,42,4,17,115
633967559,69,11,2,8,90
633970330,41,24,2,1,68
633971585,227,3,2,6,238
633971935,15,3,2,16,36
633985279,267,17,41,1,326
633987636,51,58,14,53,176
633998521,175,18,2,5,200
634021540,27,3,2,1,33
634041180,98,44,2,4,148
634055276,10,4,2,1,17
634062433,106,65,36,5,212
634062669,61,52,68,32,213
634064276,57,3,2,2,64
634066419,35,21,2,1,59
634090517,45,29,3,21,98
634125483,10,3,2,2,17
634131480,10,7,2,1,20
634147323,37,29,3,2,71
634148299,66,3,2,1,72
634159772,38,35,6,4,83
634164558,33,3,2,3,41
634182005,86,36,18,77,217
634190773,93,4,2,2,101
634194781,46,62,45,2,155
634201880,53,4,67,4,128
634210600,49,3,2,1,55
634238512,43,29,9,31,112
634243317,152,19,5,19,195
634257457,13,42,5,1,61
634266031,140,27,104,55,326
634272410,57,3,2,1,63
634273007,42,18,2,2,64
634275454,10,3,2,2,17
634289865,28,9,2,11,50
634294735,151,16,30,1,198
634296366,42,3,2,3,50
634302124,42,38,2,1,83
634306117,16,12,2,1,31
634318731,24,15,2,1,42
634338206,58,75,2,1,136
634345074,13,6,2,1,22
634357164,13,11,2,1,27
634362893,197,59,5,17,278
634365030,58,12,9,3,82
634405334,21,62,8,3,94
634413277,11,3,2,3,19
634416399,13,3,2,1,19
634427330,25,12,2,1,40
634430002,72,29,47,16,164
634433407,1417,3,2,15,1437
634436775,13,3,2,4,22
634439388,47,16,3,48,114
634450255,17,3,2,5,27
634473772,80,3,2,4,89
634484442,14,3,2,1,20
634487573,138,5,2,5,150
634506746,38,50,2,18,108
634521941,129,6,2,3,140
634524118,104,31,10,1,146
634542313,87,65,22,3,177
634553937,75,6,2,3,86
634567198,54,73,41,51,219
634606245,158,31,71,3,263
634606577,24,34,26,20,104
634627957,111,27,2,3,143
634633439,99,3,2,2,106
634635302,12,6,2,1,21
634635930,59,3,2,1,65
634646724,20,3,2,12,37
634649312,49,15,2,11,77
634660390,17,14,2,8,41
634698359,49,4,17,4,74
634698429,14,3,2,1,20
634717629,146,14,30,44,234
634722310,53,3,2,11,69
634741370,171,3,2,1,177
634742799,76,11,2,1,90
634744540,30,3,2,3,38
634749161,38,3,2,1,44
634764984,117,3,2,1,123
634766940,25,3,2,1,31
634769650,119,3,2,10,134
634772146,14,5,2,8,29
634776485,41,28,7,1,77
634787320,45,23,14,18,100
634791709,88,58,4,3,153
634800460,11,3,2,1,17
634803308,49,3,2,1,55
634807443,11,5,2,1,19
634822105,120,5,2,1,128
634823800,22,14,12,18,66
634846709,79,23,59,12,173
634852360,114,10,2,2,128
634860469,97,3,2,1,103
634862585,68,3,2,59,132
634865193,25,39,2,1,67
634871356,90,9,32,2,133
634876528,29,14,6,2,51
634877916,82,19,36,41,178
634878280,15,9,2,1,27
634926652,37,31,44,1,113
634928940,82,9,2,4,97
634931058,66,26,32,11,135
634932725,59,3,2,7,71
634941560,59,3,2,1,65
634951497,11,32,3,1,47
634955016,54,93,112,7,266
634967595,10,33,2,1,46
634985507,13,25,2,1,41
634987642,32,13,2,1,48
634991854,73,3,2,2,80
635006036,11,3,2,1,17
635010182,79,3,2,5,89
635023783,35,3,2,1,41
635027091,45,9,21,25,100
635029017,109,33,2,12,156
635034434,161,17,10,19,207
635037246,131,8,9,22,170
635042013,41,41,3,1,86
635044989,143,13,47,5,208
635055981,53,9,11,2,75
635062546,160,25,51,22,258
635111231,31,4,3,7,45
635116096,81,3,2,6,92
635123737,136,3,2,1,142
635127107,212,13,3,7,235
635133521,45,29,2,4,80
635150554,34,5,20,2,61
635155272,104,58,17,1,180
635160594,20,3,2,3,28
635161168,44,3,5,1,53
635165371,69,3,2,7,81
635167471,34,26,2,1,63
635176699,19,3,2,3,27
635181260,53,119,2,4,178
635181660,37,10,17,3,67
635184490,108,21,104,15,248
635200237,105,20,76,2,203
635209455,54,17,15,2,88
635220136,78,3,2,1,84
635223110,19,6,2,1,28
635225511,103,34,37,31,205
635234855,40,40,20,5,105
635237628,10,5,2,3,20
635238482,34,55,3,25,117
635245537,54,14,2,19,89
635246869,55,3,2,3,63
635247652,30,18,12,2,62
635248019,70,5,2,3,80
635273753,51,15,9,5,80
635277388,76,32,12,10,130
635286519,123,112,3,1,239
635294985,35,13,2,4,54
635295433,73,48,4,23,148
635327023,43,52,13,3,111
635330996,71,31,104,28,234
635363019,55,14,47,1,117
635373284,168,11,2,4,185
635373463,61,16,24,1,102
635374728,91,8,22,1,122
635377489,101,9,2,24,136
635385753,76,25,2,1,104
635387892,75,3,2,1,81
635402325,187,22,16,5,230
635406359,157,17,4,14,192
635424208,17,3,2,3,25
635424904,125,3,3,1,132
635429835,13,30,2,1,46
635441223,78,12,19,2,111
635442413,64,10,10,21,105
635450183,82,8,2,26,118
635477681,76,62,32,28,198
635489135,102,3,2,1,108
635491909,71,3,2,1,77
635495175,73,17,30,10,130
635499265,20,8,8,8,44
635512847,43,27,2,1,73
635528217,11,3,2,1,17
635533574,24,5,2,14,45
635544251,27,17,3,3,50
635551872,75,3,2,1,81
635555278,79,26,10,21,136
635556251,164,38,4,1,207
635582508,126,15,2,1,144
635596339,10,22,9,1,42
635618038,16,3,2,1,22
635620990,21,6,2,5,34
635623407,135,21,73,9,238
635642001,127,4,27,1,159
635652333,72,6,2,1,81
635662768,35,22,4,1,62
635662922,42,3,2,1,48
635668177,41,3,2,1,47
635671876,120,48,7,6,181
635675991,31,3,2,1,37
635680086,79,6,10,11,106
635688238,26,119,16,1,162
635694905,23,3,2,1,29
635695350,31,34,9,2,76
635700222,40,9,142,1,192
635705565,46,3,2,1,52
635718811,25,3,7,1,36
635720139,135,36,11,5,187
635735246,63,3,2,2,70
635746517,97,12,9,3,121
635748050,48,67,14,4,133
635757202,43,48,2,1,94
635768809,53,18,38,16,125
635771911,51,3,2,1,57
635772319,32,83,47,2,164
635773893,15,5,23,1,44
635779683,96,3,2,1,102
635788837,17,44,34,1,96
635791911,32,61,3,8,104
635794225,212,24,7,3,246
635795896,61,37,19,4,121
635812822,13,9,2,1,25
635820507,43,3,2,4,52
635845765,82,48,54,3,187
635845882,91,17,2,1,111
635848954,14,12,2,1,29
635850298,35,7,6,1,49
635852123,103,13,18,1,135
635860118,28,7,2,7,44
635861552,13,16,2,1,32
635863526,13,3,2,1,19
635880951,82,3,2,1,88
635881317,52,3,2,10,67
635884602,27,42,3,5,77
635896463,47,6,2,1,56
635922655,135,3,2,7,147
635924577,92,47,9,23,171
635940253,171,23,64,8,266
635942337,90,3,2,1,96
635947196,11,3,2,1,17
635963095,14,3,2,1,20
635967737,57,3,2,1,63
636000650,102,6,31,12,151
636007089,37,32,24,12,105
636009792,113,22,33,1,169
636009842,152,3,2,5,162
636011973,183,5,7,2,197
636035789,113,4,3,4,124
636038418,186,12,19,50,267
636051597,36,3,2,1,42
636055710,99,10,2,1,112
636076331,14,30,2,1,47
636091766,113,22,17,54,206
636094959,268,3,2,67,340
636134032,81,15,28,39,163
636148568,45,13,68,1,127
636153148,46,3,2,1,52
636158068,53,4,2,1,60
636159566,75,9,12,1,97
636181291,11,3,2,1,17
636197992,39,3,2,1,45
636207442,23,30,2,1,56
636211702,12,5,2,1,20
636211823,43,21,2,1,67
636238741,71,3,2,1,77
636244187,56,9,5,5,75
636250676,13,32,2,1,48
636267823,27,10,3,2,42
636268020,42,5,2,1,50
636289275,30,3,2,1,36
636290656,68,3,2,5,78
636297227,41,30,2,1,74
636303751,90,3,2,1,96
636304268,15,5,2,3,25
636304434,71,3,2,1,77
636308243,21,7,4,1,33
636327765,93,7,2,2,104
636333981,221,3,2,11,237
636348768,10,5,2,1,18
636361524,54,36,44,15,149
636364773,79,54,39,33,205
636394359,27,3,2,3,35
636428982,85,17,2,1,105
636442325,63,3,2,1,69
636443412,17,21,2,1,41
636445809,99,19,37,11,166
636450008,83,46,34,1,164
636484997,93,12,20,3,128
636486284,138,3,4,1,146
636486698,48,46,17,5,116
636513429,87,24,27,2,140
636518315,21,35,2,26,84
636523007,73,40,2,5,120
636532204,10,8,5,1,24
636536564,259,95,3,4,361
636554279,53,17,7,2,79
636557128,44,3,2,1,50
636562375,106,3,2,4,115
636570385,74,3,2,1,80
636575710,76,9,6,1,92
636591319,204,100,57,33,394
636592770,38,5,5,4,52
636595465,31,42,39,3,115
636611427,56,18,101,1,176
636620684,11,3,2,1,17
636622098,109,3,2,14,128
636624320,13,46,2,1,62
636634285,103,13,16,13,145
636650237,26,39,14,4,83
636652717,14,19,2,1,36
636652944,29,16,2,1,48
636656895,65,3,4,2,74
636664124,46,3,3,1,53
636679979,65,10,6,11,92
636685476,26,12,3,3,44
636685575,31,39,21,12,103
636687841,21,3,2,3,29
636692935,94,5,2,8,109
636697438,83,3,2,15,103
636701584,10,4,2,1,17
636707818,153,86,2,5,246
636720009,54,25,2,9,90
636729973,13,6,2,2,23
636748216,37,29,2,3,71
636751054,91,55,93,14,253
636751560,57,39,20,2,118
636757625,10,3,2,2,17
636758332,131,14,2,1,148
636760256,65,24,19,7,115
636775619,17,31,2,4,54
636782660,170,3,2,1,176
636782997,38,21,48,15,122
636788568,86,22,60,3,171
636795256,14,3,2,1,20
636810406,46,21,2,11,80
636813796,48,20,11,1,80
636820088,45,3,13,1,62
636826202,79,13,71,9,172
636836520,171,3,2,2,178
636851281,51,3,2,1,57
636857090,57,7,2,1,67
636868158,140,51,27,4,222
636881037,141,37,117,6,301
636883935,44,35,5,1,85
636888865,38,44,33,1,116
636890074,25,8,2,2,37
636890972,27,5,40,1,73
636892112,83,13,3,14,113
636893944,56,3,2,1,62
636895933,151,49,2,7,209
636896149,31,3,2,1,37
636898954,23,60,2,1,86
636919129,283,37,7,1,328
636932356,74,3,2,1,80
636935015,272,3,2,1,278
636937846,77,3,2,3,85
636943846,212,76,2,21,311
636948796,13,3,2,1,19
636951138,113,18,2,4,137
636970515,49,3,2,1,55
636979376,24,50,2,1,77
636995425,160,3,2,3,168
637017577,19,14,2,1,36
637027616,73,21,28,7,129
637030381,48,18,17,1,84
637032728,24,39,3,5,71
637035203,93,11,12,1,117
637045025,51,3,2,1,57
637048999,52,8,2,1,63
637063212,30,23,3,1,57
637076705,17,6,3,1,27
637082369,27,3,2,2,34
637104360,78,32,41,13,164
637106411,54,9,2,1,66
637121412,35,45,2,2,84
637122539,107,12,8,8,135
637181827,110,38,19,5,172
637184064,79,44,30,3,156
637197741,35,25,2,18,80
637200689,14,52,17,1,84
637209090,73,20,2,1,96
637213237,123,20,61,9,213
637218653,176,3,2,13,194
637220460,64,39,10,24,137
637234971,65,21,2,1,89
637247548,38,3,2,1,44
637251435,18,3,2,1,24
637253770,31,9,3,1,44
637256000,53,14,9,5,81
637261239,84,9,5,7,105
637267290,15,3,2,2,22
637268451,78,44,11,1,134
637280296,72,8,2,1,83
637281595,51,3,2,1,57
637284326,27,19,3,1,50
637303006,17,5,2,3,27
637320150,46,3,2,1,52
637324807,188,10,12,1,211
637333900,71,56,2,1,130
637362072,15,14,2,5,36
637366081,42,3,2,1,48
637366346,31,45,4,19,99
637376684,40,28,4,2,74
637400381,11,3,2,1,17
637414878,15,3,2,1,21
637416940,67,3,2,4,76
637427411,131,38,2,1,172
637434207,13,3,2,1,19
637449175,21,5,2,1,29
637467130,107,5,2,1,115
637470624,139,3,2,1,145
637487388,34,15,6,1,56
637487461,204,32,48,9,293
637496956,126,37,43,11,217
637500847,208,57,5,3,273
637505341,24,13,2,1,40
637523810,492,55,42,8,597
637530417,131,28,11,5,175
637541796,27,13,7,1,48
637555188,94,31,17,17,159
637566538,109,3,2,8,122
637566961,272,12,2,31,317
637570801,35,44,2,75,156
637575373,86,3,2,4,95
637581725,28,51,2,1,82
637592297,86,3,2,1,92
637593573,46,55,7,6,114
637610722,118,13,4,4,139
637622270,12,3,2,2,19
637624759,68,3,2,1,74
637629661,11,5,2,1,19
637647347,65,14,2,3,84
637658777,88,21,2,12,123
637677496,339,3,2,3,347
637678144,68,4,3,22,97
637699256,32,10,2,4,48
637701420,74,19,2,1,96
637712717,17,20,2,11,50
637717335,72,14,3,25,114
637719258,42,21,2,1,66
637722135,146,3,2,3,154
637728646,20,9,2,2,33
637728870,10,4,2,5,21
637732353,62,41,26,16,145
637734915,95,3,2,6,106
637738167,90,23,12,1,126
637740458,10,10,2,1,23
637761378,30,25,18,1,74
637761743,17,7,2,1,27
637785366,120,4,13,10,147
637787498,30,27,3,11,71
637789584,50,30,20,1,101
637795385,11,3,2,1,17
637797550,19,3,2,1,25
637799401,20,3,3,1,27
637804066,118,3,2,1,124
637820847,24,12,18,1,55
637828684,51,100,55,37,243
637829481,20,3,2,1,26
637832088,47,20,6,1,74
637837625,90,3,2,1,96
637837796,176,73,3,38,290
637844277,83,12,18,25,138
637852048,16,12,2,2,32
637868269,22,5,2,1,30
637889680,40,15,13,7,75
637911302,121,3,2,1,127
637917275,50,3,2,1,56
637918106,47,3,2,1,53
637923192,74,3,2,15,94
637936777,46,5,13,1,65
637937882,108,9,40,42,199
637938963,36,3,2,1,42
637948672,35,63,62,14,174
637949821,10,3,2,2,17
637967841,35,3,2,1,41
637974528,32,3,2,9,46
637994439,26,7,2,1,36
638000986,20,3,2,1,26
638001715,22,27,2,1,52
638025153,51,51,7,34,143
638027202,53,3,2,1,59
638048472,11,3,2,1,17
638049157,52,21,23,1,97
638050557,11,3,2,1,17
638053024,27,9,5,3,44
638060858,92,4,2,3,101
638074565,35,3,2,1,41
638083073,108,12,2,7,129
638084968,124,3,2,5,134
638087587,197,3,2,16,218
638094343,52,3,2,1,58
638117182,13,7,2,5,27
638120446,50,16,3,2,71
638137389,148,24,4,38,214
638147066,68,26,3,9,106
638147255,69,24,13,4,110
638152757,135,3,2,5,145
638179470,108,33,57,2,200
638181705,67,15,6,2,90
638188157,43,11,2,1,57
638198357,13,13,14,1,41
638217973,14,3,2,1,20
638218186,99,3,2,2,106
638219015,16,39,2,1,58
638232234,147,45,14,4,210
638239313,84,14,94,5,197
638241310,53,3,2,1,59
638243235,101,3,2,3,109
638249629,14,5,2,1,22
638259043,87,24,2,6,119
638265837,150,20,33,1,204
638277519,39,53,12,33,137
638278484,55,33,2,6,96
638292003,11,3,2,1,17
638321902,104,3,2,1,110
638323699,59,63,23,84,229
638329428,60,44,84,15,203
638336708,130,3,2,3,138
638342542,110,3,2,1,116
638361224,10,3,2,2,17
638367201,58,3,2,1,64
638374262,43,3,2,1,49
638383206,17,3,2,1,23
638394103,31,9,15,3,58
638400557,47,26,25,1,99
638400904,15,7,2,7,31
638407169,15,7,2,12,36
638420892,112,46,26,2,186
638434814,46,41,2,12,101
638468433,144,16,2,1,163
638491403,43,11,6,7,67
638498261,119,3,2,1,125
638502856,48,12,2,1,63
638513360,26,14,5,1,46
638515859,32,20,2,3,57
638533589,25,9,6,2,42
638538255,75,60,3,1,139
638551174,153,3,2,1,159
638558955,25,42,3,3,73
638564185,19,3,2,7,31
638578322,36,14,2,1,53
638582622,60,25,2,1,88
638587690,90,57,12,3,162
638590867,12,3,2,2,19
638596571,93,31,88,7,219
638601898,11,3,2,1,17
638621011,14,3,2,1,20
638627645,11,3,2,1,17
638631933,36,33,23,2,94
638642997,20,3,2,2,27
638643643,141,86,69,24,320
638651890,192,6,4,1,203
638665191,211,3,2,8,224
638728908,42,3,2,1,48
638744032,249,3,2,7,261
638746207,48,14,2,2,66
638751751,38,13,4,7,62
638759885,20,4,5,1,30
638762096,26,3,2,9,40
638769198,35,3,2,1,41
638790406,101,10,2,1,114
638797043,69,3,2,2,76
638797095,38,7,4,9,58
638805520,73,3,2,1,79
638806412,44,37,19,1,101
638811115,137,3,2,3,145
638818572,114,27,2,2,145
638818617,45,28,10,13,96
638823856,152,3,25,1,181
638829547,45,18,2,2,67
638830580,70,21,2,6,99
638835322,13,8,2,1,24
638842840,21,3,2,1,27
638848129,50,8,2,5,65
638854668,98,3,2,2,105
638860010,16,3,2,1,22
638875864,55,69,21,15,160
638876048,27,24,2,2,55
638886812,22,49,25,2,98
638887613,43,9,2,9,63
638898136,50,12,2,1,65
638907533,10,8,2,8,28
638912595,47,31,38,2,118
638913345,13,3,2,1,19
638921819,14,15,2,1,32
638924301,10,4,2,1,17
638928912,62,19,2,1,84
638934212,129,3,2,1,135
638939163,26,19,2,1,48
638939761,89,34,24,74,221
638945754,10,25,2,14,51
638950470,60,42,2,4,108
638951773,47,3,2,2,54
638961124,38,18,2,1,59
638964448,175,34,7,50,266
638966232,63,78,24,26,191
638978250,133,4,2,2,141
638987939,102,14,31,3,150
639000946,11,3,2,1,17
639007688,39,17,42,5,103
639013112,17,3,2,1,23
639017618,30,103,3,2,138
639018786,75,3,2,9,89
639019110,44,50,4,41,139
639026463,18,6,2,1,27
639036697,18,27,98,1,144
639039302,120,57,117,14,308
639046158,395,42,3,6,446
639051396,87,28,6,13,134
639058865,20,43,29,1,93
639065416,109,80,16,46,251
639097212,17,45,2,15,79
639114364,12,19,3,1,35
639135813,125,23,17,7,172
639137743,77,45,14,9,145
639140101,10,3,2,4,19
639145150,17,3,2,1,23
639145424,151,5,2,1,159
639146618,134,33,3,6,176
639161499,60,4,2,2,68
639188445,20,24,17,3,64
639191813,111,3,2,1,117
639207645,24,14,6,30,74
639233839,11,25,6,3,45
639235407,62,41,2,6,111
639242172,133,3,2,11,149
639242308,11,3,2,1,17
639243494,129,28,6,3,166
639250242,206,104,9,18,337
639251976,73,18,2,1,94
639256156,16,13,2,1,32
639258090,87,3,2,10,102
639263560,58,24,2,4,88
639270588,72,3,2,1,78
639273195,42,13,2,2,59
639273437,80,18,6,1,105
639280002,103,3,2,2,110
639280005,10,3,2,3,18
639304909,11,3,2,1,17
639313303,135,6,20,1,162
639318546,88,3,2,9,102
639327388,153,42,74,7,276
639327525,37,3,2,8,50
639329010,27,3,2,1,33
639334824,164,28,38,78,308
639335022,189,3,2,1,195
639337559,17,6,2,3,28
639350837,50,16,4,20,90
639356972,13,3,2,1,19
639369168,11,3,2,1,17
639377523,25,34,24,9,92
639383684,100,7,69,7,183
639386245,186,11,6,3,206
639391900,59,37,2,15,113
639392208,15,3,2,1,21
639404346,110,48,107,6,271
639409846,79,3,2,2,86
639420623,82,3,2,2,89
639430723,19,23,2,1,45
639433693,10,13,2,1,26
639446116,116,12,3,7,138
639454149,49,16,39,2,106
639457937,25,3,2,1,31
639462468,105,39,21,7,172
639469770,33,7,2,2,44
639478184,89,25,2,5,121
639488785,43,6,2,6,57
639497831,131,3,2,1,137
639520188,10,14,5,1,30
639532603,11,3,2,1,17
639535235,54,19,6,10,89
639573612,19,44,2,1,66
639584204,94,32,2,26,154
639589097,27,18,13,1,59
639609718,460,27,2,3,492
639609789,11,3,2,1,17
639612067,28,3,2,1,34
639617472,55,38,2,1,96
639630887,13,4,2,2,21
639631112,125,13,17,7,162
639635615,44,58,2,4,108
639653782,133,27,45,3,208
639660145,74,27,27,1,129
639662157,84,26,17,8,135
639667091,36,24,2,1,63
639668974,18,15,2,1,36
639676989,40,6,2,1,49
639681475,141,19,2,1,163
639691657,60,20,2,2,84
639691682,144,45,2,2,193
639693232,56,72,73,23,224
639709747,45,35,2,3,85
639727987,13,16,10,1,40
639743447,87,72,53,12,224
639755633,11,3,2,1,17
639767237,69,9,4,1,83
639770610,162,19,2,1,184
639779054,21,3,2,1,27
639782112,99,5,59,1,164
639792277,14,7,2,1,24
639816826,40,12,25,3,80
639838175,48,12,6,9,75
639841918,42,3,2,1,48
639849011,12,3,2,1,18
639849915,52,3,2,4,61
639870400,51,37,7,2,97
639873505,45,27,67,13,152
639874229,38,3,2,1,44
639880072,139,3,2,33,177
639884197,75,3,2,4,84
639894838,43,31,8,15,97
639898555,85,3,20,2,110
639898963,168,92,45,49,354
639905891,102,8,6,7,123
639919654,10,4,2,1,17
639932493,49,46,65,4,164
639940563,75,44,87,3,209
639952049,74,3,2,4,83
639954917,10,15,4,5,34
639956124,70,29,44,11,154
639964508,61,36,3,3,103
639966870,78,15,84,7,184
639974966,13,21,2,1,37
640003956,17,3,2,1,23
640010721,22,21,2,1,46
640038755,105,4,112,9,230
640082565,58,77,9,2,146
640087024,30,4,2,1,37
640087746,60,3,2,9,74
640098713,521,3,2,9,535
640113342,10,6,2,1,19
640116107,35,64,8,3,110
640118843,69,3,2,1,75
640125685,58,30,21,5,114
640130680,48,65,2,1,116
640137483,100,77,7,52,236
640138797,130,5,5,1,141
640156491,19,3,2,6,30
640159498,24,5,2,1,32
640175538,24,3,2,1,30
640177128,85,13,2,3,103
640182208,13,3,2,1,19
640186888,14,18,2,1,35
640201536,159,60,20,38,277
640205008,19,5,2,1,27
640207578,65,13,2,2,82
640208898,34,34,2,1,71
640215297,176,19,2,6,203
640218904,49,21,28,3,101
640235659,11,57,11,2,81
640236984,117,3,2,1,123
640239566,12,3,2,5,22
640262613,151,64,4,13,232
640263847,80,13,2,10,105
640266499,42,3,2,1,48
640267836,86,23,2,5,116
640274509,49,32,2,1,84
640285218,181,26,2,23,232
640287255,171,39,13,50,273
640288354,47,147,11,1,206
640288988,126,9,2,7,144
640290643,57,3,2,8,70
640310392,58,6,14,11,89
640314827,20,3,2,1,26
640322306,13,3,2,3,21
640327074,74,3,2,2,81
640333775,22,3,2,1,28
640337161,58,33,23,11,125
640342271,24,150,68,3,245
640357003,100,19,32,6,157
640361045,90,3,2,5,100
640366833,68,20,29,8,125
640387506,69,24,2,1,96
640390761,104,7,8,6,125
640398619,28,55,2,1,86
640410246,241,32,2,61,336
640416304,11,3,2,1,17
640425685,76,3,2,6,87
640433565,14,3,2,1,20
640434253,16,7,2,1,26
640437440,115,17,16,12,160
640445506,96,3,2,7,108
640463925,15,34,4,1,54
640494564,530,3,2,20,555
640494615,64,52,3,13,132
640502885,268,3,2,5,278
640504206,79,20,3,1,103
640513642,12,10,2,1,25
640543250,95,39,2,3,139
640543983,12,3,2,1,18
640551602,14,25,2,1,42
640552239,12,3,2,1,18
640555959,10,7,2,1,20
640567636,37,80,2,1,120
640582804,90,8,4,17,119
640592506,132,13,6,1,152
640616125,27,67,2,1,97
640617201,18,25,2,1,46
640632538,30,21,9,1,61
640669695,70,10,13,5,98
640680657,11,7,2,1,21
640695364,54,3,2,1,60
640705936,24,47,7,5,83
640706828,82,3,2,15,102
640707454,130,3,2,2,137
640725639,127,43,64,10,244
640727506,207,3,2,27,239
640762398,85,22,77,3,187
640762980,23,3,2,2,30
640777591,15,10,2,1,28
640786586,25,34,14,20,93
640806561,14,4,2,1,21
640806741,86,43,26,6,161
640813130,26,38,5,4,73
640825223,107,54,27,31,219
640830424,57,17,2,4,80
640852503,172,43,37,3,255
640858251,12,3,2,1,18
640909665,53,78,13,23,167
640913214,17,22,2,1,42
640917378,36,15,4,1,56
640932143,58,18,2,1,79
640943278,32,22,10,1,65
640949404,186,40,11,4,241
640997518,11,3,2,1,17
641004173,11,3,2,1,17
641005262,129,25,2,5,161
641007473,28,9,2,1,40
641010501,134,48,52,4,238
641016156,13,3,2,1,19
641027758,34,36,4,2,76
641028490,85,3,2,2,92
641028994,12,3,2,1,18
641031751,192,36,11,14,253
641031931,74,3,2,1,80
641041633,10,3,2,2,17
641059738,16,36,4,1,57
641063228,76,27,33,23,159
641063582,15,24,3,8,50
641077579,13,16,2,1,32
641079960,196,15,31,12,254
641082424,67,13,39,1,120
641084429,117,84,84,40,325
641087202,98,19,11,2,130
641094392,11,3,2,1,17
641095036,13,3,2,1,19
641097219,53,78,15,2,148
641105754,10,11,2,1,24
641117088,98,8,3,16,125
641119889,88,10,17,2,117
641123079,16,3,2,3,24
641127297,52,8,2,1,63
641152588,19,3,2,8,32
641159146,124,3,2,3,132
641167668,124,3,2,12,141
641172646,19,5,2,4,30
641199419,84,36,3,38,161
641205758,10,3,2,3,18
641228215,31,25,17,1,74
641231724,96,19,2,1,118
641235718,15,3,2,1,21
641243686,144,25,3,3,175
641249410,15,3,2,1,21
641265316,85,3,2,1,91
641265997,13,3,2,5,23
641270601,11,5,4,3,23
641301991,15,3,2,1,21
641310471,52,3,2,1,58
641315015,10,10,2,2,24
641321511,32,38,4,2,76
641332449,34,8,2,1,45
641335225,170,3,2,1,176
641350876,22,10,2,6,40
641365997,54,25,2,1,82
641388030,49,23,2,18,92
641393661,28,46,5,3,82
641405285,41,81,20,1,143
641414482,29,4,3,15,51
641418450,67,23,2,1,93
641419026,22,37,14,1,74
641426826,11,3,2,1,17
641430527,33,3,8,7,51
641431626,11,8,2,2,23
641434056,17,3,2,1,23
641440547,51,3,2,1,57
641442588,12,5,2,1,20
641455687,54,24,2,3,83
641456457,51,9,2,2,64
641472825,57,14,23,16,110
641494571,17,18,2,1,38
641505554,36,3,2,1,42
641507972,125,18,2,2,147
641512783,21,3,2,2,28
641512811,34,6,11,1,52
641520942,72,3,15,2,92
641529479,58,28,64,7,157
641538292,12,3,2,1,18
641542016,62,22,10,5,99
641561435,10,14,2,1,27
641565904,110,34,44,1,189
641571527,60,3,2,1,66
641589174,11,21,2,1,35
641605963,30,8,2,18,58
641606362,27,38,21,6,92
641622769,131,45,47,4,227
641631456,90,110,70,16,286
641634374,123,42,9,21,195
641638252,40,7,2,1,50
641650767,77,3,2,1,83
641655525,53,19,6,2,80
641663721,162,59,2,9,232
641667663,82,3,2,1,88
641674080,69,32,40,8,149
641674680,124,9,2,2,137
641677722,10,11,2,1,24
641681745,50,3,2,15,70
641683199,24,14,7,6,51
641689411,55,21,33,32,141
641691594,16,3,2,1,22
641697628,47,37,2,1,87
641703336,152,35,4,1,192
641708127,47,10,4,9,70
641721882,109,23,3,1,136
641728129,10,8,2,1,21
641732430,26,3,2,1,32
641739989,19,21,2,1,43
641745556,12,5,2,1,20
641758186,22,48,31,9,110
641766254,53,4,72,8,137
641768058,128,27,14,1,170
641773898,86,14,7,11,118
641777179,64,7,33,1,105
641782510,31,82,17,1,131
641786679,277,13,29,1,320
641832561,61,33,58,1,153
641832859,47,3,2,1,53
641833479,38,18,2,1,59
641864067,22,3,2,1,28
641865022,102,17,6,21,146
641872860,67,37,19,9,132
641884957,12,3,2,2,19
641902510,37,22,43,20,122
641903234,10,3,2,2,17
641908093,96,19,60,1,176
641909022,79,61,56,20,216
641914273,84,3,2,15,104
641928675,11,3,2,1,17
641947944,38,3,2,2,45
641956257,31,26,5,9,71
641960950,69,3,2,1,75
641961974,67,3,2,1,73
641962983,38,3,2,1,44
641972682,16,7,2,3,28
641973138,11,3,2,1,17
641979358,29,28,2,17,76
641984468,27,3,2,4,36
642008976,89,3,2,1,95
642014975,36,3,2,7,48
642029126,37,23,3,10,73
642032064,95,3,61,28,187
642032988,77,14,2,1,94
642037182,60,21,2,2,85
642058058,10,4,2,1,17
642070846,12,3,2,7,24
642081629,47,22,26,1,96
642082024,13,11,2,1,27
642121458,46,39,2,1,88
642138373,25,47,31,1,104
642154426,26,11,2,3,42
642184311,118,66,44,1,229
642194710,11,17,2,1,31
642205537,33,21,4,3,61
642217377,13,4,2,1,20
642221851,87,12,2,1,102
642225060,30,4,3,8,45
642227937,27,40,2,1,70
642229914,44,3,2,2,51
642234886,82,26,57,3,168
642245290,139,15,13,8,175
642260697,14,8,2,2,26
642280650,15,62,14,5,96
642287319,49,35,12,2,98
642289149,56,3,2,2,63
642301467,19,3,2,1,25
642301733,132,3,2,2,139
642304984,41,3,2,1,47
642312547,23,37,20,11,91
642329268,35,3,2,1,41
642333690,17,3,2,8,30
642335041,11,6,2,2,21
642339501,32,65,26,3,126
642344242,72,15,14,2,103
642349910,91,7,4,9,111
642352554,38,9,6,5,58
642359988,48,35,37,2,122
642368955,40,3,2,1,46
642377396,49,18,6,1,74
642403352,47,30,4,9,90
642403689,106,11,3,13,133
642417093,12,3,2,1,18
642420250,70,3,2,1,76
642427999,91,31,2,4,128
642434582,11,3,2,1,17
642441779,36,24,3,1,64
642447155,78,16,27,34,155
642448746,82,31,20,3,136
642462796,68,17,34,2,121
642466685,31,38,2,1,72
642470778,48,3,2,1,54
642498405,62,31,10,18,121
642498843,38,13,4,1,56
642501933,17,4,2,1,24
642518346,41,15,8,5,69
642533936,34,17,3,1,55
642548937,40,10,2,1,53
642566942,12,9,2,1,24
642571370,18,14,2,24,58
642571876,39,3,2,3,47
642572415,56,3,2,1,62
642575042,55,28,4,26,113
642577427,174,3,12,1,190
642583282,24,3,2,1,30
642600935,16,5,2,1,24
642614310,19,3,2,1,25
642627621,16,3,2,1,22
642636074,44,59,11,2,116
642650995,31,3,2,2,38
642673279,57,4,2,8,71
642686772,17,6,3,1,27
642700632,227,3,2,6,238
642704810,11,3,2,1,17
642708309,69,9,2,1,81
642715969,81,52,2,4,139
642717543,51,12,2,1,66
642718715,28,3,2,1,34
642727707,124,3,2,4,133
642736804,53,18,14,3,88
642748834,90,25,5,7,127
642780035,148,66,15,8,237
642783344,16,3,2,1,22
642804144,52,5,17,18,92
642806573,30,45,2,4,81
642806616,13,9,2,1,25
642806708,25,3,2,1,31
642825214,75,21,57,23,176
642832705,89,59,2,2,152
642849740,71,7,20,1,99
642851486,11,3,2,2,18
642857869,42,18,3,11,74
642862072,34,3,2,1,40
642880309,16,3,2,1,22
642885038,22,18,3,8,51
642891794,91,3,2,23,119
642902752,16,3,2,1,22
642911183,29,3,2,1,35
642927074,17,3,2,1,23
642932148,47,30,2,3,82
642936253,51,44,7,2,104
642939543,13,3,2,5,23
642959535,116,3,2,24,145
642964734,22,13,2,2,39
642968495,99,29,101,2,231
642970315,19,28,2,1,50
642971658,27,3,2,2,34
642981104,27,12,2,1,42
642983566,73,30,2,2,107
642998472,14,17,2,2,35
643000395,80,3,2,1,86
643002828,19,20,28,1,68
643003986,20,56,51,1,128
643004163,171,38,8,5,222
643007511,74,43,48,4,169
643007986,136,3,2,2,143
643008363,156,22,2,23,203
643012931,14,10,2,1,27
643019030,10,4,2,3,19
643024581,102,28,2,5,137
643036768,95,3,2,19,119
643037952,16,3,2,1,22
643040679,23,3,3,2,31
643046345,93,3,2,1,99
643046640,36,26,4,2,68
643052734,26,3,2,1,32
643068118,62,3,2,1,68
643076061,31,33,5,2,71
643080497,39,18,4,3,64
643095004,14,25,18,9,66
643096719,22,10,5,6,43
643098426,32,18,6,3,59
643103360,34,3,2,4,43
643104513,54,22,2,2,80
643104949,61,34,34,13,142
643107593,88,3,2,2,95
643110794,19,22,4,1,46
643111042,61,13,58,5,137
643115674,63,3,2,2,70
643122958,13,8,2,1,24
643134172,83,6,21,1,111
643134822,24,22,4,17,67
643135839,14,3,2,1,20
643162899,123,3,2,22,150
643181338,110,15,2,5,132
643187155,11,3,2,1,17
643187172,38,30,30,2,100
643206437,45,68,7,3,123
643241936,38,3,2,1,44
643246521,14,16,8,1,39
643257827,22,15,4,3,44
643266547,174,3,9,5,191
643275492,55,10,60,3,128
643279406,180,3,2,5,190
643281439,82,53,94,25,254
643295389,17,20,2,1,40
643299131,50,40,72,31,193
643300953,78,3,2,1,84
643329635,238,3,2,5,248
643330446,18,33,5,6,62
643348231,61,14,5,2,82
643369450,126,23,84,9,242
643369512,46,12,18,1,77
643382794,120,19,74,9,222
643392744,22,30,6,3,61
643399466,204,14,2,1,221
643410389,51,12,2,1,66
643427742,37,73,11,43,164
643439811,37,3,2,10,52
643447361,85,4,2,5,96
643450754,66,17,3,2,88
643451778,162,38,11,18,229
643455092,23,11,3,2,39
643455483,65,3,2,1,71
643458153,108,3,2,4,117
643471477,34,14,2,1,51
643476214,156,7,2,28,193
643477247,12,3,2,1,18
643480847,63,30,24,2,119
643482957,139,92,2,28,261
643496166,90,19,13,10,132
643498949,97,31,29,5,162
643535825,14,9,2,1,26
643543239,623,3,2,2,630
643548316,198,3,2,7,210
643549397,17,14,3,3,37
643553692,120,3,2,1,126
643566533,16,3,2,1,22
643589001,10,7,2,3,22
643593391,20,3,2,1,26
643618535,24,3,2,1,30
643637486,64,14,14,6,98
643641400,108,30,8,8,154
643642437,47,42,34,18,141
643648112,75,34,2,2,113
643658758,26,128,12,1,167
643685695,12,3,2,1,18
643692859,50,36,64,8,158
643697440,47,68,2,1,118
643704802,50,3,2,1,56
643706727,81,17,30,1,129
643709767,35,23,27,46,131
643711072,107,3,2,1,113
643721421,161,3,2,7,173
643731130,31,8,2,40,81
643742816,136,3,2,1,142
643749845,19,18,2,1,40
643758046,29,39,32,13,113
643771232,49,3,2,3,57
643779683,24,17,2,18,61
643779950,41,12,2,3,58
643783823,59,3,2,1,65
643791170,48,30,45,4,127
643796668,75,23,18,34,150
643798857,30,22,46,2,100
643823845,23,78,2,2,105
643825169,41,3,2,1,47
643830703,78,3,2,3,86
643846845,23,12,3,1,39
643849418,106,28,23,6,163
643858520,18,3,2,1,24
643873066,16,5,3,1,25
643874282,15,3,2,1,21
643882801,12,15,2,1,30
643888874,46,49,26,14,135
643889534,34,28,2,1,65
643890078,121,6,2,1,130
643895342,10,12,6,1,29
643896959,42,3,2,1,48
643913158,89,15,3,15,122
643939526,28,8,2,1,39
643958264,37,3,2,3,45
643959442,41,43,4,11,99
643962056,36,49,42,4,131
643970005,101,3,2,1,107
643970943,31,16,3,2,52
643989287,78,3,2,1,84
643990793,52,3,2,4,61
644000484,86,3,2,1,92
644000704,160,46,41,4,251
644021697,12,3,2,4,21
644024770,13,14,2,5,34
644026344,12,16,2,1,31
644036147,128,3,7,3,141
644037808,14,10,2,1,27
644044055,110,21,16,6,153
644051630,17,3,2,2,24
644052681,39,47,49,1,136
644066438,52,19,3,2,76
644070087,24,3,2,1,30
644092715,16,5,2,1,24
644096074,19,3,2,1,25
644107079,164,18,15,1,198
644124450,30,50,33,13,126
644124849,10,14,2,2,28
644130152,104,41,5,7,157
644130273,40,3,2,1,46
644141743,127,7,2,4,140
644142667,51,33,24,13,121
644148595,285,3,2,1,291
644164705,15,3,2,1,21
644166501,50,54,85,4,193
644167353,190,65,73,1,329
644176596,56,3,2,2,63
644189435,30,30,33,33,126
644200411,46,3,2,5,56
644200938,12,3,2,6,23
644205740,45,26,2,4,77
644223781,61,4,78,8,151
644263629,159,3,4,18,184
644279729,382,3,2,3,390
644282783,106,14,48,1,169
644294916,29,3,2,1,35
644297587,59,20,14,19,112
644310519,22,33,34,13,102
644316251,205,3,2,1,211
644327051,66,16,2,7,91
644337267,75,24,2,2,103
644340462,52,3,2,2,59
644347219,22,3,2,9,36
644378990,58,77,45,42,222
644389477,48,32,39,13,132
644393358,52,49,8,1,110
644407846,56,6,30,11,103
644412360,65,35,3,5,108
644414505,40,3,2,3,48
644421028,26,11,2,3,42
644421089,25,25,2,18,70
644426842,140,27,2,11,180
644430516,61,3,2,3,69
644437595,12,10,2,2,26
644439139,19,31,2,1,53
644447779,73,3,2,1,79
644469405,47,68,27,15,157
644475398,16,3,2,2,23
644480682,44,19,4,1,68
644484593,57,37,2,3,99
644505493,73,13,45,2,133
644514708,238,94,2,24,358
644518256,95,3,2,5,105
644520195,73,18,14,1,106
644534500,53,44,34,1,132
644559191,14,8,2,19,43
644586601,72,39,37,5,153
644593297,119,3,2,3,127
644596299,68,3,2,3,76
644619375,26,3,2,1,32
644619457,80,26,187,1,294
644619786,70,3,2,11,86
644630130,101,19,2,2,124
644651321,137,55,178,32,402
644654916,48,23,88,3,162
644658357,44,9,10,8,71
644666122,79,23,44,10,156
644668569,11,3,3,1,18
644681961,82,16,7,1,106
644684100,98,164,92,2,356
644691625,99,47,25,6,177
644703552,55,28,157,4,244
644703889,71,11,2,7,91
644705274,30,3,2,1,36
644710340,30,3,2,2,37
644729409,62,10,52,17,141
644740956,19,3,2,5,29
644743829,11,17,4,1,33
644744490,28,7,3,1,39
644755922,97,13,86,7,203
644759304,19,3,2,3,27
644768903,59,25,2,1,87
644781969,51,65,2,2,120
644783325,34,24,5,14,77
644796571,112,56,22,3,193
644816912,30,3,2,1,36
644825696,61,12,40,5,118
644829957,39,13,2,1,55
644831714,122,91,24,11,248
644835914,61,37,8,4,110
644840421,42,5,3,5,55
644840762,145,58,30,47,280
644857805,47,73,9,11,140
644890657,37,18,3,1,59
644903373,132,37,2,1,172
644934359,30,9,2,1,42
644948873,61,21,10,19,111
644949773,71,28,2,1,102
644955430,77,15,2,1,95
644956624,44,32,2,4,82
644978946,62,21,25,6,114
644981278,17,12,2,1,32
645007493,101,39,9,9,158
645011592,50,79,2,1,132
645011871,13,3,2,1,19
645013216,76,3,2,3,84
645023160,30,18,36,1,85
645059509,115,9,2,1,127
645068544,106,13,53,42,214
645082815,10,14,2,1,27
645096909,50,3,2,1,56
645105828,45,17,66,19,147
645106238,21,5,2,1,29
645111150,96,13,15,3,127
645122767,18,18,2,1,39
645123330,44,3,2,2,51
645132318,49,12,5,9,75
645139160,29,7,2,1,39
645142676,106,20,35,2,163
645146231,80,9,41,11,141
645147077,106,9,53,28,196
645151367,93,45,24,20,182
645174479,65,39,45,73,222
645174553,244,6,4,24,278
645193552,17,3,2,1,23
645209045,15,41,8,11,75
645214730,46,18,2,8,74
645218830,42,12,15,2,71
645223026,28,3,2,1,34
645235283,10,3,2,2,17
645242226,50,3,2,3,58
645242771,69,3,2,2,76
645253084,55,69,101,8,233
645284105,44,51,12,16,123
645293805,98,3,2,15,118
645296088,172,3,2,10,187
645297701,59,6,23,2,90
645311081,89,24,3,7,123
645316486,337,93,10,17,457
645328181,34,27,4,4,69
645331845,106,66,77,2,251
645350951,80,3,3,6,92
645361519,77,3,2,3,85
645373057,93,71,57,21,242
645384011,96,50,38,10,194
645393533,32,9,2,1,44
645405774,196,5,2,3,206
645411892,40,5,12,5,62
645418651,66,16,148,9,239
645419690,185,38,91,15,329
645424440,12,11,2,1,26
645427256,73,26,2,1,102
645447789,28,5,24,1,58
645449536,36,3,2,3,44
645474925,84,3,2,2,91
645475217,49,38,7,7,101
645477611,173,52,28,7,260
645499232,17,3,2,2,24
645515301,16,3,2,2,23
645536781,107,3,2,2,114
645544649,91,29,2,2,124
645545746,84,14,2,17,117
645558464,38,3,11,6,58
645563661,12,3,2,1,18
645564106,44,37,23,14,118
645572957,26,6,2,1,35
645580518,42,56,9,11,118
645586747,18,16,3,1,38
645605033,29,3,2,2,36
645633451,21,38,27,3,89
645636808,15,3,2,1,21
645646854,91,26,2,16,135
645655473,13,21,2,2,38
645656604,79,3,2,3,87
645663672,126,3,2,4,135
645664182,164,22,2,3,191
645680334,10,4,2,1,17
645698652,59,32,18,93,202
645702976,89,23,2,1,115
645706974,14,3,2,1,20
645722519,75,3,2,1,81
645727108,26,5,2,1,34
645732641,47,21,7,4,79
645742890,29,53,28,13,123
645748607,13,3,2,1,19
645753449,65,38,3,24,130
645755801,60,17,14,14,105
645771280,105,62,67,25,259
645773134,124,25,2,8,159
645776159,47,3,2,2,54
645778990,29,3,2,1,35
645786844,59,20,5,4,88
645791965,118,16,34,3,171
645794972,177,39,88,16,320
645797464,51,53,62,1,167
645798299,44,13,16,4,77
645798884,28,7,6,5,46
645801105,10,3,2,2,17
645804100,60,8,3,1,72
645832817,13,14,2,20,49
645840067,496,53,30,22,601
645840942,91,11,2,2,106
645841049,17,22,4,1,44
645850087,130,103,26,1,260
645851671,36,11,2,1,50
645857176,12,3,2,9,26
645882671,20,55,10,1,86
645887536,103,30,21,2,156
645892224,80,44,17,7,148
645901325,46,45,4,1,96
645902658,145,56,53,1,255
645921795,36,3,2,1,42
645924054,105,3,14,1,123
645953694,14,30,2,1,47
645959387,38,7,21,1,67
645968365,63,3,2,3,71
645993265,79,21,2,1,103
646017225,14,5,2,2,23
646020027,29,31,2,1,63
646027704,20,14,2,6,42
646035895,84,22,5,3,114
646036294,10,10,3,6,29
646039485,36,47,21,3,107
646082449,158,3,2,2,165
646083523,55,3,2,6,66
646117198,84,3,2,1,90
646117413,18,54,3,10,85
646137781,34,18,2,1,55
646182032,70,34,16,1,121
646190599,52,16,2,1,71
646196192,127,52,45,11,235
646197371,42,16,11,3,72
646208630,23,3,2,1,29
646211759,52,3,2,1,58
646227406,31,6,12,8,57
646227477,14,3,2,1,20
646229272,58,21,119,29,227
646229300,76,48,4,3,131
646236690,188,4,2,2,196
646237522,49,39,2,9,99
646238318,94,23,26,16,159
646251826,26,3,2,1,32
646262674,45,3,2,1,51
646265750,83,3,2,3,91
646266377,11,3,2,1,17
646276506,33,45,2,11,91
646282319,63,37,11,1,112
646294885,214,3,2,158,377
646296908,130,14,31,26,201
646312927,97,13,44,4,158
646318250,67,15,58,7,147
646318832,74,27,45,13,159
646333837,11,6,8,5,30
646335656,33,3,2,1,39
646347410,89,5,2,12,108
646352381,46,39,2,2,89
646358535,88,3,2,1,94
646361121,53,5,3,7,68
646370699,29,62,2,24,117
646371748,83,29,30,7,149
646382169,30,17,20,1,68
646400545,107,3,2,1,113
646402991,73,55,49,16,193
646417212,39,21,9,20,89
646420937,71,40,5,15,131
646423137,53,29,2,8,92
646431137,119,26,5,13,163
646431998,77,3,2,2,84
646438657,12,3,2,1,18
646440645,13,9,26,7,55
646443850,39,4,2,1,46
646482019,140,27,3,7,177
646483564,40,29,26,1,96
646485057,66,14,2,1,83
646488237,58,37,21,18,134
646489393,16,12,2,2,32
646489738,137,38,31,3,209
646496522,159,54,3,5,221
646503195,14,27,2,1,44
646511723,68,43,3,1,115
646522849,24,3,2,3,32
646525418,36,3,2,1,42
646544633,12,3,2,1,18
646550345,38,3,2,7,50
646557704,138,38,2,26,204
646561461,45,13,3,5,66
646570160,112,3,2,8,125
646571783,60,89,4,11,164
646574418,17,15,11,1,44
646597972,119,25,76,17,237
646598514,14,54,18,10,96
646600564,72,17,19,5,113
646602892,313,87,2,8,410
646613025,74,48,54,28,204
646629194,40,21,2,1,64
646647350,45,16,9,1,71
646650286,16,17,6,9,48
646662537,109,27,45,1,182
646662599,34,20,2,4,60
646667010,81,9,2,1,93
646667313,68,3,2,1,74
646668795,25,12,4,8,49
646700506,18,3,2,1,24
646701176,73,3,2,9,87
646719281,76,3,2,1,82
646726381,89,9,5,1,104
646730057,17,24,2,1,44
646737630,44,19,5,1,69
646742204,59,27,37,10,133
646750290,98,12,71,1,182
646762258,10,8,2,15,35
646770388,122,30,15,7,174
646781983,116,29,5,1,151
646794428,98,28,125,54,305
646795786,29,55,12,3,99
646799892,60,30,2,1,93
646801987,216,29,2,1,248
646807715,10,10,4,2,26
646808565,49,35,7,13,104
646810898,21,23,2,1,47
646812085,80,8,18,10,116
646823051,49,21,9,1,80
646828360,71,19,62,21,173
646843897,10,3,2,3,18
646860166,67,9,2,60,138
646865223,155,27,8,1,191
646867224,15,9,2,1,27
646867656,28,26,9,1,64
646877349,27,56,36,1,120
646880204,142,45,2,5,194
646887047,24,19,8,1,52
646891893,76,3,2,1,82
646892443,53,67,7,4,131
646893965,59,22,7,1,89
646895417,168,12,29,1,210
646901975,24,40,4,2,70
646905584,59,28,16,15,118
646911335,47,3,2,1,53
646916626,57,29,2,1,89
646919264,25,3,2,1,31
646920704,23,3,2,9,37
646924020,71,25,2,131,229
646925499,17,11,2,3,33
646930142,73,3,2,12,90
646944449,59,3,2,3,67
646951068,31,49,112,47,239
646956099,52,3,2,1,58
646968835,70,3,2,1,76
646968894,50,49,2,1,102
646984182,69,3,2,1,75
647022759,107,3,2,15,127
647046678,187,3,2,1,193
647069742,10,3,2,2,17
647071780,12,3,2,1,18
647075215,12,3,2,1,18
647087465,17,6,2,1,26
647094917,58,17,8,12,95
647123800,27,5,3,1,36
647129683,93,31,22,8,154
647133240,11,3,2,4,20
647134275,128,7,2,5,142
647157003,101,9,2,1,113
647171533,63,3,2,2,70
647181614,68,3,2,16,89
647192867,126,28,18,2,174
647202445,28,44,32,1,105
647202678,185,5,2,15,207
647225978,142,3,2,8,155
647238524,61,43,7,7,118
647243244,247,3,2,1,253
647245963,17,7,2,9,35
647249495,71,27,23,1,122
647264138,16,9,2,1,28
647276193,104,20,75,1,200
647279281,18,3,2,1,24
647284351,30,3,2,1,36
647288799,93,8,2,1,104
647289455,10,15,2,1,28
647291383,184,3,2,5,194
647305744,10,17,2,1,30
647306328,23,55,2,5,85
647311560,129,54,10,55,248
647322633,78,7,11,19,115
647330126,10,20,3,6,39
647336314,21,3,2,1,27
647341272,168,3,2,3,176
647351983,13,6,2,2,23
647362048,50,39,6,38,133
647362788,11,9,2,2,24
647369962,23,9,2,1,35
647389960,77,18,12,42,149
647399852,26,6,2,1,35
647411734,20,3,2,1,26
647414460,79,73,22,1,175
647421396,178,34,25,7,244
647427481,48,16,2,1,67
647448902,30,65,7,4,106
647454526,216,3,2,7,228
647459430,11,3,2,4,20
647490240,22,4,2,1,29
647491674,74,51,41,2,168
647501742,48,28,5,7,88
647508545,141,47,17,4,209
647515124,58,3,19,1,81
647522515,68,35,2,4,109
647539102,69,13,4,15,101
647546171,12,3,2,1,18
647548078,23,3,2,1,29
647557522,28,61,24,4,117
647568144,106,18,54,15,193
647587354,32,10,2,3,47
647592383,38,86,50,11,185
647605983,169,27,2,1,199
647612518,10,15,2,10,37
647616444,13,3,2,1,19
647631269,241,3,2,4,250
647667862,11,25,2,14,52
647700124,165,3,2,1,171
647715060,111,3,2,1,117
647725863,38,14,3,4,59
647734317,80,3,2,3,88
647737293,109,3,2,3,117
647757090,105,3,2,1,111
647759375,10,10,2,1,23
647761940,20,3,2,1,26
647772979,69,47,35,4,155
647775926,38,79,48,1,166
647779612,45,66,25,2,138
647795987,15,16,2,1,34
647831557,104,7,2,39,152
647833717,129,80,73,13,295
647835226,159,53,134,56,402
647839636,58,16,25,3,102
647840582,73,35,12,8,128
647840648,22,3,2,1,28
647842311,131,37,24,18,210
647843105,91,3,2,1,97
647851155,14,3,2,3,22
647857686,124,3,2,1,130
647862750,67,14,28,22,131
647900448,32,36,3,1,72
647901027,73,50,5,2,130
647909138,27,33,3,5,68
647911572,33,64,59,13,169
647912715,170,3,2,12,187
647931846,79,19,28,6,132
647937263,11,3,2,1,17
647942295,134,130,2,9,275
647947159,45,37,18,38,138
647953628,12,4,2,1,19
647980644,36,4,2,2,44
647981835,51,42,12,12,117
647987329,84,15,2,5,106
647992838,84,54,2,3,143
647998459,21,3,2,1,27
647998882,24,3,2,1,30
648027217,81,20,24,3,128
648029313,20,3,2,3,28
648031257,63,4,2,6,75
648032456,60,12,2,1,75
648033833,183,37,19,4,243
648034434,159,27,2,23,211
648042155,84,3,2,10,99
648050944,50,34,56,14,154
648054257,131,4,4,2,141
648054998,73,3,2,1,79
648063807,106,31,13,1,151
648068660,75,18,25,20,138
648100838,130,44,45,2,221
648104179,62,93,30,20,205
648105047,100,59,2,40,201
648122927,54,3,2,3,62
648126865,10,5,2,1,18
648135315,234,28,6,5,273
648136233,96,15,3,9,123
648144321,34,41,29,1,105
648147157,12,3,2,2,19
648150496,116,21,2,3,142
648159497,82,11,9,4,106
648165546,72,47,19,3,141
648179657,51,34,22,2,109
648181403,150,27,3,2,182
648182979,53,19,2,2,76
648185800,77,22,18,5,122
648195435,23,16,2,3,44
648201163,80,24,11,15,130
648207739,114,12,2,3,131
648217576,11,3,2,1,17
648247940,143,8,2,3,156
648270342,115,6,16,6,143
648289787,12,6,2,1,21
648294241,111,4,80,22,217
648296300,130,3,2,1,136
648302082,87,5,2,21,115
648320570,85,18,8,26,137
648333626,20,3,2,1,26
648334792,184,11,69,17,281
648335109,94,5,2,4,105
648335948,62,59,8,31,160
648338906,23,3,2,2,30
648340653,11,3,2,1,17
648356329,161,3,2,1,167
648362798,146,3,2,13,164
648368695,169,3,2,2,176
648424299,231,3,2,23,259
648427438,11,3,2,1,17
648436925,12,6,2,1,21
648452822,323,7,33,33,396
648453903,78,3,2,4,87
648457712,229,20,4,1,254
648460966,42,3,2,1,48
648469304,100,3,2,1,106
648471058,135,3,2,174,314
648482541,107,73,47,31,258
648483556,28,44,21,4,97
648489746,54,14,12,22,102
648494310,188,3,2,18,211
648496799,65,32,9,34,140
648511261,94,24,35,3,156
648515377,53,34,32,16,135
648518538,148,33,2,1,184
648521281,16,40,12,1,69
648526775,10,8,2,1,21
648528737,30,10,2,1,43
648531875,15,42,20,1,78
648531986,22,4,2,1,29
648531987,57,40,2,2,101
648532657,90,37,57,11,195
648535836,153,9,63,1,226
648537805,52,67,10,2,131
648537895,18,6,2,1,27
648542859,52,3,2,2,59
648544720,31,27,2,3,63
648547489,71,3,2,6,82
648547893,17,3,2,2,24
648549352,70,8,31,1,110
648549782,88,29,9,1,127
648557288,26,4,2,1,33
648574712,44,13,2,2,61
648582490,18,3,2,1,24
648586719,89,33,2,1,125
648602675,23,3,2,1,29
648631955,48,22,12,1,83
648636386,88,13,5,1,107
648637188,20,95,16,7,138
648649767,38,6,2,5,51
648663877,100,47,40,7,194
648665833,41,9,2,1,53
648675050,19,46,9,3,77
648679369,159,82,18,53,312
648682645,38,5,74,16,133
648683002,118,3,2,6,129
648712076,99,44,45,72,260
648726010,28,12,13,2,55
648745068,43,11,2,3,59
648749075,140,133,19,20,312
648753565,98,3,2,5,108
648754646,11,5,2,1,19
648756220,63,3,2,11,79
648756986,48,13,2,1,64
648781595,18,3,2,1,24
648782684,18,5,2,1,26
648785431,56,7,12,8,83
648797675,14,16,2,4,36
648828709,88,3,2,1,94
648828741,16,3,2,2,23
648832396,18,3,2,4,27
648841257,33,41,2,1,77
648847014,18,3,9,2,32
648854654,195,3,2,9,209
648855020,35,65,6,1,107
648857579,32,31,8,16,87
648865797,22,30,8,5,65
648876066,86,3,2,1,92
648881501,115,3,2,11,131
648888600,110,3,2,2,117
648892293,105,3,2,1,111
648912921,50,28,6,4,88
648951895,10,3,2,2,17
648957589,31,23,27,14,95
648962634,50,3,2,13,68
648968501,22,8,2,1,33
648970431,32,3,2,1,38
648970606,86,4,16,8,114
648975978,88,15,2,1,106
649000089,13,3,2,1,19
649010489,24,4,2,5,35
649017251,126,23,3,9,161
649020414,73,17,4,2,96
649046605,36,37,4,1,78
649049355,99,66,7,7,179
649056012,41,3,2,1,47
649059641,81,3,2,1,87
649059957,15,34,2,2,53
649061111,45,3,2,1,51
649068253,16,53,3,1,73
649075626,23,3,2,1,29
649079035,20,65,4,2,91
649103597,94,3,2,3,102
649122145,44,12,2,2,60
649133273,12,36,2,1,51
649147587,13,3,2,1,19
649153566,58,19,2,28,107
649160256,18,3,2,1,24
649165900,20,27,2,24,73
649176802,10,37,2,1,50
649182438,28,17,26,12,83
649183872,42,48,2,8,100
649184271,68,3,2,1,74
649187038,70,25,27,38,160
649206336,21,3,2,1,27
649219750,36,3,2,1,42
649249372,17,3,2,2,24
649271180,38,26,4,1,69
649274151,202,15,16,5,238
649281816,21,3,2,5,31
649287685,44,14,33,49,140
649319898,37,11,2,16,66
649334224,68,21,7,2,98
649354532,12,3,2,1,18
649368936,10,6,2,1,19
649370575,83,63,34,80,260
649380486,67,14,12,7,100
649381381,15,3,2,1,21
649386114,24,7,2,1,34
649405690,11,13,2,1,27
649414708,54,32,2,1,89
649420552,64,3,2,1,70
649421645,86,54,2,7,149
649426133,41,14,34,6,95
649439309,17,36,2,1,56
649444516,168,24,2,4,198
649454608,90,28,2,6,126
649467686,62,34,31,4,131
649471339,20,23,4,3,50
649477321,281,3,2,6,292
649483160,105,35,21,9,170
649503887,19,4,2,1,26
649540742,136,27,14,6,183
649545484,26,3,2,1,32
649553094,67,46,53,16,182
649568391,10,5,2,1,18
649582234,114,3,2,1,120
649592080,99,3,2,1,105
649596883,112,46,45,10,213
649599071,117,3,2,3,125
649604054,36,3,2,1,42
649606545,38,22,15,1,76
649616633,59,3,2,1,65
649621306,60,18,42,56,176
649633729,94,57,27,11,189
649635865,27,3,2,1,33
649654602,30,3,2,1,36
649662126,79,8,19,1,107
649674932,11,3,2,1,17
649676573,47,40,4,13,104
649682679,115,3,2,1,121
649691573,11,15,7,1,34
649713161,141,61,2,1,205
649715978,71,4,2,8,85
649717514,18,3,3,1,25
649717515,93,26,3,1,123
649725199,23,3,2,1,29
649727634,88,62,29,15,194
649736244,63,4,2,1,70
649746737,10,8,2,1,21
649748790,53,21,2,2,78
649755515,78,8,2,1,89
649768736,11,3,2,1,17
649778451,84,3,2,1,90
649787248,40,3,2,2,47
649792983,86,12,2,2,102
649808314,14,40,2,1,57
649812065,11,3,2,1,17
649818855,78,22,44,42,186
649837166,171,20,2,1,194
649837555,60,3,2,1,66
649838098,109,3,2,57,171
649844902,11,3,2,1,17
649855086,60,3,2,1,66
649861418,23,3,8,4,38
649871298,11,3,2,1,17
649885278,26,16,2,2,46
649894046,12,3,2,1,18
649904691,27,3,2,1,33
649918870,13,3,2,1,19
649934255,25,5,2,1,33
649943554,10,5,2,1,18
649953163,89,3,2,3,97
649955109,51,33,10,11,105
649974393,20,37,2,13,72
649986329,38,29,58,3,128
649989900,55,20,2,14,91
650013286,20,17,7,2,46
650014652,55,14,2,1,72
650025158,109,3,2,2,116
650028693,41,28,2,1,72
650038238,89,69,33,6,197
650043455,17,4,2,1,24
650069490,43,3,2,1,49
650071268,14,3,2,1,20
650078485,16,3,2,1,22
650089673,17,3,2,2,24
650091030,44,18,29,13,104
650125187,50,78,5,16,149
650131852,139,15,77,5,236
650150624,136,8,67,7,218
650150707,55,23,68,1,147
650151701,14,9,2,1,26
650157321,91,10,6,4,111
650167683,21,58,2,1,82
650169048,203,3,2,9,217
650171503,11,3,2,1,17
650193523,180,27,2,3,212
650195009,81,69,29,23,202
650209789,57,25,2,6,90
650212860,33,15,2,1,51
650230904,37,17,4,10,68
650232577,27,3,2,4,36
650238057,54,28,2,2,86
650253228,212,15,33,2,262
650255387,78,25,33,3,139
650260853,145,3,2,6,156
650266990,10,3,2,2,17
650267727,35,4,2,4,45
650277290,152,52,23,12,239
650286331,92,3,2,4,101
650292707,16,3,2,1,22
650293897,117,3,2,1,123
650298205,113,16,36,23,188
650298716,68,3,2,1,74
650301486,158,76,7,10,251
650314995,102,18,46,3,169
650316762,92,33,21,14,160
650335803,312,3,2,5,322
650341187,21,21,2,1,45
650353234,14,9,4,2,29
650361632,93,3,2,1,99
650362056,106,3,2,5,116
650364877,58,37,41,3,139
650367035,10,5,2,2,19
650376135,39,3,2,1,45
650378606,35,28,30,4,97
650401636,20,8,2,1,31
650407266,89,32,45,3,169
650411087,97,50,4,41,192
650424921,100,25,2,16,143
650444764,85,3,2,2,92
650470876,58,19,2,2,81
650473684,10,7,2,1,20
650475324,33,4,2,3,42
650477349,63,72,24,5,164
650493278,62,27,2,3,94
650508479,48,47,22,14,131
650526406,10,4,2,1,17
650526917,65,37,13,44,159
650546746,11,3,2,2,18
650549459,40,20,2,2,64
650559014,19,3,2,3,27
650561216,101,6,2,1,110
650563099,140,40,2,6,188
650574690,12,20,2,1,35
650578801,11,3,2,1,17
650594569,95,32,24,3,154
650608593,35,31,6,4,76
650628470,134,3,2,16,155
650648797,36,132,2,2,172
650654603,46,15,2,1,64
650659365,123,50,57,13,243
650662368,11,3,2,1,17
650668434,97,3,2,2,104
650706799,18,3,2,3,26
650716378,36,28,47,1,112
650719585,104,27,32,7,170
650722011,51,22,2,1,76
650722390,36,20,8,1,65
650724788,136,19,2,7,164
650729334,50,16,8,1,75
650748796,197,32,3,15,247
650758303,23,27,6,7,63
650772534,13,3,2,8,26
650791979,36,107,9,1,153
650810697,66,3,2,16,87
650815892,24,40,2,1,67
650839600,49,17,11,3,80
650844121,87,21,4,1,113
650859996,20,21,5,1,47
650869908,38,3,8,9,58
650872777,38,43,32,3,116
650873334,65,3,2,1,71
650876785,45,14,2,1,62
650881514,131,39,39,12,221
650883559,65,34,7,33,139
650893131,75,42,18,20,155
650923643,38,40,23,19,120
650934672,47,38,3,24,112
650935922,224,3,4,8,239
650945510,44,59,10,10,123
650958646,14,3,2,1,20
650959310,65,7,2,1,75
650982047,119,3,2,5,129
650982131,68,43,58,6,175
650996000,111,3,2,1,117
650999300,19,9,4,1,33
651001857,22,4,2,1,29
651009609,11,3,2,1,17
651009723,164,27,28,12,231
651012574,39,13,7,7,66
651013804,37,66,2,1,106
651021494,16,3,2,1,22
651035153,134,27,15,1,177
651059589,137,40,18,45,240
651081295,42,3,2,1,48
651085260,92,31,51,3,177
651114310,37,3,2,1,43
651121819,174,45,33,17,269
651123470,67,54,20,4,145
651144230,31,11,9,14,65
651146357,60,4,3,7,74
651157381,12,3,2,2,19
651164440,41,26,2,1,70
651169679,94,79,8,10,191
651183584,11,3,2,1,17
651192717,121,25,41,7,194
651213316,68,26,2,12,108
651218100,181,62,61,3,307
651223464,13,19,32,1,65
651242351,73,37,2,3,115
651258253,28,5,11,1,45
651274463,16,20,46,47,129
651277988,13,3,2,1,19
651283875,28,14,2,2,46
651291205,25,31,7,26,89
651295196,63,30,2,2,97
651295560,45,24,2,30,101
651297580,80,106,33,99,318
651304256,316,3,2,14,335
651314244,78,153,14,1,246
651317102,11,3,2,1,17
651326325,44,8,8,9,69
651345739,55,48,40,10,153
651375158,103,41,2,1,147
651376663,19,23,6,3,51
651396216,11,21,7,1,40
651397479,35,64,38,9,146
651404887,25,31,2,6,64
651407338,169,39,22,2,232
651419891,196,14,30,17,257
651423377,33,166,18,12,229
651425864,154,13,2,2,171
651426934,51,24,13,4,92
651442545,89,22,2,19,132
651458649,43,39,33,6,121
651472459,82,46,26,5,159
651478503,41,22,16,45,124
651482038,126,3,2,9,140
651482125,65,3,2,1,71
651504820,12,19,2,1,34
651511663,20,31,4,1,56
651534177,64,73,21,1,159
651540969,12,43,2,2,59
651555581,41,3,2,5,51
651578392,698,3,2,22,725
651598332,300,23,2,6,331
651602098,22,8,2,11,43
651603004,49,18,16,1,84
651613205,50,4,2,1,57
651629288,41,20,5,1,67
651636910,130,27,38,57,252
651641871,54,205,3,8,270
651650219,22,15,43,3,83
651681421,99,94,3,16,212
651684467,15,14,12,15,56
651695554,58,3,2,1,64
651712569,33,3,2,4,42
651724003,120,11,2,21,154
651725001,62,37,5,5,109
651732260,36,34,22,71,163
651748750,81,33,2,1,117
651750350,25,44,2,14,85
651762733,52,18,4,1,75
651764884,21,3,2,1,27
651773189,20,12,2,2,36
651773544,34,3,2,1,40
651778189,62,46,2,1,111
651781351,12,3,2,1,18
651783130,510,3,2,7,522
651783302,84,3,2,1,90
651799272,70,38,73,40,221
651804016,19,29,16,2,66
651804574,58,49,53,16,176
651809716,23,64,8,3,98
651818674,161,7,7,2,177
651827921,33,43,36,8,120
651832105,55,34,2,2,93
651834261,25,23,2,10,60
651847287,88,11,58,7,164
651860820,89,16,2,6,113
651869144,89,14,93,14,210
651871259,186,3,2,1,192
651872735,26,8,15,6,55
651876107,51,18,23,7,99
651879786,140,13,4,1,158
651885366,19,3,2,1,25
651891100,13,24,4,1,42
651919756,35,47,2,9,93
651938194,15,3,2,3,23
651939427,27,3,2,1,33
651951770,72,3,2,1,78
651961231,135,10,2,23,170
651976010,16,4,2,2,24
651978922,17,3,2,4,26
651989667,16,56,62,1,135
651994020,78,28,2,1,109
652006160,36,15,35,2,88
652006327,106,7,2,13,128
652021529,86,17,58,3,164
652030058,20,3,2,2,27
652035405,26,3,2,1,32
652063079,41,11,3,1,56
652069588,35,12,17,9,73
652073636,28,19,2,1,50
652073989,88,3,2,1,94
652084954,56,19,14,1,90
652098413,170,49,47,6,272
652101213,126,37,18,6,187
652107526,10,3,2,2,17
652112932,19,16,2,2,39
652113406,11,4,2,1,18
652117660,50,60,20,1,131
652120285,170,32,4,10,216
652133367,50,20,17,8,95
652140372,79,12,12,2,105
652151355,40,39,9,1,89
652175249,26,58,4,3,91
652176238,147,3,2,6,158
652185818,72,50,32,1,155
652200355,71,25,5,11,112
652230683,36,23,10,5,74
652235208,109,19,2,11,141
652238109,10,18,2,1,31
652251052,89,18,80,10,197
652251159,43,85,24,10,162
652251196,85,36,14,22,157
652262417,65,198,60,15,338
652274687,11,3,2,1,17
652279909,11,3,2,2,18
652292542,36,3,2,1,42
652296379,62,4,2,1,69
652297770,28,3,2,4,37
652303955,95,3,2,2,102
652310718,44,63,24,4,135
652311872,106,9,2,2,119
652315541,62,13,17,1,93
652321273,135,44,47,23,249
652336260,32,3,2,1,38
652343669,37,29,2,1,69
652346212,33,6,2,1,42
652346943,37,3,2,1,43
652369032,52,33,8,1,94
652369274,10,25,2,1,38
652374562,34,47,11,5,97
652374787,265,3,2,4,274
652379399,14,3,2,1,20
652386639,80,8,2,1,91
652387080,90,5,2,5,102
652400623,139,15,3,1,158
652401299,16,36,2,5,59
652407738,40,14,2,2,58
652442913,75,5,20,2,102
652448193,57,20,6,13,96
652456576,46,24,47,1,118
652478956,64,26,14,1,105
652483607,100,30,3,2,135
652483757,33,44,3,1,81
652484599,27,3,2,1,33
652490699,109,19,18,1,147
652496766,53,59,60,33,205
652499366,121,3,2,1,127
652503098,67,19,52,9,147
652505974,79,28,30,32,169
652519384,48,13,32,1,94
652534939,14,3,2,1,20
652538693,13,55,18,13,99
652544417,85,12,5,28,130
652573391,75,32,58,3,168
652574821,81,70,16,6,173
652581616,24,3,2,1,30
652599709,89,25,91,26,231
652608305,31,22,6,5,64
652613310,70,38,20,6,134
652617317,62,16,16,16,110
652624032,81,3,2,1,87
652634995,95,3,2,5,105
652635278,27,31,57,1,116
652643612,54,24,2,1,81
652650456,26,36,2,1,65
652651363,104,13,2,14,133
652654696,141,3,2,20,166
652660312,11,9,9,2,31
652666972,45,26,4,1,76
652695462,73,17,18,40,148
652708710,10,10,2,1,23
652745215,24,3,2,4,33
652748922,133,3,2,1,139
652752125,107,42,91,66,306
652756743,27,11,2,10,50
652769527,44,3,2,1,50
652780207,98,11,2,1,112
652823025,28,20,2,16,66
652845781,74,19,19,12,124
652856191,56,3,2,1,62
652879481,99,28,184,1,312
652891087,27,3,2,2,34
652900721,139,33,32,9,213
652920262,250,3,2,51,306
652929971,16,6,3,8,33
652945823,92,32,149,6,279
652961155,47,14,2,2,65
652963630,44,33,2,7,86
652984451,12,3,2,1,18
652986346,32,4,2,2,40
652991592,36,88,10,14,148
653007673,56,37,15,12,120
653008754,52,52,27,55,186
653025701,50,16,2,1,69
653027740,139,15,70,1,225
653040190,42,55,20,12,129
653041303,155,43,14,1,213
653050246,13,8,2,5,28
653052312,66,21,2,1,90
653061820,95,15,50,2,162
653065091,50,3,2,1,56
653068700,12,3,2,1,18
653070186,179,3,2,8,192
653072958,69,3,2,16,90
653079555,14,6,5,1,26
653083713,15,3,2,4,24
653086709,110,18,2,1,131
653100277,138,36,38,1,213
653100741,107,3,2,1,113
653101195,75,20,13,1,109
653102402,118,3,2,1,124
653104638,37,35,2,2,76
653109509,199,22,24,27,272
653139711,21,3,2,1,27
653149535,15,3,2,1,21
653163654,123,24,11,29,187
653164228,61,3,2,11,77
653169249,42,3,2,2,49
653174527,30,34,24,1,89
653176900,80,12,2,16,110
653184974,52,48,3,2,105
653192849,22,3,2,2,29
653209166,10,12,2,1,25
653211926,61,5,2,1,69
653214689,79,3,2,1,85
653233979,60,3,2,23,88
653251244,109,3,2,1,115
653257428,16,3,2,1,22
653263707,29,3,2,6,40
653272207,10,8,2,1,21
653280307,69,22,9,1,101
653291068,80,3,2,12,97
653294606,11,4,2,1,18
653302548,13,3,2,1,19
653307357,55,8,2,1,66
653309193,58,25,28,4,115
653317478,66,3,2,1,72
653323349,113,29,31,6,179
653336316,45,63,9,1,118
653341477,50,40,22,15,127
653343452,69,3,2,3,77
653343910,18,8,2,1,29
653354943,34,31,25,18,108
653374634,137,57,2,9,205
653381828,12,3,2,1,18
653382078,70,3,2,20,95
653423155,34,3,2,1,40
653424039,94,3,2,1,100
653443198,53,36,44,1,134
653444643,85,3,2,1,91
653446990,26,63,27,3,119
653454488,115,40,3,32,190
653469694,164,3,2,2,171
653472821,127,3,2,1,133
653478570,92,3,4,1,100
653497163,163,24,6,1,194
653499725,110,3,2,1,116
653507066,47,59,16,1,123
653517192,13,3,2,1,19
653526994,70,17,3,1,91
653533717,26,32,5,1,64
653541138,63,33,10,3,109
653556801,15,3,2,1,21
653557990,178,45,29,9,261
653572276,69,3,2,2,76
653575781,32,36,3,2,73
653581975,296,3,2,2,303
653582190,70,33,54,3,160
653588802,11,24,2,1,38
653596825,248,52,2,1,303
653603732,44,33,2,13,92
653603875,50,12,2,1,65
653611422,34,3,2,2,41
653614176,40,38,2,1,81
653633040,34,9,28,5,76
653643363,42,3,2,1,48
653650157,86,3,2,1,92
653689304,105,28,19,15,167
653694921,164,43,8,1,216
653698380,12,4,2,2,20
653702594,49,10,2,1,62
653711031,18,3,2,3,26
653732747,41,29,10,1,81
653735509,133,22,2,3,160
653738492,51,19,8,5,83
653744864,11,3,2,1,17
653747468,54,36,7,56,153
653752001,103,3,2,4,112
653752011,83,9,3,3,98
653756489,19,3,2,1,25
653764981,37,29,29,12,107
653771621,43,3,2,1,49
653789854,54,30,2,1,87
653808699,10,3,2,3,18
653814164,91,43,66,7,207
653838880,10,15,2,1,28
653842066,58,3,2,1,64
653844599,79,3,2,2,86
653845717,21,3,2,1,27
653846292,36,42,26,2,106
653884917,95,3,2,1,101
653911334,11,4,2,1,18
653913773,135,3,2,1,141
653921525,42,40,3,1,86
653938536,115,15,2,4,136
653941425,13,3,2,1,19
653943488,27,23,46,25,121
653947661,72,5,2,1,80
653951634,100,21,7,2,130
653970177,10,6,2,1,19
653982696,40,3,2,5,50
653987201,67,13,2,23,105
654000512,17,3,2,1,23
654002046,88,21,142,12,263
654007770,49,3,2,1,55
654008211,93,22,10,20,145
654018206,55,3,2,1,61
654035759,38,9,22,1,70
654047797,55,3,2,8,68
654062346,27,17,4,1,49
654072928,14,17,2,2,35
654075483,12,16,2,1,31
654085896,14,3,2,5,24
654115817,46,42,3,1,92
654118449,79,21,5,1,106
654120002,38,26,27,1,92
654122747,24,50,35,3,112
654123277,173,22,70,9,274
654137603,42,14,118,4,178
654154092,13,3,2,1,19
654155638,12,3,2,2,19
654163813,34,37,2,2,75
654178507,35,43,29,10,117
654202548,755,3,2,3,763
654222107,35,3,2,1,41
654235216,10,5,2,1,18
654237087,42,55,33,2,132
654251069,16,3,2,1,22
654254367,32,19,15,2,68
654255270,70,14,3,1,88
654271102,67,18,2,13,100
654273249,58,10,2,1,71
654276897,94,3,2,3,102
654283830,81,9,49,7,146
654287129,45,8,2,1,56
654302475,64,68,27,11,170
654303890,51,33,14,2,100
654308552,117,38,4,7,166
654328658,41,43,14,1,99
654331183,27,5,8,3,43
654341422,10,28,6,2,46
654345308,114,3,2,1,120
654347104,23,6,2,9,40
654352721,125,55,27,27,234
654364740,134,11,41,20,206
654380241,29,7,4,12,52
654385411,98,14,2,4,118
654396498,99,3,2,1,105
654409825,63,14,2,6,85
654411521,112,23,5,5,145
654421045,159,15,6,3,183
654426180,102,31,56,7,196
654428222,59,27,2,1,89
654449678,85,31,3,1,120
654453723,118,5,2,1,126
654458309,16,3,2,1,22
654472834,14,8,2,1,25
654474160,99,6,2,2,109
654474278,84,16,10,1,111
654490061,139,5,2,5,151
654505744,25,12,2,1,40
654513093,34,43,8,22,107
654515712,13,3,2,1,19
654528265,22,3,2,1,28
654530765,81,69,98,10,258
654538965,51,50,81,35,217
654560994,72,47,2,1,122
654586718,63,16,2,4,85
654603334,37,3,2,1,43
654625333,91,37,157,6,291
654627528,95,28,49,26,198
654627972,92,3,2,1,98
654632175,20,3,2,1,26
654634677,19,4,2,5,30
654658852,101,22,19,18,160
654675040,13,3,2,1,19
654684667,55,22,2,9,88
654702794,58,3,2,4,67
654704276,141,31,2,1,175
654725263,52,3,2,1,58
654732600,20,22,2,1,45
654755386,13,3,2,1,19
654756075,30,47,53,3,133
654764655,175,38,2,1,216
654764771,51,20,2,1,74
654769752,58,25,33,3,119
654775608,49,15,2,2,68
654790006,33,10,11,1,55
654792690,33,10,2,1,46
654811718,88,3,2,2,95
654813254,202,50,32,70,354
654813914,46,31,2,1,80
654822397,11,23,2,1,37
654833379,76,3,2,1,82
654842728,38,14,2,12,66
654860586,55,15,2,1,73
654864579,10,5,12,1,28
654867272,17,3,2,3,25
654870696,17,38,2,1,58
654873725,46,3,2,1,52
654877572,25,17,7,6,55
654900311,13,12,2,1,28
654934876,69,3,2,1,75
654938224,150,44,7,3,204
654940927,14,13,4,1,32
654942100,101,3,2,8,114
654966662,71,18,4,7,100
654966906,50,33,2,5,90
654981383,41,19,2,1,63
655004893,81,37,2,3,123
655008744,138,3,2,1,144
655053418,58,3,10,19,90
655064411,126,26,6,7,165
655076437,96,3,2,1,102
655077774,188,11,2,5,206
655083004,156,57,38,13,264
655083449,13,3,2,1,19
655096009,35,3,2,1,41
655097234,77,22,46,3,148
655108306,54,3,2,7,66
655127791,63,6,2,7,78
655132932,162,3,2,4,171
655142833,26,11,2,1,40
655143944,16,3,2,1,22
655150597,74,16,2,1,93
655166049,152,18,3,11,184
655171393,78,3,2,1,84
655177448,75,14,13,4,106
655180021,16,9,4,37,66
655189719,78,3,2,1,84
655194461,461,3,2,4,470
655199311,10,18,2,1,31
655202364,11,3,2,1,17
655218373,157,3,2,8,170
655222549,26,21,4,55,106
655228337,50,50,46,5,151
655232796,12,3,2,1,18
655233943,131,50,9,6,196
655234655,98,3,2,1,104
655240085,21,3,2,4,30
655252165,109,17,2,3,131
655257876,11,16,2,1,30
655285940,93,65,2,7,167
655297834,75,40,3,1,119
655299958,59,19,2,3,83
655311321,10,33,2,1,46
655331132,33,19,4,1,57
655340890,57,24,39,18,138
655350614,90,3,2,1,96
655354644,80,21,22,2,125
655357705,93,27,51,46,217
655367993,10,5,2,1,18
655379568,112,3,2,3,120
655380942,99,19,29,12,159
655385841,53,7,6,2,68
655396749,54,3,2,1,60
655398372,17,5,4,6,32
655424935,189,26,2,14,231
655429586,75,10,18,2,105
655430936,31,3,2,1,37
655452620,11,5,2,1,19
655482833,12,3,2,1,18
655486172,134,42,12,5,193
655488143,18,3,2,2,25
655489626,44,82,13,20,159
655516558,43,82,4,1,130
655520170,33,6,8,1,48
655542109,36,31,38,6,111
655561077,218,24,95,1,338
655564018,171,43,2,3,219
655568487,47,3,2,1,53
655584725,83,3,2,1,89
655585512,103,40,42,10,195
655604923,11,3,2,1,17
655606046,13,6,2,1,22
655611536,83,26,46,7,162
655613770,33,62,6,15,116
655618382,45,3,2,1,51
655621016,54,4,6,3,67
655669111,195,20,40,75,330
655672550,77,3,2,5,87
655699637,35,19,7,1,62
655703920,64,15,57,3,139
655713065,13,3,2,1,19
655716891,143,35,8,6,192
655720470,64,34,2,2,102
655721638,288,3,2,1,294
655727329,18,3,2,1,24
655733709,13,3,2,1,19
655736307,164,31,2,13,210
655744112,14,3,2,1,20
655753922,184,4,2,1,191
655760002,71,3,2,1,77
655769594,15,3,2,1,21
655773794,49,3,2,3,57
655776051,16,20,2,1,39
655792461,117,20,39,12,188
655798552,17,4,2,9,32
655803537,60,70,5,8,143
655816793,97,15,2,1,115
655823316,174,3,2,3,182
655825475,76,6,2,3,87
655835125,32,14,38,1,85
655836683,64,25,19,4,112
655836853,75,3,2,2,82
655846353,23,22,7,3,55
655848926,34,19,2,1,56
655855291,62,42,2,4,110
655857230,103,153,102,21,379
655879277,19,18,2,1,40
655882609,181,30,22,2,235
655885271,26,4,2,1,33
655885737,11,3,2,1,17
655898846,136,27,21,1,185
655904928,47,31,2,14,94
655905248,53,29,2,2,86
655909908,12,3,2,1,18
655913215,33,17,2,7,59
655914135,17,9,2,4,32
655915768,10,4,2,1,17
655921327,17,19,2,1,39
655942598,146,34,58,44,282
655945728,74,37,2,7,120
655966050,85,26,2,7,120
655967047,22,23,3,3,51
655976717,119,51,2,1,173
655997062,63,11,2,2,78
656003217,80,17,2,17,116
656004959,100,3,2,1,106
656006634,33,14,11,5,63
656010538,78,15,6,16,115
656026338,14,3,2,5,24
656030540,123,3,2,3,131
656032959,116,16,18,8,158
656047448,94,3,2,1,100
656051260,96,16,9,9,130
656058235,71,19,111,19,220
656064010,51,3,2,9,65
656068769,27,3,2,1,33
656098485,212,40,4,2,258
656099478,48,42,31,6,127
656144452,72,56,11,11,150
656146166,19,21,5,3,48
656153180,86,38,39,24,187
656160766,26,29,22,9,86
656161281,287,3,2,7,299
656167034,158,47,3,31,239
656171678,35,6,2,1,44
656184916,81,4,2,3,90
656202231,98,16,2,1,117
656211940,95,40,41,4,180
656237272,225,7,69,6,307
656238775,19,26,4,3,52
656260721,118,15,3,19,155
656261910,45,10,4,7,66
656273426,118,41,2,13,174
656288112,550,3,2,59,614
656302632,190,32,45,65,332
656305599,96,20,2,1,119
656308546,121,18,31,8,178
656318169,100,26,15,1,142
656318267,30,13,11,4,58
656319393,43,19,3,1,66
656319668,83,27,9,3,122
656326727,252,13,2,8,275
656340544,39,11,7,5,62
656341988,29,26,2,2,59
656353879,13,3,2,1,19
656360932,11,4,2,1,18
656385891,33,10,20,16,79
656395195,19,28,10,7,64
656400956,58,39,47,2,146
656409334,21,38,10,5,74
656412544,10,9,3,1,23
656423173,11,3,2,1,17
656459218,85,3,2,5,95
656471542,105,103,30,1,239
656472382,30,34,22,12,98
656477437,12,4,3,1,20
656500705,14,7,2,1,24
656508731,23,23,10,2,58
656527804,122,4,3,12,141
656536057,20,64,3,1,88
656544304,10,5,2,1,18
656554406,49,29,5,35,118
656574186,18,15,2,4,39
656575532,10,5,2,1,18
656577989,70,16,5,24,115
656588319,68,5,2,1,76
656608660,29,3,2,2,36
656623754,15,9,2,6,32
656626942,10,8,12,1,31
656639372,128,28,2,1,159
656642651,106,3,2,2,113
656646261,69,33,2,1,105
656671557,95,5,18,3,121
656689178,37,30,4,1,72
656721145,92,39,25,12,168
656728564,88,26,17,11,142
656742474,49,35,32,5,121
656746516,10,6,2,1,19
656748826,11,3,2,1,17
656755284,58,11,56,1,126
656755570,82,19,3,25,129
656755769,18,26,2,1,47
656771255,63,47,43,4,157
656775774,57,16,11,2,86
656780816,152,3,2,1,158
656783386,100,81,39,26,246
656792641,160,40,8,4,212
656802631,42,5,12,24,83
656818397,170,21,2,2,195
656822681,14,4,2,1,21
656822931,26,13,80,2,121
656834081,11,6,2,1,20
656838658,137,15,2,2,156
656851658,39,47,5,1,92
656852534,37,51,18,1,107
656861598,88,10,84,4,186
656865652,79,14,31,3,127
656877966,188,47,34,1,270
656879917,71,20,4,2,97
656880413,125,4,2,2,133
656906341,66,14,2,4,86
656922291,34,44,22,1,101
656932827,77,22,2,3,104
656935095,15,17,20,7,59
656948247,29,21,2,9,61
656951044,62,25,22,1,110
656978544,56,30,17,3,106
657008738,40,3,2,1,46
657009611,25,3,2,1,31
657014903,108,35,17,1,161
657026904,121,22,93,5,241
657035206,78,18,4,20,120
657040338,21,17,3,1,42
657049043,31,17,78,15,141
657055184,39,9,2,1,51
657066454,53,25,45,2,125
657071167,139,3,2,1,145
657077061,56,30,20,1,107
657096647,84,3,2,1,90
657108987,127,56,2,4,189
657110478,32,36,17,3,88
657111108,83,65,13,7,168
657127075,27,14,2,1,44
657128241,15,3,2,1,21
657131882,18,26,3,1,48
657136124,74,13,4,2,93
657146460,14,3,2,1,20
657146980,37,19,61,29,146
657147753,121,10,60,8,199
657155103,74,32,29,21,156
657157093,18,3,2,7,30
657169902,27,38,4,4,73
657170942,183,39,56,2,280
657178446,73,150,22,2,247
657181525,39,18,2,1,60
657185443,18,11,2,1,32
657186063,14,3,2,1,20
657189143,170,3,2,1,176
657215862,122,31,9,2,164
657220013,129,28,2,1,160
657228733,166,6,2,39,213
657238889,77,18,14,10,119
657254543,14,21,2,1,38
657258938,14,3,2,9,28
657259963,36,36,76,4,152
657262560,17,4,2,2,25
657276078,13,3,2,1,19
657301221,12,6,2,1,21
657302640,12,3,2,1,18
657310792,87,17,2,1,107
657323121,809,56,2,12,879
657326856,26,32,23,9,90
657337800,196,19,21,1,237
657341494,95,44,2,18,159
657342336,15,3,2,1,21
657395158,51,3,2,9,65
657396132,13,23,2,1,39
657403651,213,34,5,10,262
657407582,73,20,2,1,96
657408207,36,52,2,2,92
657408649,62,8,2,2,74
657427077,60,29,24,19,132
657431799,124,99,10,8,241
657435111,26,3,2,1,32
657442531,33,16,2,1,52
657485484,51,29,2,3,85
657505454,61,19,18,1,99
657506056,49,45,18,5,117
657513726,16,12,4,2,34
657521404,44,3,2,2,51
657522690,93,40,8,8,149
657523368,75,18,2,1,96
657531490,11,3,2,1,17
657531750,18,29,2,1,50
657536554,182,3,2,2,189
657537096,83,6,57,3,149
657571966,14,3,2,1,20
657580582,59,3,2,9,73
657584419,29,7,2,2,40
657598984,33,34,9,4,80
657612135,18,3,2,4,27
657617098,21,30,45,1,97
657617260,62,23,15,1,101
657624821,63,15,43,1,122
657632612,33,8,2,9,52
657635479,30,3,2,3,38
657636218,10,4,2,1,17
657649692,10,5,2,3,20
657651849,69,3,2,19,93
657660399,41,35,26,2,104
657690378,10,3,2,2,17
657694472,30,17,17,1,65
657696503,67,15,75,2,159
657697483,17,3,2,1,23
657699064,85,36,2,1,124
657706933,16,3,2,3,24
657718198,89,10,21,1,121
657726445,89,26,17,5,137
657735604,63,50,2,1,116
657751883,12,3,2,1,18
657757268,29,41,3,1,74
657764574,18,17,10,2,47
657774171,40,8,2,1,51
657778760,59,24,2,4,89
657779267,61,28,6,4,99
657788216,20,7,2,1,30
657792599,39,3,2,2,46
657800748,16,3,2,1,22
657810451,113,3,2,31,149
657822948,34,3,2,1,40
657833876,137,30,7,6,180
657839462,101,25,2,14,142
657852545,83,59,12,6,160
657854185,129,3,2,11,145
657862004,59,49,35,10,153
657880826,114,3,2,1,120
657906188,145,7,37,1,190
657910410,14,3,2,1,20
657916711,72,7,2,1,82
657924417,15,14,2,1,32
657928712,133,3,2,1,139
657936318,54,8,82,7,151
657940310,24,10,3,3,40
657949620,357,3,2,1,363
657958464,46,15,2,1,64
657981884,199,3,2,2,206
658002187,16,5,2,1,24
658016085,59,3,2,34,98
658026759,16,3,2,1,22
658027689,101,3,2,3,109
658028681,122,38,2,4,166
658031572,11,3,2,1,17
658041909,76,3,2,1,82
658042031,60,31,11,4,106
658047700,57,3,2,2,64
658049891,55,3,2,3,63
658052982,80,11,11,1,103
658055176,25,3,2,3,33
658055378,95,3,2,1,101
658058001,11,3,2,1,17
658067598,74,3,2,1,80
658080844,22,3,2,1,28
658084262,79,16,113,36,244
658084510,12,3,2,1,18
658100908,87,3,2,2,94
658101007,10,3,2,2,17
658109027,119,30,33,18,200
658111510,57,65,2,1,125
658121073,17,3,2,3,25
658123339,66,16,18,3,103
658128002,88,17,2,1,108
658128614,98,3,2,3,106
658137550,226,6,3,1,236
658151576,70,74,49,4,197
658172492,38,23,2,7,70
658180804,72,21,6,4,103
658181003,44,16,4,1,65
658182515,10,25,2,1,38
658190069,43,9,30,6,88
658190919,86,17,2,1,106
658213935,27,24,2,1,54
658219371,91,21,5,1,118
658226925,25,17,2,1,45
658227365,114,67,14,28,223
658228034,63,63,8,5,139
658240018,132,38,40,9,219
658247983,17,3,3,5,28
658265812,79,3,2,1,85
658276557,59,12,22,14,107
658277188,38,27,2,1,68
658281030,159,50,33,8,250
658303617,14,3,2,1,20
658304793,81,3,2,1,87
658333014,82,33,16,7,138
658338949,42,4,14,1,61
658367458,74,3,2,4,83
658379141,88,34,14,17,153
658383828,32,19,39,35,125
658391117,33,15,2,2,52
658392028,144,28,15,33,220
658397194,44,3,2,1,50
658399293,188,24,34,47,293
658400418,11,4,2,1,18
658406834,52,42,5,8,107
658410233,47,3,2,1,53
658420856,17,3,2,1,23
658427258,40,3,2,1,46
658435315,104,15,4,16,139
658443794,164,3,2,2,171
658449610,153,23,5,2,183
658459427,59,65,18,6,148
658464171,114,63,2,4,183
658476674,148,40,2,1,191
658479926,90,3,2,2,97
658483817,97,33,2,1,133
658494425,24,50,18,1,93
658496101,73,11,15,3,102
658496877,27,3,2,1,33
658517626,11,5,2,1,19
658522925,40,3,2,1,46
658529004,18,3,2,1,24
658575571,14,3,2,1,20
658584741,13,14,2,1,30
658599051,92,3,2,1,98
658607049,12,13,2,2,29
658609121,10,12,2,1,25
658610001,40,3,2,1,46
658629075,138,13,111,8,270
658630310,25,14,2,29,70
658638388,332,3,2,16,353
658644497,39,22,6,1,68
658647648,59,3,2,1,65
658654485,54,51,54,50,209
658670993,127,46,2,12,187
658681702,49,21,3,1,74
658689016,160,46,16,25,247
658696052,81,13,14,5,113
658702069,80,8,2,1,91
658710342,29,11,3,5,48
658710916,67,28,25,1,121
658712137,49,46,31,9,135
658716019,15,20,3,2,40
658728459,27,3,2,1,33
658742841,24,3,2,1,30
658744568,90,3,2,8,103
658744789,60,14,26,1,101
658750583,45,43,2,34,124
658760939,64,3,2,1,70
658769626,83,3,3,10,99
658786766,67,3,2,2,74
658807351,68,53,13,25,159
658823046,65,40,21,13,139
658825934,111,3,2,4,120
658846691,67,26,40,4,137
658849874,12,4,2,1,19
658850108,20,18,2,3,43
658855108,70,43,55,7,175
658856611,97,14,76,1,188
658856908,39,3,2,1,45
658883459,72,11,4,1,88
658895871,48,3,2,1,54
658899488,30,11,5,1,47
658900711,12,3,2,1,18
658941629,86,26,22,23,157
658946514,76,30,137,25,268
658948783,12,3,2,1,18
658955568,75,11,29,3,118
658959601,29,34,3,3,69
658967270,35,56,13,2,106
658981352,80,19,2,6,107
658985118,117,10,2,1,130
658992395,23,3,2,1,29
659003469,10,3,2,3,18
659004276,101,6,11,2,120
659005526,77,27,4,1,109
659024435,15,9,2,11,37
659025498,44,14,2,3,63
659040926,59,14,2,5,80
659043997,56,46,29,7,138
659060513,137,21,35,14,207
659062139,25,12,2,2,41
659064923,71,3,2,1,77
659067239,97,4,60,2,163
659083505,55,42,7,2,106
659083519,38,6,2,3,49
659085549,10,3,2,2,17
659093066,104,9,2,8,123
659095788,86,38,27,2,153
659098106,178,38,47,21,284
659101263,40,34,35,1,110
659107542,31,35,7,1,74
659108755,10,11,2,1,24
659110340,39,6,2,6,53
659126822,85,3,3,2,93
659140076,20,4,2,1,27
659141314,63,20,11,1,95
659146235,37,30,23,12,102
659167277,31,26,45,2,104
659175807,47,3,2,1,53
659189007,69,23,24,8,124
659191181,38,50,12,52,152
659198294,74,28,2,5,109
659210807,110,53,39,19,221
659255226,104,11,27,1,143
659262488,58,3,2,5,68
659266712,10,4,2,1,17
659272114,76,17,2,1,96
659279420,142,6,2,2,152
659280332,86,19,2,8,115
659291915,10,5,12,3,30
659293384,142,13,2,2,159
659297749,143,123,29,34,329
659299199,11,21,2,1,35
659318301,18,3,2,1,24
659318880,67,12,41,43,163
659326194,71,21,2,1,95
659338233,32,22,50,20,124
659341921,77,67,99,2,245
659343994,34,3,2,1,40
659349086,27,3,2,1,33
659351898,264,41,30,18,353
659362347,48,33,2,2,85
659362843,104,45,77,15,241
659367028,48,3,2,8,61
659385935,44,8,2,4,58
659389595,31,45,2,5,83
659391454,11,4,2,1,18
659395982,138,25,8,8,179
659396496,21,3,2,1,27
659397627,59,3,2,1,65
659399250,38,18,116,2,174
659399991,120,3,2,2,127
659406730,153,50,3,5,211
659414000,270,65,17,33,385
659414722,22,23,2,1,48
659425057,138,33,28,2,201
659428935,19,9,2,1,31
659451592,78,38,16,42,174
659455262,253,13,3,1,270
659470688,62,3,2,1,68
659471851,147,18,2,66,233
659489214,12,3,2,4,21
659490433,35,3,2,1,41
659498326,95,6,2,1,104
659508339,18,3,2,1,24
659510310,81,3,2,1,87
659523116,40,9,2,13,64
659529090,76,24,2,2,104
659540509,45,20,11,6,82
659559782,98,22,2,4,126
659565410,75,46,138,6,265
659569456,162,3,2,1,168
659578521,15,12,2,1,30
659578626,21,26,12,7,66
659589728,67,37,7,5,116
659594643,47,20,25,2,94
659597118,85,26,64,6,181
659600952,10,52,2,1,65
659604993,86,22,2,9,119
659623828,18,3,2,1,24
659630812,33,6,2,1,42
659642054,374,3,2,6,385
659644207,21,3,2,1,27
659644698,189,16,2,20,227
659647167,48,14,8,13,83
659648588,28,8,2,11,49
659657757,62,11,80,2,155
659659203,43,51,26,2,122
659665139,140,45,2,5,192
659669688,46,47,19,81,193
659673391,31,14,2,4,51
659673837,44,12,2,1,59
659676403,65,24,2,1,92
659691384,11,3,2,1,17
659709284,112,47,2,5,166
659711004,111,26,13,3,153
659717259,81,10,15,2,108
659720318,124,3,2,13,142
659723391,117,20,2,1,140
659727267,13,3,2,2,20
659730607,10,6,2,1,19
659756052,72,3,2,1,78
659758759,44,13,51,18,126
659773756,58,30,2,1,91
659788270,111,41,2,50,204
659791374,17,3,2,1,23
659794992,111,3,2,2,118
659800195,47,36,2,2,87
659814638,18,3,2,1,24
659814640,10,26,2,1,39
659822041,187,3,2,12,204
659826712,52,32,15,16,115
659868079,26,19,2,13,60
659868201,13,3,2,1,19
659872961,115,3,2,2,122
659873105,106,12,5,22,145
659876558,56,35,5,3,99
659881002,67,3,24,1,95
659886028,23,40,9,4,76
659888594,101,25,35,5,166
659896446,31,26,16,13,86
659900820,121,8,2,3,134
659901751,60,97,3,3,163
659903096,15,3,2,3,23
659913073,20,3,2,1,26
659915931,57,24,2,2,85
659916529,19,12,18,23,72
659918304,212,25,15,61,313
659918817,82,18,9,3,112
659924011,23,7,2,1,33
659931006,58,35,5,4,102
659944321,123,15,2,2,142
659961526,82,10,2,2,96
659968765,80,32,17,25,154
659973733,126,26,17,92,261
659974998,22,24,30,1,77
659975086,42,19,17,1,79
659978200,97,38,9,22,166
659990055,30,27,7,1,65
659993853,62,12,2,5,81
660026728,20,12,2,1,35
660035142,51,13,3,2,69
660058211,75,3,2,1,81
660068175,65,37,13,9,124
660080508,100,3,13,2,118
660081362,25,7,2,1,35
660091997,75,85,2,45,207
660092084,87,14,24,11,136
660094909,48,51,14,2,115
660095958,10,3,2,2,17
660104326,43,3,2,2,50
660121026,47,3,2,1,53
660124144,102,45,9,1,157
660130429,203,3,2,1,209
660144642,13,8,2,1,24
660147133,29,27,2,4,62
660158943,37,3,2,3,45
660175780,30,52,38,66,186
660191800,37,13,9,4,63
660193273,31,3,2,1,37
660194097,23,25,12,9,69
660220205,79,16,22,6,123
660234339,117,28,2,1,148
660235108,108,3,2,2,115
660240931,21,17,2,1,41
660243432,67,4,3,10,84
660250153,32,9,9,4,54
660254769,115,44,3,13,175
660257299,18,20,13,3,54
660260808,78,30,2,1,111
660264627,13,3,2,1,19
660277027,95,7,2,4,108
660288409,59,6,3,4,72
660288846,55,16,48,1,120
660300627,16,3,2,3,24
660301184,25,3,2,1,31
660330621,15,25,5,1,46
660331041,19,12,2,1,34
660341757,111,14,29,1,155
660357088,21,10,2,1,34
660394590,47,3,2,2,54
660405713,142,12,34,15,203
660412235,76,35,46,3,160
660418092,68,4,8,1,81
660429521,47,16,2,9,74
660448777,25,3,2,1,31
660448801,24,3,2,19,48
660459713,11,3,2,1,17
660466064,130,15,77,8,230
660473209,51,3,2,1,57
660473415,38,3,8,1,50
660488430,85,28,25,25,163
660503508,129,4,2,4,139
660516467,83,6,20,2,111
660520216,114,10,89,1,214
660520350,10,3,2,2,17
660521643,27,31,2,1,61
660533797,12,11,2,1,26
660535537,29,49,22,4,104
660540014,54,20,40,32,146
660542555,113,14,3,2,132
660542890,74,21,12,1,108
660559843,40,3,2,1,46
660563496,147,63,15,11,236
660566367,177,3,2,2,184
660566806,65,3,2,8,78
660570508,14,9,2,6,31
660601679,193,3,2,64,262
660602779,38,3,2,1,44
660604731,11,4,2,2,19
660605585,47,3,2,6,58
660620594,10,20,2,1,33
660629601,88,18,2,14,122
660652032,163,56,2,3,224
660652290,28,25,2,4,59
660659158,45,3,5,2,55
660667142,35,67,26,12,140
660671575,277,43,3,12,335
660677615,79,62,7,1,149
660679282,11,3,2,1,17
660687882,77,36,19,9,141
660707604,22,3,2,1,28
660708989,144,3,2,4,153
660727440,153,25,9,5,192
660729859,93,13,25,1,132
660735005,91,16,2,1,110
660736634,163,3,69,5,240
660750501,104,13,2,1,120
660754313,119,3,2,16,140
660762682,17,3,2,9,31
660790189,57,36,3,8,104
660813135,69,43,2,1,115
660817440,53,42,31,83,209
660817791,149,52,81,10,292
660838847,27,36,29,42,134
660843901,286,3,2,21,312
660844421,134,52,24,13,223
660851933,42,35,12,22,111
660861509,88,25,32,5,150
660869927,214,38,6,1,259
660904743,133,18,3,4,158
660905282,28,3,2,1,34
660914186,40,22,2,1,65
660917762,190,3,2,3,198
660918429,11,3,2,1,17
660919482,12,3,2,1,18
660920072,58,44,89,57,248
660924713,69,16,28,1,114
660927166,14,3,2,1,20
660933005,13,11,3,12,39
660955102,50,3,2,8,63
660957829,40,48,44,5,137
660966220,77,100,5,3,185
660978041,122,3,2,6,133
660981654,95,25,17,5,142
660998500,116,3,2,2,123
660999894,89,23,19,10,141
661008894,57,22,38,2,119
661016373,68,3,2,5,78
661018415,64,9,2,57,132
661030930,55,13,2,30,100
661033665,14,30,5,10,59
661040347,10,7,2,1,20
661042351,51,3,2,1,57
661042597,121,93,17,35,266
661059373,16,10,24,25,75
661067412,47,13,12,9,81
661090546,117,3,2,1,123
661098926,16,3,2,1,22
661122420,14,5,2,1,22
661126691,66,3,2,12,83
661137107,20,19,5,3,47
661156398,53,40,2,1,96
661170406,117,41,3,20,181
661175569,14,3,2,1,20
661240475,100,14,14,14,142
661248932,14,3,2,1,20
661255571,92,17,25,1,135
661295722,103,11,17,3,134
661313775,96,22,2,1,121
661322283,59,45,38,38,180
661325981,33,20,4,2,59
661334759,172,10,39,5,226
661335569,18,10,2,1,31
661350839,57,45,2,27,131
661363874,184,58,10,6,258
661366523,166,3,2,1,172
661371733,107,53,87,8,255
661374334,10,4,2,1,17
661374490,25,10,2,12,49
661389801,153,4,20,2,179
661404902,50,18,16,5,89
661413669,138,30,2,3,173
661433207,83,21,2,1,107
661433708,15,3,2,3,23
661434937,36,105,2,9,152
661436885,160,13,11,12,196
661437044,135,3,2,3,143
661437858,82,3,2,1,88
661441329,50,33,9,19,111
661456558,69,10,17,6,102
661460781,69,25,109,1,204
661463766,35,39,28,6,108
661474353,108,73,10,8,199
661475647,120,30,5,4,159
661479802,133,29,31,20,213
661502592,87,28,2,1,118
661511195,190,3,2,1,196
661517704,99,25,10,4,138
661523708,14,3,2,1,20
661530258,81,3,2,3,89
661542826,15,3,2,1,21
661568048,100,5,5,6,116
661573604,10,4,2,1,17
661585498,18,47,14,1,80
661592156,58,3,2,1,64
661595935,106,3,2,1,112
661599618,17,3,2,1,23
661618109,23,32,46,13,114
661621975,46,14,13,27,100
661625690,126,85,83,2,296
661631546,52,5,2,1,60
661638524,111,30,2,19,162
661648400,22,5,2,1,30
661648665,53,4,2,14,73
661651063,99,15,2,1,117
661661343,88,3,2,13,106
661662201,79,38,30,3,150
661667326,43,3,2,2,50
661674607,95,35,25,16,171
661678999,71,53,2,22,148
661681967,77,23,16,3,119
661683055,21,3,2,5,31
661688689,81,4,2,2,89
661725883,86,37,2,1,126
661726274,109,9,10,2,130
661726990,19,48,18,2,87
661735835,61,9,14,12,96
661736036,52,25,9,9,95
661747786,302,67,2,32,403
661751439,24,34,22,3,83
661774733,43,59,43,34,179
661795885,79,3,2,1,85
661798883,155,39,39,3,236
661806573,44,24,36,3,107
661807088,37,3,2,1,43
661807704,199,12,2,2,215
661820703,186,83,12,11,292
661832231,31,117,4,3,155
661834193,34,30,21,1,86
661846110,140,3,2,1,146
661853981,50,32,3,1,86
661866600,19,3,2,1,25
661877968,41,70,2,1,114
661880806,200,12,2,5,219
661915856,136,3,2,1,142
661922269,98,85,33,1,217
661926443,97,25,45,8,175
661945562,65,8,9,12,94
661949166,140,22,17,34,213
661954433,53,8,5,1,67
661954487,15,3,2,1,21
661965452,15,3,2,1,21
661967702,14,11,5,1,31
661992754,41,19,81,1,142
661995567,22,10,2,1,35
661995630,30,17,5,1,53
662018962,40,4,3,1,48
662025623,25,6,2,1,34
662034116,51,6,2,2,61
662047153,22,45,16,75,158
662051337,70,10,17,7,104
662062782,120,11,2,1,134
662071183,36,38,31,7,112
662075767,59,11,47,10,127
662079418,125,3,2,5,135
662080288,10,3,2,3,18
662085713,55,3,2,1,61
662093581,12,7,2,12,33
662095422,56,27,8,1,92
662101417,86,12,2,5,105
662101582,129,6,22,15,172
662114928,39,3,2,1,45
662155551,19,21,3,1,44
662158351,10,6,10,1,27
662161913,37,46,2,2,87
662162452,11,3,2,1,17
662174179,43,3,2,1,49
662174946,38,117,16,5,176
662180927,89,18,2,2,111
662184547,29,16,12,2,59
662193530,15,6,6,1,28
662196105,78,70,9,9,166
662201869,77,3,2,8,90
662208117,159,23,19,10,211
662223376,92,29,2,2,125
662225631,39,3,2,1,45
662230102,137,99,35,73,344
662235075,111,3,2,11,127
662238874,38,3,2,2,45
662253992,12,3,2,1,18
662272012,104,5,2,1,112
662284502,12,20,2,1,35
662291912,86,13,54,1,154
662306641,12,3,2,2,19
662309469,80,31,3,1,115
662331814,57,38,2,1,98
662335645,14,4,2,1,21
662353017,20,24,2,1,47
662362097,28,9,2,1,40
662368993,61,28,41,33,163
662370890,66,4,2,1,73
662379103,67,30,7,10,114
662382638,50,14,21,6,91
662395931,49,24,34,7,114
662396832,47,15,2,1,65
662400891,10,3,2,2,17
662404430,10,4,2,1,17
662418564,38,16,14,2,70
662418588,24,3,2,1,30
662438461,12,7,2,1,22
662442413,20,65,2,6,93
662448186,52,49,70,18,189
662448909,76,54,25,4,159
662480950,43,44,10,5,102
662481583,16,3,2,1,22
662486918,13,9,2,1,25
662498240,66,3,2,4,75
662502078,20,3,2,2,27
662506240,12,3,2,2,19
662510095,82,43,115,2,242
662520361,36,3,2,16,57
662532440,82,32,10,5,129
662537132,10,3,2,2,17
662537421,68,11,4,1,84
662547199,19,5,2,1,27
662555773,107,16,69,25,217
662559748,82,16,2,1,101
662564872,126,3,2,1,132
662567430,69,4,3,1,77
662570943,218,3,2,25,248
662573943,18,50,8,2,78
662590602,76,22,4,1,103
662609434,68,55,11,3,137
662617598,19,45,5,1,70
662618609,178,13,2,3,196
662636097,45,9,2,1,57
662640479,104,32,9,4,149
662666487,187,74,12,6,279
662667736,60,29,4,7,100
662669167,88,25,32,6,151
662693181,51,37,6,3,97
662697313,52,25,11,1,89
662702089,42,3,2,2,49
662710838,15,24,22,1,62
662732370,72,35,2,7,116
662732529,84,11,14,1,110
662740629,42,3,2,4,51
662746249,31,3,55,10,99
662752245,23,3,2,3,31
662763498,33,3,2,1,39
662777287,94,48,23,16,181
662778227,72,63,18,10,163
662779758,140,25,127,9,301
662780627,13,19,9,1,42
662807897,12,67,2,1,82
662816505,258,103,33,11,405
662819641,18,20,8,78,124
662835584,27,18,2,16,63
662838715,28,14,2,1,45
662857660,66,29,3,68,166
662857788,14,9,3,10,36
662872044,122,91,78,69,360
662873918,11,5,2,5,23
662886055,50,3,2,3,58
662900444,45,21,2,2,70
662908745,23,3,2,2,30
662913446,43,3,2,2,50
662922043,105,44,79,2,230
662930036,12,12,2,6,32
662943689,93,60,30,35,218
662960060,63,66,41,30,200
662977430,139,3,2,42,186
662985201,201,62,18,7,288
662986466,218,12,2,1,233
662999908,35,3,4,1,43
663004737,11,19,2,1,33
663010036,126,29,56,2,213
663010925,53,109,17,10,189
663012571,25,25,17,2,69
663015437,17,3,2,5,27
663021511,22,3,2,5,32
663032808,97,72,50,10,229
663050377,89,47,2,3,141
663058129,114,78,53,3,248
663064397,68,3,2,1,74
663069647,80,3,2,1,86
663075415,40,3,2,1,46
663085202,27,13,3,1,44
663111980,13,28,2,6,49
663120182,24,37,28,12,101
663120586,88,3,25,31,147
663124214,22,19,2,1,44
663124421,121,3,2,2,128
663138361,138,34,28,2,202
663148497,98,57,42,2,199
663150474,112,7,2,31,152
663152754,22,12,7,3,44
663153275,34,7,18,7,66
663159248,113,15,5,6,139
663166418,100,13,2,2,117
663167632,10,3,2,4,19
663171036,162,7,35,6,210
663175617,82,13,2,1,98
663179530,96,29,2,15,142
663196278,97,13,2,2,114
663200511,45,3,2,8,58
663216708,163,27,3,40,233
663230877,34,13,3,1,51
663245155,25,6,2,6,39
663256753,97,46,2,2,147
663261404,132,3,2,1,138
663264401,19,9,2,2,32
663282047,64,80,3,2,149
663282096,31,31,2,9,73
663313253,42,38,2,1,83
663316521,46,3,2,3,54
663319517,180,4,5,1,190
663320028,50,34,48,22,154
663327918,12,55,2,1,70
663328615,82,45,16,5,148
663331147,17,3,2,1,23
663334203,43,108,40,2,193
663341993,82,25,46,5,158
663347395,148,3,2,2,155
663347580,39,18,19,1,77
663368419,11,3,2,1,17
663379650,49,6,2,4,61
663382100,59,22,8,7,96
663385938,11,3,2,1,17
663395725,26,10,2,1,39
663399810,44,3,2,2,51
663415540,76,3,2,1,82
663416909,98,30,32,1,161
663424655,43,3,2,2,50
663425009,96,11,2,30,139
663427272,29,47,15,2,93
663461689,140,34,63,8,245
663462784,97,3,2,7,109
663474853,15,3,2,1,21
663503757,266,38,2,16,322
663511979,118,49,5,23,195
663514454,12,3,2,1,18
663526008,180,26,17,2,225
663526064,45,29,5,2,81
663542316,31,24,7,9,71
663554064,157,3,2,1,163
663558677,28,33,7,1,69
663565066,151,3,2,2,158
663565555,70,41,11,43,165
663571120,67,6,2,1,76
663582215,81,3,2,4,90
663588678,23,10,22,5,60
663594706,16,3,2,1,22
663598989,76,3,2,1,82
663604382,24,22,55,17,118
663611934,53,24,2,34,113
663615956,187,29,48,6,270
663628263,121,3,2,1,127
663643471,65,20,39,7,131
663648898,255,56,2,1,314
663665012,111,35,2,1,149
663668767,24,40,2,1,67
663673210,70,3,2,1,76
663675353,84,15,26,18,143
663676721,31,23,6,1,61
663681683,94,3,2,2,101
663682673,41,43,47,8,139
663700715,330,22,2,11,365
663702963,57,59,2,1,119
663709509,16,3,2,1,22
663722612,190,37,2,2,231
663726311,125,38,29,10,202
663728507,19,13,2,1,35
663734980,25,7,2,1,35
663745144,54,38,42,19,153
663763499,27,6,2,1,36
663765800,38,21,2,7,68
663767801,53,3,2,1,59
663769694,130,96,3,13,242
663771944,187,23,2,4,216
663792038,32,5,5,3,45
663796075,96,18,2,6,122
663799419,46,20,4,11,81
663805764,94,30,2,5,131
663811191,68,37,17,1,123
663813400,43,3,2,1,49
663814548,13,9,2,1,25
663815555,11,9,2,2,24
663825155,41,11,3,22,77
663825960,93,3,2,1,99
663848492,37,3,2,3,45
663849304,21,23,2,9,55
663853293,186,38,2,14,240
663871630,49,31,2,1,83
663882191,69,16,13,1,99
663886050,46,21,4,2,73
663896464,27,5,45,8,85
663912911,123,3,2,1,129
663925080,76,3,35,1,115
663930693,104,42,12,31,189
663931486,155,20,9,2,186
663931867,46,28,2,22,98
663932492,40,3,2,1,46
663947104,26,3,2,1,32
663955236,64,59,120,5,248
663973478,51,61,53,39,204
663977370,11,23,2,1,37
663999817,45,11,11,21,88
664008527,61,7,5,32,105
664010484,35,3,2,1,41
664017210,53,48,33,7,141
664020079,50,33,2,2,87
664022697,51,66,2,4,123
664022769,30,17,30,45,122
664026629,153,53,2,2,210
664032573,87,17,6,32,142
664034164,113,3,2,1,119
664045961,41,8,2,2,53
664045967,47,26,2,18,93
664056911,71,9,2,3,85
664060165,108,17,2,1,128
664060951,14,3,2,1,20
664072916,22,6,2,1,31
664081670,91,30,31,4,156
664084988,18,35,18,1,72
664090883,24,3,2,1,30
664093468,33,3,2,43,81
664111743,70,82,12,33,197
664112767,29,3,2,6,40
664117810,36,29,2,1,68
664132932,31,3,2,1,37
664153030,74,45,2,20,141
664160051,28,3,2,1,34
664160918,13,3,2,1,19
664175046,87,3,2,9,101
664183083,297,3,110,22,432
664193644,177,3,2,21,203
664211647,24,3,2,1,30
664213871,29,6,2,1,38
664227654,158,53,2,2,215
664244803,97,58,3,14,172
664255509,48,7,2,13,70
664261279,11,3,2,1,17
664272510,114,52,2,1,169
664282180,71,3,2,1,77
664293167,155,12,2,1,170
664296317,41,3,2,1,47
664311785,61,11,2,4,78
664319444,83,14,10,3,110
664328215,33,20,4,11,68
664351510,37,7,10,2,56
664355084,62,3,2,1,68
664357176,12,3,2,1,18
664368595,280,3,2,27,312
664369687,12,4,2,41,59
664382201,79,21,58,16,174
664385166,16,3,2,1,22
664395159,16,3,2,3,24
664402549,275,3,2,7,287
664404151,22,19,2,1,44
664413901,26,49,9,68,152
664416619,12,3,2,1,18
664417069,211,3,2,1,217
664422571,42,68,14,9,133
664432932,65,3,2,2,72
664467301,239,7,2,2,250
664472184,40,48,2,10,100
664482953,27,28,20,15,90
664488464,34,20,2,4,60
664490004,101,45,31,75,252
664491908,61,3,2,1,67
664493675,21,3,2,1,27
664527886,10,16,2,1,29
664542221,50,21,23,3,97
664553948,41,22,4,10,77
664556667,18,11,24,15,68
664560218,23,76,5,1,105
664560575,10,5,2,1,18
664564155,41,30,19,34,124
664571159,71,9,2,6,88
664577474,18,3,25,11,57
664579271,198,3,2,4,207
664595262,77,54,3,2,136
664602298,103,16,2,8,129
664609754,10,4,2,1,17
664650797,32,3,2,1,38
664659561,39,45,2,2,88
664676529,44,59,43,8,154
664689048,82,41,77,1,201
664700256,34,81,10,8,133
664711075,42,11,2,4,59
664714720,62,6,35,4,107
664729975,44,46,99,2,191
664734888,29,63,9,1,102
664739509,84,73,100,3,260
664746943,104,73,85,154,416
664766929,22,33,8,3,66
664774571,32,13,2,10,57
664786691,70,138,2,15,225
664789500,71,108,43,1,223
664791282,14,4,2,1,21
664794139,69,9,5,3,86
664796313,10,9,2,1,22
664796770,44,3,2,1,50
664799010,100,67,2,6,175
664799619,16,3,2,1,22
664800692,24,27,7,12,70
664818702,25,25,2,1,53
664819346,56,3,2,1,62
664820253,137,29,107,42,315
664851763,29,4,2,1,36
664853303,12,41,2,1,56
664893058,31,18,2,1,52
664894959,11,3,2,1,17
664907985,124,52,3,1,180
664908477,49,28,28,20,125
664925407,28,51,25,1,105
664931392,11,3,2,7,23
664931842,16,3,2,1,22
664951189,31,12,6,7,56
664957431,53,32,2,1,88
664959144,71,7,2,4,84
664974151,12,3,2,1,18
664980004,34,43,9,1,87
664986682,100,3,2,1,106
664992143,147,97,7,5,256
664992455,42,3,2,1,48
665003035,100,6,3,7,116
665011533,90,16,4,10,120
665023003,96,16,3,2,117
665023519,20,22,8,5,55
665035991,163,34,37,1,235
665036207,29,3,2,1,35
665078058,13,62,9,1,85
665078801,103,37,2,1,143
665090897,102,3,2,9,116
665092890,87,10,25,6,128
665094712,18,23,2,1,44
665100359,28,53,2,12,95
665106282,31,3,2,3,39
665119926,200,46,2,15,263
665128841,11,8,2,1,22
665135096,138,19,23,11,191
665140512,123,3,10,1,137
665149775,10,4,2,1,17
665154214,25,46,35,2,108
665158936,168,16,65,44,293
665159268,81,25,29,20,155
665163699,76,46,70,8,200
665175275,97,23,9,1,130
665179780,38,3,2,1,44
665180493,182,3,2,2,189
665183511,62,3,2,1,68
665206357,88,3,52,1,144
665216530,27,30,16,8,81
665229103,92,14,4,101,211
665230624,60,8,34,13,115
665237131,50,30,67,4,151
665238461,132,42,100,39,313
665242728,47,41,57,48,193
665244501,103,6,2,2,113
665248194,86,4,2,1,93
665258148,33,17,3,3,56
665263163,310,3,2,16,331
665271845,17,3,2,3,25
665275140,46,12,2,3,63
665313134,87,21,70,3,181
665337948,21,28,12,8,69
665341297,10,8,2,1,21
665360368,21,35,15,8,79
665367537,24,57,29,2,112
665371840,42,20,2,4,68
665372602,17,21,2,1,41
665401506,24,16,23,2,65
665405972,47,21,2,1,71
665413764,15,8,2,1,26
665428126,45,11,3,3,62
665430465,44,48,3,1,96
665431473,42,33,13,42,130
665468073,37,12,39,2,90
665498632,94,18,27,2,141
665506460,25,3,2,1,31
665522635,64,25,43,31,163
665534309,183,51,3,3,240
665535191,55,54,16,8,133
665545430,73,14,5,1,93
665556160,18,8,2,1,29
665556518,46,33,28,7,114
665558866,73,3,24,1,101
665560874,15,5,8,22,50
665561428,12,3,2,1,18
665562069,82,44,2,11,139
665562451,14,3,2,1,20
665564574,26,8,3,1,38
665567024,71,5,8,7,91
665570697,48,3,2,2,55
665571130,66,14,3,3,86
665593664,55,81,18,4,158
665600462,90,18,2,20,130
665605299,66,3,2,1,72
665621617,301,3,2,2,308
665634235,66,3,2,1,72
665634368,10,16,2,1,29
665657009,56,7,2,1,66
665660328,29,21,14,2,66
665669506,113,3,2,2,120
665671013,173,56,19,46,294
665686224,67,10,5,3,85
665700923,143,7,2,3,155
665721109,116,11,2,41,170
665737634,74,34,29,9,146
665737980,64,12,2,1,79
665740742,122,8,2,36,168
665741848,23,5,2,1,31
665744723,60,9,2,1,72
665750544,37,38,11,3,89
665750576,164,27,8,19,218
665750867,47,18,38,6,109
665750933,60,3,2,4,69
665763107,40,72,13,6,131
665766971,13,3,2,1,19
665788429,19,3,2,1,25
665788965,15,3,2,1,21
665798864,10,9,2,1,22
665800735,123,35,3,1,162
665803887,127,15,2,1,145
665810834,36,25,18,3,82
665814280,51,33,28,1,113
665823444,43,35,24,9,111
665837176,15,3,2,5,25
665842222,34,40,2,2,78
665855607,69,6,2,1,78
665871625,28,12,10,6,56
665910841,121,16,5,1,143
665937230,99,3,2,18,122
665948173,71,34,6,1,112
665956907,41,3,2,2,48
665960201,11,5,2,1,19
665985999,172,51,3,8,234
665987922,108,21,2,3,134
666003753,23,16,6,5,50
666003936,33,10,3,14,60
666022472,54,24,20,2,100
666038109,42,26,2,1,71
666049089,50,23,25,6,104
666052111,67,3,2,1,73
666065285,67,9,2,6,84
666073390,80,36,21,11,148
666086536,123,3,2,1,129
666088112,64,47,100,4,215
666100548,483,3,2,5,493
666124074,54,3,2,2,61
666156622,25,3,2,2,32
666173753,13,3,2,1,19
666173862,125,42,11,28,206
666176984,29,11,5,30,75
666188044,13,3,2,1,19
666195960,140,22,2,4,168
666207860,10,3,2,3,18
666212597,148,14,5,26,193
666238902,87,14,2,4,107
666239160,28,13,6,1,48
666240538,86,11,2,8,107
666240888,115,23,2,20,160
666242749,129,34,8,7,178
666273142,62,46,7,30,145
666278612,186,3,2,18,209
666300032,25,16,2,1,44
666321411,11,3,2,1,17
666328790,56,3,2,1,62
666342543,139,25,117,3,284
666346413,68,34,3,6,111
666357275,39,3,2,1,45
666358800,51,3,2,1,57
666363986,53,3,2,1,59
666369406,67,44,106,43,260
666378329,13,3,2,1,19
666378685,167,70,6,7,250
666389820,44,54,12,11,121
666398990,137,3,2,2,144
666401905,18,3,2,1,24
666433900,72,8,47,20,147
666437927,49,7,88,2,146
666439546,10,3,2,2,17
666451808,44,43,35,18,140
666462809,10,8,2,1,21
666486913,117,80,51,75,323
666517915,33,18,2,5,58
666526588,11,3,2,3,19
666547039,95,26,5,5,131
666571809,87,11,2,1,101
666575756,14,27,5,4,50
666587414,156,3,2,1,162
666600836,210,20,32,2,264
666612754,14,3,2,1,20
666615722,51,88,26,4,169
666620014,16,3,2,1,22
666637786,25,34,19,1,79
666642238,155,44,16,1,216
666665948,10,6,2,1,19
666673660,77,32,10,9,128
666676324,440,3,2,10,455
666684533,33,25,16,2,76
666687346,145,10,6,9,170
666690147,49,25,27,2,103
666708976,72,18,109,11,210
666724847,10,3,2,3,18
666726207,95,44,20,1,160
666752762,71,24,8,1,104
666756456,82,105,29,1,217
666759484,29,7,25,1,62
666761558,229,28,4,2,263
666775466,13,3,2,2,20
666782255,16,6,2,1,25
666798070,48,3,2,1,54
666804579,10,3,2,3,18
666834972,79,3,2,1,85
666835257,53,22,23,2,100
666835495,10,16,2,1,29
666835739,50,9,2,1,62
666844038,64,29,3,5,101
666845335,51,3,2,1,57
666850343,81,8,71,1,161
666853471,14,18,3,1,36
666854106,169,70,78,4,321
666858932,34,49,2,1,86
666885023,10,5,2,1,18
666885297,97,38,2,1,138
666888133,32,51,7,4,94
666906779,73,50,62,12,197
666931676,141,3,2,3,149
666944722,57,3,3,2,65
666945501,91,36,47,19,193
666960712,26,82,2,1,111
666971545,52,58,36,8,154
666973199,87,24,38,35,184
666974303,51,31,23,12,117
666994332,71,45,3,5,124
666999789,26,6,4,1,37
667000347,11,32,30,1,74
667031671,11,16,2,1,30
667035848,106,3,2,1,112
667040231,22,108,18,16,164
667063235,158,42,3,6,209
667063420,49,101,2,1,153
667066070,23,21,40,9,93
667072137,258,3,2,2,265
667076886,32,10,2,1,45
667086038,171,40,5,10,226
667086751,156,3,2,1,162
667088609,27,23,2,16,68
667092617,75,37,2,7,121
667092746,19,12,2,1,34
667103728,60,57,34,4,155
667136836,143,62,15,109,329
667137798,39,15,2,1,57
667140864,83,29,2,12,126
667142707,215,3,2,6,226
667157638,214,21,19,2,256
667178187,107,23,29,3,162
667181473,60,51,2,29,142
667194563,19,7,2,3,31
667197157,31,15,2,1,49
667198659,26,80,2,3,111
667201095,50,10,24,8,92
667204848,12,3,2,1,18
667220584,27,24,2,1,54
667220902,80,21,15,11,127
667228163,31,3,4,1,39
667241994,27,20,3,1,51
667245781,66,55,28,6,155
667252378,131,7,49,3,190
667262641,11,3,2,1,17
667269641,64,39,6,33,142
667303735,61,23,2,4,90
667312417,48,95,84,1,228
667324471,23,55,2,1,81
667357312,101,12,2,1,116
667361643,59,12,7,4,82
667366634,10,3,2,6,21
667369149,20,7,2,2,31
667391333,76,70,62,1,209
667403173,75,16,2,2,95
667413800,88,45,4,1,138
667424674,82,63,2,7,154
667437584,28,21,2,3,54
667441822,67,18,2,5,92
667445307,64,21,37,9,131
667447704,61,11,29,1,102
667458867,11,4,2,1,18
667476180,15,79,33,7,134
667488882,273,16,4,5,298
667516512,64,3,2,2,71
667517765,227,3,2,68,300
667528186,28,3,2,1,34
667543281,14,3,2,1,20
667556142,89,40,17,1,147
667568989,22,3,2,1,28
667571380,25,74,3,1,103
667572133,71,8,2,1,82
667588211,40,10,2,1,53
667610433,15,6,2,1,24
667619580,58,52,7,5,122
667627834,13,13,2,1,29
667627918,15,9,2,1,27
667630796,19,3,2,1,25
667633877,13,3,2,1,19
667634574,47,3,2,2,54
667638145,47,3,3,5,58
667638753,11,19,2,1,33
667653924,63,5,2,5,75
667655796,50,30,49,15,144
667682012,16,31,8,1,56
667687248,130,20,130,1,281
667690891,72,19,2,2,95
667710225,131,48,7,7,193
667714480,72,46,48,18,184
667724918,11,3,2,1,17
667728988,15,28,18,1,62
667754036,95,21,12,6,134
667759208,45,16,2,3,66
667779922,21,22,2,1,46
667780281,12,17,2,1,32
667782310,142,3,2,10,157
667802043,118,18,19,33,188
667817454,42,44,46,24,156
667820144,18,17,13,1,49
667821860,11,3,2,1,17
667842896,173,24,12,1,210
667856589,34,24,8,1,67
667860310,22,5,8,18,53
667883970,38,3,2,5,48
667885376,146,26,2,20,194
667887522,32,3,2,4,41
667900006,86,3,2,5,96
667911192,34,38,2,10,84
667936267,25,12,18,1,56
667954346,110,7,13,8,138
667961983,121,3,2,1,127
667966036,11,3,2,1,17
667968524,122,38,2,18,180
667969050,65,55,2,2,124
667979758,11,19,2,1,33
667980495,18,3,2,1,24
667980822,102,15,20,1,138
667993706,68,16,2,2,88
668011923,22,3,2,1,28
668017801,35,3,2,3,43
668021110,130,3,2,1,136
668043763,73,3,2,2,80
668044584,115,3,2,2,122
668046930,165,40,4,2,211
668049364,22,32,6,1,61
668079770,81,17,3,1,102
668084759,20,3,2,1,26
668086948,70,14,11,1,96
668090605,50,58,3,12,123
668100540,43,3,2,2,50
668110736,52,3,2,1,58
668126563,15,3,2,1,21
668132432,33,34,5,1,73
668132566,102,30,13,4,149
668139694,46,17,2,1,66
668143725,45,32,2,36,115
668151332,45,28,5,3,81
668154443,153,20,6,1,180
668174875,79,5,2,1,87
668188957,78,3,2,2,85
668205330,56,16,3,10,85
668205829,23,22,18,9,72
668223560,113,76,74,22,285
668240125,114,30,2,9,155
668321554,11,3,2,1,17
668327832,62,3,2,1,68
668343695,73,20,26,12,131
668365476,68,31,3,3,105
668370200,134,3,2,5,144
668371662,40,18,26,2,86
668402546,219,3,2,8,232
668413033,130,45,94,22,291
668417509,73,24,2,3,102
668423158,129,27,2,18,176
668431174,39,27,21,1,88
668458012,13,3,2,1,19
668474320,74,3,2,1,80
668476599,11,26,2,1,40
668486398,57,3,2,1,63
668495590,94,19,11,2,126
668501010,162,19,6,3,190
668523953,18,41,30,2,91
668535352,40,40,4,1,85
668570129,10,3,2,2,17
668582310,248,3,2,9,262
668587684,172,32,9,3,216
668590764,88,91,26,17,222
668592808,232,33,36,16,317
668597381,60,17,3,1,81
668607537,44,20,3,3,70
668615261,29,19,2,3,53
668631820,125,36,2,1,164
668636912,91,3,2,16,112
668637393,53,18,21,3,95
668638009,14,3,2,1,20
668640082,60,5,2,1,68
668644826,78,28,44,5,155
668647939,90,20,18,1,129
668670719,93,7,50,9,159
668673391,13,3,2,1,19
668698978,117,8,2,6,133
668699738,44,16,32,5,97
668699863,163,65,22,36,286
668700911,67,5,2,6,80
668703491,36,3,2,1,42
668721070,61,46,2,5,114
668724528,16,3,2,3,24
668737359,50,37,53,1,141
668738941,30,5,2,1,38
668740297,34,28,24,4,90
668745428,40,14,6,17,77
668747260,106,76,35,3,220
668750427,15,12,8,16,51
668759721,92,3,2,7,104
668764119,55,33,2,1,91
668781206,15,8,2,1,26
668790599,49,3,2,1,55
668791580,46,21,25,22,114
668792060,55,33,18,2,108
668796122,12,3,2,1,18
668796134,35,13,4,9,61
668802078,14,5,2,1,22
668807656,40,23,5,4,72
668817927,65,47,5,3,120
668826532,13,3,2,1,19
668839662,15,3,2,1,21
668841802,46,8,4,1,59
668850662,159,37,3,1,200
668861788,176,27,2,10,215
668873358,58,27,5,7,97
668873657,75,17,13,7,112
668876845,96,3,2,1,102
668890790,55,11,36,1,103
668921291,43,4,19,20,86
668928033,58,14,2,1,75
668928872,48,24,2,4,78
668938109,23,3,2,1,29
668940301,46,3,2,2,53
668972181,128,17,7,8,160
668973062,29,74,75,2,180
668982435,10,3,2,2,17
668986388,77,17,2,3,99
668986885,78,3,2,1,84
669020804,17,3,2,1,23
669025019,20,3,2,2,27
669028062,131,18,2,3,154
669035849,28,3,10,2,43
669037981,10,20,2,1,33
669053460,31,3,2,10,46
669072076,106,18,16,4,144
669090354,33,29,11,2,75
669104630,23,32,8,1,64
669108060,109,42,2,3,156
669116594,24,3,2,1,30
669127955,58,10,6,3,77
669134608,37,38,10,4,89
669135528,67,21,17,8,113
669139318,87,3,2,1,93
669145149,81,7,4,7,99
669154975,11,3,2,1,17
669162226,28,4,8,2,42
669169811,147,38,6,6,197
669184435,87,4,7,1,99
669189940,254,3,2,12,271
669203010,46,4,2,1,53
669222067,52,43,8,14,117
669229308,88,54,6,8,156
669241198,44,26,7,13,90
669253826,69,3,2,1,75
669254862,16,5,2,1,24
669254952,74,3,2,1,80
669256064,30,3,2,1,36
669265158,27,36,78,8,149
669272697,38,23,2,5,68
669286187,69,20,4,5,98
669290692,28,14,2,1,45
669322311,47,13,57,20,137
669325199,772,3,2,14,791
669325842,10,6,2,1,19
669329914,61,25,30,16,132
669330040,48,33,22,1,104
669339989,37,40,8,1,86
669347130,13,18,3,1,35
669350423,21,5,3,1,30
669355866,31,3,2,1,37
669356787,38,68,2,1,109
669357697,45,21,2,1,69
669369953,121,61,7,8,197
669383723,64,3,2,3,72
669388557,252,40,19,1,312
669390571,58,68,2,22,150
669402282,11,3,2,1,17
669406938,16,17,7,1,41
669417687,10,3,2,5,20
669417823,78,3,2,1,84
669420352,29,31,25,1,86
669424048,24,42,12,3,81
669426200,12,15,10,1,38
669426427,124,34,32,16,206
669440850,24,3,2,2,31
669456658,95,18,16,13,142
669456920,26,4,2,4,36
669468535,44,9,19,1,73
669479241,10,8,2,1,21
669480895,28,24,4,4,60
669491413,90,26,2,4,122
669495563,22,47,2,1,72
669502918,19,17,2,2,40
669509635,39,3,2,11,55
669518002,39,12,42,1,94
669525313,41,25,16,35,117
669532856,134,17,2,8,161
669543378,163,12,2,35,212
669554243,78,16,17,2,113
669556528,109,21,8,6,144
669584928,42,45,14,1,102
669591019,58,61,43,17,179
669591505,21,38,15,5,79
669599696,55,17,3,4,79
669600047,119,48,62,29,258
669600188,232,3,2,3,240
669601373,23,8,2,1,34
669603493,10,3,2,2,17
669603829,23,21,2,4,50
669610248,23,3,2,1,29
669659881,28,6,2,2,38
669668446,142,40,2,5,189
669668717,107,3,2,4,116
669678920,18,7,2,1,28
669699583,41,6,2,4,53
669712579,61,48,12,28,149
669724807,52,27,9,33,121
669729404,100,41,51,1,193
669736650,44,60,2,2,108
669738984,16,3,2,1,22
669744579,40,14,2,1,57
669745210,75,16,39,1,131
669758561,53,45,58,1,157
669762881,11,3,2,2,18
669769975,33,7,39,7,86
669779625,18,3,2,5,28
669784975,162,3,2,7,174
669785343,25,46,20,1,92
669792872,214,5,3,31,253
669795372,24,3,2,1,30
669811372,10,3,2,4,19
669821896,11,17,2,10,40
669822628,133,3,2,13,151
669823458,33,7,4,8,52
669826330,71,3,2,1,77
669829462,55,3,2,21,81
669832687,53,40,28,3,124
669849910,70,3,2,1,76
669850235,131,40,2,1,174
669870080,78,39,3,2,122
669874460,60,3,2,4,69
669877659,26,36,10,4,76
669880225,11,30,2,1,44
669902905,68,3,2,1,74
669911527,16,3,2,1,22
669913948,29,30,7,25,91
669942430,72,73,2,37,184
669946933,11,3,2,1,17
669958940,31,32,3,10,76
669961202,28,3,2,1,34
669965874,64,3,2,4,73
669968031,86,37,7,2,132
670001537,86,12,4,1,103
670002916,94,10,20,2,126
670015547,17,17,2,3,39
670023103,29,26,23,1,79
670024289,123,32,18,8,181
670030035,71,3,2,1,77
670048992,175,22,2,4,203
670050756,221,3,2,8,234
670061182,115,33,3,9,160
670061473,104,37,21,1,163
670070047,10,35,13,1,59
670072833,14,4,2,3,23
670089037,59,22,28,10,119
670092177,102,27,2,8,139
670104068,92,5,2,2,101
670105999,59,25,18,8,110
670111846,25,24,9,1,59
670118086,59,8,2,39,108
670124436,42,3,2,4,51
670130635,13,3,2,1,19
670144019,12,3,2,1,18
670146439,131,3,2,1,137
670158520,31,35,3,7,76
670164959,35,40,2,4,81
670167778,102,23,2,1,128
670170333,17,4,2,2,25
670183348,72,24,22,22,140
670195279,146,32,8,4,190
670208443,10,8,2,5,25
670218197,49,45,41,1,136
670221239,83,8,3,1,95
670227764,229,3,2,65,299
670232792,72,35,5,1,113
670239847,45,3,2,1,51
670241935,11,16,2,1,30
670245302,55,14,7,14,90
670270937,75,3,2,12,92
670274062,347,3,2,37,389
670275418,59,40,2,4,105
670280521,51,13,2,3,69
670289538,71,7,2,1,81
670303686,53,3,2,1,59
670304025,67,109,89,3,268
670305296,13,10,2,9,34
670316259,16,22,9,1,48
670320253,28,4,2,1,35
670330531,151,14,13,1,179
670333454,95,19,2,4,120
670337199,48,44,2,3,97
670338580,93,3,2,2,100
670338616,11,3,2,1,17
670339312,11,5,2,1,19
670367518,45,22,2,1,70
670387398,44,3,2,10,59
670393846,11,5,2,2,20
670403271,29,25,90,31,175
670405398,11,3,2,1,17
670408052,84,3,2,2,91
670408228,64,30,10,6,110
670408527,28,3,2,1,34
670418859,18,14,2,1,35
670427318,80,9,17,1,107
670430047,74,59,85,15,233
670434228,31,5,2,2,40
670443307,17,22,2,2,43
670461845,87,3,2,1,93
670462427,91,20,4,5,120
670467090,42,11,2,3,58
670485109,40,10,8,1,59
670485624,29,3,3,1,36
670487301,20,26,8,3,57
670488791,39,65,22,12,138
670494355,44,51,2,1,98
670515627,70,48,35,43,196
670525084,131,3,51,2,187
670530018,64,73,5,1,143
670537934,107,3,2,1,113
670542370,11,3,2,1,17
670544254,52,3,2,1,58
670552927,84,3,2,2,91
670561033,58,19,2,1,80
670568880,137,17,19,1,174
670583079,28,16,24,8,76
670594198,193,28,2,4,227
670597020,11,3,2,1,17
670625123,78,3,2,5,88
670636351,142,29,4,29,204
670667303,21,36,5,5,67
670670367,12,8,3,1,24
670713657,11,13,2,7,33
670729675,27,3,2,1,33
670736288,11,6,2,1,20
670747943,67,32,42,2,143
670756316,40,6,41,1,88
670760421,54,35,24,16,129
670769085,33,5,6,1,45
670813414,43,24,8,14,89
670816628,11,21,2,1,35
670817240,45,13,17,12,87
670823061,25,14,6,5,50
670823952,24,27,2,1,54
670829167,22,3,2,1,28
670829338,40,47,9,2,98
670830407,18,3,2,1,24
670834241,23,3,2,1,29
670847493,139,3,2,25,169
670859723,54,3,2,1,60
670870302,153,3,2,7,165
670879803,125,3,2,8,138
670888980,52,34,20,37,143
670922810,91,3,2,2,98
670938891,40,18,2,1,61
670939549,16,5,2,1,24
670941050,86,3,2,1,92
670947226,70,7,2,1,80
670956899,13,3,2,5,23
670958901,140,14,12,17,183
670961585,41,3,2,17,63
670961614,18,13,11,7,49
670962855,46,10,2,5,63
670985290,154,28,2,4,188
670986014,37,41,6,3,87
670997337,2425,3,2,9,2439
671007922,21,27,16,4,68
671008109,78,10,6,1,95
671010837,70,26,20,9,125
671012614,10,4,2,2,18
671033267,62,9,26,3,100
671043681,61,41,2,2,106
671053761,101,25,6,14,146
671066982,121,32,2,8,163
671075539,731,3,2,183,919
671075660,125,33,4,1,163
671085184,21,10,6,7,44
671098810,51,26,9,3,89
671103379,10,4,5,1,20
671104609,35,35,48,6,124
671110479,81,49,22,14,166
671115307,49,3,19,1,72
671116326,107,3,2,1,113
671136488,50,47,37,1,135
671147600,98,27,7,2,134
671149330,65,35,2,5,107
671156531,18,136,19,3,176
671156773,10,6,5,1,22
671199468,189,39,4,5,237
671216344,29,66,33,2,130
671219564,23,7,2,1,33
671224138,47,3,2,1,53
671228916,30,27,21,16,94
671231788,122,3,2,4,131
671255268,93,5,2,9,109
671268509,32,11,2,7,52
671272388,101,23,2,6,132
671278529,12,3,2,1,18
671280799,53,22,35,8,118
671286179,78,3,8,1,90
671293619,42,3,2,2,49
671298744,142,8,2,18,170
671307075,10,6,2,1,19
671334253,39,53,30,1,123
671337185,112,116,22,5,255
671345096,160,3,2,1,166
671350376,13,11,2,1,27
671351097,53,35,11,3,102
671351573,84,56,25,38,203
671353287,32,15,9,2,58
671361099,32,26,4,6,68
671365002,46,9,13,21,89
671387900,58,6,2,15,81
671391049,40,35,9,1,85
671399810,85,13,2,5,105
671399842,52,35,10,11,108
671406127,40,6,2,1,49
671424585,11,3,2,1,17
671448460,138,43,126,87,394
671451648,25,33,2,14,74
671452085,58,63,2,4,127
671462049,114,3,2,1,120
671472349,13,3,2,1,19
671476521,282,17,9,3,311
671479074,16,19,4,13,52
671488172,78,17,3,1,99
671495786,105,22,10,3,140
671501201,37,15,2,2,56
671524020,62,3,17,1,83
671537472,86,6,6,18,116
671555593,85,19,2,1,107
671559021,60,39,16,6,121
671563125,102,4,6,2,114
671577667,121,22,49,2,194
671598199,35,76,22,23,156
671621034,385,3,2,8,398
671644509,88,8,22,29,147
671670952,24,36,3,1,64
671681259,24,21,26,12,83
671685881,15,6,4,1,26
671686198,70,31,136,25,262
671691068,27,20,2,1,50
671696720,120,6,2,20,148
671696965,95,17,2,8,122
671716752,24,42,45,3,114
671719012,12,3,2,1,18
671722384,11,5,2,1,19
671725751,114,36,20,30,200
671730772,106,3,2,2,113
671732756,96,37,27,1,161
671743562,11,3,2,1,17
671748302,16,7,2,2,27
671764981,133,3,2,1,139
671768857,52,26,5,20,103
671772198,16,3,2,1,22
671776726,152,3,2,3,160
671798150,44,26,14,4,88
671811950,55,45,2,5,107
671813751,48,3,2,1,54
671815649,81,46,61,9,197
671818534,50,5,2,3,60
671828608,51,52,9,21,133
671831195,23,3,2,8,36
671831923,171,5,54,14,244
671840996,24,3,2,2,31
671845060,10,9,2,1,22
671853104,11,3,2,1,17
671854958,13,3,2,1,19
671857332,14,54,2,1,71
671864868,13,3,2,1,19
671866422,29,14,2,1,46
671871830,181,14,43,17,255
671876045,20,28,2,1,51
671876899,59,9,18,1,87
671892501,124,35,56,36,251
671896155,105,29,4,16,154
671910396,45,28,14,1,88
671917522,24,33,3,1,61
671929476,205,3,2,69,279
671939984,171,3,2,2,178
671942864,56,3,2,3,64
671951793,99,84,52,59,294
671957605,50,3,2,1,56
671962805,10,5,2,1,18
671972636,49,36,21,2,108
671998823,36,26,11,1,74
672003310,78,3,2,1,84
672022391,75,3,2,2,82
672023759,16,3,2,2,23
672024887,130,3,2,3,138
672034048,73,10,58,7,148
672034879,57,43,24,7,131
672041518,26,12,6,13,57
672073974,100,9,14,2,125
672085092,106,32,2,10,150
672090523,83,30,45,6,164
672102626,77,3,2,1,83
672119856,12,17,2,1,32
672125996,76,25,13,1,115
672129321,157,20,5,1,183
672131624,60,66,50,1,177
672132967,36,18,31,1,86
672133808,26,24,5,1,56
672136675,107,3,2,1,113
672139114,68,3,2,1,74
672155584,10,4,2,1,17
672158273,97,40,35,1,173
672175605,110,7,2,2,121
672191256,10,6,2,5,23
672198953,65,3,2,4,74
672210604,10,3,2,2,17
672210693,20,3,2,1,26
672217458,125,75,2,10,212
672223449,12,18,2,1,33
672243717,11,3,2,1,17
672262975,22,6,2,1,31
672268287,101,12,2,1,116
672273869,13,11,2,1,27
672293218,48,116,26,1,191
672295403,56,47,26,42,171
672301857,23,8,2,9,42
672315838,282,67,140,26,515
672316092,35,11,87,1,134
672316572,10,6,2,1,19
672316628,12,4,2,2,20
672320056,27,51,3,6,87
672335286,33,39,2,1,75
672340416,12,3,2,1,18
672346474,29,18,6,1,54
672351188,83,41,34,5,163
672359862,24,9,4,1,38
672361091,41,26,4,1,72
672377087,55,5,2,2,64
672422855,18,4,2,3,27
672425611,54,61,24,31,170
672427334,11,3,2,1,17
672432142,82,23,40,2,147
672436086,83,8,2,17,110
672445401,11,3,2,2,18
672455492,40,3,2,1,46
672462702,92,26,3,4,125
672466434,13,18,3,1,35
672466609,84,42,9,6,141
672474412,11,3,2,1,17
672495281,95,14,9,3,121
672496506,16,17,2,1,36
672504628,91,20,2,3,116
672504852,173,53,2,5,233
672510855,120,52,41,15,228
672516029,37,16,32,2,87
672518284,68,46,22,20,156
672522777,30,76,8,1,115
672525603,12,4,4,2,22
672543668,81,3,2,1,87
672547290,30,15,2,1,48
672571244,93,7,32,1,133
672574418,127,6,2,2,137
672576963,117,3,2,3,125
672577848,15,3,2,1,21
672583641,63,43,12,16,134
672606125,23,3,2,4,32
672613021,77,30,2,3,112
672623769,61,26,19,4,110
672636304,17,3,2,1,23
672637611,38,21,2,1,62
672653926,11,9,2,1,23
672661483,78,26,2,9,115
672664521,10,46,2,2,60
672669420,234,77,18,6,335
672671330,126,3,2,14,145
672680876,137,3,2,1,143
672681554,60,3,42,13,118
672689855,97,41,2,31,171
672710169,98,3,2,1,104
672710693,57,17,18,17,109
672718256,32,7,12,4,55
672722280,44,3,2,1,50
672731649,338,44,2,7,391
672741835,10,3,2,3,18
672743016,66,71,6,5,148
672750634,10,10,4,2,26
672770548,34,3,2,1,40
672771518,60,10,2,16,88
672823153,105,78,63,29,275
672829598,39,27,2,8,76
672832593,35,3,2,2,42
672839100,32,3,2,1,38
672845262,114,124,20,41,299
672848153,83,3,2,1,89
672858689,60,17,11,6,94
672859543,28,50,2,10,90
672876602,56,14,2,2,74
672879874,73,24,17,3,117
672880777,99,12,2,3,116
672886340,155,28,5,13,201
672894380,113,23,30,7,173
672937112,94,17,62,63,236
672938795,116,17,3,1,137
672954815,184,15,38,21,258
672968221,71,9,2,1,83
672974483,42,28,3,4,77
672982930,66,3,2,1,72
672985772,26,3,2,3,34
672990836,79,10,21,43,153
673016482,95,3,2,1,101
673033084,10,3,2,2,17
673038150,56,3,30,1,90
673052362,134,54,3,5,196
673062245,10,3,2,2,17
673066047,14,3,2,1,20
673076433,59,18,3,21,101
673080499,26,12,4,2,44
673085532,47,3,2,7,59
673117601,13,6,2,1,22
673122031,82,24,14,1,121
673124435,75,29,2,1,107
673128906,129,3,2,2,136
673140791,100,30,23,6,159
673147947,16,21,4,1,42
673161665,41,12,12,2,67
673171730,133,18,2,55,208
673180055,28,50,24,15,117
673185831,25,45,22,23,115
673205652,110,20,9,6,145
673211038,91,12,17,1,121
673226115,26,3,2,1,32
673228110,98,23,10,1,132
673233584,52,3,2,5,62
673239487,52,13,17,12,94
673253771,52,42,45,1,140
673267168,106,3,2,2,113
673273355,158,58,86,6,308
673280169,109,3,2,3,117
673280430,12,3,2,1,18
673284713,23,13,10,1,47
673286173,57,4,3,32,96
673286961,65,25,49,7,146
673291935,118,3,2,6,129
673300284,12,3,2,1,18
673318410,21,5,2,1,29
673321500,31,3,2,5,41
673354106,63,36,9,11,119
673369992,146,31,27,9,213
673392175,82,20,125,1,228
673410378,164,11,45,3,223
673415948,12,3,2,2,19
673421810,52,8,20,10,90
673426812,15,3,2,1,21
673446832,67,3,2,38,110
673448140,41,11,14,20,86
673476919,10,37,2,3,52
673477862,27,14,4,7,52
673479038,68,8,5,1,82
673479631,64,3,2,1,70
673480046,70,3,2,1,76
673491848,47,16,18,1,82
673495609,141,3,2,1,147
673501642,44,3,2,1,50
673504707,17,3,2,1,23
673506206,15,3,2,1,21
673508533,69,3,2,28,102
673513565,75,28,4,39,146
673515639,87,3,2,12,104
673520407,46,47,4,12,109
673521446,231,39,3,8,281
673521688,69,8,2,4,83
673532853,10,13,2,1,26
673532949,11,36,2,2,51
673533464,14,12,4,1,31
673552688,64,3,2,2,71
673578607,24,29,16,2,71
673593394,27,92,28,1,148
673628468,54,44,61,3,162
673644438,90,3,4,17,114
673654449,20,29,78,6,133
673676322,35,28,3,1,67
673681371,28,3,2,1,34
673690992,35,18,2,1,56
673720061,58,3,2,7,70
673723134,23,3,2,3,31
673738887,10,19,11,1,41
673749673,40,26,5,4,75
673782598,38,3,2,2,45
673794927,62,51,17,5,135
673798720,43,38,6,20,107
673801850,110,33,31,38,212
673823519,222,60,10,6,298
673827723,33,3,2,1,39
673843900,27,13,2,1,43
673844851,108,12,19,1,140
673852963,157,29,2,2,190
673855853,692,3,2,3,700
673862319,40,25,38,1,104
673874929,43,22,2,11,78
673878489,26,6,6,6,44
673889976,104,28,2,3,137
673891569,28,56,8,6,98
673897555,53,32,25,1,111
673907670,55,50,2,1,108
673933902,79,6,14,24,123
673952248,30,14,2,14,60
673953631,136,35,2,1,174
673970090,79,14,20,3,116
673973067,204,33,11,1,249
673976157,39,34,9,13,95
673978151,42,3,2,1,48
673985897,90,12,11,10,123
673988733,56,3,2,1,62
673993388,128,3,2,2,135
673996688,32,35,7,1,75
674004577,41,3,2,1,47
674006412,91,7,9,3,110
674013132,57,44,5,2,108
674022783,42,3,2,1,48
674030439,22,30,2,3,57
674036491,161,35,54,26,276
674043492,116,11,5,12,144
674049663,31,90,19,37,177
674051783,68,24,12,15,119
674070419,29,3,2,1,35
674082501,16,9,2,1,28
674098611,63,33,66,10,172
674104642,154,24,38,5,221
674116019,101,11,2,1,115
674121760,74,3,2,1,80
674126215,66,9,5,4,84
674131174,63,3,2,1,69
674158342,97,6,3,3,109
674160528,66,38,2,11,117
674171662,17,11,22,9,59
674174076,22,17,66,1,106
674177223,28,10,3,1,42
674194389,34,37,4,36,111
674210790,39,3,2,2,46
674228086,56,36,14,2,108
674269642,47,3,62,1,113
674274243,22,3,2,1,28
674283041,90,48,36,19,193
674286683,72,112,15,19,218
674292392,21,3,2,1,27
674294787,68,42,84,1,195
674296969,75,3,2,1,81
674312740,12,3,2,1,18
674320033,61,41,40,1,143
674329148,96,30,2,5,133
674334308,151,33,23,33,240
674339571,60,3,2,22,87
674348431,28,37,36,5,106
674394768,17,3,2,1,23
674407059,78,3,2,1,84
674424649,17,19,2,1,39
674428775,62,12,2,3,79
674470936,12,3,2,1,18
674482207,19,20,2,1,42
674484801,17,3,2,2,24
674491693,32,30,6,5,73
674492388,19,27,5,1,52
674501657,29,4,2,1,36
674516760,55,3,2,2,62
674518713,11,3,2,1,17
674519298,106,3,2,9,120
674524374,100,3,2,1,106
674550070,38,29,8,2,77
674559437,103,6,2,1,112
674568965,162,44,6,5,217
674581250,57,3,28,2,90
674587624,16,9,12,1,38
674615112,30,4,2,11,47
674617415,33,13,2,28,76
674633527,98,18,2,4,122
674658078,40,20,2,2,64
674667609,70,31,37,1,139
674670426,58,6,2,8,74
674673053,103,34,126,25,288
674694080,44,19,2,1,66
674706341,15,25,20,1,61
674711003,24,23,14,11,72
674716732,114,66,35,25,240
674739880,26,55,12,4,97
674745464,134,7,11,13,165
674763863,32,44,13,1,90
674764329,10,6,2,1,19
674769406,58,9,2,1,70
674783601,60,8,2,1,71
674791597,47,3,2,1,53
674802738,14,7,2,2,25
674806536,15,4,2,2,23
674806953,137,34,115,47,333
674817788,121,4,2,1,128
674823920,20,3,2,1,26
674824239,116,31,2,1,150
674825861,16,3,2,1,22
674827217,62,19,2,1,84
674830726,24,3,2,6,35
674831687,36,3,16,1,56
674846174,124,64,8,20,216
674846337,22,22,2,1,47
674846604,127,36,27,8,198
674847250,11,3,2,1,17
674849070,10,19,2,2,33
674883229,132,45,2,2,181
674886699,18,3,2,1,24
674898844,36,3,2,6,47
674899400,25,28,3,21,77
674905835,10,38,2,2,52
674908419,87,20,17,4,128
674908895,24,25,2,2,53
674910127,93,15,2,3,113
674932407,63,25,35,7,130
674936563,87,21,29,44,181
674976567,169,3,2,6,180
675007167,147,53,10,11,221
675008232,126,37,4,11,178
675013103,18,38,2,3,61
675021133,98,51,68,13,230
675028920,75,30,57,54,216
675033765,85,3,2,6,96
675037170,79,5,51,3,138
675055230,138,13,45,1,197
675056157,500,5,2,12,519
675056465,66,58,3,3,130
675057965,62,3,3,11,79
675058109,88,3,2,9,102
675092355,88,28,29,1,146
675111134,103,3,2,33,141
675111825,113,3,2,4,122
675114807,39,58,10,6,113
675124013,123,26,43,5,197
675137737,174,5,2,3,184
675149193,291,33,3,7,334
675151738,34,3,2,1,40
675163658,57,26,6,19,108
675164972,10,8,3,1,22
675171199,10,9,2,3,24
675172451,167,11,2,19,199
675187141,72,3,2,10,87
675189643,95,23,51,1,170
675196473,76,37,10,4,127
675206534,24,4,2,1,31
675209951,54,6,7,6,73
675216967,91,14,2,2,109
675225372,56,38,15,12,121
675233830,39,3,2,1,45
675235294,60,3,2,16,81
675249780,67,18,2,1,88
675260798,10,6,2,4,22
675261193,15,3,2,1,21
675278563,11,3,2,3,19
675317842,12,3,2,1,18
675318814,143,54,22,3,222
675339836,30,3,2,1,36
675355316,121,3,2,1,127
675367450,141,12,18,31,202
675372215,42,6,8,1,57
675381358,10,16,2,1,29
675383285,77,21,37,22,157
675394872,27,19,52,1,99
675402028,22,13,2,4,41
675406140,12,3,2,1,18
675420060,63,18,10,4,95
675423397,114,18,9,1,142
675431508,62,10,4,1,77
675432420,24,3,2,1,30
675441527,14,3,2,1,20
675449829,89,63,24,1,177
675453876,133,13,2,7,155
675454625,77,46,88,1,212
675470824,64,16,2,1,83
675473130,17,3,2,1,23
675474417,58,17,37,9,121
675474513,81,36,6,5,128
675475993,169,8,46,4,227
675491603,57,20,2,9,88
675519349,22,7,13,1,43
675523910,31,8,2,6,47
675525587,41,57,94,2,194
675534690,27,38,5,6,76
675538089,50,3,2,1,56
675542554,21,60,16,3,100
675544170,105,7,82,1,195
675554420,18,22,12,1,53
675564207,76,21,116,2,215
675572204,53,42,4,17,116
675577876,41,15,39,1,96
675582661,10,3,2,4,19
675585828,49,3,2,1,55
675599352,29,72,2,1,104
675609419,40,3,2,1,46
675609697,46,7,2,10,65
675613553,256,11,2,2,271
675628814,26,3,2,1,32
675640504,36,22,2,1,61
675642978,36,21,94,1,152
675644896,65,17,15,1,98
675648388,58,9,2,1,70
675657321,28,3,2,1,34
675665048,31,45,11,1,88
675667869,51,25,10,21,107
675675362,11,3,2,1,17
675693031,335,7,3,2,347
675702420,42,13,2,2,59
675715701,130,33,20,12,195
675722798,398,82,5,10,495
675750801,109,3,2,1,115
675754850,17,3,2,1,23
675764693,12,3,2,3,20
675765599,23,8,10,6,47
675783351,24,3,2,1,30
675783943,11,3,2,1,17
675792370,19,3,2,1,25
675792829,35,10,2,1,48
675795319,145,35,28,22,230
675797246,45,15,17,4,81
675797326,16,10,2,1,29
675813370,17,11,2,3,33
675815979,143,57,6,3,209
675816671,42,47,49,1,139
675833196,12,4,2,1,19
675833237,22,13,2,1,38
675843301,22,17,5,20,64
675845696,82,50,5,1,138
675846318,69,51,19,1,140
675851042,39,10,2,5,56
675851406,42,26,2,26,96
675853803,23,16,15,1,55
675857886,11,44,2,2,59
675872614,119,36,11,9,175
675895732,15,3,2,3,23
675902522,109,20,2,1,132
675904629,79,6,4,2,91
675906869,10,22,2,2,36
675912891,93,70,72,20,255
675928603,21,144,32,3,200
675940835,87,3,2,1,93
675956570,12,6,3,2,23
675956967,73,24,2,1,100
675967511,10,8,4,1,23
675979563,39,3,2,1,45
675980951,125,40,148,1,314
675991427,85,21,15,13,134
675993192,49,6,2,1,58
675997004,53,29,9,6,97
676001562,282,3,2,4,291
676008112,12,3,2,1,18
676014630,80,20,36,7,143
676019349,34,5,2,8,49
676026117,93,9,2,21,125
676028373,31,3,2,1,37
676031403,117,23,34,2,176
676034756,174,3,2,1,180
676037152,170,54,2,8,234
676039559,88,3,14,3,108
676061862,39,14,2,1,56
676071846,10,3,2,2,17
676077252,113,10,12,6,141
676086416,81,3,2,60,146
676087289,34,3,2,1,40
676094576,96,21,4,1,122
676098547,46,20,2,30,98
676123576,77,3,2,1,83
676127490,20,48,10,45,123
676137064,125,54,69,1,249
676138707,65,20,2,8,95
676149851,79,21,4,1,105
676150433,84,32,9,22,147
676153250,34,3,2,1,40
676157160,151,3,2,7,163
676171191,115,10,8,3,136
676179535,169,103,2,3,277
676186961,36,13,2,1,52
676202374,11,3,2,1,17
676202963,18,10,14,3,45
676207373,27,3,2,4,36
676216001,36,81,11,3,131
676227901,42,3,2,1,48
676240959,18,5,2,7,32
676249182,83,3,2,1,89
676263144,82,3,2,1,88
676264063,12,3,2,1,18
676268426,25,3,2,1,31
676275631,93,34,20,6,153
676285271,32,45,2,1,80
676290790,12,3,2,2,19
676296299,21,11,2,1,35
676322455,16,3,2,1,22
676324933,84,25,24,17,150
676345293,20,19,3,1,43
676345826,119,16,42,4,181
676350372,19,3,2,2,26
676350641,135,22,15,5,177
676352192,221,22,9,32,284
676358495,52,26,51,10,139
676378234,41,3,2,1,47
676383866,88,3,2,1,94
676387498,42,3,7,1,53
676388472,120,39,138,13,310
676399895,143,28,2,3,176
676406166,39,3,2,1,45
676414073,89,4,22,1,116
676426784,43,18,73,1,135
676428862,75,6,3,9,93
676443149,63,34,2,2,101
676448986,10,3,2,5,20
676458080,143,8,2,66,219
676467048,118,36,25,1,180
676471638,131,16,19,23,189
676476865,54,49,61,4,168
676497378,32,3,2,1,38
676501390,57,29,2,1,89
676509327,16,6,2,27,51
676511154,91,3,2,1,97
676512057,61,20,2,16,99
676559183,36,26,2,1,65
676562887,13,3,2,1,19
676589794,65,22,20,1,108
676596072,43,3,2,1,49
676596403,65,18,2,4,89
676600221,12,3,2,1,18
676600918,75,3,2,1,81
676605598,13,3,2,1,19
676605635,42,20,30,3,95
676638155,36,23,16,7,82
676642301,19,3,2,1,25
676651029,93,65,90,1,249
676667836,16,3,2,4,25
676668526,145,3,2,2,152
676680464,39,3,2,2,46
676687986,47,34,10,19,110
676689005,86,15,3,1,105
676698534,44,3,2,20,69
676701858,59,44,7,42,152
676704348,115,51,24,4,194
676710970,55,12,2,1,70
676711906,66,3,2,2,73
676717186,32,84,5,3,124
676745447,33,25,2,1,61
676767305,35,3,2,1,41
676770382,32,18,2,1,53
676775220,129,3,2,1,135
676779597,73,8,2,1,84
676788987,10,5,2,1,18
676800391,11,3,2,2,18
676808529,54,19,72,12,157
676820764,12,11,2,1,26
676821835,182,3,2,1,188
676842779,16,3,2,1,22
676877796,10,43,2,1,56
676877851,69,32,5,4,110
676879222,19,20,24,1,64
676880629,156,5,2,1,164
676882597,40,3,2,1,46
676883758,92,42,34,1,169
676891218,34,35,24,3,96
676895078,12,11,2,1,26
676917794,13,3,2,1,19
676927648,29,23,10,3,65
676930804,119,32,6,3,160
676930928,69,3,2,1,75
676932693,25,55,16,14,110
676935926,12,15,2,1,30
676954964,131,83,77,2,293
676970561,99,8,4,9,120
676970638,214,13,2,2,231
676981180,61,3,2,2,68
676982023,117,33,2,5,157
676989240,11,35,12,4,62
676994463,15,3,2,1,21
676995701,73,29,5,6,113
677002543,22,16,2,1,41
677004678,111,3,2,1,117
677012424,42,5,2,1,50
677014248,32,52,3,1,88
677038108,163,15,113,1,292
677040991,189,3,2,7,201
677046116,39,10,2,6,57
677060188,23,22,2,3,50
677065537,102,7,2,1,112
677068260,38,46,71,61,216
677073108,16,8,6,7,37
677106977,27,8,25,1,61
677133905,120,3,2,10,135
677140958,90,28,12,5,135
677141639,119,19,6,20,164
677141805,25,31,2,1,59
677142314,19,3,2,2,26
677149564,79,27,2,1,109
677159762,19,30,4,1,54
677176817,59,4,2,8,73
677186880,11,35,2,1,49
677190556,154,24,2,1,181
677195675,100,43,15,10,168
677203376,49,3,2,2,56
677206149,19,26,2,5,52
677209352,14,3,2,1,20
677209932,11,3,2,1,17
677220675,20,9,2,1,32
677232563,18,3,2,1,24
677233559,123,30,2,5,160
677236568,25,19,2,11,57
677237704,54,25,29,7,115
677252342,83,3,2,1,89
677253040,17,3,2,3,25
677277831,31,22,29,2,84
677288256,56,13,3,7,79
677294590,18,72,3,1,94
677301811,75,3,2,6,86
677310996,61,17,29,1,108
677313865,43,4,2,2,51
677316135,181,115,56,106,458
677332406,29,5,2,1,37
677347177,25,7,2,1,35
677353338,51,15,3,7,76
677374939,20,6,2,1,29
677380083,10,3,2,2,17
677391688,191,3,27,3,224
677416337,103,10,2,1,116
677430872,94,3,2,1,100
677442993,86,10,8,12,116
677458559,75,54,27,13,169
677462870,116,46,3,17,182
677464926,13,3,2,1,19
677470738,20,52,2,3,77
677478175,114,25,2,12,153
677486333,42,3,3,1,49
677509032,69,36,2,1,108
677509189,11,3,2,1,17
677517309,14,5,2,1,22
677519624,111,16,2,4,133
677524434,12,6,2,1,21
677534976,145,18,25,1,189
677537114,48,34,13,1,96
677551159,84,3,2,1,90
677560916,56,30,24,1,111
677565260,52,40,46,1,139
677570775,24,35,9,26,94
677582334,16,3,2,1,22
677583789,47,15,18,3,83
677586024,13,6,2,1,22
677587382,223,4,30,6,263
677612367,188,3,8,1,200
677613031,10,3,2,2,17
677618037,58,13,14,10,95
677622371,26,74,52,9,161
677644626,112,19,27,21,179
677645583,27,43,2,2,74
677649347,66,34,10,14,124
677659517,90,8,2,2,102
677659954,132,61,67,1,261
677665681,235,3,2,54,294
677669550,35,3,2,1,41
677672125,80,3,2,1,86
677672355,95,3,2,3,103
677681695,82,14,15,8,119
677683283,86,40,2,1,129
677696770,102,25,19,18,164
677703211,142,15,21,2,180
677704903,65,3,2,8,78
677711439,61,27,22,3,113
677715211,18,12,6,4,40
677727287,17,16,16,3,52
677727871,61,16,23,1,101
677731665,73,6,2,1,82
677748021,41,36,4,1,82
677759199,96,20,2,1,119
677760518,13,3,2,1,19
677763681,74,10,2,1,87
677766242,12,45,26,2,85
677773517,128,15,5,2,150
677776237,72,25,17,9,123
677779481,237,3,7,20,267
677790698,124,41,47,18,230
677803807,52,3,10,1,66
677819478,108,36,25,18,187
677820145,11,6,2,1,20
677824421,43,3,2,1,49
677824715,104,12,32,13,161
677831302,145,3,2,1,151
677838397,12,3,2,1,18
677842312,54,6,3,1,64
677864733,53,31,24,12,120
677885962,53,41,3,2,99
677906774,73,21,70,4,168
677907617,83,11,2,10,106
677934572,23,3,2,9,37
677941892,16,3,2,1,22
677960724,50,21,19,4,94
677963367,30,3,2,1,36
677967104,198,9,19,13,239
677975613,15,3,2,1,21
677979601,181,21,40,16,258
677995713,38,38,2,1,79
677996392,64,3,2,14,83
678006194,59,80,2,2,143
678007983,14,3,2,3,22
678008579,137,3,2,6,148
678014142,83,3,2,3,91
678019219,38,3,5,1,47
678024037,43,8,17,1,69
678038337,182,36,39,5,262
678039188,11,4,2,1,18
678040677,22,15,19,1,57
678050886,150,3,5,3,161
678054212,64,8,12,2,86
678060667,137,3,2,3,145
678066521,54,17,2,2,75
678079300,45,19,7,5,76
678099621,92,31,6,2,131
678102061,117,48,30,78,273
678107296,125,23,2,12,162
678107850,38,19,41,1,99
678108593,95,11,7,1,114
678110847,17,3,2,3,25
678127095,31,23,2,1,57
678142333,49,25,29,68,171
678143327,51,3,2,2,58
678151018,47,3,2,1,53
678166677,78,29,130,5,242
678169146,18,3,2,2,25
678174527,93,9,2,1,105
678175285,88,36,32,77,233
678183371,33,3,6,1,43
678197618,27,3,2,1,33
678203232,29,17,28,13,87
678221108,14,3,2,1,20
678225938,44,31,16,27,118
678232109,89,3,2,3,97
678237315,10,4,2,1,17
678251076,17,16,2,1,36
678254729,63,3,2,15,83
678264999,65,64,10,19,158
678270350,34,3,2,3,42
678271617,30,3,2,1,36
678271914,56,21,28,2,107
678280235,10,3,2,2,17
678294991,57,7,2,1,67
678304368,178,39,2,1,220
678304846,44,10,18,3,75
678315695,97,82,78,49,306
678317633,36,8,2,3,49
678321328,32,92,24,1,149
678322410,11,3,2,1,17
678329792,23,13,3,1,40
678334322,18,6,2,1,27
678337485,65,31,2,3,101
678346147,10,3,2,4,19
678349206,221,3,2,3,229
678356063,17,3,2,1,23
678368957,96,35,4,39,174
678379422,44,38,34,1,117
678391531,39,90,5,26,160
678397313,36,8,2,4,50
678415408,168,21,2,34,225
678438639,14,15,5,1,35
678445376,60,23,9,6,98
678449379,132,28,110,25,295
678468994,108,9,9,1,127
678472753,82,23,41,1,147
678479810,121,3,3,6,133
678492816,44,12,5,9,70
678494611,17,3,2,1,23
678519266,11,3,2,1,17
678526496,51,154,22,1,228
678577714,34,45,2,13,94
678581765,110,6,4,3,123
678581952,54,14,39,1,108
678582925,43,22,11,14,90
678591519,347,5,2,41,395
678600802,67,53,39,29,188
678607089,136,3,2,5,146
678608958,167,47,22,5,241
678614803,13,6,2,5,26
678616283,14,15,2,2,33
678616433,21,33,2,1,57
678618531,39,5,2,31,77
678632168,11,21,2,2,36
678642942,125,3,2,1,131
678666780,56,3,2,3,64
678679937,23,3,2,5,33
678695667,76,23,4,1,104
678700561,105,3,2,1,111
678720926,15,3,2,2,22
678729903,505,3,2,14,524
678733174,43,28,4,1,76
678739920,175,7,7,1,190
678743877,11,3,2,1,17
678756727,72,22,80,9,183
678772286,85,9,2,1,97
678793488,22,3,2,1,28
678805426,16,38,2,1,57
678812085,67,3,2,1,73
678824085,26,3,2,1,32
678825595,52,67,45,13,177
678826495,70,10,3,1,84
678838209,89,38,35,18,180
678840801,10,5,2,1,18
678850303,20,37,9,21,87
678857683,14,7,2,1,24
678875259,65,25,4,1,95
678877131,42,25,103,80,250
678898691,34,12,7,4,57
678918276,89,39,11,27,166
678922775,42,3,2,1,48
678924463,29,3,2,4,38
678929741,57,22,43,3,125
678947954,71,41,6,1,119
678968020,26,3,2,2,33
678969688,131,13,32,2,178
679016643,12,5,2,1,20
679017351,404,3,2,14,423
679022888,22,3,4,1,30
679033241,141,23,6,9,179
679046936,52,28,3,12,95
679052398,77,44,22,1,144
679064678,35,3,2,1,41
679070765,47,3,2,5,57
679075413,20,21,11,1,53
679090191,10,3,2,3,18
679093630,46,20,41,2,109
679116625,49,5,2,1,57
679123594,11,26,2,17,56
679127428,79,54,2,4,139
679131199,81,23,2,6,112
679139598,44,21,2,1,68
679150963,95,52,12,17,176
679152049,36,47,2,21,106
679158673,36,23,46,55,160
679168494,15,23,2,1,41
679172431,104,28,6,3,141
679175584,20,7,2,1,30
679186404,23,3,2,1,29
679187987,161,37,18,1,217
679190026,12,17,2,1,32
679194216,12,7,2,4,25
679218046,13,6,22,4,45
679224438,14,3,2,3,22
679228349,33,4,2,1,40
679230556,15,3,2,4,24
679240101,49,3,2,1,55
679245233,53,41,60,8,162
679246974,115,86,9,3,213
679251092,174,6,56,1,237
679255056,57,28,59,4,148
679278529,214,35,31,64,344
679291332,46,25,6,12,89
679295706,10,11,2,1,24
679304993,21,22,10,25,78
679309332,93,10,2,2,107
679313421,87,13,2,1,103
679323445,165,3,2,3,173
679327140,91,12,3,1,107
679329396,221,31,8,6,266
679335658,159,22,65,2,248
679337328,22,13,2,8,45
679345154,49,3,2,1,55
679349922,370,3,4,29,406
679353108,125,3,2,5,135
679365962,52,3,2,5,62
679370180,52,16,8,1,77
679382452,57,28,15,4,104
679387630,26,9,2,5,42
679391797,11,20,6,1,38
679406368,43,20,2,4,69
679412381,59,21,37,27,144
679421821,97,76,40,59,272
679422446,152,38,7,8,205
679429769,56,23,48,1,128
679434307,15,7,2,1,25
679434383,54,107,14,58,233
679439559,95,6,3,1,105
679439570,88,4,2,1,95
679442083,44,3,2,1,50
679452970,47,72,32,13,164
679454458,12,3,2,2,19
679471322,139,30,6,2,177
679474390,66,42,32,24,164
679487376,74,18,12,25,129
679489784,113,3,53,11,180
679491384,54,38,25,29,146
679496676,56,21,34,9,120
679519063,72,10,72,6,160
679521028,15,3,2,1,21
679525748,93,3,2,1,99
679541245,37,3,2,1,43
679544805,33,10,2,1,46
679544861,68,38,2,1,109
679559829,17,3,2,1,23
679562934,27,3,2,3,35
679573967,45,23,15,1,84
679576190,60,7,52,43,162
679578487,109,24,28,17,178
679600653,65,61,144,4,274
679604990,55,15,2,1,73
679609654,36,10,2,36,84
679615574,56,19,34,7,116
679618373,83,40,2,1,126
679622407,12,5,2,1,20
679643723,12,4,2,1,19
679663019,23,7,12,10,52
679678692,90,7,7,1,105
679689243,11,17,2,2,32
679712590,23,18,3,71,115
679737262,313,3,2,7,325
679745476,10,6,2,1,19
679752338,13,3,2,2,20
679753279,133,5,2,2,142
679764293,90,36,2,20,148
679791700,149,31,2,10,192
679803516,173,3,2,1,179
679817620,50,36,51,1,138
679826287,69,27,68,3,167
679832739,53,3,2,1,59
679835398,15,3,2,1,21
679845594,28,23,2,1,54
679916941,23,3,2,1,29
679932185,19,71,26,25,141
679948038,75,28,2,3,108
679950115,113,15,14,5,147
679950136,104,3,2,1,110
679961468,16,41,2,1,60
679968616,85,4,50,1,140
679993435,89,3,2,1,95
680000663,144,19,2,20,185
680002007,49,16,39,1,105
680003153,61,3,2,3,69
680004962,11,3,2,1,17
680006788,180,3,2,7,192
680035437,83,3,2,1,89
680037335,88,3,2,5,98
680038594,17,14,7,1,39
680043170,54,3,2,2,61
680043257,79,13,7,7,106
680051723,13,3,2,1,19
680053551,160,38,17,3,218
680059498,72,12,2,1,87
680063398,67,21,14,4,106
680083748,252,31,2,7,292
680086608,15,3,2,1,21
680090798,59,28,38,1,126
680098828,97,8,2,3,110
680103469,24,23,2,1,50
680112345,73,70,4,2,149
680123370,18,11,6,10,45
680142173,133,3,2,1,139
680153651,127,8,24,18,177
680158427,127,3,2,1,133
680165838,74,15,7,9,105
680182577,29,29,2,3,63
680184337,69,3,2,1,75
680189099,21,3,2,1,27
680200600,42,3,2,1,48
680201533,21,49,18,5,93
680205966,51,94,32,18,195
680223276,215,3,2,4,224
680227538,15,7,7,10,39
680230402,33,39,9,5,86
680230599,16,3,2,1,22
680239577,107,13,26,11,157
680245044,13,3,2,1,19
680253981,36,3,2,4,45
680275602,94,16,2,14,126
680281387,146,37,14,89,286
680286082,19,30,3,7,59
680286344,44,33,15,10,102
680295048,37,23,9,3,72
680309328,50,16,2,1,69
680309611,159,3,2,1,165
680312185,31,112,16,9,168
680312586,82,17,36,5,140
680317013,55,66,11,12,144
680337384,266,15,29,2,312
680339262,14,3,2,1,20
680346225,11,8,2,1,22
680350459,34,3,2,1,40
680380802,210,24,4,3,241
680385026,68,41,74,2,185
680385855,85,3,2,8,98
680403286,18,12,14,1,45
680407734,14,23,2,21,60
680426435,35,34,2,1,72
680436259,108,64,3,7,182
680457056,40,32,21,8,101
680462879,12,3,2,1,18
680467650,36,25,13,4,78
680469129,33,27,12,11,83
680483227,14,5,2,1,22
680500429,69,36,31,6,142
680508118,69,15,9,14,107
680510737,68,3,2,3,76
680516616,106,3,2,2,113
680546256,161,3,2,3,169
680554584,56,47,181,8,292
680599490,231,40,17,15,303
680610344,19,36,42,7,104
680619435,84,3,2,3,92
680636234,55,36,23,6,120
680651827,47,22,2,1,72
680654953,135,16,52,12,215
680657090,162,7,4,1,174
680657422,11,3,2,1,17
680658700,13,36,6,5,60
680670146,111,18,30,34,193
680678255,44,56,21,2,123
680685897,24,10,5,13,52
680686473,140,3,2,1,146
680687797,21,16,2,1,40
680691912,13,3,2,1,19
680693091,18,29,2,1,50
680727778,15,55,8,5,83
680742451,20,8,2,1,31
680745920,178,3,2,1,184
680746182,69,21,34,6,130
680768825,29,5,2,2,38
680777609,30,61,7,1,99
680789143,15,3,2,4,24
680806998,111,38,33,38,220
680831593,10,19,2,8,39
680832393,26,7,2,1,36
680836015,55,23,24,5,107
680842713,12,45,2,4,63
680848987,71,7,2,5,85
680851796,171,33,2,1,207
680857356,26,7,2,17,52
680862806,46,12,44,27,129
680868170,62,20,24,17,123
680882629,252,3,2,21,278
680896801,228,3,2,4,237
680906203,50,3,3,6,62
680919993,59,6,2,4,71
680922012,12,3,2,2,19
680922833,21,107,32,7,167
680930269,115,78,52,51,296
680933617,107,3,2,1,113
680939871,45,3,2,1,51
680947109,18,6,2,3,29
680963798,62,26,58,2,148
680992383,20,3,2,1,26
680993304,22,3,2,1,28
680999982,163,3,2,5,173
681005677,149,52,14,12,227
681014472,17,6,2,1,26
681031085,163,3,2,1,169
681032608,23,21,7,2,53
681039170,34,40,2,25,101
681041414,129,37,12,5,183
681043649,13,3,2,1,19
681044090,40,45,5,1,91
681069156,161,6,2,2,171
681086253,13,32,9,2,56
681089237,10,7,2,1,20
681091721,72,25,18,50,165
681107319,18,12,2,2,34
681113891,146,17,19,38,220
681123720,15,3,2,1,21
681124406,13,3,2,1,19
681125260,42,3,2,2,49
681125952,63,34,35,4,136
681138221,22,33,76,1,132
681157651,15,11,2,1,29
681159613,13,11,2,1,27
681184712,147,27,21,16,211
681188864,10,11,2,1,24
681194960,16,15,2,4,37
681200816,38,5,2,2,47
681217039,45,30,3,1,79
681231397,59,7,2,6,74
681233798,105,28,2,16,151
681238074,16,5,2,1,24
681245575,142,30,129,10,311
681255607,134,7,2,1,144
681268678,52,14,2,13,81
681281130,16,3,2,1,22
681285464,10,5,2,2,19
681316017,34,33,29,6,102
681320837,15,3,2,2,22
681327973,23,15,4,1,43
681338836,18,3,2,1,24
681349587,19,21,5,1,46
681360309,36,65,2,7,110
681364210,103,4,21,7,135
681364451,30,48,5,3,86
681383064,60,3,2,1,66
681385214,93,23,35,85,236
681410428,64,16,4,4,88
681412190,47,43,58,9,157
681413139,31,22,101,1,155
681415675,27,3,2,2,34
681431339,31,21,4,2,58
681433793,53,72,35,1,161
681448866,25,16,31,12,84
681455714,79,39,2,9,129
681457964,119,60,20,31,230
681467540,16,3,2,1,22
681490184,92,3,2,1,98
681491413,14,6,2,1,23
681491876,137,55,91,6,289
681523674,57,78,23,1,159
681524288,24,7,17,15,63
681531778,16,3,2,1,22
681532216,13,16,2,1,32
681538393,71,5,2,2,80
681550935,50,17,26,3,96
681559770,20,12,2,12,46
681561236,46,47,33,35,161
681572351,122,43,43,31,239
681573521,33,4,4,1,42
681580693,66,12,2,1,81
681580764,47,6,2,1,56
681581399,13,15,2,1,31
681626161,43,3,2,5,53
681632002,167,6,2,2,177
681639805,121,17,32,1,171
681651437,20,3,2,1,26
681654784,10,3,2,2,17
681655023,42,8,2,1,53
681671902,10,10,2,1,23
681675528,225,3,2,1,231
681684203,28,6,5,1,40
681693873,87,3,2,3,95
681741033,94,82,9,6,191
681741531,123,27,48,1,199
681742742,10,37,2,1,50
681809074,13,3,2,1,19
681811423,38,3,2,1,44
681835646,15,3,2,1,21
681869912,54,17,20,1,92
681873311,95,29,24,3,151
681875093,45,20,2,1,68
681877507,13,3,2,2,20
681887220,52,20,6,5,83
681908955,160,7,60,10,237
681912189,71,27,9,12,119
681921060,72,3,2,1,78
681926831,119,44,10,1,174
681932015,54,33,16,7,110
681942724,64,3,2,1,70
681953459,27,4,2,1,34
681978516,24,38,22,1,85
681981597,172,24,29,7,232
681998801,80,15,2,26,123
681999156,10,3,2,2,17
681999524,66,3,2,5,76
682009234,171,55,115,49,390
682015086,47,38,31,4,120
682016198,69,27,72,22,190
682024513,518,3,2,16,539
682026598,17,3,2,1,23
682035421,123,21,24,19,187
682036548,115,92,32,65,304
682061016,19,32,11,1,63
682064283,129,52,13,18,212
682070865,12,4,2,1,19
682073973,61,53,3,11,128
682078769,69,3,2,15,89
682107785,41,15,3,1,60
682108902,123,27,7,1,158
682110174,40,14,6,21,81
682118308,40,13,6,1,60
682121568,26,36,2,2,66
682126197,12,22,2,1,37
682157137,54,3,6,8,71
682169927,44,17,2,1,64
682176870,82,3,2,3,90
682180039,91,3,2,1,97
682197586,52,3,2,1,58
682204789,108,10,2,1,121
682206696,22,9,2,1,34
682207397,108,5,12,22,147
682218152,75,22,2,2,101
682227924,70,22,71,4,167
682259441,99,18,5,2,124
682259445,81,77,2,3,163
682267091,19,3,2,1,25
682272805,18,8,9,14,49
682278667,120,26,53,8,207
682282757,32,21,50,21,124
682283256,15,3,2,25,45
682309700,23,71,10,1,105
682329352,46,3,2,2,53
682335003,10,3,2,2,17
682341329,73,23,17,6,119
682364654,27,3,2,1,33
682372987,12,7,2,1,22
682387776,111,3,6,14,134
682390401,127,44,69,1,241
682409978,22,3,2,7,34
682416072,50,3,2,11,66
682417859,88,3,2,1,94
682422920,36,10,36,37,119
682422961,77,3,2,5,87
682425934,86,28,67,2,183
682430663,61,29,2,10,102
682439679,84,17,5,6,112
682441753,18,3,2,8,31
682442740,46,3,2,1,52
682452954,84,5,2,1,92
682460701,44,8,21,5,78
682463833,62,27,2,43,134
682469884,10,33,2,3,48
682473522,38,122,6,2,168
682476001,35,14,15,4,68
682482817,144,9,2,2,157
682494691,49,3,2,1,55
682518282,109,12,2,2,125
682520965,11,8,2,1,22
682527773,103,26,2,4,135
682543499,101,13,3,4,121
682547597,28,3,2,4,37
682550606,63,4,2,1,70
682557080,73,24,27,2,126
682559616,18,3,2,4,27
682586164,309,3,2,1,315
682588728,43,28,4,7,82
682594482,29,27,40,1,97
682598190,74,18,5,86,183
682600436,158,3,2,4,167
682603681,31,18,3,1,53
682632662,20,28,2,4,54
682650405,60,37,58,1,156
682668031,205,3,2,13,223
682689587,37,36,4,7,84
682694736,41,29,42,1,113
682696394,62,9,35,1,107
682701024,113,67,56,11,247
682701173,41,22,4,2,69
682706765,11,3,2,1,17
682715095,23,5,2,4,34
682717972,14,3,2,1,20
682720181,30,31,5,1,67
682726919,105,30,101,5,241
682733141,24,41,4,4,73
682744631,75,3,2,2,82
682746822,101,41,35,4,181
682752319,83,3,2,1,89
682765941,26,3,2,13,44
682767306,44,15,18,12,89
682768022,44,18,2,1,65
682774393,123,3,2,2,130
682776918,13,3,2,1,19
682787039,59,60,2,1,122
682809856,27,12,2,1,42
682831142,27,14,3,2,46
682837847,86,4,2,2,94
682852640,20,10,2,1,33
682888786,71,10,2,3,86
682889375,89,19,3,1,112
682898296,60,6,2,1,69
682943204,18,3,2,7,30
682952198,10,3,2,2,17
682972884,68,39,5,5,117
682981907,87,3,2,17,109
683002974,73,3,2,1,79
683010069,44,3,3,1,51
683020399,64,43,5,48,160
683030204,30,8,2,2,42
683032240,41,45,5,18,109
683034663,94,89,63,3,249
683053940,10,5,2,1,18
683057317,178,3,2,2,185
683066213,99,29,2,22,152
683066652,56,28,2,17,103
683079389,34,3,2,1,40
683081644,77,3,3,14,97
683098676,106,29,22,1,158
683108697,52,42,25,7,126
683137249,27,4,2,1,34
683146128,27,3,2,1,33
683157457,139,15,2,6,162
683160331,48,21,2,1,72
683166114,20,3,2,2,27
683166569,11,3,2,1,17
683170601,63,39,9,3,114
683199433,105,8,2,2,117
683202936,62,24,21,4,111
683203060,10,6,2,1,19
683209040,112,3,2,1,118
683212222,44,3,11,2,60
683220435,42,3,2,7,54
683230076,77,3,2,1,83
683251198,67,3,5,19,94
683261210,16,3,2,1,22
683287694,12,16,2,1,31
683290390,49,3,2,1,55
683295640,116,37,20,5,178
683297019,131,36,131,4,302
683308940,18,15,2,1,36
683313804,19,3,2,1,25
683314443,14,10,2,3,29
683335103,64,3,2,22,91
683351382,38,3,2,2,45
683357101,75,35,34,1,145
683377877,23,3,2,1,29
683386509,30,3,2,9,44
683396940,50,13,15,6,84
683397867,108,3,2,2,115
683402291,15,3,2,1,21
683411792,210,3,5,1,219
683419892,78,3,2,3,86
683436597,70,3,2,1,76
683441309,41,33,5,5,84
683453009,18,3,2,2,25
683463189,54,38,56,21,169
683463397,10,4,2,1,17
683482355,140,16,2,1,159
683498528,158,14,48,8,228
683506721,19,3,2,1,25
683506863,38,3,2,1,44
683510913,17,3,2,1,23
683511427,32,19,5,8,64
683513091,24,41,17,3,85
683522672,58,16,10,1,85
683534144,98,3,2,1,104
683534380,44,47,30,38,159
683552256,77,3,2,2,84
683564218,115,3,2,6,126
683570790,35,3,2,2,42
683575611,79,22,2,22,125
683576618,20,3,2,1,26
683579212,112,9,5,7,133
683581172,30,3,2,2,37
683583393,29,5,2,1,37
683592305,19,62,5,9,95
683593881,33,12,3,1,49
683605702,54,3,2,3,62
683607428,34,3,2,1,40
683626035,59,15,4,1,79
683630749,79,3,2,1,85
683638721,83,12,45,2,142
683669808,32,3,2,6,43
683671626,25,3,2,7,37
683688926,127,3,2,1,133
683697375,91,37,28,4,160
683724000,144,24,19,4,191
683729089,64,3,2,3,72
683732190,114,17,2,3,136
683732466,15,7,2,1,25
683733857,45,21,26,23,115
683738014,27,28,2,1,58
683747833,91,3,2,1,97
683750281,43,3,2,1,49
683762569,110,47,53,7,217
683788263,32,3,2,1,38
683805710,30,3,2,1,36
683818296,87,3,2,2,94
683819095,50,3,2,5,60
683849596,57,12,95,1,165
683850285,93,3,2,2,100
683858759,11,4,2,1,18
683871157,135,3,2,17,157
683872904,153,18,2,1,174
683873615,46,3,2,1,52
683876164,70,18,4,5,97
683883236,196,5,5,9,215
683889470,158,20,122,4,304
683917528,26,16,2,3,47
683917770,294,3,2,16,315
683918082,11,3,2,1,17
683942596,12,3,2,1,18
683953765,45,3,8,3,59
683961286,21,3,2,1,27
683964659,188,3,2,1,194
683973590,79,60,13,3,155
683973612,43,22,9,26,100
683988205,37,12,2,3,54
683989066,50,23,31,2,106
684022708,17,4,2,1,24
684040896,11,3,2,1,17
684045628,29,4,9,1,43
684053355,203,41,51,7,302
684060439,71,16,2,1,90
684090506,70,3,2,6,81
684097984,198,54,19,8,279
684101295,128,3,2,43,176
684102171,35,3,2,2,42
684111182,51,3,2,1,57
684113954,15,14,2,1,32
684129369,96,12,2,13,123
684134965,11,3,2,1,17
684147097,22,28,4,15,69
684148678,23,3,2,1,29
684150458,12,3,2,1,18
684163756,13,3,2,2,20
684165670,11,3,2,1,17
684166536,94,29,53,41,217
684172323,46,77,5,36,164
684184301,60,3,2,1,66
684206209,12,17,6,3,38
684214113,14,3,2,1,20
684225958,138,18,3,18,177
684234230,77,27,4,1,109
684240419,17,3,2,1,23
684247358,31,8,2,2,43
684251269,50,45,3,1,99
684259851,11,9,2,1,23
684262473,28,4,2,15,49
684264147,56,12,2,2,72
684268774,12,3,2,1,18
684277823,27,22,2,5,56
684282321,63,20,10,5,98
684290761,18,3,13,1,35
684291828,36,3,3,1,43
684293192,37,3,2,6,48
684295174,53,60,38,2,153
684319855,30,3,2,5,40
684325587,73,5,2,2,82
684331539,177,3,2,7,189
684345694,42,26,7,2,77
684351614,117,9,72,9,207
684353168,52,3,2,1,58
684355261,143,23,93,32,291
684364851,36,129,23,4,192
684369881,88,3,40,2,133
684372478,48,3,2,1,54
684373916,40,16,2,9,67
684375710,54,3,2,1,60
684377554,28,21,16,8,73
684391762,26,8,7,4,45
684396157,32,59,5,4,100
684402035,21,7,2,1,31
684411291,101,27,15,5,148
684428836,107,3,2,1,113
684436373,32,13,3,1,49
684436391,199,3,2,7,211
684451935,22,17,2,1,42
684467060,97,7,2,7,113
684477359,54,33,16,41,144
684480285,27,15,9,1,52
684489536,58,43,2,2,105
684496535,34,3,2,1,40
684505648,124,14,2,2,142
684545879,104,25,2,4,135
684554736,55,87,3,2,147
684556115,88,29,2,4,123
684565402,129,31,53,12,225
684570974,51,52,20,12,135
684579103,72,38,11,5,126
684598459,83,25,2,4,114
684599714,110,22,52,10,194
684622705,63,3,2,1,69
684623428,75,49,56,96,276
684628159,191,63,63,26,343
684640630,20,3,2,3,28
684650222,205,27,49,6,287
684651478,154,25,66,19,264
684660476,10,9,2,1,22
684664772,16,16,2,1,35
684680186,69,12,2,1,84
684680341,16,52,33,1,102
684686317,15,3,2,1,21
684693701,32,6,3,5,46
684706119,12,46,2,1,61
684709811,39,51,45,3,138
684712821,122,44,2,1,169
684719943,17,3,2,1,23
684724047,12,4,2,1,19
684736474,38,44,86,2,170
684738280,150,23,81,20,274
684738545,26,29,2,1,58
684740857,34,44,2,13,93
684749227,107,3,2,3,115
684759118,102,10,18,9,139
684762993,30,13,2,1,46
684764275,103,57,21,16,197
684789986,53,25,2,3,83
684797820,76,10,2,1,89
684803241,31,15,2,2,50
684840940,41,48,2,1,92
684843595,155,3,2,6,166
684851056,20,15,24,1,60
684865642,28,34,3,4,69
684866241,14,17,2,1,34
684870700,78,14,2,16,110
684882153,36,20,14,10,80
684888661,96,3,2,1,102
684889688,10,7,2,1,20
684902772,10,52,2,1,65
684906775,67,27,14,8,116
684906957,11,8,2,1,22
684917427,101,148,24,6,279
684923685,70,3,2,6,81
684930620,18,8,2,1,29
684938748,56,4,3,1,64
684941782,106,37,2,4,149
684944808,69,40,21,39,169
684978030,10,3,2,2,17
684986495,87,8,6,7,108
684989423,29,17,5,15,66
685002724,82,3,2,3,90
685013300,74,5,2,18,99
685021741,56,23,2,4,85
685022257,139,17,2,14,172
685024273,212,11,2,2,227
685030706,36,30,51,4,121
685038337,68,42,33,3,146
685073584,67,3,2,2,74
685079446,35,4,2,1,42
685091579,96,5,22,1,124
685099784,42,149,30,6,227
685113406,100,47,76,33,256
685135645,129,22,39,57,247
685137356,70,57,26,51,204
685142633,102,16,2,2,122
685144166,207,3,2,7,219
685146788,11,3,2,1,17
685146891,44,3,2,1,50
685158344,49,12,14,9,84
685184044,41,40,2,13,96
685187832,123,37,22,37,219
685192787,73,16,13,3,105
685213615,141,20,2,4,167
685238195,163,40,105,21,329
685242554,11,3,2,4,20
685246507,57,41,7,44,149
685249335,165,23,2,1,191
685249732,35,3,83,1,122
685251839,49,18,2,9,78
685261572,18,12,4,1,35
685269898,17,8,2,9,36
685273372,167,3,2,1,173
685295777,10,67,2,1,80
685307390,38,14,2,1,55
685323344,32,3,2,1,38
685344157,13,3,2,1,19
685344889,35,5,8,2,50
685350783,151,3,2,7,163
685351073,20,3,2,1,26
685376162,78,3,2,1,84
685397532,68,4,2,8,82
685415204,136,3,2,1,142
685425658,95,3,2,5,105
685429545,13,3,2,1,19
685432931,68,49,4,16,137
685454830,64,31,3,3,101
685461835,119,4,2,2,127
685466840,83,28,55,6,172
685471427,216,8,2,3,229
685479706,19,3,2,1,25
685482601,17,3,2,1,23
685502199,32,11,2,5,50
685518088,146,6,2,1,155
685548204,29,38,2,4,73
685553207,123,21,10,1,155
685568034,80,12,101,27,220
685569264,12,11,2,10,35
685592376,35,3,2,1,41
685626558,79,32,2,8,121
685627362,145,9,2,2,158
685634497,56,20,9,1,86
685634617,81,41,70,3,195
685651181,57,19,2,2,80
685667707,44,32,23,5,104
685671154,23,3,2,1,29
685682771,17,3,2,1,23
685692178,11,15,2,14,42
685696537,11,50,21,1,83
685697401,149,26,43,2,220
685701797,52,84,3,1,140
685707176,14,3,2,1,20
685713608,62,24,2,20,108
685730692,79,95,56,5,235
685745013,28,3,2,1,34
685755682,48,14,2,8,72
685766231,34,46,13,5,98
685777623,36,9,15,2,62
685785349,71,14,2,10,97
685790689,54,32,15,1,102
685798745,50,23,16,1,90
685807817,20,4,11,1,36
685813783,178,36,81,7,302
685846060,37,37,2,5,81
685858442,39,45,16,4,104
685860719,51,3,2,2,58
685877690,82,122,33,7,244
685878546,25,3,2,7,37
685888159,105,3,2,8,118
685890459,197,3,2,13,215
685891326,56,18,2,5,81
685899173,69,26,2,6,103
685900270,41,3,2,6,52
685911162,45,47,32,1,125
685920964,109,5,10,22,146
685936145,93,16,3,1,113
685939825,368,3,2,1,374
685942287,54,3,8,3,68
685951733,91,5,17,1,114
685952346,12,5,2,1,20
685953206,25,3,2,1,31
685986106,58,3,2,2,65
685989427,71,19,20,2,112
685996640,32,36,63,9,140
685998012,78,3,2,4,87
686000619,25,3,2,1,31
686018593,18,53,5,1,77
686032228,10,5,2,1,18
686034802,159,6,4,12,181
686044890,14,3,2,2,21
686045707,224,3,2,1,230
686047794,29,3,2,1,35
686074584,98,3,2,12,115
686077766,29,14,5,3,51
686083990,22,64,9,1,96
686086368,103,3,2,6,114
686098088,83,35,2,1,121
686101864,75,68,4,7,154
686122010,56,9,2,13,80
686133849,117,38,5,3,163
686153968,113,43,46,5,207
686158977,16,3,2,1,22
686162601,55,20,20,8,103
686163166,10,8,2,1,21
686170617,49,10,5,1,65
686188809,68,16,43,8,135
686205620,101,4,6,5,116
686214054,138,3,2,1,144
686226033,80,3,2,13,98
686237871,65,21,3,8,97
686246666,30,31,5,1,67
686253699,64,3,2,2,71
686265795,98,55,8,3,164
686267117,28,119,122,1,270
686272776,37,3,2,1,43
686276186,109,53,19,2,183
686288429,46,5,2,1,54
686306577,108,3,2,1,114
686316674,26,12,16,1,55
686318609,29,34,2,4,69
686320773,66,17,5,6,94
686354730,78,3,2,8,91
686370105,48,8,2,1,59
686377034,17,16,9,7,49
686378945,42,3,2,10,57
686384500,11,22,2,2,37
686392833,129,21,25,22,197
686400275,59,15,2,1,77
686419600,40,21,7,24,92
686435444,94,25,2,1,122
686438520,116,8,5,10,139
686441024,38,65,3,7,113
686447763,82,14,7,8,111
686451684,15,3,2,1,21
686452717,129,26,2,1,158
686473438,100,5,2,2,109
686508814,81,10,62,1,154
686511311,175,16,2,22,215
686515966,165,3,2,5,175
686517770,39,3,2,1,45
686518770,36,3,2,5,46
686524762,42,42,2,8,94
686526427,28,58,15,5,106
686533818,15,3,2,1,21
686546545,116,3,2,1,122
686550133,36,6,47,2,91
686551682,29,3,2,1,35
686574979,168,3,2,4,177
686575219,106,20,34,4,164
686583079,71,78,18,2,169
686590114,293,3,2,17,315
686609233,19,3,2,1,25
686611586,84,16,2,8,110
686616165,20,34,2,25,81
686618868,47,55,30,3,135
686622160,12,3,2,1,18
686640974,74,3,2,1,80
686644659,33,3,2,1,39
686655178,13,33,42,1,89
686659557,51,11,32,1,95
686662295,43,16,2,1,62
686675658,73,5,2,3,83
686676902,87,3,2,1,93
686686825,32,3,2,1,38
686686946,67,30,43,8,148
686689502,62,9,8,3,82
686698255,67,9,27,10,113
686700421,13,3,2,1,19
686710385,28,3,2,1,34
686715714,12,3,2,1,18
686715803,44,16,6,4,70
686717899,14,17,2,1,34
686722774,13,3,2,1,19
686723556,105,32,5,13,155
686725819,154,3,2,1,160
686758502,11,3,2,2,18
686766306,26,3,2,1,32
686786500,76,12,2,1,91
686796144,148,3,10,11,172
686797344,39,3,2,2,46
686800883,113,16,10,2,141
686804963,58,16,10,13,97
686806563,110,5,2,1,118
686807281,14,3,2,1,20
686819412,131,3,2,2,138
686822118,57,12,16,7,92
686825222,11,3,2,8,24
686825702,58,3,2,1,64
686828918,83,21,2,1,107
686829090,95,43,2,7,147
686832645,19,3,2,1,25
686835585,51,18,2,1,72
686886275,121,22,61,7,211
686896598,108,21,2,16,147
686898277,120,34,93,19,266
686906927,13,8,2,7,30
686944005,79,3,2,4,88
686948994,119,42,2,1,164
686954907,124,22,2,1,149
686957694,90,24,4,1,119
686960224,10,13,2,1,26
686969673,22,3,2,7,34
686978493,53,14,31,18,116
686997466,80,17,2,2,101
686997564,22,16,2,1,41
687003624,59,31,41,5,136
687007343,41,3,2,1,47
687010083,120,79,55,5,259
687019205,93,24,57,10,184
687023125,11,3,2,1,17
687023159,17,3,2,1,23
687036733,13,20,4,1,38
687061820,103,40,56,2,201
687063916,11,3,2,4,20
687076006,46,54,2,6,108
687080827,97,52,87,1,237
687086087,11,10,2,1,24
687090222,180,22,3,20,225
687091842,68,6,2,1,77
687092336,51,15,18,20,104
687108616,24,39,44,18,125
687116525,16,3,2,3,24
687139583,32,3,2,2,39
687157318,13,3,2,1,19
687197976,11,3,2,2,18
687200740,10,4,2,1,17
687202006,49,49,2,1,101
687205007,81,25,6,3,115
687222546,11,3,2,1,17
687238938,45,14,2,2,63
687242233,174,39,2,5,220
687244700,169,3,2,4,178
687259035,90,20,10,18,138
687265589,45,23,2,4,74
687266701,77,14,17,1,109
687287637,76,17,12,29,134
687287900,39,7,3,1,50
687291316,42,3,2,1,48
687292040,37,26,58,3,124
687300009,50,71,115,6,242
687305133,12,3,2,1,18
687315374,173,6,2,6,187
687320801,19,14,2,13,48
687327205,88,3,2,2,95
687372981,26,3,2,1,32
687382438,79,6,4,3,92
687387956,35,5,2,2,44
687388159,50,70,2,1,123
687404420,23,3,2,1,29
687422999,10,6,2,1,19
687426170,72,61,3,1,137
687435624,53,3,2,1,59
687439239,11,16,2,1,30
687443987,131,3,2,1,137
687453400,86,3,2,5,96
687458497,65,38,35,10,148
687466415,56,33,2,1,92
687494835,50,3,2,1,56
687500430,17,3,2,1,23
687504598,69,22,33,27,151
687518359,124,10,3,6,143
687525686,51,46,2,10,109
687569396,72,3,2,23,100
687589797,77,3,6,9,95
687604805,89,53,11,33,186
687605155,37,51,22,1,111
687606474,148,40,13,43,244
687612508,106,59,70,32,267
687623430,30,35,2,2,69
687633407,85,14,3,1,103
687643859,42,12,9,1,64
687662963,116,9,17,19,161
687678641,105,7,30,4,146
687686288,81,6,3,5,95
687687142,109,33,60,51,253
687690600,106,45,6,1,158
687690619,23,83,16,1,123
687711453,11,10,2,1,24
687724430,54,3,2,5,64
687732119,164,3,2,17,186
687764799,57,3,2,3,65
687773904,46,39,16,3,104
687785121,129,10,6,4,149
687793960,11,8,2,1,22
687812643,73,3,20,1,97
687815471,47,36,16,1,100
687825571,93,3,2,1,99
687833133,12,3,2,2,19
687847929,44,3,2,1,50
687870830,101,89,58,20,268
687871892,57,29,10,1,97
687874133,41,10,2,7,60
687881048,33,46,42,2,123
687888635,147,3,2,5,157
687894490,47,3,2,1,53
687902950,71,32,40,22,165
687905278,16,9,2,4,31
687915768,262,3,2,8,275
687919473,42,14,2,1,59
687927121,34,3,2,2,41
687927442,99,80,68,15,262
687938574,35,3,2,1,41
687942971,97,3,2,1,103
687954149,79,3,2,1,85
687955398,41,3,2,9,55
687967191,57,37,14,13,121
687972483,75,15,30,3,123
687976580,101,18,2,1,122
687978246,16,3,2,4,25
687980556,17,3,2,1,23
687984529,75,11,2,1,89
688002823,12,3,2,3,20
688007094,141,27,2,1,171
688008236,66,21,4,35,126
688009931,235,3,2,12,252
688028667,34,27,2,1,64
688043806,74,3,2,8,87
688051559,116,53,2,67,238
688065905,68,40,7,24,139
688074111,30,31,7,1,69
688074136,63,3,2,1,69
688074729,39,21,8,1,69
688078979,33,3,3,3,42
688079827,109,3,2,3,117
688082044,60,7,2,4,73
688094784,60,3,2,2,67
688097137,26,3,2,1,32
688097437,57,55,2,34,148
688117825,42,12,8,1,63
688119473,12,9,2,1,24
688122496,63,3,2,14,82
688134558,131,3,2,10,146
688142813,14,7,2,1,24
688152306,33,22,2,3,60
688153006,118,3,2,5,128
688160050,29,71,33,29,162
688161263,115,28,63,38,244
688162984,53,10,37,33,133
688164066,14,26,2,1,43
688164795,235,3,2,1,241
688166617,42,3,2,3,50
688170518,96,13,2,4,115
688178421,151,3,2,1,157
688181390,89,5,4,6,104
688186205,140,65,2,1,208
688197571,29,11,23,1,64
688199565,83,3,7,1,94
688201964,58,28,31,3,120
688213405,78,21,2,1,102
688231448,12,3,2,1,18
688236550,72,35,47,1,155
688240831,340,41,32,22,435
688241750,14,6,5,1,26
688243939,109,26,6,19,160
688250013,17,12,4,1,34
688253496,65,7,94,4,170
688257169,38,63,26,5,132
688268495,13,3,2,1,19
688270307,13,3,2,1,19
688285796,13,5,2,1,21
688289150,27,28,4,12,71
688294906,80,3,10,1,94
688300661,50,33,43,4,130
688305078,141,50,25,4,220
688308312,177,69,14,13,273
688334699,12,3,2,1,18
688335196,12,8,2,1,23
688341205,27,3,2,1,33
688353591,70,7,2,1,80
688354933,28,3,2,1,34
688355665,85,46,22,32,185
688359146,69,3,2,7,81
688363422,12,27,2,1,42
688392222,21,4,2,4,31
688397365,69,3,2,2,76
688404690,14,18,2,1,35
688410079,89,25,22,79,215
688420121,85,3,2,1,91
688425223,12,38,2,1,53
688441204,47,27,35,2,111
688448664,23,3,2,1,29
688455575,11,3,2,1,17
688479633,56,41,3,1,101
688483101,62,37,24,7,130
688521775,46,66,49,2,163
688527672,102,3,2,7,114
688544254,24,3,2,1,30
688547960,46,9,13,3,71
688557669,21,11,6,6,44
688563087,22,3,2,1,28
688567995,111,3,2,2,118
688591767,52,15,3,3,73
688608830,11,3,2,1,17
688622272,29,3,2,2,36
688622946,16,12,2,1,31
688632694,15,31,2,1,49
688641294,116,51,52,1,220
688643248,14,3,2,1,20
688647604,10,3,2,2,17
688658422,10,3,2,4,19
688670277,89,61,39,27,216
688696266,119,3,2,1,125
688702414,106,3,2,3,114
688704116,11,3,2,1,17
688712315,10,13,2,1,26
688718943,62,3,2,1,68
688741746,16,16,2,1,35
688745114,54,22,55,6,137
688746383,12,3,2,1,18
688786197,93,3,2,1,99
688802486,19,5,2,1,27
688832866,39,14,21,8,82
688843468,43,3,2,6,54
688848417,45,80,7,13,145
688848647,137,3,2,5,147
688856781,145,13,19,25,202
688863825,139,3,2,2,146
688870776,67,3,2,13,85
688875568,18,4,2,1,25
688880678,57,3,2,3,65
688900118,61,20,2,2,85
688901872,238,52,7,61,358
688920610,57,7,9,2,75
688929360,14,5,2,1,22
688933108,36,25,9,1,71
688950375,51,19,2,1,73
688954267,31,3,2,1,37
688960252,22,3,2,1,28
688973187,17,3,2,1,23
688980736,79,51,38,3,171
688983131,54,3,2,3,62
688989803,11,3,3,2,19
688989844,11,3,2,1,17
688992155,161,3,3,3,170
688996600,29,44,12,4,89
688998944,54,3,2,1,60
689011790,29,11,2,1,43
689016784,92,3,2,1,98
689023469,71,11,4,5,91
689025821,35,27,11,1,74
689029740,71,13,2,1,87
689036537,237,3,2,1,243
689040519,25,34,2,1,62
689057173,28,30,10,30,98
689067939,127,15,2,1,145
689077087,45,80,72,5,202
689081622,181,66,2,1,250
689083099,74,34,2,15,125
689084566,11,6,2,1,20
689091916,81,32,12,12,137
689094296,66,28,4,13,111
689106413,30,65,17,17,129
689118177,31,6,2,6,45
689121754,67,20,3,56,146
689125938,284,3,2,14,303
689127874,46,32,2,3,83
689136135,37,25,27,61,150
689139366,46,20,19,8,93
689150451,31,4,2,3,40
689160662,105,16,16,10,147
689166657,73,12,19,19,123
689175420,12,12,2,12,38
689211623,74,3,2,1,80
689214383,64,32,2,8,106
689218584,26,3,2,2,33
689226496,14,3,2,2,21
689236545,85,39,51,23,198
689255625,38,3,2,1,44
689257738,105,27,17,1,150
689258127,38,3,2,5,48
689268839,32,3,2,1,38
689269409,35,7,2,10,54
689270230,98,28,3,1,130
689280471,39,3,2,3,47
689291307,83,48,2,2,135
689298180,160,5,2,1,168
689324187,54,3,2,1,60
689346231,128,3,2,1,134
689354621,91,91,20,12,214
689358619,15,3,2,1,21
689364124,10,7,2,1,20
689365697,11,3,2,1,17
689367722,38,37,40,48,163
689381332,47,26,19,11,103
689388276,30,3,2,1,36
689416620,10,10,2,3,25
689450826,24,16,5,3,48
689460914,32,12,2,1,47
689462458,10,32,49,1,92
689482876,212,3,2,2,219
689486314,84,45,56,3,188
689489028,36,9,8,1,54
689495876,76,59,68,36,239
689511693,74,28,54,2,158
689513224,59,3,2,1,65
689520393,29,29,2,3,63
689521387,169,27,2,2,200
689530583,174,3,2,1,180
689534453,209,31,30,12,282
689536829,136,63,17,13,229
689537344,41,38,19,1,99
689539332,161,27,53,14,255
689541515,55,30,45,1,131
689546422,11,3,2,1,17
689547531,26,37,2,1,66
689557012,175,14,40,4,233
689559047,27,17,2,1,47
689579803,37,7,2,1,47
689599471,10,6,2,1,19
689600939,23,3,2,1,29
689604809,139,12,21,3,175
689604879,138,3,2,5,148
689611490,131,30,30,3,194
689611670,15,27,9,1,52
689615897,27,10,2,1,40
689628988,11,3,2,1,17
689634933,31,10,2,1,44
689636382,64,13,2,2,81
689638706,15,15,2,1,33
689653247,28,32,14,4,78
689656080,60,36,24,12,132
689663257,25,10,3,6,44
689682560,21,5,2,1,29
689694208,73,3,2,26,104
689700199,10,4,2,1,17
689706036,92,35,6,9,142
689710161,106,4,12,1,123
689730076,83,48,2,7,140
689736030,26,8,36,1,71
689744037,57,3,2,1,63
689774841,111,3,2,1,117
689775610,67,5,2,1,75
689789150,17,3,2,3,25
689809107,31,3,2,1,37
689848886,74,8,2,1,85
689849492,65,17,7,1,90
689859738,38,14,12,1,65
689860880,44,21,18,6,89
689883651,105,3,2,4,114
689884785,87,14,2,1,104
689884791,23,28,2,1,54
689885304,56,18,14,5,93
689904717,21,55,19,1,96
689905708,57,43,2,1,103
689908889,33,6,2,1,42
689917130,45,17,11,5,78
689920450,49,7,2,16,74
689926117,100,58,76,8,242
689929631,182,7,2,5,196
689948406,38,45,2,22,107
689977900,16,3,2,1,22
689983336,64,47,2,2,115
689989055,128,3,2,1,134
689993111,65,4,48,1,118
689994458,109,3,2,5,119
690004466,58,5,13,1,77
690018345,154,3,2,32,191
690024881,12,5,8,1,26
690038722,60,24,7,6,97
690041888,81,17,2,3,103
690048905,10,5,2,1,18
690054667,146,3,2,1,152
690057073,65,13,2,1,81
690065345,56,25,17,1,99
690081718,76,24,7,1,108
690085145,108,38,15,1,162
690109094,16,16,2,1,35
690109706,65,6,22,5,98
690111741,84,18,2,1,105
690113292,15,42,2,1,60
690119657,87,14,116,15,232
690120376,142,81,46,1,270
690122942,95,3,2,9,109
690136684,171,65,49,9,294
690137978,78,56,60,15,209
690149021,55,25,2,4,86
690161257,37,3,2,1,43
690175725,15,3,2,1,21
690177081,36,3,2,1,42
690198859,56,28,14,1,99
690200855,85,19,40,1,145
690218430,73,13,12,2,100
690226624,108,3,2,1,114
690228024,17,3,2,1,23
690235522,11,3,2,6,22
690241294,11,3,2,1,17
690254379,35,3,2,5,45
690256263,73,29,2,16,120
690265172,28,3,2,1,34
690268603,55,7,33,5,100
690275924,10,5,2,1,18
690288634,48,53,5,21,127
690294017,18,3,2,1,24
690299589,12,3,2,3,20
690311096,24,66,7,6,103
690335734,94,25,13,20,152
690339875,66,18,3,1,88
690352426,53,4,2,1,60
690360703,26,3,2,10,41
690368351,10,13,2,1,26
690369684,41,3,46,1,91
690370306,216,3,2,8,229
690387977,136,21,2,1,160
690389864,32,57,2,5,96
690391372,324,3,2,1,330
690409665,35,11,2,4,52
690416655,70,3,2,19,94
690447798,90,24,2,3,119
690470388,31,26,22,25,104
690476450,14,3,2,1,20
690484877,12,8,2,1,23
690485292,12,10,2,1,25
690494030,67,30,2,1,100
690499221,60,12,10,5,87
690519393,15,3,2,2,22
690527481,110,3,2,1,116
690537910,92,42,5,1,140
690550624,40,47,7,3,97
690580841,25,13,2,1,41
690590548,51,39,30,21,141
690598915,43,44,16,1,104
690601817,16,3,2,3,24
690627140,105,3,2,1,111
690631237,102,3,2,3,110
690636314,42,39,3,4,88
690644920,21,3,2,1,27
690645594,73,142,61,28,304
690647671,44,95,2,7,148
690653124,122,31,3,16,172
690654731,77,21,7,29,134
690655212,68,3,2,2,75
690666098,49,8,4,1,62
690679768,20,3,2,1,26
690686217,42,3,2,1,48
690701779,42,45,2,34,123
690719482,107,52,4,25,188
690723171,82,26,4,1,113
690728196,79,45,30,1,155
690730241,44,5,27,1,77
690739931,103,4,4,6,117
690742320,45,3,2,1,51
690745016,108,3,2,19,132
690756855,95,3,2,4,104
690766509,16,9,2,2,29
690791759,72,20,23,11,126
690799347,109,3,2,4,118
690800088,18,3,2,1,24
690814753,35,3,2,1,41
690821427,36,3,2,28,69
690824762,138,47,7,17,209
690831003,26,3,2,2,33
690835287,29,18,2,9,58
690837041,22,4,2,1,29
690855385,91,43,64,3,201
690858289,152,3,2,8,165
690871083,25,32,3,4,64
690875345,231,25,17,2,275
690877518,17,3,2,1,23
690883881,99,32,22,6,159
690896260,10,3,2,2,17
690901309,45,7,62,1,115
690908770,25,59,21,8,113
690918697,28,3,2,27,60
690925667,58,32,5,8,103
690932324,26,19,2,1,48
690941461,118,57,35,11,221
690959362,38,34,20,1,93
690966217,96,3,2,20,121
690977266,43,4,2,4,53
690986618,453,3,2,3,461
691001510,57,3,2,1,63
691031555,72,3,2,4,81
691038193,37,3,2,1,43
691045164,10,5,2,8,25
691054262,10,6,2,2,20
691078352,57,45,2,6,110
691105977,51,23,18,1,93
691111472,23,25,11,1,60
691127436,13,55,20,2,90
691140178,30,48,26,16,120
691154566,34,3,2,1,40
691164380,14,3,3,1,21
691169466,99,7,23,44,173
691169788,20,3,2,1,26
691178069,45,25,24,1,95
691189427,58,3,2,12,75
691212987,42,45,9,3,99
691218058,74,24,37,3,138
691228828,99,19,2,2,122
691240782,70,20,6,38,134
691253707,41,3,17,8,69
691257936,30,3,2,3,38
691263639,94,16,3,4,117
691272492,119,38,78,19,254
691276426,52,40,86,13,191
691288673,19,3,2,1,25
691294390,45,24,63,12,144
691296451,28,21,11,1,61
691303565,58,26,6,7,97
691329329,60,3,2,7,72
691330423,76,23,15,5,119
691334986,10,4,2,1,17
691341241,117,52,114,1,284
691366251,105,51,25,4,185
691367391,137,23,74,19,253
691369612,66,57,45,1,169
691372591,195,3,2,22,222
691375351,23,4,2,1,30
691382166,94,16,13,1,124
691390127,75,70,26,28,199
691396555,334,125,87,8,554
691405089,52,23,14,14,103
691436733,177,62,34,15,288
691440357,10,19,2,1,32
691445328,41,15,2,2,60
691487294,49,22,21,8,100
691494848,151,19,3,3,176
691497308,100,86,3,15,204
691506238,182,3,2,3,190
691509982,116,12,32,4,164
691509986,31,3,2,1,37
691524822,113,3,2,1,119
691542742,75,12,8,7,102
691545490,64,29,2,5,100
691552134,172,37,2,19,230
691553655,145,31,26,7,209
691564253,35,12,2,1,50
691566437,129,3,2,23,157
691575515,12,3,2,4,21
691580094,90,36,37,1,164
691599144,52,47,30,1,130
691611580,42,3,2,1,48
691616524,39,3,2,1,45
691620425,65,25,2,7,99
691621811,470,3,2,19,494
691644349,54,37,27,18,136
691644686,18,10,2,1,31
691645139,28,3,2,1,34
691649473,55,14,2,1,72
691657670,14,3,2,1,20
691693936,12,6,2,1,21
691694504,54,25,36,28,143
691701703,66,24,2,7,99
691708049,14,3,2,1,20
691718152,58,14,4,5,81
691762231,21,3,2,1,27
691788934,106,27,2,4,139
691795106,150,3,2,8,163
691807653,66,34,2,3,105
691818601,65,72,14,11,162
691839796,48,3,2,1,54
691843691,186,18,22,5,231
691847319,70,8,2,8,88
691859135,47,38,3,21,109
691860413,12,11,2,6,31
691862773,13,9,2,2,26
691869323,84,28,2,5,119
691882694,72,13,3,3,91
691892045,175,57,7,2,241
691893399,134,6,28,7,175
691895833,26,14,2,1,43
691896950,160,17,12,2,191
691903014,195,3,2,67,267
691908376,21,3,2,2,28
691922233,51,20,2,6,79
691922749,17,24,2,1,44
691942188,38,50,2,8,98
691952662,41,14,10,1,66
691953870,20,16,20,1,57
691959507,13,3,2,1,19
691962930,39,46,6,13,104
691963042,49,16,8,1,74
691969196,31,7,3,1,42
691969425,20,13,23,10,66
691980677,17,35,2,1,55
691980989,26,21,2,1,50
691983887,25,3,2,1,31
691999053,53,3,2,7,65
692003854,33,21,3,3,60
692004111,40,3,18,1,62
692004503,127,35,10,3,175
692005356,15,27,23,2,67
692009546,21,33,23,5,82
692022594,105,3,2,2,112
692031149,138,3,2,2,145
692043247,11,10,2,3,26
692047871,53,37,2,8,100
692056436,43,3,2,5,53
692065562,10,4,2,1,17
692073357,97,45,87,23,252
692094161,74,3,21,1,99
692098229,58,9,7,10,84
692108463,152,21,34,64,271
692128293,10,7,2,1,20
692131451,55,3,2,3,63
692134796,51,5,2,3,61
692137061,19,23,4,3,49
692146224,16,16,4,1,37
692148884,44,16,4,1,65
692156192,25,38,19,1,83
692163556,33,3,2,9,47
692164082,139,37,39,23,238
692168073,86,35,42,2,165
692172373,10,5,2,1,18
692173517,127,3,2,2,134
692178284,85,3,2,1,91
692182220,28,18,2,1,49
692194107,129,3,21,1,154
692223004,101,3,2,1,107
692223323,71,5,11,2,89
692224436,54,55,27,21,157
692245535,22,3,4,4,33
692246400,46,8,2,9,65
692266944,37,28,10,4,79
692271818,16,3,2,1,22
692283025,62,7,2,4,75
692283524,548,3,2,83,636
692304373,148,57,2,9,216
692307489,21,15,2,3,41
692310174,59,5,28,1,93
692353066,14,3,2,1,20
692357180,79,3,2,6,90
692370552,22,3,2,1,28
692379672,82,7,2,7,98
692384742,61,12,2,9,84
692402551,64,28,6,14,112
692407991,32,57,6,9,104
692415726,10,8,2,6,26
692419051,71,18,53,2,144
692425859,35,8,2,15,60
692454748,108,15,116,1,240
692457043,40,16,2,1,59
692459439,162,3,2,1,168
692480486,80,5,2,11,98
692484164,38,3,2,4,47
692493342,122,3,2,5,132
692494272,18,37,2,1,58
692521108,36,3,2,10,51
692521519,138,35,2,3,178
692525244,86,3,2,10,101
692529076,38,44,3,11,96
692539984,128,20,3,2,153
692564444,64,35,3,1,103
692566464,117,24,2,2,145
692578032,48,44,27,30,149
692593075,49,34,20,18,121
692593115,140,25,31,15,211
692607019,14,7,2,1,24
692609995,34,3,33,1,71
692626241,77,21,47,38,183
692635176,155,15,2,1,173
692641770,43,19,4,11,77
692643188,250,14,7,8,279
692644573,22,32,3,1,58
692662022,373,11,58,12,454
692679901,42,9,15,1,67
692693494,117,25,12,5,159
692698107,23,3,2,1,29
692734154,28,3,2,1,34
692748248,14,7,2,1,24
692764358,111,20,29,56,216
692768157,31,14,21,3,69
692770097,43,9,3,5,60
692773253,76,50,36,1,163
692777366,15,3,2,3,23
692784034,59,9,39,1,108
692788706,116,33,8,3,160
692795731,125,3,2,1,131
692833217,10,3,2,3,18
692834870,161,3,2,91,257
692839106,36,13,2,4,55
692844369,35,7,7,10,59
692853253,61,18,4,1,84
692854927,293,3,2,29,327
692857981,44,17,21,36,118
692858687,12,20,2,1,35
692868404,111,14,49,2,176
692879937,190,110,3,18,321
692881046,12,5,2,2,21
692884660,19,3,2,8,32
692891912,122,17,71,2,212
692898671,16,3,2,2,23
692899198,27,11,2,16,56
692903152,88,3,2,1,94
692908482,32,50,12,1,95
692930130,65,4,2,5,76
692937970,125,30,49,2,206
692943115,22,17,4,7,50
692944813,234,19,2,8,263
692950066,56,19,2,9,86
692964822,156,3,2,3,164
692965018,36,3,2,6,47
692977870,17,37,2,1,57
692988182,20,9,10,1,40
692992753,273,3,2,3,281
692994632,23,24,2,2,51
693000871,128,7,20,11,166
693006961,16,12,2,1,31
693007428,116,11,2,1,130
693012843,37,3,2,1,43
693030498,37,3,2,1,43
693038728,104,32,18,3,157
693039919,29,22,36,1,88
693041244,148,102,52,11,313
693056793,66,36,18,1,121
693066589,53,22,2,12,89
693070578,35,19,3,3,60
693091174,29,28,2,2,61
693104460,68,3,2,1,74
693105501,47,43,25,10,125
693107774,19,12,2,1,34
693108954,44,45,2,1,92
693108990,33,6,4,15,58
693115142,55,34,3,2,94
693150663,16,6,2,1,25
693154813,122,13,5,4,144
693162235,78,4,3,1,86
693167527,35,9,2,1,47
693167748,43,3,2,1,49
693170837,12,13,37,3,65
693180834,24,4,2,1,31
693181253,63,71,22,11,167
693201318,88,3,24,8,123
693214235,31,37,6,2,76
693229188,12,3,2,1,18
693230554,149,7,2,2,160
693235092,185,51,67,2,305
693239207,51,14,2,2,69
693272265,58,55,2,1,116
693290367,127,6,5,7,145
693295962,18,16,2,7,43
693297453,63,8,5,11,87
693303104,56,13,3,1,73
693306678,25,50,5,21,101
693315904,57,15,8,5,85
693316766,54,35,2,4,95
693328919,15,5,2,3,25
693341868,97,17,2,2,118
693347172,82,12,2,18,114
693360062,167,15,2,3,187
693361897,55,3,2,2,62
693390973,13,14,2,2,31
693398438,113,19,87,15,234
693411270,122,4,2,1,129
693411894,117,15,11,1,144
693431046,64,21,2,1,88
693442520,40,3,2,1,46
693459070,11,3,2,1,17
693461634,300,11,2,38,351
693479346,29,4,2,5,40
693480352,46,3,2,2,53
693490596,30,35,13,1,79
693492261,107,14,3,35,159
693514228,82,3,2,3,90
693520026,40,14,2,1,57
693525182,22,3,2,3,30
693525784,94,12,3,1,110
693538175,59,51,32,19,161
693559187,53,63,108,35,259
693560082,11,3,2,1,17
693568196,62,14,20,2,98
693568197,92,15,62,5,174
693578262,11,3,2,1,17
693584127,58,35,10,1,104
693584361,100,35,2,1,138
693587939,39,59,16,11,125
693599387,29,3,2,1,35
693605445,18,16,2,1,37
693628714,82,16,2,26,126
693645843,16,16,2,1,35
693652712,83,57,33,2,175
693659294,128,3,2,17,150
693666167,29,91,11,27,158
693674702,29,21,31,7,88
693678418,74,23,27,1,125
693692021,82,3,3,1,89
693693661,37,21,2,3,63
693696074,109,3,2,4,118
693697227,122,47,8,1,178
693703463,42,5,2,1,50
693717329,16,20,2,3,41
693719135,54,14,2,12,82
693732618,46,29,18,2,95
693751787,66,9,12,5,92
693769100,22,3,2,1,28
693770794,36,3,2,1,42
693774862,41,48,2,1,92
693778995,121,45,2,6,174
693782265,11,18,2,1,32
693785048,258,3,2,1,264
693797985,115,39,18,10,182
693810284,24,98,3,4,129
693838001,18,3,2,1,24
693840068,10,6,2,1,19
693841449,10,4,2,1,17
693843195,41,9,2,1,53
693853153,74,8,14,11,107
693854447,28,3,2,1,34
693854788,49,3,2,12,66
693903729,13,11,2,1,27
693911610,124,7,2,5,138
693920271,20,31,2,1,54
693931511,26,3,3,1,33
693932982,72,34,60,28,194
693937166,77,21,2,12,112
693946564,14,3,2,5,24
693978102,29,34,5,2,70
693986003,28,24,2,16,70
693991754,41,3,2,3,49
693998629,49,3,2,12,66
694026482,75,3,2,1,81
694027978,11,3,2,2,18
694032454,18,5,2,1,26
694036023,66,16,33,1,116
694040801,95,26,75,1,197
694049769,76,15,44,20,155
694056605,73,76,20,2,171
694067292,18,42,2,1,63
694091652,57,10,62,3,132
694095075,90,130,47,28,295
694096241,46,4,10,1,61
694098143,10,4,2,1,17
694103644,114,15,27,10,166
694104547,92,26,31,5,154
694123578,62,22,2,10,96
694147148,40,3,2,4,49
694156720,118,9,23,14,164
694160837,84,10,69,7,170
694168703,34,30,23,8,95
694175405,83,3,2,1,89
694175551,13,3,2,1,19
694185834,11,3,2,1,17
694188637,88,3,2,1,94
694190765,92,19,7,26,144
694191480,108,3,2,1,114
694203467,14,3,2,1,20
694221476,127,3,2,2,134
694223740,47,13,3,1,64
694226297,116,3,2,2,123
694226802,174,32,11,7,224
694237443,12,10,2,1,25
694243814,53,42,2,7,104
694246488,29,21,13,14,77
694250094,11,3,2,1,17
694259380,14,18,2,2,36
694262896,62,27,21,19,129
694273363,30,24,18,2,74
694278822,73,38,48,2,161
694288051,40,23,2,1,66
694290911,41,3,2,2,48
694293739,10,5,2,2,19
694307647,104,9,3,1,117
694314686,74,74,3,30,181
694331847,12,3,2,1,18
694334025,72,20,6,1,99
694337672,112,3,2,1,118
694340444,36,67,2,1,106
694348962,20,4,2,3,29
694352729,122,13,3,3,141
694370008,50,3,16,1,70
694380312,51,22,30,39,142
694383922,103,26,49,14,192
694396593,37,26,6,1,70
694430145,65,7,2,1,75
694433790,85,3,2,3,93
694435062,65,24,5,10,104
694440749,17,24,2,3,46
694442684,14,3,2,3,22
694449702,82,11,9,4,106
694460837,53,30,36,1,120
694501045,72,3,2,3,80
694512946,13,14,2,1,30
694512955,22,7,2,2,33
694522466,89,3,2,1,95
694529407,12,3,2,1,18
694558192,159,6,2,2,169
694559952,144,10,2,1,157
694560164,156,28,135,5,324
694562069,11,14,3,1,29
694566375,16,4,2,1,23
694571461,77,4,2,62,145
694585664,33,24,2,2,61
694602030,83,29,2,7,121
694604706,13,3,2,1,19
694639576,92,19,61,5,177
694648210,24,48,4,1,77
694653484,33,3,2,1,39
694657940,14,4,13,10,41
694660323,31,31,2,2,66
694686869,51,12,2,3,68
694693582,55,3,2,2,62
694736536,73,10,2,1,86
694742628,51,43,12,1,107
694750715,63,31,2,12,108
694754029,11,3,2,1,17
694754274,68,3,2,1,74
694772194,27,3,2,1,33
694779281,18,3,2,1,24
694785812,92,15,54,4,165
694789454,81,44,61,2,188
694803359,33,36,42,3,114
694811163,58,3,2,6,69
694817998,79,3,2,1,85
694828091,10,3,2,4,19
694837293,150,4,2,1,157
694843696,71,31,23,8,133
694848105,36,14,2,1,53
694849662,35,22,3,5,65
694857388,93,49,25,8,175
694861835,96,3,2,1,102
694862017,91,20,13,3,127
694888551,39,28,2,14,83
694892950,44,33,14,4,95
694896330,82,3,2,6,93
694901749,77,15,4,1,97
694902576,31,6,2,2,41
694932228,11,3,2,1,17
694939843,49,73,2,1,125
694947883,89,17,17,3,126
694957187,51,19,69,13,152
694965209,48,8,6,1,63
694967536,145,32,39,5,221
694974732,105,3,2,1,111
694979946,186,31,21,18,256
694980030,34,3,2,1,40
694983503,53,20,31,1,105
694984956,35,25,2,1,63
694986809,54,63,10,14,141
694990736,13,21,2,26,62
694996279,12,3,2,1,18
694996376,184,21,11,1,217
695002231,66,12,10,2,90
695006720,12,3,2,2,19
695010554,11,3,2,1,17
695024441,102,27,19,3,151
695027646,39,51,5,30,125
695029565,135,25,73,25,258
695030121,94,3,2,2,101
695053292,56,23,5,4,88
695065274,37,46,21,9,113
695066554,36,42,51,2,131
695075964,12,3,2,1,18
695081302,24,25,5,1,55
695090064,202,29,4,18,253
695095106,13,3,2,2,20
695098797,85,37,2,4,128
695102060,133,28,9,54,224
695117746,10,5,2,1,18
695120686,17,12,8,1,38
695122568,18,34,2,5,59
695127527,58,19,9,1,87
695145916,69,7,2,1,79
695162940,98,3,2,1,104
695166201,91,25,26,14,156
695170422,11,3,2,1,17
695186887,171,14,18,10,213
695189195,19,3,2,1,25
695192818,61,3,2,1,67
695196466,81,10,26,18,135
695200329,48,84,23,5,160
695215260,50,12,3,1,66
695215454,111,25,61,1,198
695219172,45,3,2,1,51
695223260,105,8,19,2,134
695245147,151,3,2,2,158
695245767,106,33,29,41,209
695253208,73,42,3,13,131
695258387,47,3,2,2,54
695264417,40,27,2,3,72
695266677,10,4,2,1,17
695277007,60,38,2,21,121
695285830,45,33,22,67,167
695289325,125,3,2,1,131
695295303,39,15,37,6,97
695297772,94,3,2,1,100
695298503,61,13,2,2,78
695317376,185,3,2,9,199
695330140,34,24,2,2,62
695330317,76,14,2,6,98
695332892,115,3,2,2,122
695333949,99,36,2,1,138
695336934,113,39,102,4,258
695339388,65,3,2,1,71
695339752,17,6,2,1,26
695339950,23,7,2,1,33
695341849,180,50,23,11,264
695343509,121,5,9,3,138
695348190,36,3,2,1,42
695356891,72,3,2,8,85
695362297,90,3,2,1,96
695365778,54,3,2,1,60
695374879,227,3,2,5,237
695382014,166,3,2,2,173
695388081,83,19,7,13,122
695393409,59,6,2,1,68
695410053,14,3,2,1,20
695415963,130,14,14,10,168
695421690,38,3,2,2,45
695436996,29,4,9,3,45
695467428,243,3,2,5,253
695488379,10,4,2,1,17
695488888,78,3,2,1,84
695491328,97,3,2,1,103
695492236,12,7,2,12,33
695495178,111,42,32,20,205
695497405,59,3,2,2,66
695505195,53,66,20,10,149
695512934,43,10,78,7,138
695545155,15,3,2,3,23
695548375,11,3,2,1,17
695551074,84,6,7,4,101
695572499,11,3,2,1,17
695616620,26,13,2,3,44
695617693,49,6,4,6,65
695640945,103,47,5,46,201
695647878,113,40,51,3,207
695650541,60,45,27,11,143
695666959,10,11,2,1,24
695670413,26,10,17,1,54
695672058,18,3,2,1,24
695683305,90,3,2,6,101
695685025,11,3,2,1,17
695693175,51,15,2,11,79
695704909,55,41,25,40,161
695710448,28,21,4,1,54
695725316,44,3,2,7,56
695737923,18,6,6,1,31
695755432,33,45,2,1,81
695762802,24,8,2,1,35
695774271,41,20,2,1,64
695777714,84,35,18,8,145
695780024,18,14,12,1,45
695790203,83,3,2,1,89
695794196,42,22,16,1,81
695807445,101,6,11,2,120
695807861,90,9,20,10,129
695826742,15,3,2,1,21
695828335,86,10,2,1,99
695844966,32,25,22,7,86
695850641,475,3,2,1,481
695870274,142,3,2,45,192
695873155,103,25,2,13,143
695877443,127,73,9,39,248
695893668,15,5,2,4,26
695903354,124,15,18,4,161
695912443,46,55,7,7,115
695917991,204,84,17,1,306
695923514,23,3,2,1,29
695927970,35,16,2,1,54
695935320,105,3,2,5,115
695937233,45,3,2,32,82
695945180,229,14,2,26,271
695946113,202,47,3,1,253
695953647,18,3,2,1,24
695959242,145,3,2,1,151
695975000,32,3,2,1,38
695975026,12,13,2,1,28
695986229,59,47,37,2,145
695987090,118,15,9,7,149
695991527,75,29,65,5,174
695994281,16,6,2,1,25
696000411,32,40,15,3,90
696009530,67,43,25,11,146
696015943,80,43,25,2,150
696018111,27,3,2,3,35
696021665,134,7,23,4,168
696025377,50,18,46,1,115
696030085,56,7,82,12,157
696043355,68,3,2,3,76
696046272,36,26,2,7,71
696049663,58,29,57,10,154
696064314,106,18,99,7,230
696065348,104,24,51,1,180
696066333,10,7,2,2,21
696096207,68,3,2,1,74
696101052,154,3,2,1,160
696112099,28,16,24,1,69
696115841,76,20,2,1,99
696116437,67,46,88,48,249
696117096,11,11,2,1,25
696118295,62,29,114,1,206
696128724,78,3,2,1,84
696131949,16,32,29,1,78
696133667,75,29,56,30,190
696146188,14,4,2,5,25
696146307,39,23,65,56,183
696152251,119,37,69,35,260
696153278,51,14,103,3,171
696156880,108,13,11,21,153
696166790,50,3,2,3,58
696168914,41,3,2,4,50
696172169,98,14,2,1,115
696172834,23,31,3,6,63
696189049,14,9,2,1,26
696203695,69,3,2,3,77
696210731,142,25,111,69,347
696213398,81,3,2,13,99
696232312,95,14,43,3,155
696233278,16,48,19,1,84
696240705,68,33,32,36,169
696243770,159,3,2,7,171
696258365,97,3,2,5,107
696264129,93,30,20,30,173
696266753,11,6,8,4,29
696277900,83,41,31,19,174
696287344,54,3,2,1,60
696311881,18,33,10,1,62
696312765,110,31,2,14,157
696316500,59,35,13,42,149
696321593,156,59,2,47,264
696333217,78,5,2,9,94
696334564,13,38,7,4,62
696352416,15,3,2,4,24
696364499,64,3,2,4,73
696372376,98,30,13,1,142
696377942,25,30,16,8,79
696404369,117,17,47,12,193
696435287,44,108,5,8,165
696444658,37,3,2,1,43
696461008,21,67,21,27,136
696477712,20,7,7,1,35
696502405,77,15,67,1,160
696513762,12,3,2,1,18
696530276,155,3,2,1,161
696532243,39,11,4,4,58
696535304,15,3,2,1,21
696538229,44,42,2,1,89
696544564,99,25,54,1,179
696548627,23,3,2,1,29
696558646,11,11,2,1,25
696561314,18,3,2,1,24
696569744,18,3,2,1,24
696569892,42,67,9,13,131
696578455,30,4,2,3,39
696585571,38,16,10,7,71
696594227,60,5,2,3,70
696604188,813,3,2,12,830
696613646,149,19,14,1,183
696616609,64,3,3,1,71
696618023,15,62,37,6,120
696619266,17,3,2,1,23
696619836,185,3,2,7,197
696619938,29,30,7,22,88
696635412,64,3,28,2,97
696635641,95,10,2,1,108
696644761,90,32,2,7,131
696646155,18,12,2,1,33
696646498,93,30,11,4,138
696653414,59,12,2,1,74
696669948,15,3,2,8,28
696681627,110,3,2,4,119
696681768,60,49,32,1,142
696694107,79,23,12,1,115
696743003,36,97,24,3,160
696749924,87,45,43,2,177
696761893,14,23,4,1,42
696763661,37,11,21,11,80
696766361,14,29,35,30,108
696770517,110,27,2,5,144
696771389,62,27,11,4,104
696773802,51,72,8,28,159
696782048,95,17,38,11,161
696784420,30,3,10,2,45
696786946,21,3,2,1,27
696798810,12,3,2,1,18
696799389,57,21,2,2,82
696803377,16,11,2,1,30
696814309,25,3,2,5,35
696825754,90,7,2,6,105
696837110,48,69,39,21,177
696849354,119,4,2,4,129
696860820,43,43,12,8,106
696862878,21,88,9,1,119
696892639,126,3,2,1,132
696902818,99,28,2,1,130
696903691,32,11,3,8,54
696909814,62,34,4,3,103
696912796,11,3,2,1,17
696920544,101,16,86,8,211
696926337,122,3,2,1,128
696927323,75,3,23,1,102
696932273,45,19,5,4,73
696941718,127,18,68,13,226
696948165,11,3,2,1,17
696948965,23,10,3,17,53
696955618,99,11,29,13,152
696971177,35,17,12,1,65
696980408,47,21,10,2,80
696993432,43,3,2,1,49
697036937,47,17,2,2,68
697043453,106,33,2,3,144
697046097,32,43,4,3,82
697064381,31,42,2,1,76
697066309,86,15,2,2,105
697072774,23,3,2,1,29
697103273,74,27,29,13,143
697130799,122,52,56,15,245
697131694,65,5,2,1,73
697135419,52,12,2,1,67
697148530,72,8,6,12,98
697151185,38,49,29,2,118
697155471,59,11,2,1,73
697157894,60,45,54,19,178
697173308,13,3,2,1,19
697182348,93,59,93,26,271
697184847,62,8,2,2,74
697187564,81,3,2,4,90
697201724,20,3,2,1,26
697210436,35,10,2,5,52
697226308,142,3,2,1,148
697258841,20,3,2,6,31
697266606,102,10,3,3,118
697273832,190,54,58,6,308
697304916,69,8,3,8,88
697308990,35,15,5,1,56
697323347,36,33,12,4,85
697345125,94,18,2,1,115
697355534,22,15,2,1,40
697355723,44,26,12,3,85
697365970,45,3,2,1,51
697375593,66,25,29,3,123
697411369,19,3,2,2,26
697428468,42,3,2,1,48
697432083,101,3,2,1,107
697444312,12,5,2,1,20
697449569,18,12,2,1,33
697463825,87,33,10,52,182
697480911,34,38,4,3,79
697481681,71,4,2,1,78
697493596,106,3,2,1,112
697496970,101,9,4,4,118
697509431,20,39,2,5,66
697526234,57,3,2,1,63
697528935,108,15,2,18,143
697531763,48,33,2,3,86
697537275,69,3,2,10,84
697539758,65,64,40,2,171
697550379,43,23,5,10,81
697552158,83,14,2,4,103
697561921,16,3,2,6,27
697586465,10,3,2,5,20
697589533,17,35,2,5,59
697614828,63,15,46,27,151
697625180,31,3,2,2,38
697628320,44,6,10,1,61
697636812,12,3,2,1,18
697640199,30,61,4,26,121
697650346,214,3,2,1,220
697659746,112,3,2,5,122
697662040,93,15,6,1,115
697681945,61,3,2,1,67
697694636,55,27,2,2,86
697704338,61,18,7,35,121
697705985,56,15,26,1,98
697707795,212,43,10,10,275
697708868,168,42,12,7,229
697709957,31,38,20,24,113
697712307,13,6,2,1,22
697750879,128,21,2,2,153
697761617,110,48,61,22,241
697765227,116,16,2,9,143
697766287,23,3,2,1,29
697770739,11,3,2,1,17
697776555,40,17,18,5,80
697784663,118,30,46,46,240
697791817,149,3,2,6,160
697792834,53,13,7,2,75
697797459,31,11,2,1,45
697813019,37,4,2,9,52
697816782,102,38,78,10,228
697819677,13,3,2,1,19
697825893,96,58,48,13,215
697828675,111,30,47,13,201
697844804,29,15,2,1,47
697857668,175,36,35,7,253
697878648,15,34,16,23,88
697893316,95,3,2,2,102
697901373,12,6,2,3,23
697908895,142,3,2,1,148
697910323,52,3,2,1,58
697910447,19,13,2,6,40
697918824,38,36,16,2,92
697923947,51,3,2,1,57
697939219,15,3,2,1,21
697957824,96,10,2,1,109
697966694,30,84,46,8,168
697993152,51,26,6,13,96
697997428,169,8,2,1,180
698012987,35,31,14,11,91
698016093,23,20,22,6,71
698016625,36,43,9,4,92
698017089,54,16,3,5,78
698036206,120,3,2,1,126
698037988,140,4,16,12,172
698047857,126,32,19,1,178
698052835,97,22,2,9,130
698057700,10,12,2,1,25
698082185,38,29,3,2,72
698088155,46,3,2,10,61
698089854,98,81,26,10,215
698093502,13,3,2,1,19
698098623,11,3,2,1,17
698103886,116,99,53,8,276
698106943,134,34,8,4,180
698113872,83,7,22,7,119
698127466,80,3,2,2,87
698132661,11,6,2,1,20
698153474,12,3,2,1,18
698153555,47,24,13,4,88
698157812,61,4,2,1,68
698192207,10,34,2,1,47
698204542,107,3,2,3,115
698215122,48,4,2,1,55
698217090,17,3,2,1,23
698218820,36,55,7,3,101
698225730,123,50,15,1,189
698229113,85,10,46,9,150
698241792,21,3,2,1,27
698242671,45,25,18,2,90
698252571,139,3,2,6,150
698273513,30,4,2,1,37
698281127,31,19,10,1,61
698282489,87,3,2,5,97
698301936,92,11,3,1,107
698307509,70,20,21,1,112
698309360,16,13,4,3,36
698321479,23,3,2,4,32
698328378,96,10,2,5,113
698358503,11,3,2,3,19
698361013,142,9,16,82,249
698368314,63,16,2,1,82
698372982,86,47,18,8,159
698377335,48,3,18,2,71
698402235,81,3,2,1,87
698434243,130,13,2,2,147
698442673,12,3,2,1,18
698442957,81,3,2,1,87
698453456,57,27,9,14,107
698454030,19,5,2,1,27
698459577,118,19,3,1,141
698481795,20,10,3,1,34
698486526,14,59,2,1,76
698496588,70,22,6,3,101
698505083,31,64,40,8,143
698522059,12,3,2,1,18
698530208,30,16,2,17,65
698530965,66,4,2,3,75
698531846,16,22,5,1,44
698533305,24,3,2,5,34
698554584,21,3,2,2,28
698558296,58,30,12,9,109
698558637,115,47,90,9,261
698598423,83,3,2,11,99
698600831,35,5,2,9,51
698608658,135,3,2,35,175
698622947,52,3,2,1,58
698623637,46,39,10,25,120
698628707,166,24,24,1,215
698629854,74,32,20,12,138
698638149,30,33,2,3,68
698644689,43,3,2,2,50
698650043,43,10,53,2,108
698661510,102,18,4,13,137
698687858,56,56,125,1,238
698696277,38,23,2,4,67
698713298,73,7,2,1,83
698723276,150,66,2,5,223
698743338,16,4,2,1,23
698760982,24,3,2,1,30
698761661,10,3,2,2,17
698771217,117,11,3,1,132
698777784,81,3,2,1,87
698781901,51,8,2,3,64
698787573,87,27,6,34,154
698792216,24,8,2,2,36
698795758,32,25,2,4,63
698803897,19,3,2,1,25
698811263,10,7,2,1,20
698850241,70,3,2,8,83
698859194,177,3,2,4,186
698860420,47,13,3,11,74
698873759,51,25,2,1,79
698891345,83,3,2,10,98
698903818,19,13,2,1,35
698909634,26,4,2,1,33
698919701,162,96,26,16,300
698928336,42,139,2,1,184
698931133,14,3,2,3,22
698953909,205,40,3,17,265
698964166,28,110,20,4,162
698979825,62,3,2,1,68
698983221,253,3,2,3,261
699002687,95,5,2,1,103
699004017,60,33,2,26,121
699006333,20,3,2,2,27
699013187,102,49,84,27,262
699019947,125,28,6,15,174
699070881,77,14,18,10,119
699072654,41,11,2,3,57
699074811,34,47,43,1,125
699084981,103,3,2,1,109
699085421,11,6,2,1,20
699100389,187,3,2,1,193
699104234,28,3,2,1,34
699106434,62,23,4,21,110
699110076,85,3,2,1,91
699127863,84,3,2,15,104
699139017,61,33,25,117,236
699151593,58,3,2,1,64
699152387,14,3,2,1,20
699171047,56,31,2,7,96
699175797,18,3,2,1,24
699204597,102,3,2,1,108
699236439,74,5,2,1,82
699246582,56,11,21,2,90
699267301,23,3,2,1,29
699275368,38,34,28,8,108
699280614,24,3,2,3,32
699283974,67,13,2,18,100
699287403,119,19,39,23,200
699308053,75,11,42,22,150
699309096,10,3,2,2,17
699353953,42,45,2,1,90
699365025,12,5,9,1,27
699374731,26,3,2,1,32
699377989,25,68,2,2,97
699393152,21,3,2,2,28
699399954,723,3,2,7,735
699416669,56,16,47,4,123
699428075,38,36,28,3,105
699462759,27,12,40,1,80
699471360,11,3,2,1,17
699501506,164,10,2,13,189
699518401,39,3,2,1,45
699518732,38,18,29,2,87
699519020,23,11,2,11,47
699530978,66,31,3,21,121
699540633,72,25,2,7,106
699544560,120,3,2,1,126
699552800,100,43,33,1,177
699554229,113,4,3,1,121
699582886,93,10,2,1,106
699595913,91,3,4,1,99
699625357,16,28,2,3,49
699634911,104,20,21,19,164
699646973,64,13,9,1,87
699649489,27,3,2,1,33
699653854,15,53,2,1,71
699681069,14,3,2,1,20
699684667,99,3,2,1,105
699741660,108,6,2,16,132
699742797,11,3,2,1,17
699747622,53,73,2,1,129
699761339,45,21,103,4,173
699766043,373,3,2,2,380
699772060,114,50,3,6,173
699781329,20,16,2,12,50
699787079,52,26,16,1,95
699799310,115,9,2,7,133
699800241,30,3,2,2,37
699804155,44,42,6,1,93
699853834,68,3,2,4,77
699873608,73,48,36,7,164
699878622,111,20,61,2,194
699887510,78,4,2,1,85
699887537,125,23,2,11,161
699893048,124,49,13,3,189
699905879,20,42,2,1,65
699920238,119,42,18,1,180
699925790,15,6,4,6,31
699927817,44,34,60,10,148
699929865,49,67,49,56,221
699947258,34,6,2,5,47
699947858,21,3,5,1,30
699951642,66,34,7,1,108
699954594,41,3,2,4,50
699965463,13,3,2,5,23
699970030,91,3,2,1,97
699984790,78,11,16,2,107
699990367,20,66,59,3,148
699993323,44,14,34,6,98
699995169,63,69,4,4,140
700009710,26,12,2,1,41
700028454,96,27,2,2,127
700030797,149,20,2,1,172
700042675,17,6,12,1,36
700049229,85,23,2,7,117
700068048,87,3,2,4,96
700081386,76,3,2,1,82
700082718,65,5,6,86,162
700083247,31,26,35,4,96
700093543,100,65,33,46,244
700102518,38,9,2,15,64
700118175,113,24,2,22,161
700130580,30,8,2,5,45
700133817,23,26,2,1,52
700148956,85,22,14,3,124
700150200,52,38,4,11,105
700170942,78,24,43,9,154
700179089,243,80,4,3,330
700190557,14,3,2,1,20
700205491,108,13,33,11,165
700209310,67,23,27,4,121
700213684,66,3,56,1,126
700222271,47,3,2,3,55
700254324,141,40,64,3,248
700265983,76,11,20,1,108
700270095,30,17,95,10,152
700282652,133,32,4,10,179
700296633,19,7,3,22,51
700306320,11,3,2,1,17
700314019,10,14,2,1,27
700316278,119,37,2,2,160
700321742,166,34,3,11,214
700322202,74,3,5,3,85
700337107,34,31,2,6,73
700344022,59,3,2,6,70
700355471,49,16,2,2,69
700368815,46,17,12,3,78
700368998,11,4,2,2,19
700376335,13,3,2,1,19
700377444,180,3,2,5,190
700382134,38,65,18,28,149
700410872,11,3,2,1,17
700417196,32,15,14,9,70
700421841,12,7,16,1,36
700455860,32,60,2,7,101
700455920,133,31,74,34,272
700462059,11,3,2,1,17
700468775,15,7,2,12,36
700470622,55,31,46,9,141
700472620,270,3,2,1,276
700480828,52,20,2,12,86
700483880,103,31,10,11,155
700486908,20,17,2,1,40
700496828,19,28,30,2,79
700504164,36,3,2,1,42
700505195,10,7,2,1,20
700505662,70,32,77,1,180
700514945,132,3,2,1,138
700527348,121,3,2,2,128
700531110,92,71,6,4,173
700531717,33,17,6,9,65
700534594,80,15,22,18,135
700541239,125,3,2,6,136
700563704,78,4,2,6,90
700570124,10,10,2,1,23
700589180,77,78,65,65,285
700597027,59,27,3,3,92
700605409,14,3,2,1,20
700621935,32,22,7,7,68
700644781,21,3,2,1,27
700679784,14,26,2,1,43
700691366,135,3,2,1,141
700693641,52,3,2,1,58
700702931,52,17,2,4,75
700705038,18,36,2,4,60
700719274,53,3,2,7,65
700729784,12,3,2,2,19
700736134,11,3,2,2,18
700737059,10,4,10,5,29
700750093,67,3,2,3,75
700755330,188,3,2,5,198
700759472,241,28,2,2,273
700761107,37,3,2,6,48
700766933,71,3,2,3,79
700781414,276,48,2,5,331
700786759,17,22,2,1,42
700790522,10,15,2,1,28
700793940,17,5,2,1,25
700807836,15,9,2,4,30
700811881,47,34,37,45,163
700817176,11,10,2,1,24
700830757,65,29,14,33,141
700848389,41,3,2,2,48
700858984,100,40,9,16,165
700864330,12,27,2,1,42
700869546,60,31,10,38,139
700887038,44,6,2,1,53
700909296,57,25,39,1,122
700910159,53,28,39,2,122
700914271,95,43,23,5,166
700921174,50,19,13,17,99
700922147,60,14,4,9,87
700923644,77,3,2,2,84
700925684,28,3,2,2,35
700928658,189,3,2,4,198
700940684,16,49,2,22,89
700944612,134,28,11,13,186
700948244,47,6,4,2,59
700953801,96,49,115,3,263
700968174,72,3,2,6,83
700968413,25,13,2,1,41
700972874,10,16,2,1,29
700981460,35,49,26,1,111
700984450,10,5,2,1,18
701009019,67,26,2,17,112
701026786,23,3,2,1,29
701047345,118,3,2,3,126
701055986,54,64,4,1,123
701089829,10,3,2,3,18
701093915,28,3,2,1,34
701117513,13,29,2,1,45
701133175,80,3,2,1,86
701141909,99,34,96,21,250
701142001,139,41,8,1,189
701168325,38,3,2,5,48
701179372,112,3,2,4,121
701187240,88,23,4,9,124
701191698,46,14,9,2,71
701199570,49,25,33,1,108
701203158,82,87,94,45,308
701227555,10,3,2,2,17
701231654,188,3,2,2,195
701236996,19,3,2,10,34
701241175,160,3,2,1,166
701247084,128,15,87,16,246
701249945,46,14,5,5,70
701251148,76,19,19,11,125
701264724,171,12,2,11,196
701272328,49,3,2,1,55
701272591,37,31,21,9,98
701287253,47,53,8,7,115
701306519,71,10,3,9,93
701306757,57,13,2,18,90
701306937,18,12,2,2,34
701307834,68,3,2,1,74
701314418,74,7,2,6,89
701323698,12,3,2,1,18
701329345,13,3,2,1,19
701331210,21,3,2,1,27
701337888,48,6,2,1,57
701346977,141,40,6,4,191
701354427,19,6,12,10,47
701359318,24,13,17,2,56
701359582,65,33,3,6,107
701360905,57,10,2,4,73
701367087,59,68,5,14,146
701367407,55,12,2,1,70
701375912,15,5,2,1,23
701385035,62,18,2,2,84
701385341,179,29,17,47,272
701404502,38,92,4,5,139
701411064,22,3,2,1,28
701411189,28,3,2,1,34
701413874,20,3,2,2,27
701421154,74,69,25,5,173
701431255,55,18,19,5,97
701431397,41,12,6,12,71
701439163,16,3,2,1,22
701443553,12,3,2,1,18
701443639,164,7,7,5,183
701455797,146,15,20,8,189
701463736,38,3,2,2,45
701468398,43,58,2,1,104
701468628,64,50,2,6,122
701502608,58,72,2,1,133
701528230,98,14,2,24,138
701554268,172,57,12,83,324
701554752,19,29,10,1,59
701559218,27,52,2,3,84
701590713,18,3,2,1,24
701605730,40,30,3,1,74
701605840,112,7,57,5,181
701606742,10,5,2,1,18
701614943,63,3,2,1,69
701645573,111,74,2,6,193
701655509,49,3,2,1,55
701668923,93,3,2,10,108
701683542,40,17,6,1,64
701695763,68,23,18,8,117
701695960,198,3,2,1,204
701700485,46,26,22,10,104
701702127,106,23,35,14,178
701711001,11,3,2,3,19
701713872,184,3,2,1,190
701720693,61,49,13,1,124
701738959,173,3,2,11,189
701741032,103,3,2,3,111
701743162,132,26,3,1,162
701747198,208,11,2,1,222
701760939,15,3,2,1,21
701762767,96,3,6,3,108
701773184,55,30,51,16,152
701799228,101,24,46,3,174
701813273,86,16,4,1,107
701816443,134,3,2,10,149
701822544,112,3,2,30,147
701832078,35,21,2,6,64
701840419,70,17,4,3,94
701860365,128,20,8,2,158
701882180,14,3,2,1,20
701883420,25,13,12,34,84
701883452,131,23,9,5,168
701885074,117,3,2,1,123
701924666,73,59,2,1,135
701927019,11,3,2,1,17
701934400,118,39,25,25,207
701938424,57,25,7,11,100
701946708,51,3,8,2,64
701965100,58,3,2,3,66
701971150,122,3,2,22,149
701980594,12,4,2,2,20
701980955,11,3,2,1,17
701982743,34,34,26,40,134
701983546,92,20,2,11,125
702001225,53,7,29,10,99
702007277,64,23,2,33,122
702010809,63,39,2,4,108
702019811,59,6,5,24,94
702031302,15,29,2,1,47
702032735,88,3,2,1,94
702036088,27,13,2,1,43
702043187,62,3,2,6,73
702051064,49,32,8,1,90
702066458,10,6,2,1,19
702091893,65,66,21,6,158
702110553,69,3,2,1,75
702114657,112,10,2,64,188
702117439,40,3,2,1,46
702126780,18,3,2,2,25
702141827,57,3,2,5,67
702146496,13,3,2,1,19
702147920,193,18,2,1,214
702151035,81,6,2,2,91
702153374,17,12,2,3,34
702160760,90,3,2,3,98
702166559,17,7,27,33,84
702195906,110,17,2,1,130
702199788,14,3,2,1,20
702202494,24,3,2,2,31
702213175,57,16,3,9,85
702228895,85,3,2,1,91
702238605,128,8,2,1,139
702252602,134,3,2,2,141
702254696,110,3,2,13,128
702255202,48,39,8,8,103
702279605,29,5,2,3,39
702294118,18,3,2,1,24
702296010,13,3,2,5,23
702299774,30,23,3,3,59
702320436,21,3,2,3,29
702320948,20,17,2,1,40
702323164,159,19,21,43,242
702337079,103,6,2,3,114
702338922,23,3,2,1,29
702341356,64,30,19,38,151
702359797,112,37,5,2,156
702359993,44,3,2,1,50
702366739,31,14,33,1,79
702367542,10,7,2,3,22
702375478,11,3,2,1,17
702376908,11,10,2,22,45
702388776,16,7,6,7,36
702389629,55,15,2,4,76
702393194,12,24,2,4,42
702400130,40,51,2,1,94
702404482,79,57,16,7,159
702428601,58,3,2,4,67
702430680,67,22,31,7,127
702431513,17,23,2,1,43
702433961,115,21,9,6,151
702435137,75,30,2,17,124
702456725,70,3,2,1,76
702457769,156,3,2,10,171
702470339,54,8,2,1,65
702487673,46,3,2,1,52
702533582,61,27,2,1,91
702540285,41,51,2,2,96
702603605,37,17,2,1,57
702607439,91,14,2,5,112
702614769,28,15,2,1,46
702614825,13,9,2,1,25
702650076,11,3,2,1,17
702671637,40,19,12,32,103
702674356,20,13,2,3,38
702714994,37,3,2,1,43
702716886,108,3,2,5,118
702717019,92,3,17,5,117
702730332,78,29,3,4,114
702744472,233,23,22,4,282
702755667,39,20,2,11,72
702765280,38,29,11,1,79
702767330,189,26,86,6,307
702793712,76,23,14,9,122
702794374,53,3,2,1,59
702798197,16,19,7,2,44
702798880,13,11,2,1,27
702823209,11,3,2,1,17
702827151,22,7,2,5,36
702829129,95,21,2,2,120
702842662,178,31,3,6,218
702856011,52,52,34,8,146
702862154,50,12,2,19,83
702865118,55,59,15,1,130
702871640,71,17,5,1,94
702875059,30,20,3,4,57
702917432,201,3,2,3,209
702918579,37,51,37,27,152
702933450,33,34,21,17,105
702934725,14,3,2,1,20
702949908,96,23,43,68,230
702954413,132,334,142,9,617
702957480,155,4,2,3,164
702959962,196,3,2,3,204
702962135,13,3,2,1,19
702977184,128,3,2,1,134
702978975,37,9,7,53,106
702980722,45,14,2,2,63
702981106,51,30,5,10,96
702988054,16,8,2,1,27
702991332,11,27,4,1,43
703000416,179,6,2,1,188
703016935,67,39,36,1,143
703032444,10,7,2,1,20
703034396,40,35,2,1,78
703046891,71,22,27,1,121
703051326,109,15,79,12,215
703051498,60,3,2,1,66
703095301,121,3,2,1,127
703096580,91,7,2,1,101
703105899,66,3,2,3,74
703110320,56,20,6,1,83
703113588,46,30,17,4,97
703114110,10,9,2,1,22
703119557,16,5,2,1,24
703124286,22,75,2,55,154
703155418,69,30,2,1,102
703172165,41,3,2,6,52
703174726,27,27,9,4,67
703174764,63,20,18,18,119
703184822,82,13,5,2,102
703192249,66,12,42,2,122
703196506,115,3,2,5,125
703207701,32,42,4,11,89
703225289,81,21,21,21,144
703250963,31,50,2,2,85
703254687,120,17,32,24,193
703266619,23,3,2,1,29
703269263,105,18,102,1,226
703274599,32,3,2,11,48
703297580,15,12,3,1,31
703306818,23,35,2,2,62
703313631,103,3,2,5,113
703320784,88,3,2,1,94
703322007,44,3,2,1,50
703343405,10,8,2,2,22
703354020,19,6,2,1,28
703366831,99,24,2,4,129
703385921,31,11,12,3,57
703387140,50,3,3,1,57
703397562,86,15,22,3,126
703398232,138,23,28,22,211
703403168,51,25,2,1,79
703421160,165,101,41,21,328
703427689,14,6,2,1,23
703429396,133,31,20,9,193
703446136,75,29,62,11,177
703454826,43,15,2,24,84
703462389,119,3,2,1,125
703491395,45,3,2,6,56
703503853,12,3,2,1,18
703510029,27,25,2,1,55
703512517,70,3,2,1,76
703520273,144,30,3,2,179
703533576,55,24,3,2,84
703535976,34,39,3,1,77
703540322,12,3,2,1,18
703543847,85,5,2,7,99
703579957,49,15,2,1,67
703591253,71,19,16,6,112
703609538,21,7,2,1,31
703609721,36,34,2,2,74
703620949,34,18,4,1,57
703632680,31,97,45,1,174
703658890,20,36,6,3,65
703666834,95,3,2,2,102
703668914,29,3,2,1,35
703670505,36,9,4,8,57
703680897,120,24,17,24,185
703687398,97,31,11,2,141
703696536,74,8,11,7,100
703707997,10,13,3,1,27
703726032,92,3,2,2,99
703729989,14,3,2,2,21
703734825,27,13,3,1,44
703745792,51,9,2,4,66
703765149,75,11,2,3,91
703781700,75,23,66,3,167
703785766,43,3,2,1,49
703790410,51,16,2,4,73
703796224,15,3,2,1,21
703814418,21,3,2,1,27
703843034,35,53,3,3,94
703847633,12,3,2,1,18
703850542,18,11,13,1,43
703852263,26,18,21,5,70
703854693,86,47,2,8,143
703861962,13,3,2,1,19
703886358,128,68,22,1,219
703900671,31,40,14,1,86
703922161,133,63,2,5,203
703927157,17,13,2,1,33
703939540,17,6,2,1,26
703945159,75,3,2,7,87
703957511,12,13,2,1,28
703965068,35,54,2,1,92
703972065,37,6,2,7,52
703974365,148,3,2,2,155
703984273,27,20,2,1,50
703990245,64,3,2,1,70
703996478,58,3,2,1,64
704000162,48,21,24,2,95
704005726,24,32,2,1,59
704009652,151,3,2,1,157
704028422,354,3,2,1,360
704035133,143,3,2,1,149
704044841,104,41,2,39,186
704046538,45,5,25,2,77
704069501,71,3,2,4,80
704069885,12,3,2,1,18
704070998,57,12,7,1,77
704073975,40,3,2,1,46
704097633,52,25,36,1,114
704108219,124,25,3,13,165
704115730,16,3,2,1,22
704124207,51,59,3,2,115
704151812,52,3,2,4,61
704152587,129,22,2,7,160
704166202,15,4,2,1,22
704169015,158,28,2,1,189
704177645,221,3,2,3,229
704179123,105,26,8,6,145
704180450,14,3,2,3,22
704181750,130,29,36,5,200
704200199,63,25,10,3,101
704201484,76,24,18,73,191
704216649,24,5,16,1,46
704221754,27,3,2,1,33
704228606,66,3,2,1,72
704242188,32,25,5,29,91
704251763,169,31,3,1,204
704252727,44,33,2,3,82
704252796,109,11,2,1,123
704268383,47,3,2,1,53
704271719,48,53,19,35,155
704281583,140,3,2,19,164
704289581,66,23,6,3,98
704293173,97,27,53,1,178
704294266,11,3,2,1,17
704301275,57,32,29,4,122
704302654,86,3,2,1,92
704304593,94,26,42,2,164
704322772,78,32,29,2,141
704344698,70,110,132,11,323
704362770,16,3,2,1,22
704370736,52,23,95,33,203
704381671,139,16,2,6,163
704394147,55,3,70,5,133
704396837,41,98,13,6,158
704412757,15,30,2,1,48
704416470,26,30,12,1,69
704420192,50,31,2,3,86
704444296,26,38,18,2,84
704444384,44,32,40,12,128
704447906,40,19,3,1,63
704462856,24,39,24,1,88
704472530,32,9,2,1,44
704474243,56,32,15,15,118
704485886,44,27,38,10,119
704486216,32,25,2,7,66
704502703,13,4,2,3,22
704506308,12,13,2,3,30
704514368,72,4,2,1,79
704516187,38,7,18,6,69
704520315,13,3,2,1,19
704520635,162,13,2,10,187
704521639,151,15,70,31,267
704526008,25,18,4,7,54
704526405,35,46,23,1,105
704533195,87,33,5,4,129
704534789,35,29,2,5,71
704539130,139,3,2,5,149
704552411,78,26,15,1,120
704558185,55,10,2,10,77
704598932,19,41,9,1,70
704600057,88,58,138,10,294
704602779,91,3,2,2,98
704603171,43,5,2,1,51
704632769,15,95,14,26,150
704641781,34,6,2,7,49
704642739,43,16,2,4,65
704645482,25,22,5,2,54
704649797,107,7,2,12,128
704654727,45,3,2,1,51
704660199,117,13,2,11,143
704660201,43,3,2,24,72
704663312,113,47,2,1,163
704664488,58,16,2,2,78
704667081,13,3,2,1,19
704699204,11,4,2,1,18
704724331,15,3,2,5,25
704728794,90,31,2,3,126
704728972,55,42,19,1,117
704731274,80,18,2,1,101
704740020,80,3,2,2,87
704749057,112,19,37,43,211
704752724,11,3,2,1,17
704756300,125,78,74,38,315
704763895,196,21,27,3,247
704765462,100,14,2,5,121
704772897,186,36,11,5,238
704775214,50,3,2,1,56
704803775,82,21,15,9,127
704805158,11,8,2,1,22
704841502,42,3,3,4,52
704843530,22,14,2,1,39
704858607,53,55,49,9,166
704873270,66,29,2,2,99
704882487,21,3,2,1,27
704892467,63,50,22,2,137
704894560,47,13,3,54,117
704902968,13,8,2,5,28
704949897,294,112,45,72,523
704960464,47,39,10,6,102
704960491,45,27,12,3,87
704961835,22,3,2,9,36
704986198,102,20,2,1,125
704986218,58,3,2,1,64
704991291,50,20,2,1,73
704995782,144,27,3,5,179
704998212,179,3,2,2,186
705001719,23,38,3,1,65
705009252,138,3,2,5,148
705013760,20,17,9,2,48
705020945,16,3,2,1,22
705056078,10,12,2,1,25
705063270,106,3,2,1,112
705064589,108,21,2,1,132
705076611,217,13,85,1,316
705079022,105,35,3,4,147
705079251,20,3,2,5,30
705090186,42,3,2,1,48
705096172,114,30,72,1,217
705101390,68,3,2,1,74
705103256,83,11,18,1,113
705105584,93,26,4,1,124
705123738,203,50,80,54,387
705130175,16,3,2,1,22
705136007,15,33,24,4,76
705180897,13,3,2,1,19
705182853,57,3,19,1,80
705190640,16,3,2,1,22
705207907,30,3,2,7,42
705210420,35,8,2,1,46
705232153,114,44,15,1,174
705240616,33,34,48,23,138
705240908,82,3,2,1,88
705241587,99,17,7,2,125
705251715,57,20,3,1,81
705252159,99,5,2,2,108
705254772,45,33,46,43,167
705257964,11,3,2,1,17
705258270,60,39,2,2,103
705262862,21,3,2,3,29
705270417,42,4,2,1,49
705275287,67,63,59,16,205
705286383,12,3,2,1,18
705286904,276,20,2,12,310
705325071,67,3,2,1,73
705333979,120,31,31,2,184
705343371,19,5,2,2,28
705346900,24,26,9,2,61
705350223,34,79,3,4,120
705365290,91,3,2,1,97
705383289,42,21,2,5,70
705392254,184,15,33,1,233
705392811,10,4,2,1,17
705396948,95,3,2,1,101
705397882,88,40,6,8,142
705403577,67,33,2,8,110
705420011,149,10,21,11,191
705422977,121,64,31,17,233
705430335,145,17,16,8,186
705452938,92,3,2,3,100
705453033,17,3,2,1,23
705461514,16,17,2,1,36
705467518,51,29,7,1,88
705470571,23,10,3,10,46
705474835,111,16,2,1,130
705480660,16,3,2,1,22
705488276,102,52,104,28,286
705498232,69,9,2,3,83
705501791,76,33,25,17,151
705502353,42,3,2,1,48
705530520,62,25,3,13,103
705531095,60,17,48,20,145
705539430,20,3,2,1,26
705540519,57,15,2,2,76
705543541,425,3,2,10,440
705558874,119,3,2,1,125
705559488,17,16,2,3,38
705562655,16,17,2,1,36
705570981,28,3,2,1,34
705575379,59,3,2,1,65
705576711,184,28,2,12,226
705577439,175,3,2,3,183
705581015,10,3,2,5,20
705595236,67,17,5,1,90
705601782,105,4,2,1,112
705607302,86,3,2,1,92
705620851,13,37,2,1,53
705640841,40,8,2,5,55
705643075,42,108,7,171,328
705645618,41,34,23,1,99
705647790,41,53,4,41,139
705649560,50,49,32,5,136
705679748,54,3,2,1,60
705682264,65,3,2,6,76
705682554,11,3,2,1,17
705688317,104,3,2,1,110
705704456,52,17,2,17,88
705719298,110,16,3,5,134
705721365,95,14,16,4,129
705734607,97,6,2,2,107
705747658,10,4,2,2,18
705752219,52,29,17,1,99
705767775,11,3,2,1,17
705787880,70,17,2,1,90
705799972,14,3,2,1,20
705811266,10,3,2,3,18
705827955,25,31,2,1,59
705832107,22,10,3,1,36
705833139,30,24,9,2,65
705838588,125,14,17,1,157
705846501,57,11,17,1,86
705863251,25,3,2,1,31
705877530,12,3,2,1,18
705879904,19,3,2,2,26
705882245,96,18,15,20,149
705884044,243,3,2,5,253
705888523,109,69,7,2,187
705894747,10,6,2,3,21
705906765,18,3,2,1,24
705917824,201,3,8,4,216
705936495,104,15,81,1,201
705944877,42,25,17,1,85
705947379,25,10,2,4,41
705949903,73,12,2,11,98
705959191,84,11,50,5,150
705963262,382,3,2,6,393
705966351,39,5,2,1,47
705972077,100,23,4,1,128
705980652,115,24,6,71,216
705986652,49,26,2,9,86
705987360,84,32,38,10,164
706004935,61,7,3,14,85
706009145,34,37,14,2,87
706020739,60,11,4,5,80
706046944,14,6,2,3,25
706060598,85,26,9,1,121
706061758,55,33,11,5,104
706069884,138,3,2,17,160
706077713,94,24,54,26,198
706111910,57,42,27,3,129
706114232,25,18,2,2,47
706124187,50,12,2,11,75
706126431,66,54,40,14,174
706143116,24,18,2,6,50
706155480,12,21,2,1,36
706161120,216,18,41,1,276
706162273,21,7,2,6,36
706172391,17,16,7,1,41
706177440,25,3,2,1,31
706184868,62,34,140,2,238
706190172,283,3,2,1,289
706191460,75,3,2,6,86
706192249,65,8,43,7,123
706202020,11,3,2,1,17
706221210,83,20,49,33,185
706221527,11,9,2,3,25
706231305,93,6,2,1,102
706233384,66,15,7,4,92
706235995,10,16,2,1,29
706237350,139,3,2,1,145
706239373,57,54,33,28,172
706255429,14,6,2,2,24
706262858,49,12,56,26,143
706276883,34,3,2,2,41
706277068,88,36,2,10,136
706286624,23,4,2,1,30
706301499,30,4,2,1,37
706308428,86,7,9,12,114
706318690,61,24,61,2,148
706338378,10,3,2,2,17
706357019,28,3,2,1,34
706370196,11,6,2,3,22
706385891,60,26,10,8,104
706389856,46,12,2,1,61
706393449,30,19,23,1,73
706409159,177,3,2,1,183
706415642,123,8,2,14,147
706419967,11,3,2,1,17
706422129,94,3,2,4,103
706426890,129,39,20,1,189
706432146,33,3,2,1,39
706433483,47,3,2,1,53
706439748,141,11,19,10,181
706439888,11,3,2,1,17
706471247,79,32,2,1,114
706482145,58,28,32,1,119
706484825,34,3,2,1,40
706494477,22,17,2,1,42
706501779,129,24,3,2,158
706517326,124,35,36,2,197
706517781,251,24,6,1,282
706519912,130,22,5,14,171
706566657,27,15,2,1,45
706574417,239,95,31,5,370
706591277,90,41,2,12,145
706604222,16,24,2,2,44
706604502,22,3,2,1,28
706616634,173,28,13,11,225
706621570,21,3,2,2,28
706639471,99,38,44,19,200
706644835,33,9,2,2,46
706653280,19,3,2,1,25
706656540,15,3,2,1,21
706663328,11,3,2,2,18
706669505,21,22,4,1,48
706677619,17,7,12,7,43
706703146,177,11,2,2,192
706742513,122,29,162,15,328
706748377,32,75,38,1,146
706748674,176,3,2,13,194
706757610,23,51,2,43,119
706758770,86,29,36,37,188
706782835,94,3,2,3,102
706801276,47,7,2,1,57
706807618,80,10,2,1,93
706812369,21,3,2,1,27
706822905,12,3,2,1,18
706829562,10,3,2,2,17
706840736,194,25,19,19,257
706860967,101,12,2,17,132
706899002,143,168,2,1,314
706899434,22,7,2,1,32
706907860,47,34,4,15,100
706937376,73,3,2,1,79
706939802,53,3,2,2,60
706949263,18,10,2,1,31
706952111,73,3,2,2,80
706973321,84,3,2,1,90
706987736,141,35,42,4,222
706991402,56,46,5,33,140
707000578,82,9,22,7,120
707005384,29,15,2,1,47
707010553,74,30,29,1,134
707042661,60,31,2,2,95
707043779,80,49,46,3,178
707049049,56,17,28,2,103
707056426,10,9,2,1,22
707061456,163,53,2,1,219
707071619,166,52,21,8,247
707079521,33,17,3,1,54
707081491,72,3,2,1,78
707108267,10,16,2,2,30
707146718,936,3,2,5,946
707154213,27,12,3,1,43
707155667,26,19,5,8,58
707162692,90,6,3,7,106
707173407,25,36,2,3,66
707179515,15,34,2,1,52
707179755,37,25,9,29,100
707184603,136,35,69,28,268
707184753,28,11,2,1,42
707187793,25,9,2,4,40
707194865,64,7,30,1,102
707211056,43,3,2,3,51
707255240,69,107,11,28,215
707264537,16,3,2,1,22
707270634,10,12,2,1,25
707280415,10,35,2,1,48
707280500,42,3,2,3,50
707280848,44,22,20,93,179
707281935,12,3,2,1,18
707289763,20,19,2,1,42
707292402,22,20,23,4,69
707295468,38,3,2,1,44
707310395,20,18,2,1,41
707337687,52,3,2,8,65
707341047,18,33,2,1,54
707371642,101,3,2,4,110
707375727,94,17,99,7,217
707397757,164,16,23,6,209
707398867,38,11,2,1,52
707405537,13,3,2,1,19
707411526,13,3,2,4,22
707418990,50,29,3,1,83
707435245,11,3,2,1,17
707440193,87,18,26,5,136
707443873,11,3,2,1,17
707448600,13,7,4,5,29
707486517,13,34,2,7,56
707488377,119,13,2,9,143
707495655,42,18,16,21,97
707506091,84,3,2,2,91
707513011,18,38,2,7,65
707523316,40,32,2,1,75
707532620,84,19,2,1,106
707553862,13,3,2,1,19
707554217,34,20,2,1,57
707560751,121,22,111,3,257
707580834,93,31,2,1,127
707585479,60,31,3,97,191
707598748,52,17,27,2,98
707613277,29,47,20,4,100
707636795,24,6,5,2,37
707637243,11,12,2,3,28
707646406,52,18,2,1,73
707651713,63,3,2,1,69
707653253,167,46,2,9,224
707653480,18,3,2,1,24
707657589,17,67,42,16,142
707660108,62,75,31,66,234
707683947,68,31,2,3,104
707716135,84,36,11,1,132
707723474,26,3,2,6,37
707724935,70,3,2,1,76
707732458,29,15,2,1,47
707757776,71,16,81,1,169
707776962,114,3,2,13,132
707781350,82,31,60,15,188
707790300,64,16,3,1,84
707794053,170,4,2,1,177
707800561,34,19,3,1,57
707806653,150,3,2,6,161
707808204,149,61,34,25,269
707826864,87,50,4,6,147
707850635,96,62,42,45,245
707850905,18,6,2,3,29
707851264,11,6,2,1,20
707854358,72,54,2,1,129
707859307,22,3,2,4,31
707860822,65,13,2,11,91
707895913,17,3,2,1,23
707896392,116,6,2,3,127
707897677,19,15,2,1,37
707912472,16,9,2,1,28
707927473,211,26,19,6,262
707937640,156,24,2,1,183
707940799,182,3,2,1,188
707952897,60,11,5,10,86
707987402,20,48,2,1,71
707996794,105,3,2,1,111
708001594,145,24,35,2,206
708003200,103,26,31,11,171
708004570,390,3,2,41,436
708012165,250,3,2,1,256
708012907,55,3,2,1,61
708021902,26,43,19,3,91
708023542,208,37,2,7,254
708024084,23,3,2,1,29
708042798,96,32,4,8,140
708045174,85,27,2,18,132
708047471,28,49,2,1,80
708051720,83,3,2,1,89
708059254,19,7,4,1,31
708066267,139,7,2,2,150
708082582,105,15,12,1,133
708093190,10,3,2,3,18
708097438,91,49,95,1,236
708116144,33,22,24,18,97
708142984,110,3,2,46,161
708148064,67,3,2,1,73
708148575,98,13,3,40,154
708153178,56,67,8,5,136
708158772,35,19,2,7,63
708162716,167,40,20,3,230
708163807,63,36,2,21,122
708166482,205,47,4,6,262
708168943,66,7,103,3,179
708174717,13,5,2,2,22
708193683,54,3,2,2,61
708202926,75,5,28,3,111
708205870,29,20,2,2,53
708205960,102,30,2,14,148
708224258,35,32,2,5,74
708230900,72,13,19,14,118
708232429,99,39,3,12,153
708237049,186,3,3,1,193
708244691,17,4,2,1,24
708256724,11,9,2,1,23
708267052,64,70,6,19,159
708287790,36,42,33,2,113
708288242,42,8,4,2,56
708292713,61,3,2,1,67
708293713,99,25,12,5,141
708294229,48,5,2,1,56
708294882,59,30,23,30,142
708304821,22,26,10,6,64
708305994,11,3,2,1,17
708321246,138,34,53,17,242
708368564,77,21,2,2,102
708368851,17,44,4,2,67
708397206,11,3,2,1,17
708402921,32,44,2,3,81
708410747,58,38,54,10,160
708418857,51,30,3,10,94
708424895,68,3,2,7,80
708431502,60,37,3,2,102
708447250,42,3,2,5,52
708489026,11,9,30,1,51
708506052,116,3,2,1,122
708510845,17,15,5,2,39
708519810,13,3,2,1,19
708521283,39,3,2,1,45
708524805,76,28,10,15,129
708525247,19,20,2,1,42
708539999,23,3,2,2,30
708543599,15,5,2,3,25
708545862,83,3,2,5,93
708554243,14,3,2,1,20
708556219,28,6,43,7,84
708572614,10,6,2,1,19
708575225,11,9,2,3,25
708575898,106,51,2,5,164
708585841,153,3,2,6,164
708599958,95,40,4,5,144
708611478,41,32,2,3,78
708612831,212,28,25,3,268
708622561,90,31,15,1,137
708625782,13,3,2,2,20
708638028,11,3,2,1,17
708639997,152,3,2,3,160
708647403,32,3,2,1,38
708653919,57,18,2,1,78
708662968,36,14,2,1,53
708694511,10,3,2,3,18
708698511,69,8,3,2,82
708707049,39,19,21,8,87
708717488,43,3,2,4,52
708723099,20,16,2,4,42
708740964,32,25,14,22,93
708745265,10,4,2,1,17
708746748,39,29,2,3,73
708747776,75,6,29,1,111
708754273,28,3,2,1,34
708755381,11,3,2,1,17
708769738,12,5,2,1,20
708771968,18,15,5,3,41
708808299,225,11,27,2,265
708814639,42,38,2,1,83
708816825,177,87,35,21,320
708832399,25,22,4,1,52
708833830,69,31,15,16,131
708844531,27,6,2,1,36
708847659,27,26,3,4,60
708863771,147,15,15,6,183
708869309,91,25,23,5,144
708893215,53,42,12,12,119
708909658,14,32,14,6,66
708915023,19,3,2,1,25
708922498,13,29,3,1,46
708922869,430,3,2,14,449
708931946,23,23,2,1,49
708937515,14,3,2,4,23
708939226,124,78,30,18,250
708945885,86,12,2,1,101
708952002,39,21,2,3,65
708952780,64,3,2,1,70
708968754,40,52,29,2,123
708985440,52,3,2,13,70
708985996,43,3,2,1,49
708986005,37,3,2,1,43
708994611,88,4,2,10,104
708997711,10,6,2,1,19
709008761,16,3,2,1,22
709009017,48,50,41,2,141
709016096,11,3,2,1,17
709022972,109,3,2,5,119
709028347,12,8,4,1,25
709029576,17,10,2,1,30
709030264,41,29,2,11,83
709041931,22,13,3,7,45
709044885,175,69,17,1,262
709057852,27,56,14,2,99
709081471,113,32,2,36,183
709098291,56,26,26,54,162
709101045,25,42,10,70,147
709118127,51,3,2,1,57
709156222,49,42,25,1,117
709157520,10,3,2,2,17
709158913,61,53,2,16,132
709169472,12,3,2,3,20
709175637,17,3,2,1,23
709180283,94,3,2,11,110
709183190,12,16,3,1,32
709188084,156,21,2,3,182
709188560,196,3,17,22,238
709210759,11,3,2,1,17
709232435,25,3,2,1,31
709235473,64,67,177,22,330
709243028,45,3,3,11,62
709259950,146,42,155,6,349
709274601,89,19,2,1,111
709286550,46,10,81,20,157
709297857,35,30,4,1,70
709308703,81,3,2,1,87
709310693,11,8,2,1,22
709313349,25,3,2,1,31
709323189,26,3,2,1,32
709325400,57,7,2,1,67
709329123,16,49,2,9,76
709337454,37,5,10,6,58
709339320,22,31,13,3,69
709342225,11,3,2,1,17
709357782,68,3,2,8,81
709368186,89,47,55,28,219
709369835,107,3,2,61,173
709374287,83,20,2,6,111
709378860,36,9,2,1,48
709387394,101,3,2,5,111
709391624,17,3,2,1,23
709395280,37,28,30,9,104
709408814,37,50,56,1,144
709422554,19,15,2,7,43
709429758,55,26,28,5,114
709443942,105,11,17,1,134
709461184,36,24,2,6,68
709481544,27,3,2,3,35
709486225,20,94,2,1,117
709494551,247,46,70,6,369
709501540,119,62,6,16,203
709502215,16,8,2,6,32
709504535,109,18,112,5,244
709530493,49,3,2,1,55
709537914,30,3,4,1,38
709538589,48,24,8,1,81
709549667,120,3,2,5,130
709553311,215,15,2,6,238
709555338,27,16,5,1,49
709566951,98,3,2,3,106
709567278,46,46,14,14,120
709579546,45,11,2,2,60
709589139,67,11,2,5,85
709594135,112,8,79,19,218
709595318,853,3,2,31,889
709600372,53,33,30,1,117
709624911,76,15,3,4,98
709637118,86,34,3,10,133
709638004,60,50,76,4,190
709641489,22,12,2,2,38
709646982,86,3,2,11,102
709659977,71,75,32,86,264
709669812,26,8,2,1,37
709693893,160,15,2,1,178
709694530,23,3,2,14,42
709699048,82,33,45,4,164
709699711,69,36,27,4,136
709700666,156,39,16,15,226
709712857,49,8,11,2,70
709719113,68,10,14,1,93
709728485,33,26,2,1,62
709730722,23,23,2,3,51
709739894,142,16,13,24,195
709744715,79,23,49,1,152
709750748,46,3,2,1,52
709774440,20,3,2,1,26
709778993,77,3,2,2,84
709779913,91,69,26,10,196
709782881,54,22,75,34,185
709785290,32,5,2,1,40
709806595,33,3,2,19,57
709826526,45,29,2,7,83
709830450,41,44,2,1,88
709832613,56,17,26,10,109
709849011,69,69,37,4,179
709866988,39,80,42,5,166
709882667,66,25,3,6,100
709892114,32,10,3,7,52
709909571,63,60,6,25,154
709915265,82,12,19,5,118
709916509,52,63,19,5,139
709919185,16,20,2,3,41
709920149,85,3,2,1,91
709920858,57,35,33,8,133
709922078,24,3,2,1,30
709922465,11,3,2,1,17
709941593,123,29,19,12,183
709955736,127,21,2,6,156
709965449,216,11,3,1,231
709984954,16,24,2,1,43
710006274,12,3,2,1,18
710016321,115,25,2,54,196
710038371,45,4,2,1,52
710045670,78,17,16,6,117
710051406,61,3,2,1,67
710060470,38,19,2,9,68
710088249,55,3,2,1,61
710094565,38,22,18,29,107
710096608,65,15,58,9,147
710098804,242,3,2,1,248
710103638,136,29,2,12,179
710113207,137,3,2,2,144
710117570,14,3,2,1,20
710126350,15,27,5,1,48
710145521,106,3,2,1,112
710162610,60,3,2,1,66
710162930,88,40,3,1,132
710177234,62,50,11,12,135
710178703,54,15,2,1,72
710180899,22,13,7,9,51
710191845,56,9,23,4,92
710196439,35,44,34,1,114
710197368,28,25,7,1,61
710198649,80,18,3,2,103
710217927,84,4,3,1,92
710233524,53,3,2,1,59
710246781,11,3,2,1,17
710248988,71,3,2,1,77
710257331,19,15,2,1,37
710266104,12,31,2,1,46
710266653,73,24,93,1,191
710270126,154,35,12,2,203
710276286,37,45,11,21,114
710276341,87,16,47,6,156
710278078,11,3,2,1,17
710282518,11,22,2,2,37
710292784,10,3,2,2,17
710298793,73,25,2,1,101
710313913,77,3,2,3,85
710318873,111,3,2,1,117
710321972,40,3,2,2,47
710322684,26,88,40,32,186
710327563,107,30,2,7,146
710328335,29,25,3,2,59
710362038,39,17,2,1,59
710363861,14,39,2,1,56
710367173,62,6,5,21,94
710370237,30,10,2,5,47
710377900,42,7,2,11,62
710384631,22,3,2,1,28
710407560,20,3,2,1,26
710420484,20,3,2,1,26
710431499,55,33,8,26,122
710433760,86,34,18,5,143
710439743,20,33,2,1,56
710446500,57,10,2,4,73
710449672,59,8,4,3,74
710466482,136,17,103,5,261
710475134,15,3,2,1,21
710475759,57,34,7,7,105
710478015,19,3,2,5,29
710480562,71,3,2,1,77
710490220,36,10,2,5,53
710519271,56,50,13,4,123
710523024,19,9,2,1,31
710539929,42,4,2,2,50
710551972,160,28,81,34,303
710558216,60,3,2,1,66
710574756,58,17,2,1,78
710576936,39,3,2,1,45
710586035,92,50,38,9,189
710605500,31,7,2,1,41
710614481,14,3,2,1,20
710616038,102,39,3,4,148
710624345,51,6,2,20,79
710629095,107,3,2,1,113
710632382,41,11,12,2,66
710638281,15,3,2,1,21
710638310,12,3,2,4,21
710668525,37,3,2,3,45
710671646,352,3,2,3,360
710676303,40,14,4,2,60
710684921,30,7,2,3,42
710716449,43,18,40,27,128
710721569,42,26,2,8,78
710725443,35,16,21,2,74
710726360,18,10,6,6,40
710739130,125,34,4,7,170
710750697,69,43,23,60,195
710751066,54,23,12,1,90
710757446,19,30,21,6,76
710764269,81,39,19,18,157
710767694,61,10,54,21,146
710771742,48,8,2,2,60
710781025,20,26,2,3,51
710785736,47,3,27,1,78
710819336,11,3,2,1,17
710824392,58,3,2,1,64
710831271,54,49,3,19,125
710832186,194,10,2,2,208
710845699,14,16,15,1,46
710847102,206,22,3,11,242
710852775,11,3,2,1,17
710892391,33,21,3,1,58
710901669,144,13,7,1,165
710902220,134,65,112,98,409
710906750,41,3,2,2,48
710912358,19,3,2,1,25
710919740,25,3,2,1,31
710925712,131,3,2,8,144
710926921,48,3,2,4,57
710927230,124,3,2,2,131
710934732,142,11,8,1,162
710948380,11,3,2,1,17
710961314,42,54,10,25,131
710970240,147,57,22,6,232
710971063,19,20,2,6,47
710985301,31,73,2,3,109
710990768,11,3,2,1,17
710991408,56,4,2,4,66
710994002,49,6,22,6,83
710994042,64,36,2,6,108
710995138,89,3,2,2,96
711011097,12,7,2,1,22
711016349,384,3,2,9,398
711030947,163,27,81,7,278
711040727,123,31,2,1,157
711044114,46,3,2,1,52
711056097,41,3,2,1,47
711071425,33,30,5,4,72
711074482,41,67,13,20,141
711078521,15,29,2,1,47
711089096,30,32,48,44,154
711091967,30,32,3,10,75
711095200,125,74,35,22,256
711116761,11,3,2,2,18
711132015,17,9,2,1,29
711133642,147,36,23,35,241
711139831,71,19,16,34,140
711144096,46,6,7,7,66
711150522,14,9,2,5,30
711156393,47,14,31,1,93
711167035,59,38,8,20,125
711184048,58,33,18,1,110
711184124,15,12,6,7,40
711186226,40,14,30,1,85
711205363,61,28,128,1,218
711210197,73,28,2,11,114
711221173,107,26,39,45,217
711231461,113,10,2,1,126
711234592,14,13,6,1,34
711235998,74,3,2,1,80
711245468,38,38,24,20,120
711262678,26,24,12,14,76
711275194,13,9,2,1,25
711291459,42,39,5,3,89
711294478,47,3,2,6,58
711295148,22,3,2,1,28
711296039,48,3,2,10,63
711298733,14,3,2,1,20
711306991,113,3,2,1,119
711314276,56,3,2,1,62
711339223,12,3,2,2,19
711342008,10,3,2,2,17
711347760,56,20,3,11,90
711351493,36,3,2,1,42
711361759,88,13,62,8,171
711363511,73,3,2,1,79
711370511,37,3,2,1,43
711373788,118,38,8,12,176
711376103,10,35,2,1,48
711376991,64,3,2,1,70
711386053,10,18,2,1,31
711391019,27,3,2,1,33
711404636,129,7,3,4,143
711422894,48,40,142,4,234
711424309,123,3,2,8,136
711429340,98,39,16,2,155
711434881,10,4,2,1,17
711440897,107,29,56,1,193
711442845,68,44,55,2,169
711456600,141,20,8,8,177
711478125,99,3,2,1,105
711478285,77,9,68,5,159
711480304,115,3,2,40,160
711497669,23,3,2,1,29
711507211,43,8,15,1,67
711514484,44,28,2,1,75
711525224,125,9,2,2,138
711537628,94,23,81,33,231
711543723,33,3,2,4,42
711561018,37,3,2,1,43
711567440,146,24,7,15,192
711583630,42,47,7,16,112
711585190,21,27,4,3,55
711633034,186,33,12,3,234
711643836,58,3,2,1,64
711656565,36,16,4,35,91
711680199,30,3,2,1,36
711681682,56,3,2,1,62
711685095,15,3,2,1,21
711700323,90,15,3,1,109
711700789,84,27,37,2,150
711719648,37,18,5,24,84
711722599,129,3,2,27,161
711728224,647,3,2,4,656
711729602,128,18,2,8,156
711734397,21,3,2,1,27
711744873,55,3,2,1,61
711763833,17,58,2,3,80
711775649,11,3,2,1,17
711776572,19,51,2,1,73
711777825,104,28,2,14,148
711778598,19,4,2,1,26
711795651,136,7,13,8,164
711795961,20,3,2,1,26
711796569,13,3,2,4,22
711814298,87,56,59,8,210
711816816,50,42,15,2,109
711819828,18,8,2,2,30
711823509,99,7,17,20,143
711824546,30,14,45,4,93
711840354,98,3,2,12,115
711844654,29,24,11,1,65
711847513,64,3,2,1,70
711860418,72,6,15,3,96
711864619,45,3,2,10,60
711876845,16,3,2,1,22
711889283,91,19,5,1,116
711895608,54,3,2,1,60
711896328,131,25,30,1,187
711902761,64,3,2,1,70
711904700,10,13,2,1,26
711905230,134,3,2,8,147
711925430,53,4,2,1,60
711935368,37,3,2,1,43
711939232,49,11,8,8,76
711940780,27,3,2,1,33
711954897,129,35,2,14,180
711997405,127,83,24,16,250
712002776,18,3,2,4,27
712017248,27,44,20,27,118
712019595,64,33,2,3,102
712022445,32,21,4,16,73
712044369,19,3,2,1,25
712057887,61,47,6,1,115
712060429,39,19,13,4,75
712085161,25,15,2,1,43
712091254,11,12,2,1,26
712092806,95,3,2,9,109
712098478,83,21,27,58,189
712102017,45,4,10,9,68
712106736,66,6,10,7,89
712107641,31,29,2,1,63
712113946,141,81,31,2,255
712125198,88,10,2,1,101
712128976,43,24,2,18,87
712149421,10,3,2,2,17
712155405,122,11,20,1,154
712160717,82,7,2,1,92
712186361,29,45,17,8,99
712223717,72,7,49,12,140
712224651,17,3,2,1,23
712231740,28,3,2,1,34
712235858,161,62,36,3,262
712236389,92,36,55,12,195
712242235,84,16,31,1,132
712252821,33,25,2,1,61
712261389,39,3,2,1,45
712263164,51,9,9,8,77
712293000,20,3,2,1,26
712296037,12,28,2,1,43
712297542,79,3,2,1,85
712308317,95,38,2,14,149
712318828,10,9,2,11,32
712334568,78,3,2,2,85
712338031,62,3,2,1,68
712346711,27,7,2,1,37
712350617,68,55,38,1,162
712354763,16,3,2,1,22
712362449,14,5,2,1,22
712364067,179,60,7,83,329
712386671,108,39,17,15,179
712394617,18,20,5,2,45
712418195,16,3,2,1,22
712445943,276,3,2,3,284
712451029,16,3,2,1,22
712452594,58,3,2,2,65
712459724,14,3,2,1,20
712467001,43,6,2,3,54
712470807,75,8,2,13,98
712481070,131,36,2,1,170
712487385,20,5,2,2,29
712504947,43,50,56,39,188
712509605,63,41,18,1,123
712520819,57,18,2,1,78
712523136,53,40,27,3,123
712531614,92,25,2,4,123
712552324,151,31,43,1,226
712557856,40,39,16,5,100
712563449,39,24,21,73,157
712576563,76,21,13,5,115
712592284,72,44,27,51,194
712593856,25,3,11,10,49
712596562,12,3,2,1,18
712620223,136,4,4,27,171
712621602,204,3,2,5,214
712625420,25,8,2,2,37
712651010,105,3,2,8,118
712651202,16,24,2,1,43
712654267,194,3,2,1,200
712655824,13,12,2,2,29
712656346,237,75,2,4,318
712658874,60,24,3,2,89
712675789,22,8,2,1,33
712685538,28,18,2,1,49
712695708,178,30,2,2,212
712703797,13,3,2,1,19
712716453,76,35,13,2,126
712724679,16,3,2,1,22
712727016,30,6,23,13,72
712736057,11,3,2,2,18
712736347,11,3,2,1,17
712751791,16,40,2,1,59
712754016,19,45,2,1,67
712763378,140,45,26,39,250
712774703,138,3,2,29,172
712775844,123,30,27,8,188
712805710,35,30,4,1,70
712805780,23,29,27,4,83
712807119,114,3,2,1,120
712834298,21,30,2,1,54
712843750,19,6,2,2,29
712845705,19,12,3,1,35
712849156,139,37,9,4,189
712863536,32,3,2,3,40
712887876,24,7,2,7,40
712888222,83,52,14,25,174
712890688,25,5,2,7,39
712891931,112,58,2,26,198
712898685,33,18,9,2,62
712905004,40,3,2,1,46
712913819,16,3,2,1,22
712916275,180,8,17,23,228
712921021,188,10,2,3,203
712925409,16,3,2,2,23
712935459,135,11,6,5,157
712936627,148,77,52,33,310
712943519,10,39,2,1,52
712950475,39,35,9,18,101
712973571,31,3,2,5,41
712976632,24,3,2,1,30
712983813,24,3,2,1,30
713014094,69,14,9,2,94
713029357,286,3,2,2,293
713038085,30,18,21,3,72
713060112,21,3,2,1,27
713061393,17,3,2,4,26
713066759,115,39,3,9,166
713080182,182,54,9,29,274
713080417,195,74,14,10,293
713086291,145,26,20,38,229
713096344,57,26,3,1,87
713101382,76,20,10,4,110
713113987,78,41,22,1,142
713115353,77,38,10,13,138
713116129,11,8,2,1,22
713146830,25,3,2,1,31
713180691,53,20,19,1,93
713181747,37,7,19,2,65
713183590,59,57,4,5,125
713193162,67,10,3,1,81
713200207,10,3,2,3,18
713201683,48,20,3,4,75
713204916,62,29,2,5,98
713208587,15,45,2,3,65
713210290,43,3,2,1,49
713229676,82,40,6,1,129
713241056,34,4,2,3,43
713249086,39,49,4,1,93
713261908,67,19,2,3,91
713262239,77,34,2,1,114
713269632,20,14,2,2,38
713271466,63,8,2,1,74
713274805,78,3,2,1,84
713277641,30,3,2,2,37
713291761,106,50,101,4,261
713300541,63,105,4,3,175
713310582,230,3,2,22,257
713334129,11,3,2,1,17
713365916,82,57,3,15,157
713377070,78,3,2,1,84
713401372,44,53,2,1,100
713403154,29,29,59,4,121
713403546,62,37,3,1,103
713406040,86,32,2,4,124
713411104,155,46,49,10,260
713413805,80,3,2,1,86
713424298,17,23,2,7,49
713427007,48,29,34,6,117
713430493,20,119,88,2,229
713470227,200,22,15,1,238
713470756,57,3,2,14,76
713485823,101,42,36,1,180
713487001,35,4,2,2,43
713487425,105,26,45,79,255
713497748,217,3,2,2,224
713513906,45,51,4,11,111
713514912,19,3,2,1,25
713517314,92,3,3,7,105
713522658,123,3,2,8,136
713524234,20,4,19,1,44
713538460,47,25,2,10,84
713547597,65,20,31,1,117
713569723,23,9,5,1,38
713574260,65,10,13,2,90
713591434,60,17,11,3,91
713606828,16,3,2,1,22
713615324,80,38,12,2,132
713620986,10,6,4,1,21
713626767,91,3,2,3,99
713627298,27,10,3,1,41
713633222,70,34,30,2,136
713639998,111,37,7,7,162
713651670,16,10,4,1,31
713656647,39,3,2,1,45
713664351,125,25,23,4,177
713675060,68,20,2,1,91
713680178,77,47,9,15,148
713681260,108,3,2,5,118
713694805,55,55,12,50,172
713718431,188,3,2,5,198
713718804,26,3,2,1,32
713720510,12,3,2,1,18
713730939,33,5,2,6,46
713734632,17,7,2,1,27
713738344,66,81,3,2,152
713751302,11,4,2,2,19
713759036,13,3,2,1,19
713781562,18,42,16,1,77
713782874,57,10,4,1,72
713794541,21,3,2,1,27
713806152,11,3,2,1,17
713826670,54,30,2,1,87
713829952,49,3,2,6,60
713830687,69,3,2,1,75
713833593,15,9,2,1,27
713846060,14,3,2,7,26
713850074,10,12,2,2,26
713857195,34,3,2,1,40
713864758,10,9,2,1,22
713865662,37,3,2,5,47
713867950,17,13,10,1,41
713871978,182,45,89,9,325
713872281,20,3,2,1,26
713883377,14,32,8,2,56
713889921,69,27,48,3,147
713900339,16,22,2,1,41
713900544,35,40,2,11,88
713904161,28,48,9,1,86
713923971,132,67,113,1,313
713935009,98,3,2,7,110
713935444,131,5,21,10,167
713965981,21,3,2,1,27
713969625,13,3,2,1,19
713970476,53,17,3,1,74
713975196,70,37,20,1,128
713990669,60,48,7,2,117
713994718,83,28,2,14,127
713999722,22,12,4,1,39
714016240,43,30,2,2,77
714023773,23,25,30,17,95
714025512,38,3,2,3,46
714029534,20,12,2,1,35
714038905,1037,3,2,14,1056
714048741,30,30,8,29,97
714053666,126,10,7,5,148
714059658,62,48,7,2,119
714077392,12,23,2,1,38
714086795,190,15,14,4,223
714101964,45,36,6,2,89
714102249,121,14,2,1,138
714104820,59,3,2,2,66
714107032,12,11,2,1,26
714109826,11,3,2,1,17
714127908,204,11,2,50,267
714131273,103,21,25,2,151
714136161,135,3,2,6,146
714141756,143,35,3,17,198
714142311,54,3,2,1,60
714144973,148,3,2,10,163
714162889,48,3,2,1,54
714179916,69,20,15,6,110
714186057,208,3,2,2,215
714188300,52,54,2,15,123
714214237,58,89,2,15,164
714217521,89,132,2,2,225
714217831,17,3,2,1,23
714218907,84,10,72,5,171
714223512,32,8,18,1,59
714224204,17,8,2,3,30
714230916,21,38,7,1,67
714238862,12,3,2,1,18
714242867,52,3,2,16,73
714258471,49,24,2,1,76
714261062,39,20,15,5,79
714282904,89,16,2,2,109
714293189,51,15,13,5,84
714309045,154,31,58,16,259
714311713,57,22,2,4,85
714321979,60,16,14,2,92
714322112,71,36,20,12,139
714323236,59,8,13,3,83
714335851,54,5,42,1,102
714339462,53,3,2,1,59
714350090,112,30,2,7,151
714361342,65,7,2,3,77
714363668,109,32,18,7,166
714364511,38,20,2,12,72
714381649,62,3,2,6,73
714393114,20,9,2,2,33
714412332,123,30,2,8,163
714418584,37,34,15,9,95
714419854,23,23,5,9,60
714430253,20,15,2,6,43
714433671,25,3,2,1,31
714443397,51,24,47,15,137
714447785,49,33,2,16,100
714449163,60,3,2,7,72
714463596,48,18,4,1,71
714463703,50,11,2,1,64
714497822,71,23,55,14,163
714501074,36,33,2,1,72
714505125,45,7,13,7,72
714508799,108,40,73,1,222
714511210,10,4,2,1,17
714540520,26,5,2,6,39
714549011,45,28,3,11,87
714552701,24,3,2,3,32
714560066,25,3,2,1,31
714560280,92,37,53,19,201
714577930,27,3,2,1,33
714585859,73,26,26,1,126
714619283,120,12,16,11,159
714633996,134,48,8,12,202
714635719,121,6,14,10,151
714648179,199,3,2,2,206
714649196,63,30,26,18,137
714669064,45,26,38,10,119
714678292,51,17,12,5,85
714687556,87,3,45,1,136
714712375,33,27,50,5,115
714743388,43,29,2,1,75
714747805,69,7,2,25,103
714748430,22,90,7,5,124
714758915,57,22,16,3,98
714761989,29,17,44,1,91
714767495,16,3,2,1,22
714768007,145,9,2,6,162
714775856,14,9,4,1,28
714778493,63,3,2,1,69
714781938,73,27,2,1,103
714783738,15,3,2,1,21
714789069,39,17,2,5,63
714797559,96,17,27,4,144
714811832,46,43,26,1,116
714815602,82,3,2,1,88
714821881,103,38,6,1,148
714829306,79,88,4,6,177
714832529,134,3,2,1,140
714838269,70,26,30,1,127
714850247,132,34,5,2,173
714854362,42,45,21,1,109
714861069,69,3,2,1,75
714871800,242,48,22,46,358
714877515,24,5,2,1,32
714877572,11,3,2,1,17
714878199,78,33,74,6,191
714881153,89,3,2,25,119
714890465,45,41,4,1,91
714891360,99,44,14,4,161
714919410,64,10,10,33,117
714921140,122,37,82,2,243
714927713,30,29,3,7,69
714951029,118,3,2,1,124
714953193,24,21,4,8,57
714955919,95,22,32,2,151
714960726,38,32,8,27,105
714968552,26,3,2,1,32
714969475,10,3,6,1,20
714969748,139,10,2,1,152
714975543,47,34,2,2,85
714980936,57,21,3,7,88
714998246,78,30,49,2,159
715000220,62,34,46,3,145
715009932,11,3,2,1,17
715021934,26,15,6,1,48
715022141,15,4,2,2,23
715022568,56,5,2,1,64
715023072,31,23,18,9,81
715026035,16,4,2,1,23
715029415,11,6,2,1,20
715031189,10,6,2,1,19
715036643,38,32,13,13,96
715046261,16,3,2,1,22
715048581,10,6,2,1,19
715051492,44,73,22,10,149
715062285,11,5,2,1,19
715072535,86,35,4,2,127
715073676,90,11,23,2,126
715079510,90,28,3,2,123
715100017,35,54,14,3,106
715101951,53,55,2,18,128
715107427,86,3,2,2,93
715108221,92,35,31,27,185
715109503,33,3,2,1,39
715115814,18,20,17,1,56
715116606,13,3,2,1,19
715128891,75,3,2,1,81
715150996,21,32,2,1,56
715158289,136,13,3,1,153
715158314,97,3,2,1,103
715160424,48,24,2,2,76
715165397,11,27,2,1,41
715175452,20,3,2,19,44
715188633,59,10,3,2,74
715202597,119,3,2,2,126
715210154,62,3,2,1,68
715230653,74,6,88,1,169
715249244,36,23,9,1,69
715254455,52,7,2,1,62
715272603,81,45,15,14,155
715277139,98,3,2,2,105
715277177,152,3,2,1,158
715283275,72,14,2,1,89
715308634,77,3,2,1,83
715315053,81,44,9,4,138
715327391,84,57,25,2,168
715337947,91,3,7,1,102
715392264,52,3,5,2,62
715396607,53,60,25,1,139
715400678,65,3,2,1,71
715415764,68,19,26,1,114
715426260,109,86,40,118,353
715438067,30,48,17,1,96
715443717,119,66,17,86,288
715447801,48,9,6,25,88
715450582,98,108,17,1,224
715475075,11,3,2,1,17
715490203,54,3,2,1,60
715496351,185,21,35,5,246
715498173,29,5,2,1,37
715499611,48,3,2,6,59
715499916,10,6,2,1,19
715501332,20,4,2,1,27
715508554,42,32,5,11,90
715512029,162,3,2,1,168
715528282,75,11,2,1,89
715535628,24,19,46,1,90
715537963,14,4,2,1,21
715543911,125,21,14,1,161
715569344,34,3,2,12,51
715570195,62,28,20,9,119
715580304,137,13,12,1,163
715591097,58,45,29,3,135
715596352,21,7,13,1,42
715603140,137,50,7,6,200
715612063,88,14,9,5,116
715618446,88,8,23,8,127
715632178,12,11,4,1,28
715642181,34,12,2,3,51
715649206,41,62,11,1,115
715654306,74,4,3,42,123
715656632,96,48,14,8,166
715664876,141,29,155,1,326
715676737,79,7,13,26,125
715677579,17,15,2,1,35
715678943,65,30,3,1,99
715688336,68,3,2,1,74
715689476,25,69,42,2,138
715699785,130,3,2,1,136
715703626,157,17,125,11,310
715709715,20,3,2,1,26
715716102,88,26,156,7,277
715721008,46,44,2,4,96
715722504,177,3,2,4,186
715727987,55,3,2,1,61
715730291,107,28,19,10,164
715730963,86,3,18,1,108
715734231,83,71,5,1,160
715734454,65,9,15,1,90
715746089,27,3,2,3,35
715750148,172,3,2,1,178
715765233,11,3,2,2,18
715774253,153,47,9,2,211
715775295,78,3,2,1,84
715785529,104,3,2,1,110
715794506,106,3,2,1,112
715796333,24,28,2,2,56
715799260,113,38,93,7,251
715801658,48,5,2,1,56
715802315,102,50,25,20,197
715804265,11,3,2,1,17
715807937,27,37,10,1,75
715826511,22,21,3,5,51
715837501,32,13,2,4,51
715845368,147,24,5,2,178
715855777,37,44,2,8,91
715861527,151,84,5,34,274
715878364,41,26,31,15,113
715897307,29,14,3,1,47
715903167,53,42,2,2,99
715905386,155,27,2,1,185
715906402,19,55,2,1,77
715907071,50,47,3,6,106
715908258,35,3,2,4,44
715910509,20,3,2,1,26
715914611,90,40,104,3,237
715915022,26,45,2,2,75
715928153,78,66,38,12,194
715932978,73,3,2,1,79
715934561,50,6,3,2,61
715947307,38,3,2,1,44
715957575,100,22,10,7,139
715976712,52,3,2,1,58
715982576,26,42,2,1,71
716003164,47,26,2,9,84
716016254,291,3,2,3,299
716030046,62,3,2,1,68
716032645,50,29,5,4,88
716037922,67,15,32,47,161
716038007,11,3,2,1,17
716043308,127,31,3,9,170
716053900,33,10,2,1,46
716069745,84,12,2,2,100
716085599,129,3,23,4,159
716087032,79,7,33,4,123
716088428,83,21,2,1,107
716103170,157,22,2,2,183
716109500,66,3,2,1,72
716118431,145,32,68,1,246
716135888,26,10,10,1,47
716140293,74,11,4,5,94
716152041,12,3,2,4,21
716157766,76,8,32,1,117
716158016,185,41,2,9,237
716175025,20,3,2,1,26
716193404,11,3,2,1,17
716194366,92,3,2,1,98
716206644,25,3,2,2,32
716206916,11,10,3,1,25
716208952,40,3,2,2,47
716210844,48,13,2,32,95
716223020,36,3,2,1,42
716236940,73,21,43,3,140
716240207,150,3,2,1,156
716255396,106,3,2,4,115
716257402,15,3,2,3,23
716259401,152,29,23,1,205
716262943,131,42,45,12,230
716263813,49,29,12,11,101
716264029,219,3,2,30,254
716269466,118,19,31,1,169
716275508,133,3,2,9,147
716296146,67,35,70,56,228
716298527,66,3,2,1,72
716303210,10,30,2,1,43
716305157,64,62,82,15,223
716309412,121,9,7,8,145
716309578,12,3,2,1,18
716334421,16,3,2,1,22
716341973,137,19,2,1,159
716342015,42,3,2,5,52
716345026,101,10,3,22,136
716346619,76,20,2,11,109
716364696,94,3,2,30,129
716372892,48,6,10,9,73
716383132,11,3,2,1,17
716393965,68,68,15,17,168
716400199,125,3,2,5,135
716414020,13,33,2,2,50
716419014,28,3,2,1,34
716435604,97,4,2,1,104
716440029,94,47,3,1,145
716450089,18,3,2,1,24
716459310,15,3,2,18,38
716495213,85,80,33,1,199
716501600,10,5,2,3,20
716509729,245,3,2,3,253
716518112,24,107,47,3,181
716519548,80,18,57,4,159
716523611,85,43,20,3,151
716524997,239,6,2,7,254
716526288,20,31,2,1,54
716529266,12,8,2,10,32
716534428,90,11,13,2,116
716541576,36,5,14,1,56
716542020,13,6,2,1,22
716565870,69,3,2,1,75
716587577,30,3,2,1,36
716593215,30,21,45,8,104
716594910,61,3,2,1,67
716603890,77,13,2,1,93
716609205,21,18,3,6,48
716614217,148,42,80,14,284
716623552,26,3,2,7,38
716625615,25,3,2,3,33
716651635,130,52,160,1,343
716657820,51,3,38,1,93
716657894,83,21,15,1,120
716658417,148,10,2,2,162
716667268,58,9,2,1,70
716670631,28,3,2,1,34
716683281,40,46,32,3,121
716690583,11,35,2,1,49
716692632,429,38,26,13,506
716700205,76,21,10,1,108
716704749,11,3,2,1,17
716707360,11,4,2,1,18
716724874,20,7,2,3,32
716726679,152,31,2,5,190
716767853,10,3,2,2,17
716768851,148,3,2,1,154
716773481,46,3,5,6,60
716777054,48,61,6,14,129
716780428,110,31,7,57,205
716789405,28,85,27,12,152
716792921,47,21,2,20,90
716806641,15,3,2,2,22
716815336,127,15,2,9,153
716819960,124,27,2,25,178
716831877,106,29,61,5,201
716837391,175,4,2,6,187
716846206,16,25,2,1,44
716852308,150,3,2,6,161
716854694,15,3,2,1,21
716868676,213,47,22,46,328
716870304,10,6,2,1,19
716882970,227,25,7,9,268
716889987,102,56,29,12,199
716891042,13,11,2,1,27
716898376,38,3,2,3,46
716914272,48,31,24,32,135
716926382,10,3,2,2,17
716927642,49,41,20,1,111
716928434,112,3,2,1,118
716939812,12,6,2,1,21
716943624,72,28,40,7,147
716943649,13,3,2,1,19
716950515,131,18,25,11,185
716963282,70,3,2,5,80
716969596,88,38,4,6,136
716979299,92,22,9,13,136
716989735,29,21,12,3,65
716996983,60,67,2,12,141
717001261,13,3,2,1,19
717010692,20,3,2,1,26
717010733,21,3,2,1,27
717025682,14,3,2,1,20
717028221,91,47,2,36,176
717044485,14,3,2,4,23
717044804,83,7,53,3,146
717047416,179,8,2,1,190
717051682,544,19,2,7,572
717052366,35,5,9,1,50
717062011,86,41,14,14,155
717062895,143,33,89,2,267
717069614,92,29,15,6,142
717076084,16,11,2,1,30
717086545,27,3,2,1,33
717087719,15,12,2,1,30
717091701,104,5,2,2,113
717095193,106,3,2,4,115
717097097,79,44,2,1,126
717102091,19,3,2,1,25
717103300,11,3,2,1,17
717103892,48,4,3,1,56
717106047,86,17,2,1,106
717114452,27,6,2,1,36
717156071,131,3,2,5,141
717160769,33,44,9,3,89
717161336,10,3,2,2,17
717164121,40,47,44,14,145
717169433,25,20,2,3,50
717171323,69,44,5,5,123
717176150,50,3,2,1,56
717189437,71,12,2,1,86
717214269,141,3,2,3,149
717216597,160,4,2,1,167
717216716,14,3,2,1,20
717218596,13,33,2,1,49
717242182,100,31,14,3,148
717265751,72,19,8,53,152
717265952,51,36,2,40,129
717274153,87,122,2,3,214
717290834,53,3,2,5,63
717331026,26,18,2,1,47
717334369,64,4,17,6,91
717340468,10,8,2,1,21
717351512,24,3,2,11,40
717358892,33,17,2,1,53
717360878,11,3,2,1,17
717365317,124,4,2,2,132
717371473,23,32,4,1,60
717373918,95,46,28,28,197
717375740,34,3,2,2,41
717386631,144,47,20,5,216
717393855,13,22,2,1,38
717397061,139,19,3,1,162
717403434,18,3,2,1,24
717408037,33,7,2,1,43
717408976,37,33,2,8,80
717423024,21,21,3,2,47
717441282,13,3,2,3,21
717447428,41,16,2,2,61
717448400,51,3,2,1,57
717464571,32,35,3,3,73
717468819,2917,3,2,87,3009
717503203,167,20,77,45,309
717505066,43,3,2,1,49
717528456,102,3,2,1,108
717537839,82,50,121,52,305
717543831,89,3,2,8,102
717547756,53,16,12,1,82
717557594,28,6,2,2,38
717566203,67,39,182,72,360
717581621,16,23,2,22,63
717590047,129,3,2,3,137
717599688,31,64,2,8,105
717610598,61,3,2,2,68
717631097,12,3,2,1,18
717654656,61,28,4,1,94
717664528,148,17,2,60,227
717669827,123,23,20,8,174
717678727,30,46,24,2,102
717682710,12,3,2,2,19
717694139,75,51,53,9,188
717698315,70,22,2,20,114
717700933,74,45,58,1,178
717713007,98,9,56,14,177
717716061,18,19,11,5,53
717738946,38,3,2,7,50
717743373,20,11,2,10,43
717745854,66,3,2,9,80
717753162,120,3,2,1,126
717756544,22,6,2,1,31
717760388,45,3,2,1,51
717769335,115,14,2,1,132
717777577,132,45,21,16,214
717806651,25,9,2,2,38
717821943,127,21,2,3,153
717822768,17,3,2,1,23
717834745,33,6,2,1,42
717853665,18,3,2,2,25
717869205,11,3,2,1,17
717869903,11,4,2,1,18
717890768,91,18,2,2,113
717894261,85,68,15,23,191
717906169,48,3,2,3,56
717913256,38,3,2,1,44
717918084,45,18,2,30,95
717926181,32,29,107,64,232
717929244,77,48,8,2,135
717938970,35,74,58,19,186
717951283,72,3,2,1,78
717954995,141,49,10,30,230
717955488,120,3,2,1,126
717973473,153,54,34,19,260
717979943,82,14,22,7,125
717981291,12,7,2,1,22
717997250,149,3,3,2,157
718000685,80,29,5,9,123
718013467,93,12,2,1,108
718032977,15,26,2,1,44
718042492,54,3,2,1,60
718044452,33,27,9,33,102
718062824,277,3,2,9,291
718063223,144,3,9,2,158
718066893,48,30,41,1,120
718071634,43,3,2,3,51
718075308,11,3,2,1,17
718077354,194,3,2,7,206
718083359,59,20,38,19,136
718094322,47,3,2,1,53
718099988,12,3,2,3,20
718103033,59,37,2,8,106
718116892,10,3,2,2,17
718120012,23,9,2,1,35
718132742,13,3,2,1,19
718132807,108,76,3,3,190
718151435,103,3,2,1,109
718159327,66,9,7,5,87
718173195,67,3,2,1,73
718184220,13,3,2,1,19
718213612,76,3,2,1,82
718215820,16,26,14,1,57
718221793,48,33,5,2,88
718223624,358,42,2,14,416
718235383,320,3,2,2,327
718254751,92,22,23,44,181
718258215,98,22,7,3,130
718259860,14,44,15,1,74
718279908,26,25,2,3,56
718285304,74,29,11,9,123
718290286,168,45,55,17,285
718295058,104,4,2,2,112
718300203,113,4,2,1,120
718321230,313,10,12,2,337
718350598,26,11,2,1,40
718381659,61,52,20,41,174
718406308,83,29,74,3,189
718434538,171,43,28,26,268
718437451,11,3,2,1,17
718455371,94,9,12,38,153
718458452,11,3,2,2,18
718459741,122,3,2,4,131
718462240,138,21,10,9,178
718479960,29,27,6,1,63
718480202,66,30,2,4,102
718481280,34,51,17,21,123
718503178,39,72,2,3,116
718505921,72,3,2,1,78
718539779,135,16,2,21,174
718543832,222,3,2,5,232
718547749,10,6,2,1,19
718549960,211,16,50,5,282
718556010,69,23,85,158,335
718568704,10,3,2,2,17
718571002,10,4,2,1,17
718577642,17,39,2,1,59
718605589,47,3,2,4,56
718610718,57,14,42,83,196
718616687,10,3,2,2,17
718617847,109,20,6,15,150
718654076,14,3,2,1,20
718656132,102,14,39,40,195
718661387,10,4,2,1,17
718668860,31,3,2,1,37
718676839,90,3,2,1,96
718678552,11,3,2,1,17
718678793,11,3,2,1,17
718679141,34,5,2,3,44
718684572,19,9,2,1,31
718688486,27,21,3,2,53
718690914,40,3,2,1,46
718695521,18,16,2,1,37
718699007,228,19,55,31,333
718700560,33,27,24,1,85
718702244,28,3,2,14,47
718721681,174,20,16,16,226
718727195,10,20,13,1,44
718732260,17,3,2,1,23
718736351,19,7,2,3,31
718742794,64,3,2,1,70
718750206,25,3,2,7,37
718755850,25,3,2,1,31
718769272,80,3,6,6,95
718769602,74,3,2,1,80
718771401,81,31,63,7,182
718772306,62,3,2,13,80
718778249,21,28,11,3,63
718786382,56,8,2,4,70
718789912,83,83,21,4,191
718803123,37,3,2,1,43
718809296,18,3,2,4,27
718811987,15,12,2,1,30
718823855,55,9,23,1,88
718826745,88,3,2,1,94
718828393,53,8,4,12,77
718834614,14,15,2,1,32
718844583,206,3,3,1,213
718848881,50,3,2,1,56
718879462,278,3,2,4,287
718881477,90,34,2,3,129
718900338,31,3,2,4,40
718918857,53,3,2,1,59
718920783,24,3,2,1,30
718921495,174,55,44,3,276
718926616,182,79,5,21,287
718928665,90,3,2,1,96
718930169,65,13,3,11,92
718955394,95,35,51,4,185
718956537,162,41,14,29,246
718960928,22,3,2,1,28
718975567,20,3,2,1,26
718982972,112,3,2,1,118
718996472,44,3,2,1,50
719013167,26,3,2,1,32
719020937,13,11,2,1,27
719049962,63,3,2,1,69
719049991,59,22,40,12,133
719052428,11,4,2,1,18
719054167,10,28,2,1,41
719056540,92,58,63,13,226
719060163,11,7,2,1,21
719063996,68,5,2,3,78
719101004,147,7,52,2,208
719105827,79,28,62,10,179
719106111,103,10,43,1,157
719109436,86,32,2,8,128
719112493,62,65,3,22,152
719119842,13,3,2,1,19
719137697,162,9,2,1,174
719148860,18,3,2,1,24
719158302,187,3,2,3,195
719159861,11,3,2,1,17
719166765,11,3,2,1,17
719169665,416,25,88,46,575
719173347,95,27,4,1,127
719188555,78,28,3,1,110
719192708,12,10,2,1,25
719199183,82,3,2,5,92
719205294,67,11,51,33,162
719214365,34,35,14,3,86
719214595,24,25,2,1,52
719226896,12,16,2,1,31
719227511,12,3,2,1,18
719237772,12,3,2,1,18
719241595,22,31,40,1,94
719249063,45,3,2,1,51
719257274,94,10,2,1,107
719271711,11,5,2,1,19
719273966,105,3,2,3,113
719290063,86,28,10,1,125
719296301,13,6,2,1,22
719309688,100,4,40,7,151
719313473,87,13,4,2,106
719318742,14,3,2,1,20
719350614,111,117,13,7,248
719354478,147,36,2,1,186
719368263,46,8,6,2,62
719368406,19,3,2,1,25
719371264,62,15,6,1,84
719388306,17,21,9,1,48
719392707,30,3,2,7,42
719392897,143,33,24,23,223
719403657,17,4,2,1,24
719409905,43,3,2,1,49
719414316,43,23,8,5,79
719425044,20,3,2,1,26
719453243,16,3,2,5,26
719458984,22,3,2,1,28
719473522,26,3,2,1,32
719474889,10,18,2,1,31
719479299,27,17,2,1,47
719489124,73,30,2,1,106
719489578,30,14,2,6,52
719493400,47,35,11,8,101
719494530,23,74,3,11,111
719496159,26,92,48,14,180
719499866,91,40,2,13,146
719531385,86,17,2,1,106
719545911,74,3,2,1,80
719550437,68,59,27,11,165
719566082,115,24,2,2,143
719570203,18,15,2,1,36
719576607,82,4,2,1,89
719580415,56,23,2,4,85
719584592,37,3,2,4,46
719605021,26,3,2,1,32
719618165,119,12,2,1,134
719632458,58,3,2,1,64
719634254,89,40,6,1,136
719654580,144,3,2,1,150
719655234,108,8,2,2,120
719668414,92,17,3,1,113
719678794,11,3,2,1,17
719694322,44,30,20,2,96
719707411,27,3,2,1,33
719713239,48,38,2,1,89
719725397,41,3,2,8,54
719726559,92,3,3,3,101
719731190,12,23,2,1,38
719741086,51,61,29,3,144
719749337,69,21,7,21,118
719754741,85,13,31,1,130
719758388,155,23,2,2,182
719759452,24,15,2,5,46
719772730,45,28,46,2,121
719786534,82,10,64,8,164
719795808,12,7,2,1,22
719805994,82,32,2,4,120
719811071,43,25,43,12,123
719811483,87,3,2,1,93
719811552,31,41,27,1,100
719821297,27,18,2,27,74
719822730,53,3,2,1,59
719837588,35,3,2,2,42
719845612,21,57,9,9,96
719853588,10,4,2,1,17
719857685,78,3,2,1,84
719884088,87,47,2,25,161
719886980,37,21,3,8,69
719893278,103,3,2,1,109
719906017,123,13,26,6,168
719907389,19,3,2,2,26
719907605,93,11,4,2,110
719908757,197,3,2,2,204
719913600,147,3,2,2,154
719920752,115,131,77,4,327
719922413,119,3,2,1,125
719923586,23,43,3,13,82
719937310,57,32,2,1,92
719937986,63,3,2,4,72
719943711,40,15,21,19,95
719960322,61,109,3,16,189
719977316,23,3,2,8,36
719998187,26,15,25,10,76
720005742,48,4,2,1,55
720040216,14,3,2,1,20
720046231,83,3,2,1,89
720047138,13,11,2,1,27
720060837,73,29,2,1,105
720063346,78,21,13,23,135
720068898,29,3,2,1,35
720069950,43,17,2,1,63
720072917,11,19,2,1,33
720074514,16,10,2,1,29
720077616,39,3,2,4,48
720088153,76,123,39,5,243
720098456,60,21,3,8,92
720109593,325,7,2,5,339
720109787,21,6,2,1,30
720114385,75,4,31,4,114
720117297,48,3,2,4,57
720118473,47,3,2,1,53
720141536,76,31,2,16,125
720144003,10,4,2,1,17
720150824,94,3,8,1,106
720158228,130,3,2,16,151
720163269,10,9,2,1,22
720164096,38,20,2,47,107
720171828,14,11,8,1,34
720176097,74,20,9,2,105
720179711,11,3,2,1,17
720200743,12,4,2,1,19
720220763,28,3,5,2,38
720236895,95,18,14,21,148
720238938,93,8,33,3,137
720248034,20,3,2,1,26
720250598,65,87,56,16,224
720250851,70,24,21,15,130
720265932,20,3,2,2,27
720269176,50,3,2,1,56
720281712,36,3,2,1,42
720285374,14,3,2,2,21
720285605,13,28,5,3,49
720297640,73,39,33,2,147
720327004,57,3,2,2,64
720331171,15,8,2,1,26
720344837,122,20,4,18,164
720362395,92,16,61,12,181
720368013,50,12,14,1,77
720371863,55,46,2,20,123
720371868,41,24,5,1,71
720373846,76,12,10,8,106
720376119,68,43,20,1,132
720378124,120,34,28,5,187
720390969,332,3,26,1,362
720391842,51,27,15,2,95
720393034,100,40,12,1,153
720406542,41,17,38,5,101
720407473,101,3,6,9,119
720410958,115,3,2,1,121
720419401,83,9,2,1,95
720440529,76,32,2,2,112
720455658,98,33,76,4,211
720461050,52,34,2,11,99
720467380,22,3,2,1,28
720469779,193,21,61,5,280
720472408,117,27,4,15,163
720485154,10,3,2,2,17
720493389,40,27,2,1,70
720536246,24,4,2,1,31
720543915,111,3,2,1,117
720558828,55,15,2,2,74
720562421,95,3,2,1,101
720568690,57,50,3,3,113
720571851,13,44,6,2,65
720576550,55,5,2,1,63
720576784,51,33,37,2,123
720584387,40,16,2,7,65
720585978,30,14,2,8,54
720586221,48,34,4,1,87
720590505,29,21,14,7,71
720590853,11,3,2,1,17
720595233,159,3,2,1,165
720598537,59,19,50,8,136
720607923,10,5,2,1,18
720620185,53,12,2,6,73
720625042,125,18,2,1,146
720631911,20,5,11,1,37
720642359,10,11,2,1,24
720645851,12,8,2,1,23
720647539,22,3,2,1,28
720656515,48,19,7,1,75
720659382,11,13,2,1,27
720669770,32,27,2,2,63
720676876,83,35,7,1,126
720679446,45,23,2,1,71
720687876,37,38,8,15,98
720692091,10,23,3,1,37
720713608,79,3,2,1,85
720717327,30,75,16,3,124
720736532,87,12,12,1,112
720744263,107,3,2,1,113
720748037,29,25,2,6,62
720765955,92,65,2,20,179
720784739,10,6,2,8,26
720793308,11,3,2,1,17
720800402,64,54,12,11,141
720801494,159,3,2,2,166
720808903,39,39,12,22,112
720813980,139,29,62,2,232
720823594,117,23,111,3,254
720831130,10,3,10,8,31
720835263,14,3,2,1,20
720841884,23,13,2,6,44
720863443,76,51,34,7,168
720872966,132,8,5,38,183
720873195,23,7,2,2,34
720873730,24,11,2,1,38
720881726,48,3,2,1,54
720893235,22,3,2,2,29
720908740,33,65,12,15,125
720938593,252,4,2,4,262
720944629,60,14,3,13,90
720964554,71,21,2,33,127
720998357,203,48,2,2,255
721002193,43,45,3,7,98
721003175,131,3,2,1,137
721015136,11,3,2,1,17
721018617,26,15,2,1,44
721027346,57,31,2,1,91
721031520,91,59,12,3,165
721042131,12,3,2,1,18
721049515,78,30,29,15,152
721057052,11,3,2,1,17
721057382,74,43,2,1,120
721060616,112,6,27,3,148
721061746,69,3,2,2,76
721074330,40,10,8,3,61
721075554,88,11,137,6,242
721084311,19,18,25,6,68
721085410,38,42,2,1,83
721123104,64,61,2,3,130
721157938,183,22,2,7,214
721178039,12,13,2,1,28
721180601,21,48,9,1,79
721192566,73,31,4,7,115
721195228,24,69,2,10,105
721198878,111,107,9,19,246
721204952,11,7,2,1,21
721213190,47,9,2,4,62
721224396,12,3,2,1,18
721234642,61,3,2,21,87
721238309,47,3,2,1,53
721241588,113,36,2,11,162
721244240,105,48,39,50,242
721257569,10,3,2,2,17
721261075,16,3,2,1,22
721264811,54,3,2,1,60
721275778,85,50,2,17,154
721276473,117,8,2,4,131
721296016,49,5,2,3,59
721307311,22,3,2,2,29
721315462,123,6,19,7,155
721319087,49,12,19,2,82
721331767,30,3,2,1,36
721355136,83,5,5,8,101
721357935,44,31,32,47,154
721363374,34,19,15,7,75
721366449,21,29,2,1,53
721370452,93,53,43,18,207
721387026,36,5,5,23,69
721391800,19,5,6,1,31
721407127,10,5,2,1,18
721412861,30,38,50,1,119
721418602,47,4,3,1,55
721421325,182,3,2,1,188
721425613,42,10,2,5,59
721429522,16,25,8,1,50
721431551,23,3,2,3,31
721433369,56,42,16,2,116
721438833,18,3,2,1,24
721468064,83,35,44,50,212
721478375,142,3,2,8,155
721486759,72,14,23,2,111
721493635,158,7,2,3,170
721494716,262,8,2,3,275
721509835,27,3,2,1,33
721509971,48,3,2,3,56
721512607,19,3,2,1,25
721516520,21,8,4,2,35
721527521,33,14,17,1,65
721531118,19,3,2,1,25
721539326,52,3,2,3,60
721552222,12,3,2,1,18
721576130,95,63,7,20,185
721579801,76,22,94,2,194
721584141,35,3,2,18,58
721594004,63,3,2,5,73
721609424,43,3,2,1,49
721622363,84,9,52,2,147
721627982,37,3,2,1,43
721650569,27,44,2,1,74
721651558,96,21,7,4,128
721656757,59,33,14,1,107
721658825,30,13,14,5,62
721670512,54,8,29,18,109
721686935,110,13,12,33,168
721706101,15,6,2,5,28
721709960,50,13,20,27,110
721716991,66,18,33,3,120
721733821,67,24,4,1,96
721737301,18,3,2,1,24
721759373,50,60,8,4,122
721769310,153,51,78,52,334
721779859,18,11,5,2,36
721780741,99,3,2,2,106
721785000,104,3,2,2,111
721787953,68,18,30,13,129
721795214,14,3,2,1,20
721810627,16,3,2,12,33
721825356,199,3,2,6,210
721833086,13,3,2,1,19
721833708,115,51,2,1,169
721840153,22,9,3,5,39
721843094,50,3,2,1,56
721854658,145,11,2,13,171
721861889,56,28,11,1,96
721903332,76,14,8,1,99
721920055,43,21,2,4,70
721927014,143,25,36,1,205
721936907,31,18,45,4,98
721937386,11,3,2,1,17
721969917,138,3,2,4,147
721972830,23,16,47,1,87
721988098,75,3,2,1,81
721990039,13,3,2,1,19
721991831,136,3,2,1,142
722025343,14,3,2,1,20
722030117,14,3,2,1,20
722036410,174,13,21,24,232
722036684,46,65,13,2,126
722039080,19,3,2,1,25
722048366,37,57,9,3,106
722053392,82,22,6,23,133
722053608,36,3,2,1,42
722063142,28,20,8,1,57
722087945,36,15,12,5,68
722097778,93,13,2,5,113
722110106,335,59,3,3,400
722150214,47,11,2,1,61
722175497,86,3,2,1,92
722185771,11,3,2,1,17
722187688,16,3,2,1,22
722189496,11,5,2,4,22
722210211,66,45,42,3,156
722228090,54,3,2,1,60
722250046,46,13,3,3,65
722266666,54,3,2,3,62
722267382,54,35,2,8,99
722272584,35,24,28,25,112
722275580,166,3,2,1,172
722277603,66,46,31,3,146
722285538,32,17,11,3,63
722293030,35,15,2,3,55
722295798,86,9,2,19,116
722307794,165,26,28,12,231
722316692,68,16,2,3,89
722330186,121,24,9,1,155
722330966,35,38,2,1,76
722347631,43,9,28,1,81
722352008,55,6,2,6,69
722359946,13,9,2,1,25
722384820,16,3,2,1,22
722384909,57,3,2,4,66
722387153,138,10,2,3,153
722388279,66,34,42,15,157
722388887,68,7,2,1,78
722389312,27,82,2,1,112
722403239,57,5,2,8,72
722406995,65,12,2,1,80
722412030,58,21,33,5,117
722417729,46,3,2,1,52
722436701,71,21,42,1,135
722438541,70,32,2,1,105
722438560,132,3,2,2,139
722454129,112,26,2,17,157
722457117,60,45,13,1,119
722458747,66,32,2,12,112
722473509,47,16,2,5,70
722476947,38,21,9,2,70
722488833,91,15,20,2,128
722490417,52,36,2,1,91
722492704,488,3,2,3,496
722493650,23,3,2,5,33
722503868,109,28,9,52,198
722506911,42,11,15,2,70
722511678,52,32,36,24,144
722537475,123,43,12,5,183
722551030,78,21,4,3,106
722564165,11,3,2,2,18
722569582,14,3,2,1,20
722570482,66,9,2,1,78
722574458,17,5,5,1,28
722585580,79,86,76,2,243
722589129,42,9,2,7,60
722599867,19,22,2,7,50
722607512,51,5,9,6,71
722624311,85,5,2,1,93
722655786,11,3,2,1,17
722656539,72,60,54,22,208
722681863,33,52,4,3,92
722689724,14,3,2,1,20
722690096,68,45,6,2,121
722709989,140,87,18,7,252
722716451,62,3,2,2,69
722716510,43,3,2,1,49
722721641,35,27,51,1,114
722738496,35,29,2,1,67
722757447,139,3,2,3,147
722761096,11,3,2,3,19
722762081,83,3,2,1,89
722768194,89,35,24,1,149
722782859,153,3,12,11,179
722788002,224,28,2,3,257
722818625,84,25,5,5,119
722820787,33,22,57,2,114
722835546,24,25,2,1,52
722836628,33,33,20,14,100
722836885,80,3,2,2,87
722837554,38,60,3,3,104
722850446,15,3,2,2,22
722857793,22,3,2,3,30
722858674,122,3,2,2,129
722863912,843,6,2,6,857
722867747,89,16,5,10,120
722867883,71,8,2,7,88
722888138,108,26,27,31,192
722894278,36,15,2,12,65
722896108,69,8,6,3,86
722900244,29,59,2,1,91
722902077,24,30,3,1,58
722904606,103,45,4,28,180
722913860,59,3,2,3,67
722924603,81,46,32,2,161
722933608,88,20,2,2,112
722951297,101,16,6,8,131
722976020,110,14,23,2,149
722979045,148,3,2,3,156
723001920,13,3,2,1,19
723004478,96,27,14,6,143
723009835,174,15,2,1,192
723011693,144,3,2,1,150
723031074,10,4,2,3,19
723033585,42,111,49,22,224
723035475,46,39,2,2,89
723038817,47,22,23,10,102
723047947,123,24,24,1,172
723050786,40,3,2,1,46
723052601,436,3,2,1,442
723057416,151,24,15,7,197
723089890,50,3,2,1,56
723092656,36,14,6,2,58
723100197,23,8,2,1,34
723107618,13,18,2,1,34
723127323,18,11,2,8,39
723135257,12,6,2,1,21
723136348,10,13,6,3,32
723145906,64,4,20,4,92
723178182,12,9,4,3,28
723182047,14,7,2,1,24
723182224,91,34,3,2,130
723187000,71,12,42,16,141
723189150,62,9,6,9,86
723208287,29,74,30,2,135
723210941,51,59,4,55,169
723217985,18,14,3,1,36
723219507,16,9,2,1,28
723224236,23,23,6,3,55
723234439,148,33,2,7,190
723244143,97,11,2,2,112
723246791,57,6,2,9,74
723256012,85,15,83,3,186
723264000,62,10,5,3,80
723265905,72,30,66,2,170
723273304,15,3,2,2,22
723274853,10,4,2,1,17
723284200,33,20,54,12,119
723286370,26,3,2,2,33
723294008,54,17,2,4,77
723297570,10,4,2,1,17
723298103,65,11,55,18,149
723309666,100,10,2,21,133
723333117,228,9,34,30,301
723337357,37,12,2,1,52
723346008,117,5,22,6,150
723372110,10,14,2,1,27
723372408,21,32,2,3,58
723383107,15,3,2,7,27
723390651,157,88,3,7,255
723391597,52,3,2,8,65
723391879,23,38,15,1,77
723398694,221,31,3,4,259
723411387,84,18,13,7,122
723413993,42,26,2,5,75
723421121,13,3,2,1,19
723431965,51,42,24,2,119
723442544,30,9,2,1,42
723455621,36,3,14,1,54
723456383,36,30,2,5,73
723459122,55,3,5,4,67
723465213,11,3,2,1,17
723465670,69,12,22,1,104
723467428,19,25,2,7,53
723467539,76,3,2,3,84
723471787,86,5,3,7,101
723471959,111,22,104,12,249
723483802,44,3,2,2,51
723517085,14,3,2,1,20
723524203,54,75,159,20,308
723526986,50,9,2,1,62
723535873,101,29,73,8,211
723546390,163,50,30,20,263
723547443,116,3,2,1,122
723550874,11,4,2,1,18
723584798,38,90,6,1,135
723588447,65,23,29,1,118
723599435,99,3,2,1,105
723611880,137,3,2,2,144
723617955,84,3,2,1,90
723643627,36,96,3,9,144
723645775,112,11,31,3,157
723652868,109,89,4,2,204
723653692,88,3,2,1,94
723667094,60,19,35,10,124
723667880,55,3,2,1,61
723674414,65,21,4,8,98
723684078,103,36,3,4,146
723692312,51,59,14,1,125
723700662,70,52,2,1,125
723713639,19,3,2,1,25
723713773,15,6,2,1,24
723718990,21,52,18,12,103
723731158,45,30,2,1,78
723744756,25,20,32,1,78
723756443,21,34,2,3,60
723762919,67,3,2,1,73
723791068,36,58,2,1,97
723792215,114,15,8,1,138
723794042,71,12,2,19,104
723795709,17,12,2,1,32
723797916,76,16,2,12,106
723807401,12,3,2,1,18
723811041,10,5,2,1,18
723813527,74,38,84,16,212
723821417,81,3,2,9,95
723828081,126,75,119,12,332
723831298,32,8,2,1,43
723836320,54,45,3,1,103
723838428,57,3,2,3,65
723838601,38,14,16,5,73
723846704,50,48,2,2,102
723848601,36,28,3,1,68
723862028,110,13,2,1,126
723862065,171,12,25,29,237
723863446,13,3,2,1,19
723864727,200,3,2,6,211
723866648,462,22,2,22,508
723868326,23,3,2,5,33
723869923,108,3,2,2,115
723885602,13,3,2,1,19
723899391,15,3,2,1,21
723902289,64,14,39,1,118
723907569,14,13,2,1,30
723921297,12,5,2,1,20
723932283,15,4,2,1,22
723934024,27,38,9,3,77
723937250,12,67,11,5,95
723939788,122,21,2,14,159
723941593,51,26,2,1,80
723947719,85,59,39,10,193
723964535,34,10,7,2,53
723982051,39,15,2,6,62
723988046,32,3,2,2,39
723996952,34,16,21,2,73
724022423,68,3,2,1,74
724040833,91,117,41,5,254
724046556,193,9,2,15,219
724065279,136,3,2,3,144
724067926,51,52,2,1,106
724078570,117,51,2,4,174
724105713,20,4,2,1,27
724151182,63,41,2,11,117
724156417,43,37,18,4,102
724165402,39,49,26,1,115
724166688,22,12,2,1,37
724166895,20,8,2,1,31
724168147,27,3,2,1,33
724184238,82,8,2,1,93
724185543,38,20,37,2,97
724194177,132,16,2,30,180
724211148,11,3,2,5,21
724221502,19,9,3,1,32
724224031,13,3,2,1,19
724228916,69,49,45,11,174
724241827,229,9,2,3,243
724243844,44,10,2,2,58
724263118,121,44,31,33,229
724264805,98,11,2,2,113
724272335,135,16,15,1,167
724279608,17,3,2,1,23
724289548,15,9,2,1,27
724295011,134,56,38,8,236
724339400,17,3,2,3,25
724354810,45,13,41,1,100
724387054,11,3,2,1,17
724402390,81,3,2,1,87
724413988,45,9,2,11,67
724423184,44,22,33,6,105
724453727,57,8,2,1,68
724459731,35,3,2,5,45
724466390,67,39,63,5,174
724485307,26,11,25,3,65
724492947,182,23,33,1,239
724497014,72,33,4,5,114
724507770,48,53,4,5,110
724508975,38,53,21,26,138
724512997,53,27,2,1,83
724513307,30,68,2,2,102
724536740,79,24,38,5,146
724553147,29,83,16,36,164
724553607,18,57,2,1,78
724586823,49,19,43,14,125
724588404,46,28,2,4,80
724600672,11,3,2,1,17
724600912,103,54,56,86,299
724604838,55,3,2,1,61
724607162,245,3,2,2,252
724607738,22,35,3,3,63
724620630,14,10,2,1,27
724620928,12,3,2,1,18
724627032,288,3,2,3,296
724631112,69,3,2,1,75
724631183,99,96,122,1,318
724639549,126,14,2,8,150
724652249,45,112,27,5,189
724657789,154,69,2,7,232
724658557,32,3,2,1,38
724661946,11,32,2,4,49
724664975,75,18,6,3,102
724689510,122,23,3,54,202
724700122,224,11,2,1,238
724730319,77,12,2,1,92
724732382,80,3,2,3,88
724736353,61,50,52,5,168
724742540,17,3,2,1,23
724751464,53,49,6,5,113
724762622,30,39,2,10,81
724780605,67,25,2,2,96
724788439,19,24,14,2,59
724799773,89,6,2,2,99
724800995,132,3,2,2,139
724805659,10,5,2,1,18
724807101,83,4,3,9,99
724819445,170,3,4,1,178
724822704,26,19,30,1,76
724824777,71,22,8,1,102
724840861,45,39,12,14,110
724843767,103,3,2,7,115
724844932,72,17,74,8,171
724846448,48,3,2,3,56
724846641,18,32,2,24,76
724847592,10,3,2,2,17
724855681,20,3,2,1,26
724857721,103,18,3,3,127
724884176,70,8,6,1,85
724889046,64,16,3,1,84
724892222,228,4,2,1,235
724894601,23,3,2,3,31
724898767,92,3,6,7,108
724908691,40,21,8,11,80
724941862,44,22,39,4,109
724942419,95,37,64,16,212
724958947,77,3,2,5,87
724964840,144,42,2,1,189
724972630,61,55,23,8,147
724976995,71,29,2,1,103
724980025,66,13,2,7,88
724982561,11,4,3,1,19
724989728,18,29,16,7,70
725009859,25,3,2,1,31
725025072,132,14,3,8,157
725026271,14,6,2,1,23
725031478,61,5,11,4,81
725045944,82,35,132,61,310
725046007,24,24,4,2,54
725049467,16,9,2,1,28
725052134,52,11,2,8,73
725061303,24,8,2,4,38
725063778,102,39,135,3,279
725077961,196,3,2,6,207
725086796,32,6,6,1,45
725089075,102,3,2,1,108
725092991,55,47,18,7,127
725101129,34,3,2,1,40
725121780,11,8,11,1,31
725137279,23,3,2,11,39
725138828,712,3,2,10,727
725145573,10,8,2,1,21
725155542,72,31,9,2,114
725164280,100,3,5,3,111
725178693,189,23,2,1,215
725180392,64,3,2,1,70
725181483,13,22,2,1,38
725209252,12,3,2,1,18
725211158,97,17,3,1,118
725215299,76,3,2,6,87
725231290,18,9,2,2,31
725247462,75,51,7,5,138
725250881,119,33,2,1,155
725276554,225,4,3,9,241
725278723,169,3,2,24,198
725288037,75,7,2,4,88
725303533,34,3,2,2,41
725307100,109,17,16,14,156
725334182,176,25,5,5,211
725342385,108,8,3,20,139
725346914,50,3,2,1,56
725348746,32,4,2,4,42
725358299,125,68,69,3,265
725358420,14,15,13,3,45
725361686,17,5,2,1,25
725368188,39,5,2,1,47
725380192,28,42,2,1,73
725394173,332,23,20,7,382
725397757,102,3,2,1,108
725413166,13,32,26,5,76
725413618,154,12,3,4,173
725426747,82,33,18,11,144
725436963,38,24,19,10,91
725443651,87,3,2,9,101
725452755,28,5,3,7,43
725458024,131,86,4,1,222
725462934,77,19,96,1,193
725465048,20,26,8,4,58
725475110,93,63,23,11,190
725479649,11,3,2,1,17
725485492,109,3,2,1,115
725488921,22,5,2,1,30
725497762,11,3,2,1,17
725499274,114,3,2,1,120
725509971,28,21,9,1,59
725518125,280,3,2,11,296
725524050,48,16,13,6,83
725532124,49,42,4,1,96
725549778,41,25,25,1,92
725558812,102,38,2,29,171
725559301,47,3,2,1,53
725564943,82,3,2,11,98
725565163,90,30,19,20,159
725587813,66,11,28,1,106
725589777,102,4,2,23,131
725597465,60,8,38,3,109
725598564,11,3,2,1,17
725603700,179,66,4,7,256
725605825,49,6,8,1,64
725609968,43,36,10,1,90
725622891,127,27,11,1,166
725631416,10,7,2,2,21
725647123,11,3,2,1,17
725650305,268,51,4,15,338
725653816,12,15,2,1,30
725673991,120,17,24,63,224
725691818,61,27,11,3,102
725692912,99,41,93,9,242
725698785,71,18,27,7,123
725699836,129,3,2,1,135
725703491,30,24,2,1,57
725721193,271,3,2,1,277
725729622,101,25,22,3,151
725735133,102,5,2,16,125
725738695,78,19,33,9,139
725749631,10,5,2,1,18
725758458,15,3,2,1,21
725759112,53,9,2,1,65
725781873,100,36,80,10,226
725784683,111,45,20,55,231
725801829,110,3,2,1,116
725841585,42,22,3,1,68
725853415,15,7,2,1,25
725859998,76,17,36,1,130
725865308,53,30,2,2,87
725872302,49,45,109,4,207
725875534,32,38,26,1,97
725892060,151,51,30,1,233
725898739,103,43,35,6,187
725922545,11,3,2,2,18
725922574,47,79,11,1,138
725926313,61,3,2,23,89
725928045,64,42,55,3,164
725932818,29,23,2,1,55
725933784,13,28,2,5,48
725934827,12,3,2,1,18
725944450,70,13,2,5,90
725960730,42,11,24,2,79
725972385,92,19,12,13,136
725974248,60,5,24,9,98
725993355,64,42,32,56,194
726004802,89,34,16,3,142
726020825,152,20,5,3,180
726029815,21,3,2,1,27
726032748,49,45,19,1,114
726033163,86,34,5,2,127
726062959,37,36,6,10,89
726068144,11,38,2,1,52
726069520,31,3,2,1,37
726081242,303,3,2,1,309
726084164,70,41,2,11,124
726111807,165,3,2,3,173
726133993,55,42,59,1,157
726145661,127,11,116,2,256
726157862,126,3,16,1,146
726158467,49,3,2,12,66
726196047,54,19,33,1,107
726200741,59,7,53,11,130
726207523,207,7,7,10,231
726207828,49,3,2,2,56
726219203,134,3,2,4,143
726224565,66,3,2,2,73
726249470,183,3,2,8,196
726257698,11,64,2,11,88
726272480,69,15,52,4,140
726274147,31,34,43,7,115
726277461,24,10,41,1,76
726283378,53,19,24,6,102
726300197,74,28,3,1,106
726301019,184,34,60,15,293
726303347,16,6,2,1,25
726343044,25,11,7,21,64
726364340,13,3,2,1,19
726379039,66,42,2,9,119
726382573,12,62,2,2,78
726383897,10,4,2,1,17
726409284,49,20,30,1,100
726409391,112,33,40,4,189
726414590,76,50,9,20,155
726434303,59,3,2,4,68
726445210,52,68,19,1,140
726447181,18,19,2,6,45
726453393,75,8,28,1,112
726459734,43,78,55,26,202
726464498,100,3,2,12,117
726465341,32,64,18,1,115
726480663,57,65,24,40,186
726502573,75,18,8,8,109
726527300,183,3,2,1,189
726529038,18,28,3,5,54
726529409,64,3,2,1,70
726532144,92,26,5,3,126
726533675,27,17,2,1,47
726538116,180,32,17,1,230
726566985,57,41,70,18,186
726581734,115,40,2,2,159
726584985,331,27,2,24,384
726585089,10,24,2,3,39
726585580,43,36,2,1,82
726591022,19,4,2,1,26
726597330,91,17,2,2,112
726607180,90,23,4,19,136
726613999,73,78,56,2,209
726625471,166,27,5,4,202
726629495,58,9,5,8,80
726638683,233,6,5,27,271
726651078,38,3,2,1,44
726657337,48,21,23,1,93
726665230,267,3,2,16,288
726672521,92,9,2,1,104
726690058,164,56,15,5,240
726691857,24,3,2,13,42
726708540,10,4,2,1,17
726731661,90,35,2,2,129
726739601,56,30,2,1,89
726746474,23,27,14,6,70
726755747,69,38,2,1,110
726762580,99,10,2,1,112
726765650,11,3,2,1,17
726769508,51,6,2,1,60
726792132,14,3,2,1,20
726806963,12,7,2,2,23
726810695,69,3,2,1,75
726815168,112,16,14,16,158
726816666,36,3,2,1,42
726817019,35,3,2,2,42
726817938,151,3,2,11,167
726818381,13,3,2,1,19
726830073,22,4,2,1,29
726840467,67,21,2,1,91
726844637,19,41,2,2,64
726850049,54,55,46,12,167
726859093,116,54,3,1,174
726871707,166,35,2,1,204
726877099,31,23,31,1,86
726902135,77,47,3,6,133
726907596,96,3,2,1,102
726908231,40,17,36,1,94
726917652,37,3,2,6,48
726928324,116,59,6,2,183
726929758,178,3,2,48,231
726933918,45,73,2,6,126
726936734,96,3,2,1,102
726955963,142,49,70,21,282
726960526,34,3,2,1,40
726962962,47,46,9,18,120
726969784,12,10,2,1,25
726981485,15,7,2,1,25
727002980,59,3,2,1,65
727013141,11,16,2,1,30
727014267,75,32,114,3,224
727017484,30,44,3,8,85
727048789,10,8,2,1,21
727053411,10,4,2,1,17
727059594,37,37,22,1,97
727067170,63,19,2,4,88
727079490,52,6,2,2,62
727097345,171,27,41,30,269
727097905,36,33,2,1,72
727100331,36,34,12,5,87
727110164,49,3,2,1,55
727118017,10,30,2,1,43
727118144,127,15,18,1,161
727120330,29,3,2,2,36
727137513,128,13,2,1,144
727144313,119,32,2,1,154
727144747,53,3,3,3,62
727162468,66,28,6,28,128
727177849,30,26,3,1,60
727188153,14,18,2,1,35
727194018,33,46,25,24,128
727194654,39,18,7,1,65
727197191,53,3,2,1,59
727197318,114,53,84,3,254
727208125,50,20,3,12,85
727220440,182,41,5,12,240
727232276,93,3,2,8,106
727238114,18,14,17,1,50
727243474,41,19,2,1,63
727243809,25,3,2,2,32
727251916,107,50,63,1,221
727266692,95,10,2,1,108
727271266,54,11,22,3,90
727287198,14,34,2,2,52
727298653,10,4,2,1,17
727315514,36,24,6,1,67
727323248,16,3,2,1,22
727328614,46,12,8,5,71
727334590,12,3,2,1,18
727338212,289,33,146,26,494
727339197,83,28,22,16,149
727367954,89,38,3,56,186
727380276,14,3,2,1,20
727380280,62,3,2,2,69
727388358,20,20,2,14,56
727388437,17,3,4,2,26
727393085,95,3,2,2,102
727393201,92,3,2,11,108
727393472,34,25,17,32,108
727394577,98,36,97,5,236
727402224,30,13,2,1,46
727409526,48,41,4,6,99
727418984,111,21,9,5,146
727427644,11,3,2,1,17
727429814,23,68,9,45,145
727431240,66,3,2,12,83
727440776,17,9,2,2,30
727445909,16,3,2,1,22
727446955,67,63,45,13,188
727454106,52,3,2,1,58
727457969,79,19,2,3,103
727471172,16,26,18,1,61
727517677,13,3,2,1,19
727518000,115,3,2,8,128
727518127,46,10,2,1,59
727529089,10,9,2,1,22
727533232,74,17,2,8,101
727536877,36,5,30,11,82
727539077,36,11,2,2,51
727564031,18,23,5,1,47
727571302,14,3,2,1,20
727571358,55,32,33,2,122
727573719,53,3,2,3,61
727575699,135,23,8,2,168
727577199,22,16,27,1,66
727577956,46,30,7,89,172
727594118,23,34,10,8,75
727608280,116,3,2,22,143
727617571,86,4,2,6,98
727641556,88,133,15,66,302
727652414,113,20,2,1,136
727654570,38,6,2,1,47
727658530,97,3,2,1,103
727660338,32,28,2,2,64
727677242,60,11,3,5,79
727681755,12,41,2,1,56
727693819,37,11,6,2,56
727706481,15,6,2,1,24
727707146,48,46,49,3,146
727715721,34,9,2,3,48
727716301,46,8,2,6,62
727722810,34,58,43,4,139
727731626,44,13,2,1,60
727739933,67,19,2,3,91
727742244,36,6,2,3,47
727743094,18,3,2,1,24
727744842,17,5,3,3,28
727769087,58,18,3,7,86
727775550,57,49,18,7,131
727781779,145,16,50,10,221
727798142,10,7,2,1,20
727801661,10,17,2,1,30
727807519,64,43,2,6,115
727821912,60,108,18,8,194
727834137,19,7,2,1,29
727847932,148,69,4,28,249
727863241,16,3,2,1,22
727881430,27,4,17,4,52
727885033,81,70,22,19,192
727897256,15,3,2,3,23
727908519,27,30,3,24,84
727923789,15,29,2,1,47
727927962,17,27,4,1,49
727937823,15,6,2,2,25
727954507,24,3,2,4,33
727954993,46,22,15,6,89
727959893,93,3,2,1,99
727968970,110,20,5,6,141
727977884,71,10,2,1,84
727980320,70,25,33,6,134
727994029,10,5,2,1,18
728011088,61,12,25,4,102
728024851,70,3,2,7,82
728024882,19,3,2,1,25
728032986,188,5,2,3,198
728046419,91,14,71,2,178
728053556,44,67,25,7,143
728077601,23,3,2,1,29
728082523,104,10,125,19,258
728094356,36,17,2,3,58
728106473,17,48,2,8,75
728122571,72,27,10,5,114
728123120,49,31,2,1,83
728150560,91,28,51,3,173
728160107,10,6,2,1,19
728165124,131,64,3,19,217
728169772,36,40,70,3,149
728171518,110,18,2,7,137
728200148,72,13,20,6,111
728204502,35,14,7,2,58
728211904,136,33,16,8,193
728221893,54,3,2,2,61
728228358,78,9,2,4,93
728229120,74,9,2,4,89
728240351,37,30,2,8,77
728263298,34,31,11,6,82
728267810,11,3,2,1,17
728275861,11,25,2,1,39
728277683,10,3,2,3,18
728281071,188,37,4,2,231
728296915,18,21,3,9,51
728315478,37,101,45,16,199
728316380,140,3,2,6,151
728322927,13,9,2,1,25
728325514,31,20,2,114,167
728327955,68,3,2,1,74
728347728,35,3,9,9,56
728361560,26,45,20,1,92
728372906,36,3,2,1,42
728375964,62,44,95,16,217
728383762,41,3,16,1,61
728385965,11,3,2,1,17
728389362,11,3,2,1,17
728394885,45,6,10,6,67
728400996,113,3,2,137,255
728402497,33,13,3,9,58
728418695,41,3,2,26,72
728431527,49,3,2,9,63
728431708,13,8,2,2,25
728443577,286,48,88,30,452
728453007,31,28,10,1,70
728454988,72,73,13,7,165
728460607,91,8,13,8,120
728462249,173,79,19,4,275
728504629,35,31,27,5,98
728507781,116,46,98,4,264
728509541,65,23,2,1,91
728509944,36,19,32,1,88
728514120,82,18,2,1,103
728519334,25,50,13,2,90
728526792,56,6,2,1,65
728547219,180,3,2,6,191
728548944,25,18,40,4,87
728549909,142,128,5,4,279
728552607,62,25,6,1,94
728552736,112,3,2,1,118
728554272,45,12,2,12,71
728555445,47,16,2,2,67
728563288,29,22,2,1,54
728573159,63,27,17,23,130
728575289,31,19,2,5,57
728580105,87,7,11,4,109
728586128,51,32,59,1,143
728586474,101,3,2,1,107
728616384,10,4,2,1,17
728616834,25,3,2,7,37
728624042,67,19,2,59,147
728639744,25,19,2,1,47
728642964,11,3,2,1,17
728650084,47,39,64,3,153
728651348,125,29,72,1,227
728672961,14,4,2,2,22
728676133,10,3,2,17,32
728683246,13,3,2,1,19
728688440,40,15,3,3,61
728698729,71,39,6,1,117
728699237,53,19,10,10,92
728707988,17,3,2,1,23
728708600,47,46,51,58,202
728709225,46,6,2,8,62
728710614,37,3,2,2,44
728711911,18,77,14,3,112
728721458,66,27,6,7,106
728754848,20,3,2,1,26
728760849,16,26,7,20,69
728766980,53,21,75,15,164
728767531,202,59,54,10,325
728774534,11,7,2,1,21
728775107,79,19,16,1,115
728785039,108,19,17,4,148
728802238,12,9,2,1,24
728820633,33,23,2,1,59
728823150,103,31,12,44,190
728828140,106,15,26,25,172
728844040,76,3,2,1,82
728857777,66,22,2,7,97
728860532,180,3,2,2,187
728865859,48,44,2,1,95
728872837,103,18,8,4,133
728892953,116,27,2,1,146
728899111,35,12,2,1,50
728906595,130,16,30,14,190
728912083,14,3,2,2,21
728924556,50,4,2,4,60
728968890,10,3,2,3,18
728979314,72,37,35,37,181
728993481,72,40,9,18,139
728995594,45,4,12,4,65
728996445,147,6,2,10,165
729002128,56,3,2,5,66
729022895,87,20,2,2,111
729028352,86,25,2,19,132
729028652,35,19,4,5,63
729034904,11,3,2,1,17
729044798,26,28,2,3,59
729046231,172,3,2,1,178
729052205,211,26,2,27,266
729059812,29,11,2,2,44
729066171,148,3,2,4,157
729089327,11,11,2,1,25
729097464,55,68,36,1,160
729103310,49,34,21,10,114
729104537,11,3,2,1,17
729104754,20,21,7,1,49
729105289,25,3,2,1,31
729114071,68,14,2,2,86
729114964,50,3,2,3,58
729115343,75,27,27,54,183
729116687,34,3,2,1,40
729143794,19,3,2,1,25
729150518,55,19,2,8,84
729153198,10,7,2,1,20
729158491,85,45,44,4,178
729159861,17,3,2,2,24
729160689,41,3,2,4,50
729173351,159,44,2,30,235
729176585,48,15,2,11,76
729181346,26,7,2,1,36
729182750,72,52,34,25,183
729183702,12,3,2,1,18
729192127,40,3,2,1,46
729203338,89,54,98,14,255
729203607,118,63,38,35,254
729206030,184,27,2,1,214
729207002,51,22,9,27,109
729215913,107,6,2,8,123
729222650,27,17,2,12,58
729227291,27,3,2,1,33
729231760,127,3,2,3,135
729236357,11,51,2,1,65
729272718,11,3,2,2,18
729283108,116,41,2,1,160
729298845,14,3,2,1,20
729314290,12,3,2,1,18
729322638,170,79,2,1,252
729329281,58,3,2,1,64
729336222,21,7,2,1,31
729341912,13,3,2,1,19
729358799,71,3,2,1,77
729361044,10,5,2,1,18
729367603,105,3,2,1,111
729376553,89,46,37,94,266
729396033,43,3,2,6,54
729397315,15,3,2,1,21
729400324,26,61,19,5,111
729401857,50,15,18,1,84
729402240,173,40,19,5,237
729431773,61,4,2,10,77
729432626,132,3,2,1,138
729443829,11,3,2,1,17
729446822,114,51,16,13,194
729447823,101,3,2,1,107
729467230,44,35,26,1,106
729471892,87,30,9,8,134
729490449,133,3,2,10,148
729492098,105,23,17,4,149
729517025,16,3,2,3,24
729521748,48,3,2,1,54
729523567,155,57,59,7,278
729526000,99,37,14,53,203
729536099,17,3,2,8,30
729542403,30,3,2,1,36
729559551,15,19,2,4,40
729563314,65,3,2,1,71
729581392,90,3,2,2,97
729602564,21,8,64,1,94
729604237,10,31,2,1,44
729655739,68,16,55,22,161
729656972,28,11,5,1,45
729660262,50,24,2,7,83
729664285,47,3,2,6,58
729666499,171,3,2,7,183
729730977,19,6,2,3,30
729751886,34,24,10,12,80
729758431,25,3,2,3,33
729766784,49,15,36,2,102
729769439,34,6,2,2,44
729771016,31,3,2,2,38
729775773,58,16,2,1,77
729789944,101,30,94,47,272
729796972,35,3,2,2,42
729806748,119,30,10,15,174
729819523,30,25,2,1,58
729821878,81,53,4,12,150
729828685,44,81,21,3,149
729838496,115,3,2,1,121
729838773,151,18,2,20,191
729848046,30,33,8,3,74
729855203,88,6,2,1,97
729865029,86,24,23,30,163
729869752,80,3,2,3,88
729872834,16,14,2,1,33
729894668,12,28,2,1,43
729894866,105,14,47,7,173
729904958,13,3,2,6,24
729905559,125,18,2,10,155
729906174,33,12,2,1,48
729907794,95,50,2,19,166
729920084,90,12,2,1,105
729921200,54,52,2,11,119
729940731,45,65,119,100,329
729949617,32,24,6,3,65
729950604,19,3,2,1,25
729955123,88,3,2,35,128
729968749,35,25,55,13,128
729970401,101,18,2,3,124
729983338,130,23,2,14,169
729992542,68,4,19,1,92
729996627,56,47,31,18,152
729997448,80,30,2,1,113
730000759,140,22,6,2,170
730007518,24,3,2,1,30
730014987,120,12,109,7,248
730062757,36,73,2,2,113
730062972,24,14,2,5,45
730068600,116,38,2,3,159
730074213,96,14,5,4,119
730086416,58,3,2,1,64
730086559,103,15,2,4,124
730090117,75,3,2,6,86
730096144,24,3,2,1,30
730100888,61,40,12,11,124
730106826,93,24,11,5,133
730115683,58,3,2,1,64
730130488,27,4,2,33,66
730131706,140,13,111,9,273
730154601,140,3,2,1,146
730156202,33,3,4,1,41
730190121,12,3,2,1,18
730192080,18,14,2,1,35
730195510,23,17,21,6,67
730200568,39,22,7,3,71
730203570,128,22,2,6,158
730242891,81,31,2,1,115
730268118,20,3,2,1,26
730277452,94,11,27,1,133
730297533,73,3,2,5,83
730319009,11,3,2,1,17
730350337,17,7,3,3,30
730364939,49,3,8,1,61
730367407,10,11,2,1,24
730403716,144,38,50,73,305
730408245,130,19,3,35,187
730414695,86,3,2,7,98
730419577,165,23,79,5,272
730429830,36,3,2,1,42
730433595,25,26,15,1,67
730441461,45,19,26,4,94
730447446,41,27,40,5,113
730450639,188,40,9,23,260
730486679,109,12,32,3,156
730489489,47,4,2,3,56
730504521,30,15,7,1,53
730511730,87,19,8,7,121
730512489,10,3,2,2,17
730521695,36,40,17,5,98
730528993,398,3,2,19,422
730532590,154,53,227,44,478
730533127,777,3,2,8,790
730542750,72,37,32,1,142
730549206,70,40,43,7,160
730562493,21,89,8,1,119
730562846,126,10,2,6,144
730589349,353,4,22,16,395
730592437,15,3,2,2,22
730611358,13,7,2,1,23
730617256,19,17,3,1,40
730638857,68,25,2,1,96
730653769,25,20,4,15,64
730662047,91,3,2,4,100
730666704,22,9,4,2,37
730680653,32,12,3,3,50
730688552,11,3,2,4,20
730694613,10,5,2,1,18
730708647,17,15,2,1,35
730716270,88,33,44,10,175
730724162,35,55,30,9,129
730728063,25,55,22,1,103
730734022,22,60,4,5,91
730740094,12,3,2,1,18
730742981,100,14,2,1,117
730763336,79,26,22,9,136
730766449,129,57,20,3,209
730783375,58,55,2,1,116
730805725,11,3,2,1,17
730808908,69,11,54,5,139
730813980,34,3,2,1,40
730815218,68,3,2,4,77
730830636,129,40,23,7,199
730830640,54,3,2,1,60
730837307,66,7,3,31,107
730853998,50,17,5,9,81
730876141,158,30,14,4,206
730878455,61,35,2,5,103
730885173,46,25,2,1,74
730887573,85,17,7,3,112
730894011,72,25,7,39,143
730901028,10,47,2,2,61
730910307,55,4,11,15,85
730910753,83,3,2,4,92
730912168,58,11,2,1,72
730915607,116,38,87,10,251
730928441,40,55,6,2,103
730931308,55,3,2,2,62
730948255,102,29,3,2,136
730948459,139,3,38,1,181
730987479,13,3,2,1,19
730988825,11,6,2,1,20
730997532,106,47,15,4,172
731003194,11,5,2,1,19
731005980,75,6,2,5,88
731011170,17,3,2,1,23
731014537,94,18,3,7,122
731022399,23,63,24,6,116
731025649,156,3,2,3,164
731042905,27,3,2,4,36
731046272,57,36,71,1,165
731073357,114,10,2,1,127
731082375,30,3,2,1,36
731090175,46,61,95,10,212
731091948,100,61,17,92,270
731159751,32,3,2,4,41
731167366,146,14,2,7,169
731168096,78,3,2,1,84
731183489,89,4,52,1,146
731186885,76,22,35,1,134
731200806,140,3,2,2,147
731205142,19,4,2,1,26
731209105,62,25,16,37,140
731219075,10,3,2,2,17
731222820,64,37,3,5,109
731228258,76,32,15,1,124
731258376,10,3,2,2,17
731314009,169,3,2,1,175
731330810,14,3,2,1,20
731331180,92,16,2,3,113
731336884,64,23,13,8,108
731341339,29,58,2,5,94
731342327,96,40,41,2,179
731363098,38,11,31,4,84
731370942,151,3,2,16,172
731371418,33,13,11,2,59
731389081,54,17,11,1,83
731392064,40,10,16,3,69
731416515,105,38,2,7,152
731425736,13,3,2,9,27
731443536,76,30,33,6,145
731456554,13,8,4,1,26
731462560,74,3,3,1,81
731476607,50,34,5,1,90
731482400,14,3,2,2,21
731486963,22,3,2,3,30
731501970,238,3,2,14,257
731510472,159,3,2,1,165
731513614,218,5,2,6,231
731514335,20,10,2,2,34
731514462,136,3,2,1,142
731525454,12,3,2,2,19
731526777,124,6,12,1,143
731528158,70,7,2,1,80
731538383,578,3,2,3,586
731557853,12,3,2,1,18
731565656,171,3,49,81,304
731576322,59,8,2,3,72
731580815,160,24,29,7,220
731585759,49,35,5,3,92
731605609,75,89,16,1,181
731609392,10,5,2,1,18
731624252,12,6,2,1,21
731630231,20,3,13,3,39
731653728,19,3,2,1,25
731673112,83,9,2,1,95
731677335,53,21,4,9,87
731686710,161,3,7,3,174
731692697,60,23,9,3,95
731694985,75,9,2,2,88
731710066,44,10,2,3,59
731730787,120,6,41,31,198
731733584,84,34,19,15,152
731735969,108,11,3,2,124
731736307,70,3,2,9,84
731774277,61,5,47,1,114
731778886,69,3,2,1,75
731789819,96,3,2,3,104
731802111,99,6,2,1,108
731815951,27,23,2,2,54
731824704,168,20,6,1,195
731828132,105,15,23,18,161
731839719,15,3,2,1,21
731845955,166,9,2,4,181
731847757,63,6,2,1,72
731848600,68,33,103,33,237
731855252,228,21,53,47,349
731855499,161,39,56,12,268
731874069,36,46,3,1,86
731878553,24,9,2,1,36
731886594,44,44,8,3,99
731893470,21,44,2,19,86
731901573,14,3,2,1,20
731910632,75,5,4,8,92
731916507,385,5,2,11,403
731942613,10,3,2,2,17
731946310,29,10,2,3,44
731968903,96,21,10,3,130
731971084,89,30,122,50,291
732011630,103,32,2,6,143
732016878,95,3,2,1,101
732019483,26,3,2,1,32
732024068,33,3,2,1,39
732029481,44,3,2,3,52
732037264,34,3,2,9,48
732067655,76,26,48,17,167
732076308,273,10,2,4,289
732089808,79,3,2,1,85
732099222,204,3,2,5,214
732101765,81,12,4,1,98
732105414,62,3,2,1,68
732108205,19,21,4,1,45
732108690,19,71,3,6,99
732117114,13,18,4,1,36
732131230,17,18,2,1,38
732135857,18,40,2,1,61
732137231,34,41,3,1,79
732141741,101,3,4,1,109
732152696,13,3,2,6,24
732159446,129,4,16,2,151
732194801,12,5,9,5,31
732194835,50,45,4,9,108
732195200,73,37,2,68,180
732197818,86,18,5,14,123
732204930,58,61,40,1,160
732218837,42,25,14,15,96
732232947,38,24,42,3,107
732246995,126,7,18,1,152
732248614,104,21,2,7,134
732248659,13,4,2,1,20
732250707,59,9,2,3,73
732250879,85,24,2,11,122
732262885,17,34,2,18,71
732281825,51,28,2,6,87
732293421,12,3,2,1,18
732298826,184,21,25,39,269
732308013,106,17,41,48,212
732311073,25,4,2,1,32
732315496,79,28,20,2,129
732315869,54,23,17,17,111
732326012,54,16,19,1,90
732330395,122,3,2,1,128
732345220,49,42,15,17,123
732350246,10,12,2,1,25
732364505,16,41,2,1,60
732390891,21,4,8,1,34
732398515,63,82,30,2,177
732405273,10,11,2,1,24
732408747,10,10,4,1,25
732409307,10,4,2,1,17
732412971,47,17,2,1,67
732426016,153,47,19,2,221
732427656,168,22,17,3,210
732432966,52,3,2,3,60
732439963,87,8,74,7,176
732445801,53,34,11,1,99
732465863,209,67,58,62,396
732466627,120,23,2,1,146
732469147,47,22,2,2,73
732493106,66,15,3,1,85
732494377,62,3,2,1,68
732496774,87,36,19,2,144
732500108,27,3,2,1,33
732519752,129,73,75,13,290
732521730,83,31,9,6,129
732524590,126,3,2,1,132
732548604,224,42,13,1,280
732551034,47,39,17,1,104
732563388,263,3,2,7,275
732576224,48,21,6,10,85
732588974,13,4,2,1,20
732595644,46,3,2,8,59
732595833,128,13,112,22,275
732604277,17,3,2,1,23
732613122,11,3,2,1,17
732627115,96,49,2,1,148
732644299,21,12,2,6,41
732658588,12,3,2,1,18
732663378,30,27,57,27,141
732671389,81,18,8,12,119
732692184,53,55,46,22,176
732696588,16,4,2,1,23
732702052,57,5,24,10,96
732706202,26,11,10,1,48
732722970,29,49,72,1,151
732723713,66,3,2,1,72
732732202,52,18,2,1,73
732739181,14,3,2,2,21
732749777,62,40,10,8,120
732761979,58,14,10,5,87
732766465,41,70,32,33,176
732770909,115,3,2,4,124
732774675,56,21,16,22,115
732796239,92,12,19,15,138
732807563,26,3,2,2,33
732812432,28,3,2,2,35
732812805,69,3,2,3,77
732831182,157,12,2,4,175
732837416,125,3,2,1,131
732840297,18,17,2,3,40
732841477,84,56,45,13,198
732841938,100,18,2,5,125
732842824,43,4,3,2,52
732847777,112,3,2,1,118
732854424,79,20,30,5,134
732858655,14,3,2,1,20
732859593,79,4,6,2,91
732863816,12,30,2,1,45
732889934,13,3,2,3,21
732901692,11,3,2,1,17
732901724,12,3,2,1,18
732935189,44,6,2,2,54
732942581,137,8,2,2,149
732956058,38,27,25,1,91
732959541,88,3,2,17,110
732962021,152,32,3,10,197
732976141,12,3,2,2,19
732991974,89,3,2,3,97
732993306,134,51,12,3,200
732996153,88,60,50,8,206
733031192,43,28,25,1,97
733034177,13,12,2,1,28
733046673,38,3,7,3,51
733048394,52,38,7,5,102
733049993,20,3,2,1,26
733053770,48,13,2,4,67
733054861,62,9,47,2,120
733057306,95,47,15,20,177
733065514,15,3,2,1,21
733068739,10,3,2,2,17
733078075,68,3,2,40,113
733084233,53,9,4,10,76
733085163,16,3,2,1,22
733088409,57,17,2,2,78
733096412,1377,4,2,9,1392
733096855,152,7,2,1,162
733099367,29,12,21,7,69
733109163,19,6,2,3,30
733117450,45,36,2,15,98
733122336,27,54,2,3,86
733138678,42,50,52,19,163
733142307,23,20,3,15,61
733148037,62,17,2,4,85
733154625,51,10,2,1,64
733176962,13,3,2,1,19
733183409,27,15,3,1,46
733187964,34,12,54,2,102
733200664,19,3,2,5,29
733204991,81,9,2,3,95
733208029,152,29,19,8,208
733209399,152,50,18,8,228
733211623,39,3,2,7,51
733218256,45,12,2,3,62
733222807,134,32,3,3,172
733236688,42,3,2,5,52
733236782,27,29,5,1,62
733237367,34,19,2,1,56
733244353,29,17,2,5,53
733268312,88,17,4,1,110
733268368,58,16,2,12,88
733268484,178,3,2,2,185
733277266,77,16,2,8,103
733333403,15,12,3,3,33
733333578,341,3,2,1,347
733343108,36,12,7,11,66
733354997,188,29,2,1,220
733363486,13,8,2,2,25
733365961,63,3,2,1,69
733371295,74,41,2,3,120
733376953,168,23,2,4,197
733390459,12,4,2,1,19
733391526,238,3,2,2,245
733431600,31,3,2,1,37
733476763,191,3,2,1,197
733485080,17,14,2,1,34
733491603,81,3,2,1,87
733499498,54,50,11,36,151
733504748,252,3,2,6,263
733505529,125,47,22,7,201
733529816,179,14,2,5,200
733541275,128,3,2,1,134
733558040,57,45,2,4,108
733578406,64,33,41,5,143
733580849,11,3,2,1,17
733587160,50,55,50,1,156
733612884,105,26,42,6,179
733613264,180,11,2,1,194
733622149,57,73,2,30,162
733639600,16,3,2,1,22
733650721,61,30,11,10,112
733650957,97,13,49,1,160
733654545,13,24,2,2,41
733655361,39,64,13,1,117
733657592,47,3,2,1,53
733672454,12,3,2,1,18
733685093,40,5,5,5,55
733691471,71,15,2,12,100
733704948,154,3,46,4,207
733717687,53,28,16,26,123
733722380,143,38,2,18,201
733722423,52,3,189,7,251
733728302,55,77,11,1,144
733767478,116,9,2,3,130
733776176,22,34,13,6,75
733776328,44,65,37,1,147
733780202,56,3,2,2,63
733802128,34,17,26,3,80
733804726,37,3,2,1,43
733809684,57,21,7,12,97
733818516,45,16,2,1,64
733838739,17,3,2,1,23
733845029,89,30,69,6,194
733856292,86,3,2,94,185
733858373,15,7,2,1,25
733860503,12,3,2,2,19
733871861,209,3,4,2,218
733882408,250,21,2,7,280
733885305,11,3,2,1,17
733887652,93,8,29,44,174
733888701,56,60,22,45,183
733892281,151,9,55,10,225
733898532,38,67,63,1,169
733901040,13,7,2,1,23
733925286,57,20,26,8,111
733936053,64,3,2,1,70
733948588,37,18,47,2,104
733950604,56,14,6,36,112
733961182,82,3,2,1,88
733969611,61,79,7,9,156
733975847,16,22,7,1,46
733982128,346,3,2,3,354
733999735,103,8,2,31,144
734014487,13,14,2,1,30
734014803,19,3,2,1,25
734016361,108,3,2,17,130
734018775,43,3,2,2,50
734027987,207,14,15,1,237
734036680,23,22,2,10,57
734040084,147,4,27,4,182
734059789,15,3,2,1,21
734063844,91,27,2,8,128
734072112,50,16,10,3,79
734083342,34,35,3,1,73
734084641,71,10,31,10,122
734102909,104,28,4,2,138
734111304,199,12,4,1,216
734123466,60,11,6,1,78
734124510,45,45,34,4,128
734126976,29,38,3,13,83
734134878,72,5,2,1,80
734177644,69,34,29,84,216
734178753,134,24,22,56,236
734188796,193,3,2,2,200
734196704,108,27,2,1,138
734199045,91,3,2,1,97
734205082,50,18,5,2,75
734220196,12,6,2,4,24
734230281,83,16,9,5,113
734255605,17,3,2,1,23
734266541,59,39,22,4,124
734273692,11,3,2,1,17
734275825,23,38,2,2,65
734278530,11,3,2,1,17
734278806,42,99,43,7,191
734290616,10,3,2,2,17
734293589,25,3,2,1,31
734296871,35,33,20,17,105
734329020,121,14,2,5,142
734329094,23,51,33,1,108
734340890,54,8,2,2,66
734341385,56,9,33,5,103
734346122,43,3,2,3,51
734363907,10,3,2,2,17
734373213,29,3,2,1,35
734373690,159,3,2,1,165
734381165,27,3,2,1,33
734381775,13,7,2,1,23
734389888,25,27,2,2,56
734396193,34,45,2,1,82
734398793,62,17,20,14,113
734402617,11,3,2,1,17
734420493,206,80,60,3,349
734420686,77,9,43,13,142
734445579,97,12,2,4,115
734453495,24,13,2,1,40
734457357,198,3,2,6,209
734483189,16,35,25,1,77
734488254,140,11,2,2,155
734498740,147,10,2,4,163
734513476,160,3,2,6,171
734526153,191,3,13,1,208
734529422,33,8,37,14,92
734540020,140,3,2,8,153
734553876,41,11,2,3,57
734564627,114,22,6,8,150
734582772,127,18,2,2,149
734590211,10,11,2,1,24
734601617,42,3,2,1,48
734617052,67,18,2,1,88
734632331,73,29,24,9,135
734642768,38,74,7,5,124
734645294,23,3,2,5,33
734651978,108,6,66,3,183
734658818,17,3,2,1,23
734672372,84,6,2,7,99
734672916,22,18,5,4,49
734674580,36,17,20,1,74
734676865,12,3,2,1,18
734681080,55,25,3,48,131
734688435,149,29,8,6,192
734693340,12,5,2,1,20
734697482,98,15,65,8,186
734701498,96,16,22,10,144
734715050,92,27,6,6,131
734715741,15,3,2,1,21
734717320,107,3,2,1,113
734777377,109,3,2,10,124
734782157,94,14,2,1,111
734782430,12,3,2,1,18
734793338,88,19,34,3,144
734799744,31,7,11,2,51
734809246,70,3,2,7,82
734816084,52,3,2,1,58
734828360,67,15,5,5,92
734829510,40,3,2,1,46
734836903,16,7,2,1,26
734841030,92,76,40,10,218
734847401,118,47,32,17,214
734850189,71,12,2,3,88
734852177,31,24,6,12,73
734853058,34,18,2,10,64
734854961,75,31,3,5,114
734861602,12,3,2,1,18
734869098,28,3,3,1,35
734870043,12,3,2,4,21
734872828,89,3,2,1,95
734873653,68,62,43,11,184
734891595,19,3,2,1,25
734895621,181,63,6,25,275
734909423,72,3,24,1,100
734917494,11,3,2,1,17
734920257,93,13,10,7,123
734927123,20,51,2,2,75
734930636,143,35,39,1,218
734939025,147,37,4,4,192
734946229,99,13,42,21,175
734953987,22,3,2,1,28
734955131,11,3,2,1,17
734957910,45,19,6,35,105
734967329,18,3,2,3,26
734969411,16,8,2,1,27
734970292,60,8,61,7,136
734983969,18,36,9,2,65
734996047,71,26,12,18,127
735008848,86,34,21,13,154
735017313,17,24,4,1,46
735024573,96,28,5,3,132
735041547,158,39,6,2,205
735046425,26,25,2,2,55
735050643,205,3,2,6,216
735059158,73,27,2,1,103
735080014,133,17,10,4,164
735090891,164,25,27,1,217
735114500,105,3,34,1,143
735129661,19,4,2,5,30
735133692,10,10,2,1,23
735153812,123,8,9,25,165
735161252,30,3,2,6,41
735165561,191,20,60,6,277
735205266,41,37,2,4,84
735205597,27,22,2,12,63
735213229,10,4,2,1,17
735227438,84,24,18,1,127
735233622,143,9,2,5,159
735237827,85,3,2,1,91
735244039,59,9,13,2,83
735258812,71,42,5,10,128
735260620,65,28,23,14,130
735282237,15,5,2,1,23
735285603,22,3,2,2,29
735287001,18,3,2,1,24
735290057,64,6,2,13,85
735294395,100,21,25,9,155
735304573,31,42,2,1,76
735306033,83,31,105,1,220
735320423,76,3,2,2,83
735322370,106,3,2,1,112
735322480,97,23,80,27,227
735323838,58,3,2,1,64
735334424,44,3,2,1,50
735350281,70,3,2,1,76
735377092,43,25,2,2,72
735382236,76,6,2,3,87
735397949,69,3,2,2,76
735408730,10,5,2,1,18
735416322,41,3,2,1,47
735440002,201,7,9,3,220
735443627,110,63,145,30,348
735446804,13,4,2,1,20
735456575,122,51,2,5,180
735462271,10,12,2,1,25
735465493,19,15,2,2,38
735473781,10,6,2,19,37
735476396,18,3,2,1,24
735493885,35,22,2,1,60
735512955,113,34,2,4,153
735514711,33,3,2,1,39
735533883,37,60,2,1,100
735534177,47,3,14,1,65
735534661,138,37,13,1,189
735541195,157,3,2,2,164
735563142,72,41,2,36,151
735587512,86,23,28,5,142
735589792,68,16,2,2,88
735600936,93,32,2,1,128
735608930,10,4,2,1,17
735629813,48,33,2,1,84
735644712,82,19,9,4,114
735654485,60,19,8,6,93
735654921,113,8,14,5,140
735657912,19,3,2,5,29
735675861,45,54,12,11,122
735701567,49,15,10,7,81
735701879,11,3,2,1,17
735714295,58,3,2,4,67
735719669,168,26,43,1,238
735725110,36,35,3,5,79
735726038,18,8,2,1,29
735727604,43,18,3,12,76
735731086,60,3,2,7,72
735738898,30,11,2,42,85
735749357,52,3,2,3,60
735775094,60,62,30,12,164
735783107,175,71,2,15,263
735783358,33,35,2,1,71
735803083,11,3,2,2,18
735831451,115,18,101,69,303
735855758,12,4,2,1,19
735873164,62,26,4,26,118
735905920,13,3,2,1,19
735906748,136,14,26,1,177
735908269,108,3,2,1,114
735934034,61,52,90,77,280
735939968,34,3,2,2,41
735946254,31,22,13,11,77
735951059,51,31,10,15,107
735960181,81,21,44,3,149
735966201,78,159,22,1,260
735986093,255,53,6,7,321
735995029,145,3,2,5,155
735998026,176,3,2,1,182
735998450,46,22,22,5,95
736005521,14,3,2,2,21
736011601,51,8,22,30,111
736011950,128,39,2,1,170
736012354,43,19,5,1,68
736034615,26,29,20,4,79
736064136,34,24,7,3,68
736066745,13,3,2,2,20
736072737,80,3,2,1,86
736073953,58,3,2,6,69
736075754,30,3,6,3,42
736077885,71,24,2,1,98
736081428,46,13,5,7,71
736081752,169,3,2,6,180
736107821,102,19,2,6,129
736122918,411,3,2,2,418
736131759,29,3,2,1,35
736136331,77,9,21,11,118
736141079,22,23,2,6,53
736152580,55,5,2,1,63
736164834,87,19,2,3,111
736166122,13,22,6,1,42
736172974,111,3,2,1,117
736191960,43,19,5,1,68
736195695,37,37,23,4,101
736201201,22,9,2,2,35
736206228,39,3,2,1,45
736214577,46,48,40,57,191
736220362,18,10,2,1,31
736241326,115,43,2,24,184
736254166,199,3,2,8,212
736254210,13,11,2,1,27
736260910,11,13,2,2,28
736267309,23,120,14,56,213
736267614,166,7,3,4,180
736280311,16,3,2,1,22
736295167,48,3,2,3,56
736295422,12,13,2,3,30
736306094,16,11,2,1,30
736322733,28,3,2,1,34
736327193,41,51,14,1,107
736327659,43,59,15,27,144
736330537,50,3,2,5,60
736332987,47,31,43,19,140
736334907,124,3,2,2,131
736347188,48,34,6,6,94
736354585,46,63,2,2,113
736362199,60,3,2,1,66
736371206,11,3,2,1,17
736371805,95,34,15,3,147
736409531,103,13,2,4,122
736412653,15,38,2,1,56
736413489,14,19,2,14,49
736416659,36,40,24,2,102
736438691,146,73,12,22,253
736444912,77,3,2,6,88
736447883,37,3,2,1,43
736453651,20,3,2,1,26
736462057,11,4,3,2,20
736464263,16,3,2,1,22
736466771,12,3,2,1,18
736478983,104,24,61,2,191
736486289,59,3,2,4,68
736499859,61,3,2,3,69
736515351,52,23,4,1,80
736529557,153,3,2,1,159
736555977,98,20,2,13,133
736572064,20,7,41,11,79
736572845,96,3,2,11,112
736573700,55,6,2,1,64
736575901,71,51,95,32,249
736605590,10,9,2,4,25
736619291,24,3,2,1,30
736626441,19,16,2,1,38
736630142,114,20,20,13,167
736641500,26,13,2,1,42
736650357,80,50,14,20,164
736672478,15,3,2,1,21
736677403,40,5,2,2,49
736689981,30,6,2,16,54
736704460,83,3,2,10,98
736714209,77,20,26,2,125
736714426,61,14,2,1,78
736719442,57,8,2,1,68
736727485,85,57,26,3,171
736730159,87,15,51,1,154
736740032,22,14,3,2,41
736748647,182,4,2,1,189
736749482,73,16,37,66,192
736768264,10,3,2,3,18
736785375,25,3,2,1,31
736796761,15,34,4,1,54
736806396,156,7,2,1,166
736807113,52,15,2,6,75
736810966,70,3,2,3,78
736815735,111,31,4,17,163
736838913,125,66,11,11,213
736839240,66,3,6,20,95
736842201,26,25,13,1,65
736851353,274,29,5,1,309
736864171,75,18,38,10,141
736869720,54,3,2,52,111
736872698,25,3,2,1,31
736880642,22,11,2,1,36
736906635,137,26,2,4,169
736911636,25,8,42,1,76
736924576,11,3,2,1,17
736924577,55,44,31,12,142
736925892,106,3,2,1,112
736927510,75,3,2,1,81
736932495,85,7,26,29,147
736937517,11,3,2,1,17
736956478,83,8,28,19,138
736959233,151,21,5,2,179
736970698,111,3,2,7,123
736975173,68,3,52,1,124
736978121,13,5,2,1,21
736986306,24,3,4,8,39
736986983,61,26,27,24,138
736997957,15,7,5,5,32
737011352,32,32,18,4,86
737012958,56,3,2,2,63
737033096,82,8,7,9,106
737037226,204,66,92,24,386
737049129,47,3,2,2,54
737058991,77,19,2,3,101
737065434,133,3,2,13,151
737070048,174,28,17,1,220
737076692,79,71,4,15,169
737082156,70,27,13,25,135
737083611,42,56,20,50,168
737108591,85,25,69,27,206
737124664,42,7,2,1,52
737125332,45,45,51,8,149
737130915,20,21,2,1,44
737133399,80,13,2,1,96
737138021,24,35,32,3,94
737141892,12,3,2,1,18
737152784,44,21,44,1,110
737155460,35,3,3,2,43
737161744,47,10,2,8,67
737165952,62,35,19,36,152
737180911,17,3,2,1,23
737181531,13,11,2,1,27
737185723,147,19,62,16,244
737196701,95,3,2,1,101
737199702,143,41,4,1,189
737211249,17,12,2,1,32
737226137,61,32,8,7,108
737228979,43,4,2,2,51
737237110,22,3,2,11,38
737241283,136,34,5,1,176
737242010,24,8,2,3,37
737243947,23,3,2,1,29
737249682,27,3,2,1,33
737258356,69,13,2,2,86
737277938,21,3,2,1,27
737283135,256,64,3,33,356
737288112,187,10,2,6,205
737289482,12,3,2,1,18
737290901,22,5,3,4,34
737290928,16,6,5,1,28
737318849,21,6,2,3,32
737355159,88,7,2,4,101
737360725,24,43,7,1,75
737373604,45,26,13,1,85
737375818,111,9,2,1,123
737394868,110,34,2,1,147
737399612,32,15,50,1,98
737403231,31,15,4,3,53
737404277,161,3,2,7,173
737409945,45,4,2,7,58
737417749,52,22,9,13,96
737435428,10,3,2,3,18
737438616,64,34,11,15,124
737458479,82,26,2,12,122
737459052,43,21,3,5,72
737474658,89,3,5,1,98
737503837,60,15,27,1,103
737507991,174,9,2,1,186
737512839,16,5,2,1,24
737515811,44,3,2,1,50
737516763,47,9,10,3,69
737521692,22,19,2,4,47
737536219,104,25,2,1,132
737539597,11,9,2,1,23
737545236,18,13,2,2,35
737546965,55,17,29,1,102
737556723,36,3,2,1,42
737560174,77,17,40,3,137
737560759,123,10,41,3,177
737561512,83,15,3,20,121
737567312,72,19,2,2,95
737587731,30,25,38,1,94
737589360,20,3,2,1,26
737596267,71,3,2,2,78
737607367,107,60,67,3,237
737609457,10,3,2,2,17
737616407,25,19,11,1,56
737625256,11,18,2,1,32
737626017,67,6,2,4,79
737632221,62,43,5,3,113
737637557,23,3,2,1,29
737639550,98,13,46,6,163
737648514,37,51,36,2,126
737649205,14,3,2,1,20
737650507,169,56,39,3,267
737657694,18,17,11,1,47
737667605,58,9,4,24,95
737672796,43,42,2,1,88
737686962,27,42,73,2,144
737687021,133,64,21,43,261
737687496,67,38,3,7,115
737688344,10,3,2,2,17
737707880,21,3,2,1,27
737732457,33,22,5,10,70
737747444,116,3,2,8,129
737768333,27,17,21,7,72
737773346,115,35,2,7,159
737775164,106,28,42,40,216
737776250,50,3,10,2,65
737794530,253,3,2,1,259
737797057,21,80,4,3,108
737814228,13,3,2,1,19
737820015,78,42,52,9,181
737825956,166,46,67,3,282
737834686,177,32,5,3,217
737840162,151,18,84,20,273
737849209,11,19,6,2,38
737872523,88,27,38,1,154
737879493,65,62,2,10,139
737881894,174,3,2,1,180
737905989,32,40,42,1,115
737907564,13,3,2,1,19
737908805,212,3,2,16,233
737916002,21,19,2,1,43
737929222,108,19,2,22,151
737933117,125,3,2,1,131
737936671,105,40,22,8,175
737943265,10,5,2,1,18
737957590,313,3,2,55,373
737996606,77,41,2,6,126
738005618,15,3,2,1,21
738006631,36,3,2,2,43
738006733,28,56,19,2,105
738013876,19,3,2,1,25
738036997,30,46,24,49,149
738039342,64,19,17,1,101
738048487,12,3,2,2,19
738056656,91,13,6,2,112
738076977,29,3,2,1,35
738082596,25,29,2,3,59
738092849,75,3,2,1,81
738093908,34,153,2,1,190
738111754,17,36,2,1,56
738114219,24,3,2,1,30
738117996,89,15,5,3,112
738135132,72,45,2,2,121
738141437,63,8,3,3,77
738149152,46,19,2,10,77
738191695,22,3,2,1,28
738210881,254,3,2,3,262
738217000,15,3,2,1,21
738223784,43,4,3,3,53
738260194,101,16,2,3,122
738260268,48,3,2,1,54
738264077,79,6,2,1,88
738278626,10,5,2,2,19
738292684,124,3,2,1,130
738299562,137,3,2,20,162
738308217,36,25,2,7,70
738343825,64,4,7,1,76
738380276,13,3,2,1,19
738380935,43,43,3,1,90
738383565,92,22,2,4,120
738385880,87,3,2,3,95
738394013,36,33,41,1,111
738404170,10,16,2,1,29
738407602,123,3,2,1,129
738411530,74,51,13,13,151
738412086,21,35,8,1,65
738413133,302,3,2,9,316
738420708,50,22,2,4,78
738426986,15,7,3,1,26
738454735,20,3,2,2,27
738463023,140,11,20,1,172
738465321,11,3,2,1,17
738466689,71,29,16,11,127
738471833,51,4,7,10,72
738472187,52,3,2,1,58
738473961,73,3,2,1,79
738477480,49,13,2,4,68
738478613,14,12,2,4,32
738479894,69,14,2,1,86
738482526,110,3,2,3,118
738487312,190,12,3,2,207
738490264,123,21,48,13,205
738494206,38,3,3,1,45
738494844,145,24,2,16,187
738495528,36,9,2,5,52
738498567,512,3,2,20,537
738514062,16,3,2,3,24
738519936,84,12,38,5,139
738540227,17,35,2,4,58
738545318,81,39,35,7,162
738550435,47,9,2,4,62
738578140,220,22,15,16,273
738580338,19,3,2,2,26
738589841,25,27,2,1,55
738592765,61,30,62,2,155
738607603,19,3,2,1,25
738611865,132,24,2,12,170
738618692,71,36,51,1,159
738629557,77,27,2,1,107
738637116,18,15,2,3,38
738642476,103,44,2,9,158
738661221,114,14,108,2,238
738666502,65,3,4,1,73
738676290,40,12,3,4,59
738682550,94,11,3,3,111
738684609,30,24,2,31,87
738709017,144,16,23,17,200
738711998,10,4,2,1,17
738730607,133,126,57,1,317
738741788,46,3,2,1,52
738748134,21,14,2,3,40
738783696,17,13,2,2,34
738789076,16,10,2,2,30
738789529,257,35,2,16,310
738789862,123,3,2,2,130
738792787,39,3,2,1,45
738794824,36,18,38,1,93
738808738,92,3,2,1,98
738811430,80,3,2,34,119
738826145,118,52,39,6,215
738826478,100,6,2,1,109
738831152,34,25,2,6,67
738834640,48,78,16,7,149
738840781,20,3,2,1,26
738858982,52,15,2,1,70
738861294,105,13,31,93,242
738861943,185,55,5,1,246
738868248,129,81,87,2,299
738874264,129,35,10,8,182
738880765,38,55,7,1,101
738882901,11,3,2,1,17
738883872,77,12,2,4,95
738888412,13,6,5,1,25
738910113,232,22,41,1,296
738917476,12,3,2,1,18
738958344,49,29,19,13,110
738964316,60,3,2,2,67
738973276,51,35,31,27,144
738976583,85,23,2,1,111
738991627,423,3,2,1,429
738991975,57,21,2,1,81
738994520,14,3,2,1,20
738996131,15,4,2,1,22
739001709,119,34,34,9,196
739005388,81,14,2,1,98
739017603,31,7,14,1,53
739021584,33,5,4,1,43
739044399,26,24,4,1,55
739070308,47,6,2,14,69
739077226,35,12,10,7,64
739094498,54,3,2,4,63
739096435,10,15,2,1,28
739098912,65,34,2,1,102
739104158,128,43,68,2,241
739108052,77,9,2,13,101
739109106,10,5,2,1,18
739128737,226,19,3,2,250
739159393,23,11,2,1,37
739188910,135,6,2,2,145
739189671,20,5,2,1,28
739201751,29,8,5,2,44
739211914,13,31,2,1,47
739219003,162,20,88,2,272
739223710,81,27,12,1,121
739240668,13,3,2,1,19
739255712,185,3,2,1,191
739263128,66,6,54,1,127
739283260,58,11,3,1,73
739285110,96,5,19,2,122
739299329,110,24,5,8,147
739304340,129,14,51,1,195
739325646,6705,3,2,84,6794
739332542,11,21,2,4,38
739336436,62,36,10,8,116
739340622,74,37,15,2,128
739363676,38,8,2,1,49
739404837,51,14,2,2,69
739407019,19,19,2,8,48
739424034,185,46,2,6,239
739424631,59,3,2,3,67
739439418,26,7,2,6,41
739440544,58,28,4,1,91
739445346,200,17,5,2,224
739471665,187,61,6,19,273
739471853,10,5,2,1,18
739478486,16,3,2,1,22
739478947,40,26,4,15,85
739485007,34,3,2,1,40
739490171,55,17,8,15,95
739497383,31,5,2,1,39
739498523,13,12,2,2,29
739501918,54,3,2,1,60
739516097,91,18,14,29,152
739522631,43,11,27,10,91
739537729,36,50,9,15,110
739549566,50,4,15,3,72
739549569,71,3,3,2,79
739556481,28,3,2,1,34
739560685,124,34,5,1,164
739570601,31,3,2,4,40
739571056,11,3,2,1,17
739582359,74,24,35,13,146
739584769,70,3,2,1,76
739596315,45,3,2,1,51
739611705,32,26,3,9,70
739623101,15,9,2,1,27
739624302,50,3,7,4,64
739643449,14,4,2,1,21
739645108,45,3,5,10,63
739647452,55,3,2,1,61
739651746,36,10,4,1,51
739666721,10,5,2,3,20
739675025,95,15,2,1,113
739676802,66,35,5,1,107
739678255,54,15,6,14,89
739679999,172,3,2,41,218
739689670,106,3,2,5,116
739696951,10,3,2,3,18
739705975,35,47,38,5,125
739706017,39,18,7,1,65
739716439,51,11,2,5,69
739727013,29,15,2,1,47
739733445,28,24,7,7,66
739735652,26,3,2,1,32
739741369,13,31,2,1,47
739742447,13,7,8,3,31
739753600,16,4,2,5,27
739756522,45,27,33,15,120
739759976,11,3,2,1,17
739761706,56,40,31,33,160
739777097,26,3,2,4,35
739782313,71,3,2,15,91
739786005,258,11,5,9,283
739787144,162,43,11,7,223
739803526,14,6,3,1,24
739807584,33,20,48,1,102
739810327,88,4,2,7,101
739825819,94,3,2,3,102
739828800,12,20,28,1,61
739836837,89,27,39,17,172
739845805,13,4,2,1,20
739849239,17,12,2,2,33
739883886,59,15,20,2,96
739920427,24,27,2,3,56
739922813,88,17,2,5,112
739924136,63,29,55,27,174
739964355,57,3,2,1,63
739990948,43,14,13,5,75
739992685,116,9,2,55,182
740005841,84,12,2,2,100
740010260,153,15,77,16,261
740029163,21,3,2,1,27
740032673,71,3,2,2,78
740036017,14,16,8,1,39
740042310,97,29,11,11,148
740051322,53,7,2,1,63
740056203,106,3,2,2,113
740056566,48,30,3,6,87
740065386,50,10,2,4,66
740075728,15,34,2,12,63
740100346,71,27,2,2,102
740107125,11,3,2,1,17
740156563,85,8,2,1,96
740186368,246,55,38,2,341
740208168,33,37,3,9,82
740222630,94,29,19,4,146
740238797,198,3,2,3,206
740254942,107,31,17,1,156
740275683,14,3,2,4,23
740290405,66,3,2,8,79
740317036,26,31,35,1,93
740320481,122,3,2,5,132
740330960,15,9,2,2,28
740335234,111,30,2,8,151
740338159,67,11,2,1,81
740343829,106,3,2,2,113
740350014,171,3,2,30,206
740361793,219,87,33,2,341
740366618,43,25,3,3,74
740368215,85,14,2,6,107
740369202,11,3,2,1,17
740371981,28,5,2,1,36
740373392,54,11,51,6,122
740385074,91,13,2,1,107
740407025,18,3,2,1,24
740407583,63,139,2,19,223
740415658,38,8,8,9,63
740420012,45,63,66,16,190
740420382,134,34,4,25,197
740421950,18,23,2,2,45
740424574,23,18,13,4,58
740426410,77,20,2,13,112
740439232,46,43,14,5,108
740440423,129,36,33,11,209
740440664,28,3,2,9,42
740458430,14,6,5,2,27
740459059,173,3,2,32,210
740460136,84,66,29,6,185
740499865,41,41,4,1,87
740518680,40,3,2,1,46
740524680,126,29,37,5,197
740535634,76,5,16,5,102
740536687,68,3,2,3,76
740546166,11,3,2,1,17
740550466,74,3,2,1,80
740551193,55,20,25,1,101
740569998,18,22,6,2,48
740576728,103,3,2,7,115
740580283,37,3,2,1,43
740591845,75,25,2,4,106
740599177,74,16,3,1,94
740604194,135,8,3,4,150
740611423,16,9,3,1,29
740623511,78,44,5,11,138
740626810,12,3,2,1,18
740631716,80,31,4,24,139
740634535,47,3,2,5,57
740640459,326,93,72,34,525
740649123,26,29,11,3,69
740660640,81,51,34,4,170
740664732,159,15,2,1,177
740666745,38,17,17,5,77
740694135,105,20,30,31,186
740700860,159,21,5,4,189
740702748,99,14,12,9,134
740705515,76,8,66,1,151
740707568,15,11,10,5,41
740716403,81,31,2,1,115
740751142,104,11,5,34,154
740759993,73,3,2,1,79
740767927,151,65,22,67,305
740768943,58,10,23,5,96
740783479,152,3,2,1,158
740812459,73,14,19,13,119
740841076,13,18,2,1,34
740843486,59,49,52,9,169
740850095,13,3,2,4,22
740852128,119,19,2,1,141
740855217,12,3,2,1,18
740865403,16,34,7,2,59
740874551,258,61,3,5,327
740877877,12,3,2,1,18
740886018,11,3,2,1,17
740888216,10,8,2,1,21
740908353,98,32,5,8,143
740910517,93,42,74,21,230
740913417,93,34,19,45,191
740915087,132,17,2,2,153
740915836,58,27,2,14,101
740922171,79,63,5,11,158
740923852,85,40,120,23,268
740932227,159,30,8,5,202
740945495,25,5,4,1,35
740950546,20,10,2,1,33
740955993,26,54,7,6,93
740964256,40,7,2,1,50
740965059,109,3,2,2,116
740976636,15,3,2,1,21
740991634,22,13,24,5,64
741026385,35,3,2,1,41
741027897,122,22,137,14,295
741033644,48,40,2,1,91
741048598,106,101,11,1,219
741052305,133,23,10,15,181
741053757,17,17,2,1,37
741056349,215,32,18,14,279
741058043,130,3,2,13,148
741070759,88,32,2,1,123
741073550,12,3,2,2,19
741073681,13,3,2,1,19
741079635,39,3,2,1,45
741080155,47,23,3,3,76
741082443,68,6,2,5,81
741082462,91,18,2,1,112
741093373,74,35,24,5,138
741096561,29,5,2,5,41
741099067,73,3,2,2,80
741100827,67,24,23,2,116
741101162,10,5,2,2,19
741104338,139,12,15,5,171
741116118,76,3,2,2,83
741120028,30,22,37,1,90
741127869,80,3,2,4,89
741137427,22,20,29,1,72
741140989,243,7,2,13,265
741141517,34,67,165,12,278
741163008,205,3,2,1,211
741167339,10,28,6,1,45
741178666,90,12,2,1,105
741187462,61,6,43,7,117
741193154,52,70,2,1,125
741194155,10,5,2,8,25
741196384,76,35,22,1,134
741205778,117,30,40,2,189
741218210,101,24,50,3,178
741219150,10,5,2,1,18
741225209,15,11,13,1,40
741233298,110,3,2,2,117
741243928,27,3,2,1,33
741244274,110,3,2,20,135
741248126,25,109,16,3,153
741256622,80,37,26,30,173
741260994,66,21,4,7,98
741264799,63,14,2,5,84
741272908,32,6,55,1,94
741283000,13,3,2,2,20
741301515,11,3,2,2,18
741308852,12,3,2,3,20
741315516,19,3,2,5,29
741330871,84,3,2,6,95
741337086,18,3,2,1,24
741340906,51,6,8,1,66
741351651,75,30,2,3,110
741354437,140,7,2,8,157
741361341,64,49,15,67,195
741365446,49,8,2,1,60
741375432,147,30,133,1,311
741375719,20,11,2,1,34
741381362,36,17,22,14,89
741386155,16,6,2,4,28
741387887,161,68,21,9,259
741411324,81,3,2,1,87
741416481,20,9,2,1,32
741423780,120,34,4,34,192
741428777,103,3,2,15,123
741431246,163,3,2,1,169
741431727,17,3,2,1,23
741436374,120,14,112,12,258
741462027,28,42,2,1,73
741492567,32,4,2,1,39
741492673,269,3,2,10,284
741493198,73,11,39,46,169
741519237,33,21,2,2,58
741530127,41,10,6,8,65
741532866,55,38,23,8,124
741551951,28,32,2,1,63
741565301,107,4,21,2,134
741573460,91,3,2,2,98
741581399,11,3,2,2,18
741597058,89,18,2,50,159
741619700,73,28,29,3,133
741630961,35,26,26,19,106
741641109,76,55,9,4,144
741645531,10,3,2,2,17
741649727,38,23,2,1,64
741650437,37,29,3,3,72
741651904,23,22,2,8,55
741664639,95,3,2,6,106
741666374,97,65,2,33,197
741669954,74,13,6,2,95
741681238,110,3,2,2,117
741682717,103,26,22,1,152
741688103,16,12,2,2,32
741700990,24,47,12,17,100
741702719,30,20,4,4,58
741708195,89,9,2,1,101
741713791,42,38,18,10,108
741719682,138,9,21,1,169
741721962,63,18,61,1,143
741722302,101,61,2,48,212
741724741,30,14,29,15,88
741732961,162,44,108,36,350
741735671,104,34,2,1,141
741739181,76,24,32,2,134
741740645,18,3,2,1,24
741755416,65,16,31,9,121
741756144,52,3,2,1,58
741762228,11,3,2,2,18
741766119,23,31,14,3,71
741767868,49,3,2,3,57
741793241,19,7,2,1,29
741823454,20,3,2,6,31
741824075,31,94,21,6,152
741857293,13,10,2,1,26
741868344,24,3,2,1,30
741869079,64,16,2,8,90
741873694,76,49,52,3,180
741874658,70,3,2,1,76
741898320,69,35,2,2,108
741899171,33,45,14,3,95
741902305,35,21,41,16,113
741906416,323,25,135,4,487
741907386,94,23,39,2,158
741908025,33,14,5,1,53
741910559,47,3,20,2,72
741914830,15,22,2,2,41
741931256,19,3,2,1,25
741937057,37,76,34,15,162
741940738,23,3,2,12,40
741949235,10,4,2,4,20
741950399,28,26,2,35,91
741957844,62,33,16,1,112
741962997,38,24,17,1,80
741971556,89,43,12,11,155
741981239,12,3,2,1,18
742007009,87,23,3,5,118
742031550,42,3,2,1,48
742037807,10,10,3,2,25
742043280,66,3,2,6,77
742048643,74,14,2,2,92
742074833,80,3,2,1,86
742076656,154,36,2,7,199
742084545,119,3,2,5,129
742084883,32,26,12,1,71
742087670,33,22,21,4,80
742090452,116,4,28,47,195
742100439,33,20,5,3,61
742103587,10,43,4,1,58
742113133,37,37,49,11,134
742118474,27,9,14,2,52
742148462,77,37,47,25,186
742151243,143,30,85,1,259
742159832,139,3,2,10,154
742168055,27,15,2,1,45
742181692,48,43,65,6,162
742182135,11,26,2,1,40
742182232,88,3,2,1,94
742183300,25,3,2,2,32
742185614,16,3,2,1,22
742189188,88,40,58,20,206
742192026,91,56,6,22,175
742197569,10,5,3,4,22
742200944,83,3,2,4,92
742207311,150,4,11,3,168
742213364,76,3,2,1,82
742214774,22,40,2,1,65
742228239,36,7,2,2,47
742241581,174,17,3,11,205
742261764,43,83,56,10,192
742264718,73,32,4,1,110
742266736,21,3,2,2,28
742268825,73,30,27,9,139
742270198,57,13,8,5,83
742271816,11,14,2,1,28
742275623,73,3,2,1,79
742283333,25,47,2,1,75
742289008,193,15,24,6,238
742293035,71,6,2,6,85
742296582,12,3,2,1,18
742332155,49,12,2,1,64
742332343,105,33,168,86,392
742364677,21,3,2,1,27
742374612,31,71,3,6,111
742376065,12,3,2,1,18
742407814,22,5,3,1,31
742408483,73,57,20,80,230
742412716,13,3,2,1,19
742420378,13,3,2,1,19
742439269,28,20,2,3,53
742440807,10,10,3,1,24
742442249,84,57,9,9,159
742443929,94,3,2,6,105
742450629,29,13,2,6,50
742459821,129,3,2,2,136
742459906,123,3,2,1,129
742461439,175,3,2,5,185
742467170,131,36,3,14,184
742480241,46,23,27,3,99
742480752,107,10,53,47,217
742493050,92,15,4,41,152
742500701,127,4,12,9,152
742537529,43,29,2,2,76
742537532,56,6,2,6,70
742537929,81,3,2,1,87
742539247,17,3,2,1,23
742558013,35,13,2,1,51
742561835,25,20,14,1,60
742575546,84,3,2,3,92
742593371,16,31,2,1,50
742601295,94,27,12,8,141
742610706,130,5,2,10,147
742613505,48,15,4,2,69
742618655,117,63,29,11,220
742623238,80,3,2,22,107
742624631,77,3,2,1,83
742625664,34,30,31,1,96
742645025,36,10,2,6,54
742647328,35,23,2,14,74
742658790,84,25,174,3,286
742667232,18,3,2,1,24
742669999,36,3,2,9,50
742675692,89,36,64,3,192
742683794,181,20,11,6,218
742684909,73,3,2,2,80
742685011,13,3,2,3,21
742717952,104,19,24,1,148
742724869,115,18,46,20,199
742734150,93,23,54,84,254
742736078,13,3,2,1,19
742746030,58,3,2,14,77
742746680,129,16,6,1,152
742747739,21,45,19,19,104
742747922,10,13,2,1,26
742754950,11,3,2,1,17
742756310,51,7,43,8,109
742757552,17,53,2,1,73
742761685,23,5,2,1,31
742772370,106,17,127,11,261
742786444,55,3,2,1,61
742860898,163,18,103,7,291
742867522,57,110,2,20,189
742873678,85,29,18,5,137
742883411,66,30,73,2,171
742888407,72,13,8,1,94
742888673,50,31,6,1,88
742889719,142,3,2,1,148
742898689,13,9,2,1,25
742906431,40,83,38,5,166
742906463,77,79,52,37,245
742929067,22,15,2,2,41
742930423,18,3,2,1,24
742933568,65,54,2,57,178
742936350,238,61,46,30,375
742946733,62,3,2,6,73
742986389,113,16,8,2,139
742987441,47,9,74,1,131
742991472,10,3,2,3,18
742999159,36,13,5,13,67
743000099,68,5,2,4,79
743009438,61,99,81,9,250
743010019,45,12,2,9,68
743020113,14,14,2,1,31
743025791,40,18,28,2,88
743033607,130,17,20,12,179
743043512,30,3,2,1,36
743053723,104,33,3,4,144
743061797,57,7,2,1,67
743069861,26,3,2,1,32
743073457,94,57,53,26,230
743077541,97,44,60,5,206
743108176,121,3,2,1,127
743110426,19,14,2,1,36
743112206,86,28,7,3,124
743115996,38,3,2,4,47
743132089,21,17,2,1,41
743157168,42,35,11,6,94
743162967,12,3,2,1,18
743171028,34,48,47,1,130
743180892,70,13,76,1,160
743202300,49,26,11,34,120
743212275,95,55,3,1,154
743212731,100,124,26,19,269
743221167,17,3,2,5,27
743280906,46,3,2,1,52
743289380,49,6,8,1,64
743302065,24,18,8,1,51
743307357,32,8,2,9,51
743325579,12,8,2,5,27
743328477,13,16,5,1,35
743331227,25,40,10,1,76
743332544,49,4,2,1,56
743339305,95,3,2,1,101
743339538,113,37,2,1,153
743340566,94,19,36,22,171
743344841,25,3,2,2,32
743349957,152,19,3,4,178
743391546,41,3,2,8,54
743404079,13,3,2,1,19
743409365,28,18,4,3,53
743411486,24,43,19,1,87
743418811,23,14,4,1,42
743426081,63,93,114,2,272
743427948,139,37,124,4,304
743440953,10,6,2,1,19
743447563,86,19,2,1,108
743453311,63,3,2,11,79
743474811,21,6,2,1,30
743477231,43,3,2,1,49
743495568,126,55,54,15,250
743501846,13,3,2,1,19
743503055,11,3,2,3,19
743506238,173,7,3,46,229
743509189,17,3,2,1,23
743516285,121,3,2,16,142
743525275,67,31,56,17,171
743552103,21,3,2,1,27
743580502,19,6,125,1,151
743590975,171,3,2,37,213
743593792,74,16,2,1,93
743605130,84,50,40,30,204
743628529,12,3,2,1,18
743641963,43,3,2,1,49
743647122,22,5,2,3,32
743652588,76,3,2,4,85
743655281,10,4,2,1,17
743673227,46,28,56,4,134
743682664,165,3,13,18,199
743705731,89,13,2,9,113
743715098,69,68,90,2,229
743764713,39,17,2,1,59
743781778,48,14,2,1,65
743783286,51,3,2,10,66
743783488,86,45,21,2,154
743795710,61,52,34,21,168
743800442,17,3,2,1,23
743800648,33,7,2,2,44
743816141,16,26,7,1,50
743843459,36,32,2,1,71
743846597,80,30,63,10,183
743847231,20,21,2,2,45
743867984,13,3,2,1,19
743871692,15,3,2,2,22
743875827,126,15,23,15,179
743898332,10,3,2,2,17
743904356,14,3,2,1,20
743910346,79,3,2,1,85
743914878,49,13,51,1,114
743918013,24,3,2,1,30
743963973,49,48,11,7,115
743973179,91,29,2,3,125
743977154,102,3,2,4,111
743981890,18,3,2,1,24
743986949,36,3,2,1,42
743994315,63,10,2,1,76
743996331,101,3,2,1,107
744003598,85,31,51,98,265
744037362,12,3,2,1,18
744055456,72,33,2,11,118
744072045,106,14,2,2,124
744081441,37,9,4,2,52
744088800,56,22,2,43,123
744094543,89,23,2,1,115
744103987,17,9,2,3,31
744104678,28,3,4,1,36
744111453,267,7,2,1,277
744117668,54,53,2,1,110
744150275,19,18,5,2,44
744162594,47,27,18,1,93
744164669,109,23,77,1,210
744168335,23,11,2,3,39
744181629,55,22,2,1,80
744183876,40,7,9,4,60
744184226,83,29,4,2,118
744185211,11,4,2,3,20
744197443,13,3,2,1,19
744229998,28,3,2,2,35
744232626,47,45,3,2,97
744240418,220,3,2,7,232
744247145,57,15,59,8,139
744252905,43,28,20,14,105
744261837,95,11,4,4,114
744272281,121,35,3,6,165
744272716,27,50,2,2,81
744277193,17,35,12,1,65
744280861,31,16,2,1,50
744284871,99,3,2,2,106
744285338,19,18,2,1,40
744290484,103,4,2,8,117
744299143,74,20,2,1,97
744319043,38,40,58,3,139
744334921,130,34,10,1,175
744376537,16,3,2,1,22
744385383,38,3,2,1,44
744411951,86,3,2,7,98
744426384,75,35,20,1,131
744438962,10,16,2,1,29
744439270,75,4,2,1,82
744439575,144,26,37,7,214
744448820,32,9,2,2,45
744450134,10,19,2,1,32
744460257,43,4,2,1,50
744466691,95,35,2,7,139
744471409,22,75,6,16,119
744475467,253,74,2,17,346
744477467,43,3,2,1,49
744478358,298,31,8,13,350
744478882,81,3,2,3,89
744499936,96,14,2,1,113
744503416,113,32,27,1,173
744505884,113,6,50,8,177
744509746,114,3,2,2,121
744511479,79,7,2,2,90
744516222,93,15,37,14,159
744526018,31,69,22,26,148
744528502,134,28,31,4,197
744537360,69,3,31,1,104
744546563,21,3,2,2,28
744549660,38,9,4,3,54
744552415,25,3,2,8,38
744563714,58,46,2,1,107
744564095,26,32,24,1,83
744570364,143,23,4,14,184
744577140,14,3,2,1,20
744578043,17,3,2,1,23
744585553,11,15,2,2,30
744590365,140,57,33,6,236
744602643,59,6,2,1,68
744613809,53,3,2,1,59
744615959,86,89,2,2,179
744620768,15,3,10,3,31
744625077,84,28,2,13,127
744625870,115,4,3,1,123
744641484,108,34,44,36,222
744656330,166,3,2,1,172
744656440,104,3,2,7,116
744668131,68,32,12,5,117
744686138,164,24,10,2,200
744701250,31,36,17,19,103
744710782,109,4,2,4,119
744711584,40,38,31,43,152
744716205,19,3,2,1,25
744729459,269,12,2,1,284
744732952,111,16,40,36,203
744743054,34,9,4,2,49
744775436,151,3,2,1,157
744793395,67,3,2,11,83
744805462,37,67,20,5,129
744810406,33,3,2,1,39
744812366,104,34,69,1,208
744814824,217,3,2,33,255
744821079,29,20,7,10,66
744838546,37,3,2,1,43
744870933,86,3,2,1,92
744872966,15,3,2,1,21
744873384,97,3,2,7,109
744879481,11,3,2,1,17
744882492,24,3,2,4,33
744887104,175,3,2,23,203
744903924,18,3,2,1,24
744912986,10,10,2,1,23
744921390,100,58,2,1,161
744922462,87,18,41,16,162
744925187,13,40,2,1,56
744927748,59,14,2,14,89
744928429,60,23,24,3,110
744932117,25,3,2,1,31
744938811,45,11,4,1,61
744939084,71,40,2,1,114
744985853,127,23,2,13,165
744994145,77,31,11,42,161
744999179,11,3,2,1,17
745002559,65,3,2,5,75
745025534,31,3,2,4,40
745055984,62,5,3,6,76
745057274,97,33,2,9,141
745057574,189,22,107,16,334
745058798,55,11,4,2,72
745060762,95,52,90,49,286
745063459,81,21,3,3,108
745067885,47,28,13,8,96
745090840,33,10,2,4,49
745097134,58,3,2,1,64
745099350,24,16,2,1,43
745101584,55,34,79,16,184
745111430,103,23,134,1,261
745122587,134,25,49,5,213
745126840,231,13,52,34,330
745129155,17,3,2,1,23
745134318,14,15,35,2,66
745137888,25,17,7,3,52
745138520,588,3,2,7,600
745152573,64,4,2,8,78
745157690,21,10,2,1,34
745159414,100,21,16,1,138
745166522,95,3,2,1,101
745172788,66,3,2,1,72
745205753,67,43,13,6,129
745218233,43,37,58,3,141
745234857,34,22,2,4,62
745257584,37,31,2,1,71
745274510,11,3,2,1,17
745275072,168,3,2,1,174
745278702,66,64,9,40,179
745286200,24,13,3,4,44
745293353,54,49,7,5,115
745299687,76,3,52,5,136
745303146,19,10,2,1,32
745310520,75,33,25,10,143
745318037,35,48,2,1,86
745330927,43,33,2,1,79
745331657,94,9,2,13,118
745344125,162,38,2,1,203
745364537,18,3,2,1,24
745381651,46,20,22,7,95
745381751,13,3,2,1,19
745381808,21,15,12,3,51
745388402,37,3,2,1,43
745388716,39,70,10,1,120
745404495,80,15,2,1,98
745423340,37,3,2,3,45
745434845,55,11,2,1,69
745444370,61,36,14,2,113
745457074,92,10,9,1,112
745469754,15,3,2,1,21
745478391,87,29,21,2,139
745490126,96,51,15,1,163
745507538,10,9,2,1,22
745516318,10,7,2,1,20
745516492,100,45,10,6,161
745541448,56,45,3,2,106
745548811,149,19,17,1,186
745549269,23,3,2,3,31
745558578,47,51,12,1,111
745569994,52,54,19,3,128
745589175,77,3,2,1,83
745589370,10,4,2,1,17
745600617,221,7,3,1,232
745618056,13,3,2,4,22
745628994,144,24,4,8,180
745635963,19,3,2,1,25
745645566,29,37,2,1,69
745650354,27,3,2,1,33
745651315,141,19,38,22,220
745652345,17,3,2,1,23
745661349,38,3,2,1,44
745664058,78,13,26,4,121
745665440,49,9,39,4,101
745674705,54,6,2,3,65
745680033,60,10,25,23,118
745685957,51,31,2,28,112
745734968,59,20,2,4,85
745738590,213,3,2,4,222
745756729,64,20,17,12,113
745760017,65,8,2,1,76
745766676,105,25,2,18,150
745767006,57,14,2,1,74
745774724,18,3,2,1,24
745777381,32,20,5,12,69
745793702,15,3,2,1,21
745793859,86,3,2,4,95
745802211,146,29,28,8,211
745811391,13,3,2,1,19
745812087,20,3,2,1,26
745812288,17,3,2,1,23
745816820,16,7,2,1,26
745820083,107,3,2,2,114
745828425,57,10,2,8,77
745834342,10,3,2,2,17
745858382,12,7,2,2,23
745865764,41,53,14,6,114
745867004,86,21,2,4,113
745881058,45,3,2,1,51
745883079,44,3,2,1,50
745902547,41,23,4,2,70
745907700,15,9,2,1,27
745918270,156,14,13,13,196
745920035,64,28,73,46,211
745922932,62,14,2,6,84
745926606,136,3,2,1,142
745940697,109,24,22,1,156
745953980,479,3,2,11,495
745970510,17,3,2,1,23
745974679,122,49,34,11,216
745980611,84,3,2,5,94
745982941,43,4,2,19,68
745986780,17,7,2,2,28
745998524,51,50,5,3,109
745999623,44,10,2,1,57
746005156,12,3,2,1,18
746019538,125,23,28,1,177
746022863,115,3,2,3,123
746032359,80,19,18,21,138
746035921,163,3,4,3,173
746043356,40,29,8,6,83
746057485,12,3,2,1,18
746082982,56,3,2,3,64
746114207,13,4,2,7,26
746120708,161,40,3,4,208
746123443,23,32,2,2,59
746131807,11,3,2,1,17
746134451,34,46,6,19,105
746158241,70,39,16,1,126
746164402,100,16,45,19,180
746168250,10,5,2,1,18
746173412,11,3,2,1,17
746181983,10,4,2,1,17
746185137,26,29,2,1,58
746186881,71,33,2,1,107
746198531,94,13,26,1,134
746205498,20,25,52,3,100
746208427,107,49,8,17,181
746214519,50,60,73,1,184
746215301,129,32,13,6,180
746216908,178,27,38,14,257
746230454,77,6,19,11,113
746233948,73,54,3,5,135
746259694,106,25,2,6,139
746272866,18,3,2,1,24
746273777,34,54,2,1,91
746278704,62,3,18,1,84
746296605,71,3,2,1,77
746307181,49,12,31,1,93
746310863,16,5,14,1,36
746333731,80,3,2,1,86
746340387,83,24,5,2,114
746340825,15,3,2,1,21
746348229,10,40,2,1,53
746370570,125,4,2,1,132
746371306,890,3,2,9,904
746395507,72,29,29,8,138
746417628,58,34,42,1,135
746432886,32,32,3,3,70
746433674,50,3,2,1,56
746443193,17,3,2,5,27
746444828,54,17,3,5,79
746449795,76,31,34,5,146
746459114,16,11,2,8,37
746460340,51,3,2,10,66
746484021,87,21,2,19,129
746489433,67,34,19,18,138
746497635,74,25,2,1,102
746500223,190,3,2,69,264
746508149,220,21,68,9,318
746512495,18,29,13,15,75
746515496,67,12,84,1,164
746523793,11,11,2,1,25
746532003,20,3,2,1,26
746543120,20,3,2,5,30
746546754,168,3,2,9,182
746570988,71,19,22,7,119
746598421,75,16,30,39,160
746603353,46,36,8,10,100
746606539,109,3,2,2,116
746611581,126,3,2,11,142
746614678,55,22,19,2,98
746618296,67,3,2,4,76
746644402,60,4,21,7,92
746684647,105,5,2,13,125
746706059,20,3,2,2,27
746711586,94,4,3,16,117
746712330,71,3,2,2,78
746721731,23,19,7,1,50
746726618,15,26,2,1,44
746730202,147,52,37,44,280
746773372,144,3,2,5,154
746792036,94,3,2,5,104
746804592,56,3,2,3,64
746811256,73,3,2,1,79
746843593,64,14,2,3,83
746843913,31,59,90,1,181
746856387,21,30,2,1,54
746867420,245,14,116,1,376
746874614,27,5,22,3,57
746876267,14,3,2,1,20
746877976,10,26,2,1,39
746894925,88,32,31,20,171
746907964,11,3,2,1,17
746921257,17,3,2,2,24
746939266,76,3,2,1,82
746947456,54,14,2,9,79
746950345,168,7,10,21,206
746958274,44,43,14,22,123
746966117,145,11,2,39,197
746966453,63,65,32,2,162
746966922,33,9,2,4,48
746971836,193,3,2,4,202
746976960,107,20,2,16,145
746983057,10,3,2,2,17
746988330,110,28,2,2,142
746994987,174,3,2,2,181
746995351,37,40,7,2,86
747003579,71,19,2,11,103
747009607,93,17,15,6,131
747014233,68,3,2,1,74
747018468,37,18,5,2,62
747020869,89,25,18,3,135
747043925,139,3,2,39,183
747069255,45,3,3,10,61
747070487,23,3,2,1,29
747075686,37,23,8,3,71
747077318,34,16,50,1,101
747096255,65,3,2,1,71
747099107,86,5,45,11,147
747111846,60,15,35,1,111
747114031,25,5,18,1,49
747114053,17,29,26,1,73
747115874,18,3,2,1,24
747116927,36,49,2,4,91
747144210,24,4,2,1,31
747146772,73,15,40,3,131
747154388,26,41,2,12,81
747173301,19,21,4,1,45
747174588,14,3,2,1,20
747183863,28,11,2,5,46
747183994,68,41,4,8,121
747202088,18,3,2,4,27
747218369,82,9,2,4,97
747235058,35,10,6,22,73
747261942,46,11,13,11,81
747285935,148,19,14,18,199
747288034,61,68,68,36,233
747290427,43,135,20,2,200
747307525,111,53,31,12,207
747313408,179,58,73,2,312
747322868,47,7,2,1,57
747334091,10,8,2,2,22
747340192,14,7,2,1,24
747364396,46,31,37,1,115
747369528,87,25,14,14,140
747380545,107,28,51,3,189
747385866,52,15,46,14,127
747386349,64,51,5,1,121
747391940,162,21,127,1,311
747407109,17,22,2,1,42
747423043,153,8,2,1,164
747433250,125,12,2,1,140
747442148,112,12,5,1,130
747443282,71,6,9,2,88
747444350,36,3,2,1,42
747447467,41,13,2,1,57
747448705,241,6,10,4,261
747454213,19,3,2,1,25
747459879,161,49,70,13,293
747477156,62,3,2,1,68
747479486,15,3,2,1,21
747493538,123,47,59,26,255
747493613,155,42,58,11,266
747513660,79,3,2,1,85
747518220,32,46,24,2,104
747518397,14,3,2,1,20
747525342,42,11,3,21,77
747527801,125,76,20,11,232
747545208,128,7,2,1,138
747548059,61,11,2,5,79
747554998,71,4,2,6,83
747556977,33,3,2,1,39
747559546,78,29,54,1,162
747588076,41,3,5,1,50
747593132,38,4,3,3,48
747596080,94,12,2,9,117
747600324,141,40,13,5,199
747603640,32,24,30,5,91
747606106,109,8,2,1,120
747617615,71,3,2,6,82
747628016,27,4,2,3,36
747630994,11,3,2,1,17
747644948,70,3,2,11,86
747658687,101,26,10,1,138
747661395,124,25,34,25,208
747662729,54,34,6,14,108
747675786,88,22,2,1,113
747676290,60,3,2,1,66
747698301,46,6,2,8,62
747702455,12,29,5,1,47
747711038,68,31,80,1,180
747734602,89,9,14,11,123
747740421,75,15,4,5,99
747741783,33,30,5,1,69
747762046,25,25,2,1,53
747762438,13,9,3,2,27
747766346,33,3,2,1,39
747779516,20,11,17,6,54
747783832,16,3,2,1,22
747808034,44,29,2,19,94
747815577,19,3,2,1,25
747820455,101,59,10,2,172
747829168,84,47,28,14,173
747833122,37,3,2,5,47
747835843,61,25,90,2,178
747843069,32,19,2,6,59
747846597,111,12,49,7,179
747856428,64,34,15,10,123
747866639,12,3,2,1,18
747873439,33,13,2,15,63
747880393,22,4,8,1,35
747881600,32,41,8,4,85
747895961,82,14,2,1,99
747904442,180,18,2,1,201
747904837,100,19,35,3,157
747905298,57,10,14,9,90
747918630,61,3,2,1,67
747923534,11,3,2,1,17
747932158,51,45,3,1,100
747949122,169,3,2,1,175
747966408,135,5,2,15,157
747974715,26,18,5,16,65
747982855,35,3,2,1,41
747997651,153,16,2,53,224
748003262,181,30,8,16,235
748003690,97,29,20,4,150
748010327,37,3,2,1,43
748012571,77,3,2,4,86
748016527,38,52,18,4,112
748031105,57,4,44,1,106
748057027,46,29,18,1,94
748059130,68,3,3,7,81
748062856,43,3,2,5,53
748068377,41,50,2,1,94
748093001,13,48,2,4,67
748111071,144,6,2,40,192
748125609,206,3,2,1,212
748129377,100,32,26,1,159
748135454,99,3,2,11,115
748140057,39,27,2,15,83
748143934,53,27,32,66,178
748154145,260,46,27,21,354
748184312,126,3,2,2,133
748190135,23,24,13,13,73
748202158,80,23,30,33,166
748206085,81,3,2,1,87
748210982,20,15,2,7,44
748213823,40,46,45,1,132
748235861,26,7,2,14,49
748236546,24,51,2,16,93
748243375,41,28,2,7,78
748245307,11,3,2,3,19
748246759,65,3,7,1,76
748248968,415,3,2,2,422
748259236,25,44,4,2,75
748269655,33,3,2,2,40
748271225,11,3,2,2,18
748271488,112,43,7,1,163
748281059,19,3,2,2,26
748291173,117,3,2,4,126
748299531,124,7,2,3,136
748303234,136,20,2,1,159
748304098,32,33,19,16,100
748308006,16,3,2,1,22
748312158,30,5,2,2,39
748330450,27,5,2,1,35
748367623,125,41,3,3,172
748371810,19,3,2,6,30
748376478,77,43,37,11,168
748394457,66,30,15,27,138
748399837,13,7,2,1,23
748402775,110,49,43,3,205
748431723,10,18,2,1,31
748432681,14,23,2,3,42
748439622,13,8,2,1,24
748443607,44,3,2,2,51
748443619,220,25,28,40,313
748452126,98,3,2,7,110
748455953,52,18,2,4,76
748456417,199,28,72,1,300
748480061,29,23,22,35,109
748483189,82,6,72,6,166
748486016,104,30,3,5,142
748491096,18,3,2,1,24
748493458,81,13,12,46,152
748510654,197,4,2,4,207
748512559,35,54,8,8,105
748521610,44,3,2,1,50
748543879,73,59,19,19,170
748557428,123,64,67,10,264
748579401,15,78,14,14,121
748584290,59,3,2,15,79
748594270,166,3,2,8,179
748602072,37,45,48,3,133
748606747,123,35,14,51,223
748609139,49,7,34,1,91
748629652,143,73,70,44,330
748637407,89,8,2,1,100
748637621,62,5,76,11,154
748638069,82,19,21,3,125
748644271,58,6,6,1,71
748652257,152,3,2,3,160
748663620,157,3,2,10,172
748676062,53,3,2,1,59
748676446,119,9,5,1,134
748677486,43,37,8,1,89
748681903,65,8,2,1,76
748693055,13,15,2,1,31
748697595,35,48,13,1,97
748739675,18,3,2,1,24
748768152,57,36,4,10,107
748789388,19,3,2,4,28
748791986,11,3,2,1,17
748801126,43,32,7,16,98
748807510,16,55,28,1,100
748840325,14,9,2,1,26
748851996,31,30,13,4,78
748860071,92,3,2,1,98
748874625,71,19,45,2,137
748915252,45,20,26,5,96
748918116,113,44,44,2,203
748921274,23,3,2,1,29
748936996,169,43,88,12,312
748937710,63,34,7,13,117
748941408,160,3,2,5,170
748951152,71,9,57,2,139
748970815,96,3,2,1,102
748985900,13,3,2,1,19
749010528,87,3,2,4,96
749011588,31,3,2,6,42
749014896,124,92,18,4,238
749019702,37,4,13,2,56
749029071,63,31,24,5,123
749033128,47,45,20,6,118
749038362,34,48,31,2,115
749055404,18,3,2,1,24
749056810,25,49,15,1,90
749064939,26,12,2,8,48
749065020,36,19,2,7,64
749065848,152,8,10,7,177
749094792,55,16,2,1,74
749099266,22,3,2,1,28
749100806,102,21,33,37,193
749115846,26,22,23,9,80
749117077,133,12,26,1,172
749121479,88,16,27,2,133
749152524,45,14,31,15,105
749157031,75,21,77,1,174
749159553,72,3,14,1,90
749163409,115,3,2,21,141
749164983,149,31,3,1,184
749180425,19,3,2,1,25
749186335,108,59,3,14,184
749189886,31,16,38,10,95
749223059,66,57,21,2,146
749232128,28,25,6,1,60
749235071,19,3,2,4,28
749237151,19,9,2,1,31
749242793,37,25,2,3,67
749247891,32,3,2,1,38
749250030,55,69,9,21,154
749255926,28,10,2,1,41
749263421,66,23,2,2,93
749272079,137,3,2,3,145
749291363,50,37,2,1,90
749321591,59,3,2,7,71
749323693,92,21,49,24,186
749360604,126,3,2,1,132
749371718,60,29,33,17,139
749396738,52,24,2,2,80
749397277,60,28,10,1,99
749398235,109,12,59,1,181
749400262,59,7,2,1,69
749424348,79,3,2,4,88
749452919,35,3,2,1,41
749453330,58,10,41,1,110
749458915,36,84,6,1,127
749465982,23,27,2,1,53
749481286,64,3,10,1,78
749494993,91,3,2,1,97
749510414,35,3,2,3,43
749512321,55,11,9,1,76
749521891,74,3,2,2,81
749557102,91,33,8,11,143
749566009,20,3,2,1,26
749567734,13,8,2,1,24
749585646,14,49,2,1,66
749591797,17,3,2,3,25
749600352,47,21,13,1,82
749613941,117,22,20,1,160
749628232,106,37,2,1,146
749646572,48,5,21,3,77
749650841,10,3,2,2,17
749665867,71,38,42,19,170
749672233,109,3,2,1,115
749676141,13,3,2,2,20
749676742,38,28,17,36,119
749692841,53,8,2,1,64
749710556,29,43,9,73,154
749713669,17,3,2,11,33
749724552,14,3,2,2,21
749737869,14,10,2,3,29
749753121,61,33,29,6,129
749775879,125,43,177,12,357
749789834,98,17,2,84,201
749794388,63,7,2,1,73
749857901,88,3,2,1,94
749871584,43,20,3,1,67
749880555,12,3,2,1,18
749892940,80,5,15,11,111
749896018,107,31,3,8,149
749925846,93,3,2,1,99
749930431,32,79,34,38,183
749937681,51,41,17,12,121
749937946,172,20,12,12,216
749942002,90,44,7,3,144
749954836,79,12,24,6,121
749977569,11,4,2,1,18
749993674,42,3,2,9,56
749998709,47,9,15,11,82
750000411,112,11,2,1,126
750031338,122,11,3,9,145
750031752,129,99,4,4,236
750047734,29,60,2,1,92
750061637,85,14,2,1,102
750062671,20,10,2,3,35
750081089,112,19,2,62,195
750088656,39,34,46,32,151
750091195,76,17,2,1,96
750092022,46,16,6,7,75
750099549,19,16,2,1,38
750105622,55,32,44,1,132
750110385,60,13,2,1,76
750112357,71,37,62,4,174
750132929,14,3,2,1,20
750134342,51,22,13,40,126
750167776,21,86,24,3,134
750168005,87,18,49,4,158
750178700,108,17,3,6,134
750184227,43,53,3,1,100
750184843,93,24,5,1,123
750185817,10,5,2,1,18
750186392,69,24,2,1,96
750194842,71,51,35,1,158
750198720,108,145,80,5,338
750205730,264,50,48,6,368
750216947,98,29,2,8,137
750218572,20,10,12,2,44
750230670,13,3,2,1,19
750235216,198,4,2,1,205
750237052,26,50,22,4,102
750242285,30,8,2,3,43
750254142,107,30,8,18,163
750258303,34,21,16,9,80
750261293,27,3,2,4,36
750261314,78,51,2,2,133
750275924,34,3,2,1,40
750277778,13,3,2,1,19
750295206,30,30,5,1,66
750302011,15,3,2,1,21
750317703,37,24,2,5,68
750358886,111,3,2,1,117
750360119,48,3,22,7,80
750363381,62,6,2,1,71
750365937,100,10,15,4,129
750366825,98,47,4,1,150
750367060,30,29,9,4,72
750369179,60,3,2,1,66
750373166,84,16,2,2,104
750378982,184,3,2,2,191
750380283,297,19,63,15,394
750383303,21,3,2,2,28
750383722,11,13,2,1,27
750392910,48,24,19,3,94
750401209,61,19,3,7,90
750405765,88,15,24,11,138
750427995,32,3,2,1,38
750438684,105,12,9,9,135
750450771,68,12,7,5,92
750456451,41,5,18,1,65
750462061,52,3,2,1,58
750467047,30,40,11,7,88
750470713,92,3,2,1,98
750472625,11,3,2,1,17
750476234,95,3,2,2,102
750476288,15,3,2,1,21
750482308,61,27,44,58,190
750492975,40,3,2,1,46
750497332,25,26,2,12,65
750507357,143,9,48,1,201
750529031,62,15,8,3,88
750530803,64,14,10,4,92
750533228,38,36,4,14,92
750537769,105,60,28,1,194
750541532,324,33,110,7,474
750547025,90,64,3,12,169
750557983,15,3,2,1,21
750571313,96,35,10,19,160
750577599,49,6,64,23,142
750580519,32,3,2,7,44
750594360,74,76,5,1,156
750597028,12,3,2,3,20
750602562,13,3,2,6,24
750609434,28,33,17,8,86
750620453,25,20,2,1,48
750624246,14,3,2,1,20
750625624,22,53,15,7,97
750644243,45,17,2,1,65
750649283,11,3,2,1,17
750649315,16,3,2,1,22
750675938,104,17,24,1,146
750698398,23,3,2,1,29
750702784,166,46,140,1,353
750705276,12,6,2,1,21
750725042,199,3,2,2,206
750726455,169,102,32,22,325
750733203,56,40,26,1,123
750734667,42,3,3,1,49
750735170,96,26,2,4,128
750738553,10,6,2,1,19
750742695,15,9,2,1,27
750743806,36,54,20,1,111
750745748,40,3,2,1,46
750749338,31,86,27,4,148
750751407,62,36,24,1,123
750783224,38,4,2,9,53
750787634,112,45,35,2,194
750788596,64,3,2,1,70
750796670,22,16,2,1,41
750806359,10,14,2,1,27
750810466,92,51,14,9,166
750818444,35,51,13,27,126
750840363,116,3,2,23,144
750845745,46,10,14,4,74
750852311,57,5,2,4,68
750864623,16,35,11,1,63
750876578,138,27,67,1,233
750879458,24,24,2,1,51
750881670,38,25,21,1,85
750892006,21,3,2,1,27
750894869,37,15,7,16,75
750897031,83,26,72,19,200
750905400,116,6,2,2,126
750909566,223,3,2,1,229
750911205,49,10,32,1,92
750911235,118,3,2,2,125
750926168,42,20,3,1,66
750949298,52,15,3,5,75
750977633,17,10,2,1,30
750985014,220,18,2,2,242
751003251,159,10,17,48,234
751015246,104,18,44,2,168
751022661,16,38,14,1,69
751033553,74,3,2,1,80
751061414,34,65,3,8,110
751066275,56,10,2,3,71
751066594,15,14,2,1,32
751071857,125,72,12,3,212
751081613,140,3,2,26,171
751097052,127,38,2,17,184
751106957,25,30,2,1,58
751107387,63,27,65,2,157
751121465,58,20,5,7,90
751124299,132,18,2,2,154
751129339,26,63,29,2,120
751129588,75,3,2,1,81
751139723,111,27,2,1,141
751173069,44,9,2,3,58
751173114,188,92,87,68,435
751188521,37,64,73,48,222
751203488,18,3,6,3,30
751204095,259,3,2,7,271
751205362,141,3,2,1,147
751205965,28,3,2,19,52
751207850,58,14,93,1,166
751216494,51,22,70,14,157
751255179,11,3,2,1,17
751257143,18,26,17,3,64
751258821,10,11,2,1,24
751261210,16,3,2,1,22
751262240,83,30,2,2,117
751264562,65,72,12,17,166
751285262,49,47,4,8,108
751313472,74,42,35,31,182
751336302,93,3,2,4,102
751356715,101,3,2,1,107
751357310,19,69,2,1,91
751379377,17,7,2,1,27
751379896,14,3,2,1,20
751382468,33,15,2,3,53
751382813,51,3,2,1,57
751384118,140,12,22,5,179
751420034,55,57,22,10,144
751423178,54,3,2,3,62
751452836,144,49,27,1,221
751459870,101,44,4,1,150
751471117,10,3,2,2,17
751484278,28,45,2,2,77
751492123,147,3,2,3,155
751495138,93,24,58,2,177
751495740,55,11,2,1,69
751497860,50,17,11,5,83
751505196,76,3,2,1,82
751515495,99,23,2,1,125
751518926,44,34,9,16,103
751530102,55,16,2,4,77
751532257,121,33,46,19,219
751550541,13,3,2,1,19
751556543,80,4,2,1,87
751559330,36,15,2,1,54
751585379,19,13,2,1,35
751591246,249,48,15,3,315
751595568,138,6,3,2,149
751624309,12,3,2,4,21
751626511,78,15,44,11,148
751627630,63,9,176,4,252
751631533,76,14,9,2,101
751640649,45,33,13,28,119
751662355,60,3,2,1,66
751678025,68,35,2,7,112
751697957,70,32,62,13,177
751699238,107,7,2,3,119
751700013,58,62,32,3,155
751700020,96,71,10,14,191
751717587,48,65,4,6,123
751725163,203,3,2,4,212
751725322,15,13,2,13,43
751731309,83,25,27,6,141
751735804,10,24,2,1,37
751746126,11,4,2,1,18
751748496,292,11,24,13,340
751760550,31,28,5,1,65
751768336,21,56,2,5,84
751770295,81,3,2,4,90
751772127,21,5,2,1,29
751800932,53,30,2,1,86
751805058,76,24,18,32,150
751816088,13,3,2,1,19
751845814,30,79,7,6,122
751852734,30,50,5,1,86
751854140,79,27,2,2,110
751859446,11,3,2,1,17
751860725,23,3,2,1,29
751864910,53,43,10,8,114
751870480,203,20,2,2,227
751874461,83,14,2,1,100
751882722,29,4,2,1,36
751891799,17,5,2,1,25
751897119,11,3,2,1,17
751909249,66,22,2,27,117
751935921,11,5,2,1,19
751936620,12,10,2,3,27
751948691,34,137,31,3,205
751950156,109,31,2,22,164
751957693,35,3,2,3,43
751963893,110,3,15,3,131
751967905,54,128,18,5,205
751968593,16,5,2,1,24
751979059,41,37,15,11,104
751979419,79,47,105,1,232
751987106,74,12,51,4,141
751987327,96,3,2,1,102
751991287,11,9,2,1,23
751999417,10,19,2,3,34
752011138,26,3,2,1,32
752027341,120,34,4,8,166
752033080,11,8,2,1,22
752045576,60,32,2,12,106
752047824,41,68,11,2,122
752055227,146,3,2,2,153
752067183,19,10,6,5,40
752068323,45,3,2,1,51
752068421,106,60,37,39,242
752080726,14,3,2,1,20
752084872,44,7,2,1,54
752095750,18,4,10,1,33
752116722,77,16,41,27,161
752138082,144,3,6,4,157
752150647,143,48,38,1,230
752152652,12,16,19,27,74
752153243,98,8,3,1,110
752155684,190,34,2,3,229
752164786,74,17,4,4,99
752167535,146,3,2,1,152
752170842,27,3,2,1,33
752181965,10,7,2,1,20
752186101,51,3,2,5,61
752195406,229,30,2,54,315
752200866,20,22,2,1,45
752208970,34,32,10,10,86
752214477,21,20,39,1,81
752217693,136,4,2,3,145
752219173,35,10,2,1,48
752224198,106,3,2,3,114
752240152,27,50,2,1,80
752254978,85,6,2,5,98
752256443,40,3,2,1,46
752263338,54,3,2,3,62
752266782,131,45,37,1,214
752283557,66,54,19,11,150
752286091,10,3,2,3,18
752297615,94,11,2,15,122
752313922,28,3,2,3,36
752320367,11,3,2,2,18
752320735,16,3,2,3,24
752322019,14,3,2,2,21
752332276,88,37,13,1,139
752337147,19,4,2,1,26
752339233,156,14,54,5,229
752342461,104,3,2,1,110
752350575,15,10,5,1,31
752360068,28,3,2,1,34
752370117,23,68,3,4,98
752382229,21,19,4,1,45
752385778,34,3,2,1,40
752390636,43,4,8,1,56
752393561,48,12,6,5,71
752394870,24,46,5,11,86
752409513,126,22,3,16,167
752427575,60,20,2,17,99
752439925,80,32,18,1,131
752450094,62,41,20,1,124
752452314,23,10,9,1,43
752456016,18,29,7,1,55
752461169,105,3,2,9,119
752466710,54,10,2,1,67
752467482,45,4,2,10,61
752478003,51,30,2,1,84
752485563,13,34,3,1,51
752496586,11,3,2,1,17
752498561,174,65,20,18,277
752508936,17,27,5,16,65
752530769,52,7,2,4,65
752538882,25,51,9,15,100
752538942,74,10,94,35,213
752541596,33,31,9,1,74
752547875,10,31,2,3,46
752578628,96,3,2,1,102
752580797,20,41,2,5,68
752580871,17,94,26,1,138
752584855,27,61,55,2,145
752615420,25,20,20,2,67
752636841,13,3,2,2,20
752646371,20,3,2,4,29
752664067,65,3,2,1,71
752670526,61,12,2,1,76
752680696,162,58,37,7,264
752686292,31,50,5,1,87
752688593,31,19,2,1,53
752691646,121,3,2,4,130
752692069,112,27,75,2,216
752717482,49,3,2,1,55
752729677,11,3,2,1,17
752730634,91,19,2,16,128
752732955,14,3,2,1,20
752739824,42,4,9,16,71
752747844,55,57,5,2,119
752748196,17,8,2,1,28
752761330,44,3,2,1,50
752776874,51,39,18,6,114
752785883,25,49,3,1,78
752804394,54,39,3,1,97
752809885,102,67,2,10,181
752816268,23,3,2,1,29
752821763,124,13,2,2,141
752822300,133,20,43,9,205
752836680,79,16,70,14,179
752840275,35,66,7,2,110
752841134,32,58,3,15,108
752848068,50,3,2,1,56
752850512,92,26,2,7,127
752857395,27,22,14,4,67
752859469,46,8,18,2,74
752864671,50,29,3,9,91
752903527,15,21,2,2,40
752904707,53,13,9,1,76
752905220,38,103,65,18,224
752929033,33,43,16,1,93
752964202,63,62,33,1,159
752965975,72,3,2,1,78
752969726,24,22,2,34,82
752973927,29,35,47,3,114
752984665,11,5,2,2,20
752987570,508,3,2,6,519
752987980,41,43,46,1,131
753010102,58,3,2,1,64
753020536,20,27,2,3,52
753045394,70,22,15,25,132
753076428,226,12,18,5,261
753079211,37,41,72,5,155
753082103,63,23,5,5,96
753082604,23,8,2,3,36
753113187,12,3,2,1,18
753115326,34,72,12,1,119
753129377,36,48,3,25,112
753134815,76,20,95,1,192
753139966,72,39,2,6,119
753144738,40,29,2,3,74
753157972,36,29,2,1,68
753161110,95,61,42,3,201
753175935,32,19,17,29,97
753181441,11,3,2,2,18
753187698,46,3,2,1,52
753199528,140,28,46,9,223
753201553,173,13,12,19,217
753203255,96,25,2,1,124
753208770,69,31,3,1,104
753216585,18,30,4,4,56
753218674,13,9,2,1,25
753237736,33,21,4,3,61
753240841,24,7,2,1,34
753252395,32,3,2,1,38
753261701,39,3,2,1,45
753263761,27,3,3,1,34
753264320,82,42,71,1,196
753265137,153,86,30,51,320
753272401,76,3,2,24,105
753281862,42,56,8,17,123
753297632,77,82,29,57,245
753301446,27,27,10,11,75
753307486,60,3,2,19,84
753333252,18,14,2,1,35
753333847,16,19,2,1,38
753335390,10,24,2,1,37
753336348,175,3,2,2,182
753338741,15,51,40,1,107
753353361,27,41,2,3,73
753357267,10,4,2,3,19
753379147,64,13,16,2,95
753380840,119,4,50,1,174
753384120,74,3,2,1,80
753390618,13,3,2,1,19
753393424,29,3,2,1,35
753409046,10,24,2,1,37
753413817,89,12,7,7,115
753420179,38,52,11,69,170
753429680,81,23,2,1,107
753432475,14,12,2,2,30
753440184,20,7,16,1,44
753455310,105,48,58,3,214
753467579,138,11,65,1,215
753479832,27,8,5,1,41
753483819,84,14,43,1,142
753485450,93,7,7,1,108
753490460,17,3,2,1,23
753493634,84,40,22,15,161
753500303,153,31,49,1,234
753502622,44,8,7,1,60
753517023,35,3,2,1,41
753525497,87,29,36,11,163
753527527,45,4,2,3,54
753528661,19,3,2,1,25
753534061,23,7,2,1,33
753536045,52,34,40,31,157
753556752,15,24,8,1,48
753563457,54,36,2,3,95
753563921,157,3,2,2,164
753567562,83,32,2,7,124
753578351,50,4,50,1,105
753579764,22,3,2,1,28
753585947,58,61,2,3,124
753618936,159,21,50,43,273
753624527,132,3,2,15,152
753652688,37,8,41,2,88
753656579,67,18,29,1,115
753662568,72,21,2,1,96
753676471,126,25,2,18,171
753678141,55,21,2,1,79
753681475,44,8,2,1,55
753687389,99,18,19,5,141
753694041,11,3,2,2,18
753697066,101,24,2,11,138
753697613,30,4,11,4,49
753700869,103,26,32,5,166
753701234,58,3,2,7,70
753706518,69,51,11,67,198
753712685,76,4,2,2,84
753730046,12,4,2,1,19
753730742,49,17,6,20,92
753736507,23,3,2,1,29
753737558,131,3,2,1,137
753740366,32,3,15,11,61
753744433,75,11,8,4,98
753750148,21,3,2,1,27
753751411,89,12,21,3,125
753800153,65,14,2,3,84
753806898,84,3,33,4,124
753828854,41,7,36,7,91
753830209,11,4,2,1,18
753831140,65,3,2,1,71
753848567,161,47,22,8,238
753852135,45,23,3,3,74
753856010,27,3,2,1,33
753885621,170,30,36,1,237
753887628,32,11,3,1,47
753890348,69,3,2,1,75
753902833,70,37,2,5,114
753905704,51,54,52,17,174
753937932,126,10,59,48,243
753940271,46,34,2,4,86
753941189,26,3,2,3,34
753941852,66,22,38,12,138
753950043,27,32,6,1,66
753954284,24,10,2,3,39
753960770,19,5,2,10,36
753974768,63,33,4,26,126
754004513,62,56,33,6,157
754016638,132,23,7,61,223
754018342,36,9,2,1,48
754024651,49,3,2,1,55
754026342,15,21,2,7,45
754029993,62,12,2,1,77
754032923,10,36,7,1,54
754046360,151,15,2,14,182
754056323,15,3,2,1,21
754058304,38,12,2,1,53
754067778,43,3,2,1,49
754078151,36,58,22,1,117
754091507,84,3,83,1,171
754094334,47,3,2,1,53
754109199,97,30,2,1,130
754110184,21,14,27,2,64
754123506,42,13,2,6,63
754126762,161,11,111,72,355
754150369,74,31,17,1,123
754184690,194,3,2,3,202
754187355,126,3,2,1,132
754197724,117,9,2,4,132
754216334,68,10,58,1,137
754217250,37,3,2,1,43
754227993,122,31,81,8,242
754233427,12,3,2,1,18
754234184,69,3,2,2,76
754241605,114,3,2,1,120
754243100,54,25,2,1,82
754243606,224,39,5,1,269
754249665,229,8,20,21,278
754255616,63,30,70,1,164
754267286,11,3,2,1,17
754275081,92,20,4,9,125
754278823,12,5,2,3,22
754280928,31,32,2,1,66
754281941,40,7,4,1,52
754282441,19,23,38,1,81
754289477,13,3,2,1,19
754291831,35,3,2,1,41
754292703,120,3,2,1,126
754293963,11,3,2,1,17
754297438,37,4,2,5,48
754298936,50,13,2,2,67
754299533,166,3,2,4,175
754315171,17,3,2,2,24
754319129,119,38,2,2,161
754332593,44,3,2,1,50
754350872,43,3,2,1,49
754351538,37,3,2,1,43
754352518,123,6,2,12,143
754356642,24,54,24,11,113
754363787,32,34,2,1,69
754365354,10,4,2,1,17
754366825,58,30,38,1,127
754379164,24,22,4,8,58
754388512,88,18,14,5,125
754398818,12,3,3,2,20
754401090,13,3,2,3,21
754407130,40,25,10,20,95
754426869,26,3,2,6,37
754430908,41,4,3,2,50
754436254,36,15,2,31,84
754440519,67,3,2,1,73
754444212,56,23,10,17,106
754451870,42,29,12,1,84
754459308,202,3,2,14,221
754471805,109,30,15,11,165
754490732,259,35,2,9,305
754499337,37,3,2,1,43
754510840,89,3,2,1,95
754518895,86,9,42,4,141
754532549,105,7,2,15,129
754547094,80,3,2,1,86
754556015,11,3,2,1,17
754566119,27,15,3,7,52
754573037,91,18,2,3,114
754577371,51,3,2,5,61
754582993,105,45,5,27,182
754583617,91,29,55,5,180
754602646,46,18,54,1,119
754606114,201,70,2,44,317
754614675,32,15,19,4,70
754617185,50,6,2,1,59
754628638,32,17,4,14,67
754629766,10,5,2,1,18
754635840,261,3,2,5,271
754638020,31,4,2,1,38
754640298,13,3,2,2,20
754641604,11,3,2,2,18
754648100,38,38,58,1,135
754652511,13,3,2,1,19
754664621,62,3,2,2,69
754674539,97,12,2,1,112
754682850,51,39,69,1,160
754683068,52,50,2,2,106
754709044,67,21,2,1,91
754711486,71,22,11,17,121
754732781,12,11,2,3,28
754737888,171,67,15,4,257
754745951,129,12,4,10,155
754758692,35,24,2,1,62
754781555,16,39,4,1,60
754798692,17,22,4,2,45
754802518,11,53,2,1,67
754802649,19,24,2,5,50
754819106,15,3,2,3,23
754820591,39,3,2,4,48
754842901,11,3,2,1,17
754863666,28,17,2,8,55
754864234,15,8,2,1,26
754872563,34,26,8,2,70
754902833,107,3,2,1,113
754904610,162,60,61,32,315
754909346,33,86,13,1,133
754909752,149,35,31,3,218
754922894,70,16,37,2,125
754931298,174,67,3,1,245
754932705,93,6,2,1,102
754934886,12,13,2,4,31
754935724,100,28,41,6,175
754937421,142,3,2,3,150
754938562,95,26,29,5,155
754950965,10,6,2,1,19
754962057,31,38,2,6,77
754968190,27,3,2,1,33
754981527,12,3,2,1,18
754988541,72,3,2,1,78
754995793,84,31,52,62,229
754997299,53,12,5,5,75
755007821,18,75,34,7,134
755011311,90,125,3,6,224
755037597,79,20,17,7,123
755059478,40,32,7,28,107
755077967,18,3,2,4,27
755082005,18,60,2,8,88
755088878,95,41,9,2,147
755094699,74,3,2,1,80
755102693,12,3,2,4,21
755115720,21,50,2,2,75
755125060,11,3,2,1,17
755128972,123,3,2,6,134
755128978,10,15,2,1,28
755137431,114,11,7,28,160
755150447,11,3,2,1,17
755160055,15,3,2,3,23
755181720,21,3,2,1,27
755193618,44,4,3,7,58
755202693,75,7,15,11,108
755235982,56,28,7,3,94
755242994,24,32,3,11,70
755245226,92,3,2,2,99
755247484,53,67,25,27,172
755278222,95,17,2,3,117
755279861,29,16,29,3,77
755282429,30,31,47,1,109
755290039,104,3,2,14,123
755303055,18,62,2,1,83
755308624,13,3,2,1,19
755330159,88,3,2,1,94
755342686,40,43,130,4,217
755344591,104,18,11,16,149
755360650,101,22,14,4,141
755363744,80,44,4,50,178
755369287,92,84,2,7,185
755378659,18,3,2,9,32
755383248,67,26,36,10,139
755386706,148,57,33,1,239
755393173,11,3,2,1,17
755393286,75,20,73,13,181
755404113,143,20,3,18,184
755406776,37,54,16,9,116
755408505,65,22,13,9,109
755408667,11,6,2,1,20
755409640,58,45,4,3,110
755419717,61,22,2,3,88
755437098,11,3,2,1,17
755446328,60,3,2,2,67
755484385,132,3,2,22,159
755485014,11,8,2,1,22
755490872,33,49,2,1,85
755497708,26,12,11,1,50
755499540,29,3,2,2,36
755499622,43,17,53,1,114
755509464,37,54,45,1,137
755511812,64,10,2,6,82
755512408,78,27,86,50,241
755515976,39,3,2,1,45
755526087,121,50,22,36,229
755532296,111,3,2,1,117
755534967,38,11,2,3,54
755549721,74,3,2,1,80
755550706,23,3,2,1,29
755560097,20,6,2,5,33
755570018,11,3,2,1,17
755586436,16,3,2,1,22
755610346,47,3,2,3,55
755617883,110,3,2,11,126
755624629,15,5,2,1,23
755643344,39,21,2,1,63
755646126,61,115,4,14,194
755654544,74,3,2,1,80
755666129,24,17,22,1,64
755670604,90,34,17,1,142
755673173,29,12,2,4,47
755681282,17,5,2,1,25
755683045,66,17,20,5,108
755685923,84,11,2,4,101
755692468,90,23,13,2,128
755692819,11,3,2,5,21
755695761,70,15,60,6,151
755714142,10,12,2,2,26
755721427,99,46,70,6,221
755736055,39,20,8,19,86
755757256,130,3,56,2,191
755761715,188,3,16,23,230
755774203,156,55,41,3,255
755783608,81,13,2,1,97
755792032,17,3,2,3,25
755795506,44,19,2,1,66
755806041,19,27,19,8,73
755809958,46,3,2,1,52
755811840,49,9,6,2,66
755816483,146,9,2,11,168
755828464,26,3,2,1,32
755843500,76,51,2,11,140
755845671,111,3,2,1,117
755848230,11,3,2,1,17
755859366,151,15,2,1,169
755862537,124,26,8,24,182
755891184,16,57,2,1,76
755897254,141,3,2,1,147
755911461,81,18,2,1,102
755923776,76,3,2,1,82
755925407,21,3,2,5,31
755930224,92,19,75,15,201
755930925,37,21,2,3,63
755932537,31,11,4,1,47
755934088,74,3,2,1,80
755939917,142,32,9,4,187
755949806,54,3,2,2,61
755951506,48,25,22,1,96
755956181,12,3,2,3,20
755963618,114,29,2,2,147
755965915,120,3,2,1,126
755968882,175,3,2,2,182
755973081,21,51,19,4,95
756000584,106,3,2,1,112
756005775,45,13,2,10,70
756007252,11,8,2,1,22
756013966,41,20,35,5,101
756016429,68,3,2,1,74
756018308,112,42,77,5,236
756025290,101,28,85,1,215
756040860,164,46,84,8,302
756044777,70,3,2,21,96
756049330,58,44,4,24,130
756064109,65,22,41,4,132
756087378,22,3,2,1,28
756110232,118,88,47,1,254
756126588,182,24,34,4,244
756142450,13,3,2,1,19
756146161,64,19,2,1,86
756150061,19,22,3,1,45
756150178,25,3,2,4,34
756167922,34,14,2,1,51
756169543,23,3,2,5,33
756238567,98,17,28,23,166
756238710,97,3,2,1,103
756239949,55,3,2,1,61
756243471,124,6,2,1,133
756255500,44,26,12,6,88
756261830,54,22,25,1,102
756287455,18,3,2,1,24
756294033,45,7,2,1,55
756302912,28,3,2,1,34
756332655,59,46,49,28,182
756340413,98,26,2,1,127
756345290,25,46,2,1,74
756370180,10,4,2,1,17
756374654,10,6,2,1,19
756379826,47,15,2,1,65
756390093,69,51,10,45,175
756413704,27,49,11,1,88
756425945,62,45,2,2,111
756433320,170,3,2,1,176
756436677,149,26,15,64,254
756443770,66,3,2,1,72
756457131,33,4,2,1,40
756459939,122,12,6,1,141
756473258,51,56,7,14,128
756475039,109,3,7,19,138
756489392,95,5,2,1,103
756492284,52,3,2,1,58
756502567,106,47,3,8,164
756521440,98,3,2,3,106
756538604,84,49,3,3,139
756542591,74,25,34,15,148
756543773,16,6,8,2,32
756548083,47,18,2,2,69
756552753,50,3,2,4,59
756554226,104,24,63,1,192
756563895,206,70,64,12,352
756581944,24,3,2,1,30
756582939,37,3,2,11,53
756607355,44,3,2,1,50
756607478,85,28,2,14,129
756629174,110,17,12,12,151
756631839,33,3,2,1,39
756633489,87,6,16,3,112
756638041,30,3,2,2,37
756641288,16,20,2,1,39
756644002,67,76,21,11,175
756647292,48,13,12,2,75
756655283,125,15,2,2,144
756656323,45,60,6,3,114
756662611,167,7,2,1,177
756663968,25,3,2,1,31
756666572,385,10,2,15,412
756674896,160,21,3,20,204
756694145,29,65,21,58,173
756713233,68,5,40,1,114
756714381,11,3,2,1,17
756717100,21,8,3,9,41
756723625,22,3,2,1,28
756738466,23,3,2,3,31
756740624,23,20,32,1,76
756744760,47,24,13,10,94
756753422,55,47,40,41,183
756771095,18,17,4,13,52
756775358,117,24,30,5,176
756780642,57,19,2,1,79
756781862,220,3,2,32,257
756783092,88,3,2,1,94
756804557,28,7,12,1,48
756810563,159,3,30,2,194
756814198,20,3,2,1,26
756816026,11,3,2,1,17
756830943,25,5,13,1,44
756839231,316,3,2,4,325
756842288,20,14,2,1,37
756853667,15,3,2,2,22
756856505,451,13,2,8,474
756873050,47,14,4,1,66
756873877,13,3,2,1,19
756875574,125,11,16,57,209
756881950,41,59,38,8,146
756883746,10,39,2,1,52
756887871,47,41,2,2,92
756902651,73,50,40,37,200
756913103,63,35,4,4,106
756915133,195,52,2,2,251
756918193,23,11,2,6,42
756942570,42,3,2,1,48
756942942,11,3,2,1,17
756947544,101,72,2,2,177
756961037,42,53,3,53,151
756970602,14,3,2,1,20
756982089,67,3,2,3,75
756985395,122,14,2,1,139
756991047,101,3,2,1,107
756992033,50,46,11,3,110
757013360,56,27,2,1,86
757027883,47,38,11,1,97
757044248,47,15,25,2,89
757052047,109,3,18,1,131
757057714,14,36,11,5,66
757068225,14,3,2,1,20
757075067,103,17,2,2,124
757076979,17,3,2,1,23
757077404,33,73,45,3,154
757108357,111,70,48,9,238
757115747,43,8,21,8,80
757116616,10,7,2,4,23
757141975,115,3,2,1,121
757145962,87,11,2,1,101
757147697,10,11,2,1,24
757152433,15,21,4,1,41
757181208,61,16,41,5,123
757198247,125,60,48,4,237
757220131,13,3,2,1,19
757230348,84,15,27,1,127
757231393,214,17,6,53,290
757237936,11,3,2,6,22
757250185,52,56,16,19,143
757250654,51,10,2,1,64
757255483,40,3,2,1,46
757261614,75,18,12,7,112
757287463,11,3,2,1,17
757289635,87,3,2,3,95
757300153,53,12,6,1,72
757301320,35,10,3,11,59
757308825,125,26,4,9,164
757313285,105,164,58,1,328
757314311,166,54,2,28,250
757316984,14,3,2,1,20
757337657,107,23,6,1,137
757348307,126,3,2,7,138
757349410,11,3,2,1,17
757354887,53,3,2,1,59
757367103,72,14,19,1,106
757384804,10,15,3,2,30
757387905,60,47,2,1,110
757390696,18,7,2,1,28
757398252,36,47,51,6,140
757404388,147,3,2,1,153
757419490,41,3,2,3,49
757423501,125,3,2,1,131
757425413,131,41,23,13,208
757440149,68,67,55,1,191
757479730,135,3,2,5,145
757487249,45,3,2,2,52
757509154,82,18,210,17,327
757514851,29,3,2,2,36
757520511,29,78,45,36,188
757533681,53,43,2,1,99
757548762,82,7,2,10,101
757557561,90,3,2,1,96
757564302,54,100,23,6,183
757576387,94,5,2,2,103
757607353,137,24,29,16,206
757614175,54,13,2,8,77
757614452,89,18,12,5,124
757615922,14,5,2,1,22
757657380,36,3,2,1,42
757664231,18,4,2,1,25
757665439,14,3,2,1,20
757674382,44,10,2,1,57
757678719,74,3,2,1,80
757679694,39,26,2,29,96
757680679,19,6,2,1,28
757683722,357,27,7,6,397
757685670,120,28,2,52,202
757703971,44,23,2,5,74
757722975,105,3,2,1,111
757727324,36,9,2,12,59
757731459,70,42,6,1,119
757738692,58,33,55,1,147
757782046,105,15,2,1,123
757786423,33,3,2,1,39
757790561,18,40,2,5,65
757814457,13,12,2,1,28
757826234,22,3,2,1,28
757826497,42,50,10,1,103
757862135,27,3,2,1,33
757877499,124,124,18,2,268
757896150,87,3,2,2,94
757901583,68,33,27,32,160
757902290,80,3,2,1,86
757902855,85,36,108,7,236
757921679,21,32,15,17,85
757932962,178,3,2,2,185
757935730,20,47,7,1,75
757955671,44,24,48,2,118
757957596,45,24,31,4,104
757957621,10,4,2,1,17
757971357,126,3,2,1,132
757986855,115,15,2,1,133
757994612,35,41,11,1,88
757995641,65,32,2,1,100
758010777,263,3,2,1,269
758012284,67,54,16,20,157
758023173,58,32,39,8,137
758028821,118,17,4,2,141
758036911,65,124,36,39,264
758044562,59,21,10,19,109
758051779,133,3,2,3,141
758067933,23,19,12,1,55
758069272,27,12,4,1,44
758070490,85,28,20,19,152
758076400,13,11,2,4,30
758077353,19,8,3,1,31
758086890,107,3,2,7,119
758091930,73,3,2,5,83
758114161,21,28,2,7,58
758120817,62,26,36,8,132
758122106,42,30,17,1,90
758130236,43,32,20,5,100
758180588,31,3,5,3,42
758186242,25,7,4,2,38
758186698,68,62,82,10,222
758191230,66,15,12,42,135
758192411,161,3,2,2,168
758200795,58,10,2,1,71
758207600,88,19,2,1,110
758222824,73,9,2,2,86
758231252,79,3,2,5,89
758234576,15,3,2,1,21
758237724,36,47,9,3,95
758242433,121,29,12,40,202
758257438,151,22,2,10,185
758266591,126,27,2,3,158
758267590,29,26,3,1,59
758279285,13,3,2,1,19
758281250,22,20,2,1,45
758284945,18,3,2,1,24
758300014,12,9,6,1,28
758303984,18,3,2,1,24
758316474,55,3,2,1,61
758318762,30,9,2,1,42
758327423,58,21,2,5,86
758332473,130,23,3,15,171
758343473,17,3,2,1,23
758353779,11,5,2,2,20
758356038,36,3,10,1,50
758370714,27,16,37,1,81
758377272,52,14,2,1,69
758379263,129,7,8,9,153
758395600,112,3,2,1,118
758416997,148,38,111,1,298
758437265,210,35,10,1,256
758443131,63,3,12,1,79
758459506,96,20,2,5,123
758468418,11,7,2,1,21
758469164,10,3,7,5,25
758476330,41,6,2,1,50
758477120,104,15,13,8,140
758488109,75,23,34,1,133
758498173,10,3,2,3,18
758506318,61,43,2,6,112
758510903,13,6,2,1,22
758516080,111,12,2,2,127
758516408,141,6,2,4,153
758523424,583,7,2,1,593
758528897,23,15,30,3,71
758531388,14,3,2,1,20
758532063,19,3,2,1,25
758549062,65,19,13,1,98
758550701,41,90,46,5,182
758553313,13,74,5,1,93
758554279,25,17,11,3,56
758557799,14,4,2,1,21
758559775,46,3,2,1,52
758560947,18,3,2,3,26
758561491,10,8,2,1,21
758562588,70,3,2,2,77
758571565,66,14,9,20,109
758580388,115,13,17,1,146
758591651,14,8,2,1,25
758592809,10,16,17,1,44
758604507,51,23,34,4,112
758607977,18,10,7,1,36
758612692,21,3,2,1,27
758614377,57,11,7,3,78
758615553,117,3,2,3,125
758623058,12,3,2,1,18
758623975,10,8,2,1,21
758631677,22,3,2,1,28
758642035,96,7,2,1,106
758646580,175,24,3,21,223
758651742,140,15,2,10,167
758663763,84,31,21,5,141
758673930,164,3,2,1,170
758683833,78,27,83,35,223
758685235,40,32,27,2,101
758686121,63,24,26,1,114
758707201,11,3,2,1,17
758708831,21,14,2,2,39
758714341,22,37,7,4,70
758721962,167,13,2,31,213
758740975,47,3,2,1,53
758779254,125,38,2,1,166
758786638,80,23,22,14,139
758824417,32,3,2,2,39
758826571,92,3,2,1,98
758841172,109,30,16,11,166
758856436,74,19,2,2,97
758866561,19,3,2,2,26
758867077,99,26,25,18,168
758872031,52,52,18,7,129
758895664,16,3,2,4,25
758897804,160,26,4,5,195
758904310,181,13,10,31,235
758905269,68,6,5,8,87
758908081,46,43,2,4,95
758929077,12,7,2,2,23
758929658,63,29,6,8,106
758932228,162,13,8,88,271
758932522,45,106,7,1,159
758946902,44,37,16,8,105
758964664,102,10,37,14,163
758970475,32,41,9,7,89
758973410,88,29,2,9,128
758992084,100,19,7,7,133
758993940,115,37,4,3,159
758995716,12,3,2,1,18
759013194,131,11,2,16,160
759026828,11,19,2,1,33
759033519,77,16,2,1,96
759037138,20,18,6,2,46
759069531,13,3,2,1,19
759072216,33,42,4,1,80
759079915,25,3,2,1,31
759083154,35,4,2,1,42
759086333,126,30,115,2,273
759087872,70,9,2,2,83
759088694,61,3,2,7,73
759095636,11,3,2,1,17
759100851,14,3,2,1,20
759105550,11,3,2,1,17
759112243,198,6,9,4,217
759113448,162,10,23,1,196
759122430,63,3,2,1,69
759132953,16,3,2,1,22
759136203,45,24,5,7,81
759140694,57,50,11,9,127
759163754,196,3,2,4,205
759176054,37,49,3,18,107
759189042,14,11,2,1,28
759189126,15,3,2,1,21
759193468,66,7,2,3,78
759209388,22,33,67,31,153
759226085,86,63,99,1,249
759248617,13,49,2,1,65
759270683,50,13,4,4,71
759272234,65,3,2,1,71
759272794,11,3,2,1,17
759297547,110,32,23,52,217
759309576,44,3,2,1,50
759311810,14,3,2,1,20
759312630,119,3,2,1,125
759321589,47,12,11,2,72
759327196,10,3,2,2,17
759341966,26,10,2,1,39
759348916,62,3,2,4,71
759350124,24,29,2,5,60
759359002,67,3,2,1,73
759379771,16,3,2,4,25
759382470,201,51,22,18,292
759384468,81,3,41,1,126
759389501,68,22,2,6,98
759410773,48,9,27,1,85
759410986,49,22,10,4,85
759413676,325,3,2,3,333
759416375,682,3,2,14,701
759418651,30,22,7,45,104
759419376,19,3,2,2,26
759422775,62,18,34,5,119
759435655,127,17,3,6,153
759441357,51,3,2,2,58
759450432,78,24,30,5,137
759452930,18,4,2,3,27
759456181,34,66,39,5,144
759464158,81,11,58,3,153
759472704,38,41,2,2,83
759478981,13,4,2,1,20
759490533,162,4,55,12,233
759494322,121,18,10,1,150
759495390,10,4,2,1,17
759501623,85,21,8,6,120
759507759,33,52,27,3,115
759514610,107,61,46,4,218
759532293,53,5,2,12,72
759534286,11,3,2,1,17
759536396,14,3,2,1,20
759543748,39,59,44,2,144
759567525,150,19,2,9,180
759576148,21,18,2,4,45
759580620,99,3,2,1,105
759604663,42,3,2,3,50
759685116,22,3,2,1,28
759686686,124,14,63,3,204
759693024,139,36,2,12,189
759701033,143,10,30,11,194
759701281,38,3,2,2,45
759707127,24,31,3,1,59
759708268,27,10,2,3,42
759709584,52,15,3,37,107
759716315,53,11,65,37,166
759721286,53,6,2,11,72
759721357,45,47,18,1,111
759722952,13,3,2,1,19
759745896,51,32,2,31,116
759750093,32,3,2,1,38
759764057,54,3,2,2,61
759764344,71,13,23,1,108
759767213,60,3,2,3,68
759771380,75,3,2,1,81
759775820,58,14,38,3,113
759795594,78,24,2,8,112
759796457,52,3,2,3,60
759799658,11,15,2,1,29
759806900,82,20,48,20,170
759807206,33,36,20,16,105
759813736,10,4,2,1,17
759815571,40,3,2,1,46
759817458,74,56,17,32,179
759842263,46,31,11,3,91
759850616,55,4,2,1,62
759858383,13,3,2,1,19
759870992,43,104,28,14,189
759871388,142,3,2,2,149
759877459,79,32,2,9,122
759889145,11,3,2,1,17
759890469,19,3,2,1,25
759905062,36,51,23,13,123
759914413,10,4,2,1,17
759922464,49,3,2,1,55
759926015,16,3,2,1,22
759948045,73,23,31,4,131
759972933,74,15,14,1,104
759977989,10,3,2,2,17
759982831,98,8,2,17,125
759984012,45,9,4,1,59
759999402,42,15,2,2,61
760006619,10,6,2,5,23
760021704,46,44,2,4,96
760026196,59,29,65,27,180
760027360,40,23,3,56,122
760053333,107,36,2,6,151
760064098,50,28,25,5,108
760065862,12,3,2,1,18
760077082,51,3,2,5,61
760077963,96,3,2,11,112
760079482,83,16,2,2,103
760081627,129,59,56,10,254
760083648,63,4,2,3,72
760084145,11,3,2,1,17
760087166,72,35,68,12,187
760088950,37,3,2,1,43
760120024,13,6,3,1,23
760135070,33,70,2,25,130
760139627,16,3,2,1,22
760151449,80,24,29,1,134
760153587,63,30,44,12,149
760169361,10,5,2,1,18
760180036,204,3,2,2,211
760195778,21,48,2,1,72
760197695,68,5,17,5,95
760224235,48,3,2,1,54
760241908,18,3,2,3,26
760248719,102,24,15,1,142
760252396,101,3,2,1,107
760256541,46,30,6,5,87
760260731,48,31,32,2,113
760269405,68,3,2,1,74
760286883,74,42,2,13,131
760301514,10,9,2,1,22
760313903,40,16,23,6,85
760316013,20,3,2,1,26
760333810,38,3,2,2,45
760343039,27,32,2,1,62
760344263,63,40,53,23,179
760352455,113,3,2,5,123
760370346,93,3,2,5,103
760371143,268,50,12,23,353
760387119,16,3,2,12,33
760395707,135,126,2,5,268
760396253,13,3,2,1,19
760404232,10,8,2,1,21
760414331,69,22,10,19,120
760422646,32,26,2,4,64
760423820,54,39,2,30,125
760425398,67,15,4,17,103
760429353,139,25,19,20,203
760436179,160,4,96,22,282
760436388,20,5,2,1,28
760439791,14,19,2,1,36
760456690,29,3,2,5,39
760488583,132,3,2,16,153
760499349,10,4,2,1,17
760506777,148,3,2,2,155
760529193,10,3,2,2,17
760529719,23,37,2,1,63
760530659,39,25,2,1,67
760541920,68,36,32,22,158
760545191,119,6,2,6,133
760545413,165,52,19,4,240
760560390,46,31,2,1,80
760576182,37,50,4,16,107
760577557,70,25,5,10,110
760578386,73,3,2,2,80
760583528,26,14,2,1,43
760584489,14,8,25,22,69
760595930,56,3,2,3,64
760597448,81,22,2,6,111
760600970,95,9,3,1,108
760601868,31,36,60,7,134
760603079,74,3,2,1,80
760609102,132,26,22,4,184
760610911,181,29,4,10,224
760622026,63,55,5,17,140
760626702,42,35,11,23,111
760632968,79,3,2,6,90
760646436,103,43,54,6,206
760653027,15,8,2,1,26
760655590,82,24,29,4,139
760655748,17,3,2,1,23
760659051,186,44,77,47,354
760671168,123,18,2,1,144
760671805,13,19,3,1,36
760689792,84,3,2,1,90
760693406,622,3,2,12,639
760707288,110,27,33,3,173
760713592,20,3,2,1,26
760713945,53,25,16,1,95
760718977,52,24,6,4,86
760729350,64,26,2,21,113
760762175,266,3,2,4,275
760778929,19,3,2,1,25
760797833,110,3,2,2,117
760801642,46,18,2,3,69
760803513,20,15,4,8,47
760806593,18,3,2,1,24
760830268,40,3,3,1,47
760837370,15,43,2,1,61
760842864,27,3,2,1,33
760860379,45,48,4,2,99
760861545,26,87,2,4,119
760867817,56,13,2,3,74
760871947,29,78,2,3,112
760873505,66,42,36,3,147
760875808,90,35,14,1,140
760880157,65,54,18,65,202
760906309,49,3,2,1,55
760907499,32,13,2,4,51
760923709,17,6,2,1,26
760924223,23,29,28,2,82
760927430,152,21,53,49,275
760931242,43,65,18,23,149
760940086,24,3,4,1,32
760949958,10,11,2,1,24
760974511,11,4,2,1,18
760985602,217,3,2,26,248
760989380,62,3,85,1,151
760991674,75,57,30,7,169
760996736,38,7,5,4,54
761001733,54,11,2,2,69
761020795,109,25,12,5,151
761021626,57,55,10,170,292
761021747,11,3,2,1,17
761030160,17,5,2,6,30
761033513,197,22,3,2,224
761044895,43,3,2,7,55
761052018,134,36,22,8,200
761073293,28,5,2,1,36
761095371,87,50,3,4,144
761097959,109,3,2,4,118
761103656,16,3,2,1,22
761133796,53,21,73,4,151
761135242,113,26,2,10,151
761139973,47,23,25,1,96
761147502,22,18,2,7,49
761152384,181,3,2,6,192
761175199,116,5,19,4,144
761182244,80,21,17,19,137
761182592,50,3,2,1,56
761188340,87,44,62,34,227
761193542,113,18,2,2,135
761197178,35,38,12,39,124
761201499,44,15,20,3,82
761226307,16,3,2,3,24
761243848,83,49,3,11,146
761253465,30,56,40,1,127
761258319,224,18,2,5,249
761259813,10,3,2,2,17
761266293,52,23,2,8,85
761279288,17,19,2,2,40
761283048,64,17,9,33,123
761286239,57,6,98,10,171
761289299,70,34,2,3,109
761305590,46,64,12,1,123
761333793,161,7,2,1,171
761345327,12,3,2,1,18
761356888,37,3,2,3,45
761358446,137,75,58,9,279
761362412,69,37,2,1,109
761379873,126,3,2,1,132
761381218,16,4,2,1,23
761390504,45,46,38,6,135
761390846,34,9,2,2,47
761391902,69,3,2,1,75
761395011,61,43,26,35,165
761398366,25,23,41,3,92
761399001,32,34,38,10,114
761402995,81,21,17,3,122
761407239,87,9,55,15,166
761408716,80,3,2,1,86
761422017,42,3,2,1,48
761422021,74,34,47,1,156
761426208,75,3,2,1,81
761427051,217,56,103,2,378
761439621,67,12,31,10,120
761444977,46,3,2,1,52
761467255,13,3,2,3,21
761473776,263,24,49,18,354
761481327,46,3,2,3,54
761492108,54,41,8,26,129
761497070,62,33,56,14,165
761504153,17,54,2,2,75
761512464,12,3,2,1,18
761513756,89,17,8,3,117
761515403,15,37,11,17,80
761517030,109,21,6,5,141
761519885,92,56,32,6,186
761531704,34,26,2,3,65
761570036,11,3,2,1,17
761572292,28,7,2,1,38
761577713,167,3,2,1,173
761580546,20,4,2,2,28
761582547,59,39,2,6,106
761588765,65,10,4,11,90
761594040,68,12,2,1,83
761598055,89,45,2,20,156
761611096,55,27,14,2,98
761619693,111,33,7,12,163
761631757,111,11,24,3,149
761643446,11,8,2,2,23
761647465,19,22,3,1,45
761665991,31,26,2,1,60
761668682,50,17,3,1,71
761670316,168,20,3,1,192
761676854,79,37,48,50,214
761677256,85,3,2,1,91
761690344,56,8,9,17,90
761691301,34,33,3,20,90
761694436,137,15,4,17,173
761712612,146,29,34,30,239
761716223,27,5,2,9,43
761736292,10,13,2,1,26
761739860,63,3,2,1,69
761741224,75,74,3,1,153
761758861,29,3,2,1,35
761777269,189,25,2,1,217
761787194,68,23,2,4,97
761788002,54,49,4,6,113
761824609,218,15,2,1,236
761839834,13,12,2,4,31
761843549,90,42,22,2,156
761858896,150,3,2,7,162
761868546,21,14,2,2,39
761871626,58,22,2,9,91
761882583,97,3,2,1,103
761882893,129,3,2,9,143
761899208,53,9,55,9,126
761901813,130,3,2,52,187
761908139,89,30,2,8,129
761934117,134,9,2,2,147
761946324,65,19,53,5,142
761997988,47,15,71,9,142
762012049,20,3,2,2,27
762019458,110,41,2,15,168
762032770,16,6,3,3,28
762054062,52,38,7,24,121
762055546,38,3,2,1,44
762057540,69,40,25,2,136
762065397,38,27,11,9,85
762081267,61,19,2,1,83
762107277,30,3,2,1,36
762127995,32,4,2,1,39
762150691,55,32,2,4,93
762151742,11,39,2,1,53
762156880,125,31,2,2,160
762170493,112,30,2,1,145
762212365,139,42,2,53,236
762220703,89,21,2,1,113
762222909,67,3,2,3,75
762232279,65,3,2,4,74
762249773,11,3,2,8,24
762262251,83,3,12,5,103
762289222,10,11,2,1,24
762291344,78,21,2,1,102
762291500,22,26,4,8,60
762304873,13,6,96,1,116
762314837,168,40,47,13,268
762318081,32,32,13,20,97
762325952,10,8,2,1,21
762334413,32,3,2,1,38
762339003,65,28,15,4,112
762340690,91,5,7,37,140
762346775,34,21,2,1,58
762353769,47,26,42,3,118
762359759,48,28,3,5,84
762366680,185,19,20,5,229
762373411,11,3,2,1,17
762376806,22,27,2,1,52
762391081,35,31,14,13,93
762403395,76,34,277,8,395
762410989,64,3,2,1,70
762424111,39,5,9,17,70
762425392,59,36,14,4,113
762440192,14,3,2,1,20
762446212,54,11,17,7,89
762448985,66,22,2,1,91
762471245,107,51,2,3,163
762484717,48,3,2,1,54
762494793,31,3,2,7,43
762500822,117,3,2,3,125
762508167,16,22,2,1,41
762514312,42,39,2,1,84
762516331,49,13,12,1,75
762517823,56,33,40,1,130
762521592,80,3,2,2,87
762528513,36,9,2,2,49
762528841,25,3,2,1,31
762538660,66,18,24,1,109
762560268,205,3,2,1,211
762589587,85,14,3,5,107
762596430,19,3,2,1,25
762601380,16,9,13,1,39
762603340,13,3,2,1,19
762607353,122,55,16,116,309
762623372,82,12,53,13,160
762628419,22,3,2,1,28
762635830,11,3,2,1,17
762647429,46,53,11,5,115
762657375,22,20,2,1,45
762661538,109,19,90,6,224
762666761,32,3,2,1,38
762669037,17,3,2,5,27
762678154,11,3,2,1,17
762685995,35,4,2,4,45
762718415,24,3,2,1,30
762753887,34,28,7,21,90
762765314,11,3,2,2,18
762774947,91,32,2,1,126
762779427,96,14,5,2,117
762802095,81,3,2,7,93
762819082,109,19,82,4,214
762822547,203,51,27,30,311
762840282,69,23,33,1,126
762846493,89,26,12,11,138
762849999,49,15,2,3,69
762864613,72,3,2,3,80
762866597,71,3,2,2,78
762868984,47,58,3,6,114
762870291,37,29,23,5,94
762871058,171,3,2,5,181
762875098,50,22,23,3,98
762876996,22,3,2,1,28
762878352,20,5,2,1,28
762887474,16,14,2,1,33
762889249,37,8,30,1,76
762907524,65,3,2,9,79
762919227,68,4,2,1,75
762921106,400,3,2,43,448
762926698,204,3,2,1,210
762936090,11,25,2,1,39
762946344,15,20,2,1,38
762953796,53,23,2,9,87
762957340,59,53,31,42,185
762962847,45,11,88,1,145
762963918,144,51,8,16,219
762995612,28,25,2,1,56
762999637,20,3,52,1,76
763011847,27,7,3,1,38
763022682,14,3,2,1,20
763024914,19,109,9,9,146
763057636,114,29,2,3,148
763070195,28,48,2,2,80
763079988,19,41,2,1,63
763091797,32,61,6,14,113
763095496,158,27,3,1,189
763096647,197,31,6,6,240
763100539,76,15,2,1,94
763102071,178,3,2,2,185
763109554,32,34,43,49,158
763111558,85,113,2,10,210
763118642,51,12,2,1,66
763119005,82,23,3,1,109
763152716,52,3,2,2,59
763156705,68,56,2,2,128
763167662,15,3,2,4,24
763170250,76,20,3,38,137
763182235,13,13,2,1,29
763186587,108,26,52,1,187
763191825,118,50,5,31,204
763206364,32,3,2,12,49
763231235,10,5,2,1,18
763239176,99,27,11,6,143
763248652,49,30,7,1,87
763277618,121,5,2,1,129
763281326,18,16,9,1,44
763303319,92,37,7,20,156
763305647,49,13,9,14,85
763316119,37,13,5,1,56
763317539,63,21,2,2,88
763327134,13,3,2,1,19
763336399,191,6,5,6,208
763340398,151,31,35,1,218
763368337,37,28,2,4,71
763369967,129,33,36,48,246
763403620,21,3,2,1,27
763415747,136,3,2,2,143
763418115,42,17,5,1,65
763420724,16,3,2,1,22
763420851,18,9,11,2,40
763422908,147,3,56,1,207
763438914,124,24,32,3,183
763440835,86,3,25,1,115
763441483,36,16,2,1,55
763477687,17,14,2,2,35
763483636,63,13,44,33,153
763485250,29,16,2,1,48
763499795,26,3,2,1,32
763503482,149,18,3,35,205
763507770,72,35,2,31,140
763520718,23,3,2,4,32
763527253,29,55,36,1,121
763540168,62,15,18,2,97
763547510,154,27,10,13,204
763557375,160,3,2,11,176
763559169,180,62,14,17,273
763559465,57,42,9,8,116
763559706,64,36,13,4,117
763559811,73,3,2,3,81
763568527,75,12,15,1,103
763569604,57,3,57,1,118
763576721,79,3,2,2,86
763581016,158,112,43,1,314
763581385,10,9,2,1,22
763595993,12,30,2,1,45
763597912,39,66,58,1,164
763598403,121,20,2,1,144
763608537,14,51,2,1,68
763613520,237,56,44,13,350
763614160,17,3,2,1,23
763618220,22,11,3,8,44
763623160,44,37,3,9,93
763630580,51,3,2,7,63
763642145,120,10,19,7,156
763646842,174,26,12,2,214
763653489,27,3,2,1,33
763675666,111,16,3,4,134
763699861,90,27,85,17,219
763729280,132,3,2,2,139
763739117,18,143,3,4,168
763747496,13,10,2,1,26
763754598,26,3,2,3,34
763769046,63,4,2,1,70
763793424,28,3,2,1,34
763803928,69,32,35,19,155
763836429,37,30,29,3,99
763844916,52,49,6,23,130
763844938,99,49,4,3,155
763860186,357,8,2,5,372
763870181,64,7,16,1,88
763883870,137,32,6,18,193
763901850,19,38,13,22,92
763906890,62,33,2,3,100
763912575,64,3,2,1,70
763949726,44,49,2,75,170
763958065,109,57,2,4,172
763961500,114,3,2,1,120
763964501,51,8,2,4,65
763992990,86,31,23,57,197
763994886,178,60,30,42,310
763998408,131,5,86,2,224
764017430,27,3,2,1,33
764025594,23,10,2,3,38
764034527,24,52,2,3,81
764038361,59,10,2,2,73
764043028,70,8,25,3,106
764050899,14,38,2,1,55
764053560,32,16,26,1,75
764055148,62,52,20,2,136
764057105,53,3,2,1,59
764070050,51,5,8,11,75
764073072,40,34,3,1,78
764078804,66,47,20,26,159
764096978,207,60,37,120,424
764117056,37,16,3,1,57
764145505,13,44,2,3,62
764146686,125,89,65,8,287
764149697,14,6,2,3,25
764170264,14,23,2,5,44
764170750,12,3,2,1,18
764176852,122,3,2,1,128
764186663,64,27,66,86,243
764191451,18,3,2,1,24
764193820,70,19,10,16,115
764205721,72,90,2,1,165
764216777,91,11,4,3,109
764220824,10,3,2,2,17
764223571,11,3,2,2,18
764255217,14,14,2,1,31
764263546,11,8,2,1,22
764263720,133,108,22,46,309
764292496,105,75,2,13,195
764327140,80,38,20,1,139
764327468,68,3,2,12,85
764335056,58,3,2,1,64
764346411,52,10,2,18,82
764350380,40,64,13,15,132
764351329,16,3,2,1,22
764355410,206,10,31,77,324
764361388,50,32,11,2,95
764379232,40,53,2,42,137
764379508,131,33,32,30,226
764384390,130,66,18,13,227
764389872,113,3,2,1,119
764393554,57,3,2,1,63
764404651,11,3,2,1,17
764406696,120,3,2,2,127
764410977,14,21,2,1,38
764430473,60,5,4,6,75
764439119,147,6,2,3,158
764440866,96,3,2,1,102
764443995,11,18,2,1,32
764449926,49,26,2,6,83
764452455,254,17,2,1,274
764457083,98,3,2,17,120
764463768,26,26,2,1,55
764468601,144,10,2,1,157
764481253,16,3,2,1,22
764481700,10,6,2,4,22
764485069,57,10,9,1,77
764491352,48,33,42,5,128
764491578,30,15,24,1,70
764506093,155,28,2,37,222
764522960,97,29,14,18,158
764523912,27,33,13,2,75
764534390,24,14,2,1,41
764541015,31,3,2,1,37
764541973,12,3,2,1,18
764549767,178,43,13,2,236
764566809,67,25,2,3,97
764577195,42,3,2,2,49
764583951,68,3,58,2,131
764588338,44,3,2,1,50
764595166,14,3,2,1,20
764602677,34,54,18,21,127
764613296,39,3,2,1,45
764616852,39,6,12,5,62
764621344,12,3,2,1,18
764627306,11,3,2,1,17
764627924,30,17,16,6,69
764629700,42,59,23,16,140
764638838,17,36,16,1,70
764649975,20,29,2,13,64
764656470,196,13,3,9,221
764661714,23,26,6,1,56
764667798,12,3,2,4,21
764678202,38,38,21,4,101
764680273,42,49,37,7,135
764681551,53,3,2,1,59
764696510,10,3,2,2,17
764696960,12,3,2,1,18
764710125,67,36,17,14,134
764711735,36,13,10,2,61
764713529,130,64,3,3,200
764722448,72,10,22,3,107
764732265,58,31,7,7,103
764764666,49,32,24,45,150
764767336,105,19,4,2,130
764767346,41,19,2,1,63
764775913,23,6,2,1,32
764797292,15,3,2,1,21
764801853,106,3,2,1,112
764818832,16,3,2,1,22
764828293,103,3,2,2,110
764839001,62,21,6,7,96
764841279,110,7,2,38,157
764841347,43,6,33,1,83
764853983,32,24,8,1,65
764858796,13,12,9,1,35
764859729,30,3,2,1,36
764862664,12,8,2,1,23
764866836,102,19,54,2,177
764886245,16,35,2,1,54
764894012,155,28,14,5,202
764901917,10,29,2,1,42
764902615,57,3,2,11,73
764904241,10,6,2,1,19
764904871,39,36,2,1,78
764907351,17,11,2,1,31
764908678,17,9,2,1,29
764915962,170,3,2,9,184
764918173,15,56,2,1,74
764919930,70,3,2,2,77
764927198,11,3,2,1,17
764936130,27,3,2,13,45
764945803,45,11,8,1,65
764949505,26,53,44,6,129
764975387,33,3,2,1,39
764979151,132,26,12,1,171
764990882,89,15,19,3,126
764995177,13,7,2,1,23
765016851,40,50,10,27,127
765035692,14,9,2,1,26
765040703,36,6,5,6,53
765043246,13,3,2,1,19
765043608,31,5,2,1,39
765046837,13,3,2,1,19
765083121,77,3,2,17,99
765091906,102,9,87,4,202
765100361,49,12,5,15,81
765106559,21,37,2,1,61
765111842,10,4,2,1,17
765132599,126,21,17,1,165
765140572,53,18,2,23,96
765168642,12,3,2,1,18
765170679,54,3,2,1,60
765172655,198,4,2,2,206
765175721,19,45,8,3,75
765192022,33,6,4,3,46
765206420,97,3,2,18,120
765224307,102,3,2,1,108
765231763,104,27,63,16,210
765236549,28,15,2,1,46
765236780,627,78,2,7,714
765239501,98,3,2,24,127
765250781,90,44,30,5,169
765263715,121,3,8,4,136
765274074,21,11,5,18,55
765279106,47,15,2,1,65
765294411,108,11,20,26,165
765299149,125,3,2,9,139
765299806,59,28,12,14,113
765305744,10,4,2,1,17
765313497,63,4,4,1,72
765315232,22,5,2,1,30
765318012,65,29,25,5,124
765347010,46,9,41,1,97
765357323,62,3,2,2,69
765358846,48,17,2,2,69
765374277,88,3,2,13,106
765379290,12,3,2,1,18
765381857,24,52,72,6,154
765383033,23,42,2,1,68
765387379,99,10,2,3,114
765388619,29,45,2,3,79
765396709,102,36,31,1,170
765408879,59,11,2,14,86
765414667,109,38,4,8,159
765419642,52,7,2,1,62
765434490,104,3,2,5,114
765440409,44,71,37,7,159
765443420,121,39,2,2,164
765447781,73,12,39,1,125
765452865,27,30,2,2,61
765453019,102,38,14,53,207
765457054,37,3,2,1,43
765470040,82,38,30,1,151
765476165,90,8,7,9,114
765476436,146,34,144,62,386
765477203,50,139,12,4,205
765480715,21,9,2,1,33
765484474,122,28,15,7,172
765489746,65,26,23,20,134
765496815,56,21,3,9,89
765502452,21,12,2,2,37
765522185,72,75,40,1,188
765530298,73,3,2,1,79
765541780,158,18,17,15,208
765544299,14,3,2,1,20
765554387,36,5,2,7,50
765560289,106,3,5,33,147
765560868,114,3,2,8,127
765562953,68,34,10,1,113
765571999,50,31,2,12,95
765585170,54,18,37,3,112
765593835,137,3,2,2,144
765621401,26,30,2,7,65
765631682,55,32,2,10,99
765655872,13,3,2,1,19
765675394,29,3,2,1,35
765679291,56,3,2,6,67
765681711,10,7,2,1,20
765684354,22,6,2,1,31
765686372,18,50,2,11,81
765705219,415,3,2,3,423
765706135,190,13,2,10,215
765714394,28,21,9,1,59
765723303,75,3,2,2,82
765726431,84,38,32,2,156
765749098,27,3,2,1,33
765790044,54,17,2,1,74
765797611,62,5,2,3,72
765809420,12,3,2,1,18
765811190,47,125,16,7,195
765811295,82,6,9,4,101
765821055,74,18,2,4,98
765829176,35,46,10,5,96
765837683,148,5,2,18,173
765841536,113,56,2,3,174
765844089,109,9,2,42,162
765853454,12,3,2,2,19
765869383,56,45,8,9,118
765870307,18,52,2,3,75
765883600,15,3,2,2,22
765890050,18,3,2,1,24
765898476,110,27,2,3,142
765908799,11,3,2,1,17
765927663,60,16,162,13,251
765930319,56,25,58,5,144
765930429,142,22,45,6,215
765934801,73,18,22,9,122
765958269,64,51,24,5,144
765976913,47,3,2,6,58
765994432,35,3,2,9,49
765997016,29,3,2,1,35
765999985,59,3,11,1,74
766008905,100,13,37,1,151
766019625,16,7,14,9,46
766029878,107,3,2,1,113
766041478,40,9,2,1,52
766051374,16,10,2,6,34
766053361,131,37,79,1,248
766059924,69,3,26,15,113
766065086,41,11,2,4,58
766066654,72,53,11,19,155
766073297,23,9,2,1,35
766077491,11,3,2,1,17
766079048,117,20,2,14,153
766100651,11,3,2,1,17
766115345,146,26,73,16,261
766126036,15,3,2,1,21
766135036,51,3,2,4,60
766146680,41,3,2,1,47
766157997,27,8,2,1,38
766163946,32,17,2,7,58
766190759,15,3,2,10,30
766200997,94,41,2,1,138
766205009,23,3,2,5,33
766218578,20,3,2,1,26
766246937,175,3,2,1,181
766254121,345,3,2,3,353
766261036,11,7,2,1,21
766268628,87,3,2,1,93
766270014,10,80,5,1,96
766291668,21,3,2,1,27
766334784,78,50,2,2,132
766359667,24,36,10,3,73
766364401,76,3,2,3,84
766365393,63,18,9,17,107
766368439,181,19,2,13,215
766375742,51,3,2,18,74
766386924,27,9,12,4,52
766402023,29,71,43,1,144
766411670,73,15,17,1,106
766412330,31,3,2,2,38
766420184,65,8,12,13,98
766440763,11,8,5,4,28
766442498,62,43,14,6,125
766449083,63,73,10,4,150
766452366,82,14,3,4,103
766457065,144,72,35,15,266
766464250,81,20,99,3,203
766466328,77,5,2,1,85
766467164,13,3,2,1,19
766467210,10,7,2,1,20
766477365,40,31,20,4,95
766501905,59,22,2,15,98
766508663,87,30,48,19,184
766511287,76,6,4,1,87
766515481,154,3,2,2,161
766552107,27,33,9,10,79
766565041,101,41,3,8,153
766565841,87,30,3,1,121
766572930,73,14,16,9,112
766593870,181,14,4,20,219
766610541,40,6,2,6,54
766611171,17,3,2,1,23
766613815,47,30,30,5,112
766621536,136,40,2,3,181
766626611,42,56,91,3,192
766628534,24,13,2,20,59
766635858,36,24,22,7,89
766662541,10,3,2,5,20
766669051,32,68,22,7,129
766672734,64,3,2,1,70
766694185,33,3,2,1,39
766695696,115,29,2,3,149
766715461,27,14,2,1,44
766722454,17,20,6,1,44
766728124,137,38,3,10,188
766733694,26,16,4,16,62
766735912,81,27,9,7,124
766740640,33,33,53,9,128
766743848,27,3,2,1,33
766765742,65,35,105,3,208
766784450,54,18,8,4,84
766789535,86,65,8,40,199
766794099,115,26,27,15,183
766800437,32,3,2,3,40
766800745,18,3,2,2,25
766820846,12,6,2,1,21
766827596,134,3,2,2,141
766853818,92,16,10,3,121
766857687,38,13,26,2,79
766871867,86,21,67,47,221
766889311,37,3,2,1,43
766898230,11,5,2,1,19
766899428,112,13,2,8,135
766907376,31,3,2,7,43
766912717,108,3,2,2,115
766912898,59,12,14,2,87
766927740,54,3,2,4,63
766935911,46,76,69,2,193
766947158,81,3,2,3,89
766949512,16,3,2,1,22
766952552,65,40,2,5,112
766956980,44,44,16,1,105
766983218,89,3,2,1,95
767001921,51,3,2,12,68
767015522,16,3,2,1,22
767028385,62,13,2,3,80
767034597,12,3,2,1,18
767041698,34,9,5,1,49
767051943,38,16,30,14,98
767052809,111,31,75,23,240
767058980,64,3,2,7,76
767068971,12,3,2,1,18
767071145,43,3,2,3,51
767085974,10,3,2,3,18
767094696,24,3,2,1,30
767095965,35,51,10,1,97
767095966,94,59,22,6,181
767114791,46,3,20,5,74
767141110,11,3,2,3,19
767152501,224,4,8,2,238
767159365,13,16,2,1,32
767167582,190,55,3,9,257
767169037,10,4,2,1,17
767173380,17,14,2,1,34
767180918,57,17,2,1,77
767192043,34,3,2,1,40
767201424,60,27,2,6,95
767201943,52,40,14,22,128
767213956,53,67,39,16,175
767220079,14,21,2,1,38
767220237,112,12,2,1,127
767220328,66,21,64,21,172
767225250,12,3,2,1,18
767229410,102,8,5,10,125
767239485,11,3,2,1,17
767243327,11,3,2,1,17
767248843,49,7,6,5,67
767254027,21,45,2,1,69
767255691,24,3,2,1,30
767259361,78,3,2,1,84
767274069,188,3,2,2,195
767279480,14,13,2,1,30
767292084,83,3,2,3,91
767308684,107,15,2,1,125
767311683,24,3,2,1,30
767312370,546,3,2,10,561
767316118,93,3,2,1,99
767322013,210,3,2,1,216
767329620,86,37,39,24,186
767334517,20,3,3,3,29
767337736,44,33,10,7,94
767338878,47,25,24,4,100
767346674,17,3,2,3,25
767349431,420,3,2,17,442
767361456,28,13,5,7,53
767361923,23,48,2,12,85
767363646,49,27,30,2,108
767368041,74,3,2,4,83
767371751,35,19,2,1,57
767418831,64,7,2,3,76
767423808,10,4,2,1,17
767430074,190,59,35,18,302
767435529,15,3,2,1,21
767459689,120,15,2,34,171
767461040,119,16,2,4,141
767474091,43,8,2,1,54
767478561,36,78,15,24,153
767493178,51,39,36,11,137
767495931,72,3,2,1,78
767511921,62,28,19,18,127
767514427,151,16,40,1,208
767514511,16,15,2,1,34
767530122,46,22,99,4,171
767539739,20,3,2,1,26
767567241,44,21,2,7,74
767581654,36,3,2,2,43
767591386,38,31,4,1,74
767603896,110,15,12,9,146
767607542,14,3,2,1,20
767630482,54,38,2,1,95
767631696,163,13,32,21,229
767632557,125,40,22,11,198
767635687,65,3,2,4,74
767650965,78,39,76,3,196
767667414,26,25,2,1,54
767673734,32,3,2,2,39
767674171,12,34,3,6,55
767676595,87,3,2,1,93
767684005,82,28,3,2,115
767692376,69,61,2,10,142
767701402,20,3,2,12,37
767741239,350,49,12,9,420
767742582,11,7,2,1,21
767747332,143,3,2,2,150
767769906,19,6,2,5,32
767789140,11,4,2,1,18
767795804,107,27,18,5,157
767796827,34,14,2,2,52
767803185,38,3,2,1,44
767816536,43,3,30,4,80
767820439,41,18,72,8,139
767853275,140,33,3,33,209
767867694,12,3,2,1,18
767878680,24,39,2,4,69
767888645,64,43,38,26,171
767891011,45,13,16,1,75
767893037,214,3,2,43,262
767904602,50,3,2,1,56
767913848,44,51,54,10,159
767915925,37,18,3,1,59
767920400,19,11,2,1,33
767950515,233,19,8,9,269
767967238,20,16,11,2,49
767973048,47,3,2,5,57
767976996,38,36,2,1,77
767983940,114,39,7,4,164
767999903,154,3,2,6,165
768003483,12,3,2,1,18
768006049,101,27,2,1,131
768008905,42,3,2,3,50
768015039,15,3,2,1,21
768020308,23,3,2,1,29
768045656,48,58,8,18,132
768049532,162,19,2,1,184
768055567,131,45,2,18,196
768058311,57,15,2,1,75
768062549,49,45,60,5,159
768079098,49,48,4,14,115
768087596,77,31,5,5,118
768095064,174,25,83,9,291
768102280,403,3,2,1,409
768105348,60,3,2,1,66
768113540,42,38,5,1,86
768124484,31,35,2,4,72
768133317,15,3,2,1,21
768165832,11,3,2,5,21
768171682,202,43,2,2,249
768198461,205,36,5,1,247
768210482,15,22,2,9,48
768214141,18,7,2,4,31
768231067,56,3,2,1,62
768240035,130,52,3,4,189
768242814,40,7,25,1,73
768255676,116,29,13,6,164
768256621,96,3,2,31,132
768264247,55,35,26,6,122
768270164,20,3,2,1,26
768277502,111,38,53,3,205
768282198,32,21,11,5,69
768282801,25,18,2,1,46
768305124,66,11,2,1,80
768327603,26,32,171,1,230
768334165,19,3,2,1,25
768353982,97,59,136,6,298
768364888,36,12,2,8,58
768372694,97,99,15,2,213
768394399,56,3,2,1,62
768401364,32,3,2,1,38
768404118,17,39,2,6,64
768411118,45,34,2,5,86
768415039,67,3,2,2,74
768417727,68,14,6,42,130
768427300,103,8,2,5,118
768440667,109,3,2,16,130
768454485,25,39,4,1,69
768455088,104,22,37,1,164
768455715,62,51,3,3,119
768468398,18,3,2,1,24
768472894,97,19,2,23,141
768473770,111,15,118,7,251
768475715,16,3,2,1,22
768495700,157,32,42,1,232
768497851,41,4,2,2,49
768504687,48,16,2,29,95
768505085,10,7,4,3,24
768514882,43,5,2,15,65
768528239,43,3,2,1,49
768529242,39,17,4,1,61
768534720,101,8,6,8,123
768554400,21,3,2,32,58
768556260,122,24,81,16,243
768556849,49,42,24,6,121
768569908,83,23,10,3,119
768583016,12,5,2,1,20
768593091,10,38,2,5,55
768593266,69,5,31,2,107
768598162,53,35,7,71,166
768605017,54,13,2,3,72
768613654,12,3,2,1,18
768638221,17,23,2,1,43
768645740,24,3,2,1,30
768651876,24,30,27,1,82
768664407,21,40,2,3,66
768703399,86,12,2,16,116
768705811,98,52,49,4,203
768710224,83,13,4,1,101
768740946,57,3,2,1,63
768749107,166,50,4,3,223
768754120,10,15,2,1,28
768765723,55,7,21,40,123
768767771,62,38,43,3,146
768770707,52,13,56,18,139
768785202,134,26,29,1,190
768802222,10,3,2,2,17
768804282,165,3,18,23,209
768815684,72,24,16,9,121
768820566,44,13,23,2,82
768824131,98,7,6,1,112
768851076,16,3,2,5,26
768855831,11,3,2,1,17
768873042,43,3,2,1,49
768875801,11,5,2,1,19
768875873,22,49,2,1,74
768881637,72,16,57,1,146
768889266,35,34,2,1,72
768891311,70,21,4,10,105
768897580,16,53,2,1,72
768907974,121,24,3,14,162
768911576,31,42,2,1,76
768918936,13,9,2,1,25
768935116,97,33,44,5,179
768940555,53,3,2,1,59
768942230,63,17,2,1,83
768944139,112,104,20,9,245
768950845,13,3,2,1,19
768964138,61,17,18,25,121
768975418,10,3,2,7,22
768977184,91,33,2,3,129
769005652,66,15,122,1,204
769014356,69,3,2,1,75
769017661,26,20,6,2,54
769029551,47,41,7,1,96
769039643,58,14,30,2,104
769054423,81,53,79,2,215
769057714,74,3,2,2,81
769059380,28,53,19,5,105
769063377,85,3,2,1,91
769068340,55,13,2,2,72
769072556,10,11,2,1,24
769080907,35,26,2,2,65
769081350,57,9,50,4,120
769083951,13,8,2,1,24
769085150,52,85,2,8,147
769093220,75,20,3,1,99
769099611,69,36,63,3,171
769105975,141,3,2,1,147
769117540,11,3,2,3,19
769122409,89,32,2,1,124
769139374,37,42,2,1,82
769171954,79,31,34,1,145
769178945,65,10,2,15,92
769185464,179,3,2,22,206
769193164,26,3,2,2,33
769198207,73,3,2,2,80
769209809,71,4,30,10,115
769223140,24,12,3,1,40
769227865,92,11,4,18,125
769236924,42,20,13,13,88
769242602,28,3,2,1,34
769265418,157,3,10,24,194
769268042,73,25,2,4,104
769268130,10,3,2,5,20
769278089,115,3,2,5,125
769293354,28,3,2,2,35
769301618,51,3,2,1,57
769303243,33,3,2,1,39
769310290,45,31,14,10,100
769334956,18,22,2,1,43
769336824,42,32,2,2,78
769349310,203,31,2,1,237
769350925,114,71,21,31,237
769352575,14,4,2,1,21
769364933,13,3,2,1,19
769373098,10,3,2,2,17
769384694,91,106,37,66,300
769391113,14,19,2,1,36
769391443,47,7,3,87,144
769392946,58,21,17,8,104
769412452,83,9,70,10,172
769417207,20,24,2,2,48
769427991,166,35,50,23,274
769429580,88,46,34,3,171
769435902,37,3,2,1,43
769436801,14,3,2,4,23
769447216,136,62,8,8,214
769448248,97,5,36,1,139
769454278,11,3,2,1,17
769457422,89,27,2,1,119
769459450,84,25,40,8,157
769479593,135,6,6,7,154
769486021,62,13,2,6,83
769497956,13,3,2,1,19
769502494,89,89,2,3,183
769503827,142,9,50,1,202
769504103,147,7,176,8,338
769513252,222,9,2,5,238
769515072,32,54,197,3,286
769519439,85,29,4,9,127
769521796,76,3,2,21,102
769523714,10,14,2,1,27
769540098,218,71,27,8,324
769551522,11,3,2,1,17
769589968,55,106,45,12,218
769590972,92,3,2,1,98
769603716,56,4,2,1,63
769615249,60,3,2,2,67
769624254,74,3,2,1,80
769655230,41,15,36,1,93
769656812,72,4,2,1,79
769659089,227,88,2,3,320
769662397,59,3,2,1,65
769670077,77,40,31,3,151
769676634,11,3,2,1,17
769680790,42,3,2,1,48
769697313,13,7,2,1,23
769712253,125,45,44,5,219
769712254,44,19,49,2,114
769733240,11,3,2,1,17
769754676,16,3,2,4,25
769787660,50,3,2,1,56
769791464,23,34,9,1,67
769805116,148,13,65,3,229
769813311,63,3,2,2,70
769819911,124,46,3,10,183
769821619,67,48,23,2,140
769840846,16,11,2,5,34
769845949,27,5,2,2,36
769852843,96,30,11,8,145
769855067,34,47,35,7,123
769864102,11,4,3,2,20
769869349,25,12,10,1,48
769876097,63,55,4,3,125
769882073,29,9,4,6,48
769902326,22,13,13,1,49
769937904,71,58,17,3,149
769954031,25,61,4,6,96
769960946,106,3,12,5,126
769973492,24,3,2,2,31
769977360,18,3,2,4,27
769977811,91,3,2,1,97
769999869,101,65,128,3,297
770006973,51,25,8,2,86
770019366,14,3,2,1,20
770052383,104,48,2,1,155
770054843,31,3,2,1,37
770072916,99,15,19,6,139
770086680,11,3,2,1,17
770095361,315,6,3,4,328
770095455,137,38,19,2,196
770100084,13,6,2,1,22
770136473,47,6,8,6,67
770143704,21,3,2,1,27
770156674,60,10,2,3,75
770171337,10,3,2,2,17
770172167,20,11,2,1,34
770188280,171,11,34,12,228
770189941,10,5,2,1,18
770193707,145,3,2,1,151
770194599,58,25,28,8,119
770208761,109,76,11,2,198
770221170,92,3,2,11,108
770234947,41,8,3,1,53
770250315,117,31,15,10,173
770255112,62,18,4,1,85
770258353,91,17,8,10,126
770285901,119,8,39,14,180
770294805,16,3,2,2,23
770298671,43,22,10,1,76
770311981,66,45,8,11,130
770318299,111,27,14,7,159
770324002,116,3,2,3,124
770327388,182,33,39,37,291
770338508,29,3,2,8,42
770350740,81,61,44,3,189
770371155,87,33,2,21,143
770388598,10,8,2,1,21
770390663,16,4,2,1,23
770393483,109,3,2,1,115
770394057,40,29,32,50,151
770401203,13,4,2,1,20
770405527,132,46,50,48,276
770406595,13,5,2,1,21
770415143,19,22,2,7,50
770417473,28,3,2,1,34
770418128,50,97,37,1,185
770426700,23,10,2,1,36
770434145,10,12,2,1,25
770451868,57,21,25,4,107
770464032,89,12,2,1,104
770482123,19,14,13,12,58
770484036,111,36,57,1,205
770484710,15,10,2,2,29
770485742,142,19,2,1,164
770488651,52,18,5,2,77
770499761,13,3,2,1,19
770511481,35,14,2,11,62
770517676,11,3,2,1,17
770518489,88,3,2,4,97
770526655,17,3,2,1,23
770530618,90,35,2,3,130
770531197,275,14,2,5,296
770537309,10,4,2,1,17
770542750,54,5,9,3,71
770549594,25,7,2,2,36
770618897,85,17,6,3,111
770621857,53,42,2,1,98
770632010,55,23,39,6,123
770647075,122,3,2,2,129
770679628,22,8,2,1,33
770684620,49,33,2,17,101
770703154,74,21,9,9,113
770710688,78,3,2,1,84
770740279,23,26,2,1,52
770749700,77,3,2,1,83
770758350,100,17,48,11,176
770765499,32,15,3,1,51
770771203,27,38,5,4,74
770775459,127,40,41,8,216
770787713,23,33,78,31,165
770790510,74,15,30,1,120
770800469,22,58,12,16,108
770813096,121,20,85,16,242
770813386,68,11,2,4,85
770816331,104,28,2,4,138
770820542,147,43,45,14,249
770826021,13,22,2,1,38
770827195,39,3,2,1,45
770836058,12,34,2,1,49
770841599,46,3,2,1,52
770842866,99,3,2,2,106
770846876,12,21,2,2,37
770849394,96,13,14,1,124
770870518,60,23,5,6,94
770877730,111,3,2,2,118
770884547,46,57,48,15,166
770885423,29,10,2,1,42
770886809,25,21,6,2,54
770888110,146,15,46,18,225
770895668,20,3,2,1,26
770898559,33,3,2,1,39
770921288,225,48,27,63,363
770932739,16,3,2,8,29
770933807,59,4,2,2,67
770944694,56,3,2,1,62
770948469,195,38,2,9,244
770957505,59,31,51,1,142
770961421,60,24,33,9,126
770984744,26,3,2,1,32
770992567,167,3,2,1,173
770995011,67,27,12,84,190
771000876,136,3,2,5,146
771003487,74,24,5,5,108
771017838,27,60,5,7,99
771028308,118,21,2,2,143
771038955,19,3,2,1,25
771048732,13,27,7,1,48
771061871,119,29,73,52,273
771078364,112,18,8,1,139
771082516,91,56,25,15,187
771118499,107,39,2,1,149
771133908,54,27,14,1,96
771135925,33,10,5,8,56
771148714,18,3,2,1,24
771155913,19,3,2,1,25
771162661,96,37,50,1,184
771163953,46,30,12,2,90
771165153,59,7,72,1,139
771168098,29,8,2,6,45
771176185,72,27,8,53,160
771195935,89,5,2,1,97
771204328,103,23,60,8,194
771208294,93,3,2,1,99
771221702,57,15,2,1,75
771226544,67,19,24,6,116
771235361,37,15,12,1,65
771241098,10,3,2,2,17
771246835,62,3,2,1,68
771262718,11,3,2,1,17
771263164,87,30,2,12,131
771266553,53,15,24,2,94
771282368,56,8,6,6,76
771289956,102,52,2,4,160
771322669,68,3,2,4,77
771327167,200,3,2,1,206
771339023,64,9,4,5,82
771347719,27,3,2,2,34
771354729,30,5,2,1,38
771358129,122,80,52,15,269
771362665,49,14,27,2,92
771363834,70,13,5,6,94
771364378,25,3,2,1,31
771367744,357,3,2,5,367
771374435,31,3,2,9,45
771375727,89,11,2,11,113
771376541,13,13,3,1,30
771378483,27,23,25,35,110
771381085,112,9,2,2,125
771382011,134,39,42,60,275
771393254,64,26,3,14,107
771400398,48,3,2,2,55
771402426,87,32,17,3,139
771408938,91,23,47,3,164
771427583,59,138,13,11,221
771438521,169,3,2,1,175
771465835,46,3,2,3,54
771467863,98,22,76,4,200
771495152,183,3,2,1,189
771495581,68,7,5,1,81
771503705,33,5,2,4,44
771518830,15,3,2,1,21
771536390,15,3,2,4,24
771551011,79,33,44,1,157
771552687,107,7,155,1,270
771553515,60,28,2,1,91
771556201,80,69,10,5,164
771587093,14,4,2,1,21
771594225,72,10,32,1,115
771631639,95,13,4,7,119
771634561,29,10,2,2,43
771635566,41,3,3,1,48
771647495,31,36,3,1,71
771684782,94,62,23,66,245
771696628,14,3,2,1,20
771698048,85,39,29,3,156
771700795,203,5,2,1,211
771708280,241,3,2,16,262
771710148,11,3,2,2,18
771713927,86,3,2,1,92
771717618,30,19,7,3,59
771723742,11,3,2,2,18
771733302,25,34,2,1,62
771733337,155,32,70,7,264
771748818,10,53,11,3,77
771774163,76,4,2,1,83
771778420,154,103,99,54,410
771781533,18,3,2,1,24
771785872,65,32,18,20,135
771788466,98,8,2,6,114
771791858,120,35,24,1,180
771798164,67,3,2,1,73
771799951,10,12,35,1,58
771804128,16,8,2,1,27
771835210,161,7,2,21,191
771856348,37,37,52,1,127
771864071,55,27,15,2,99
771878396,73,3,2,5,83
771885424,17,43,2,1,63
771904992,34,41,3,1,79
771910557,40,45,33,10,128
771916420,71,21,2,1,95
771929685,118,3,2,31,154
771939147,105,27,16,1,149
771940512,11,3,2,1,17
771942427,34,22,34,5,95
771945106,95,7,3,3,108
771991822,80,33,4,3,120
771999888,59,3,2,1,65
772016601,12,3,2,1,18
772025617,125,12,98,33,268
772029944,49,31,128,7,215
772030287,86,3,2,12,103
772046475,68,18,3,1,90
772047692,36,9,2,1,48
772077644,45,29,11,1,86
772081924,57,20,2,1,80
772082074,100,22,2,32,156
772083772,31,22,57,65,175
772106622,41,19,8,1,69
772115660,16,3,2,7,28
772124586,22,24,2,1,49
772143183,171,40,33,15,259
772145925,161,43,2,1,207
772148135,100,5,2,13,120
772179989,39,44,11,18,112
772188871,11,4,2,1,18
772190538,159,3,2,4,168
772192593,14,3,2,2,21
772201076,105,3,2,3,113
772205411,228,63,41,10,342
772208706,33,3,2,2,40
772212415,28,37,2,1,68
772213614,119,36,2,1,158
772216279,150,7,2,1,160
772225898,20,9,4,11,44
772253199,65,10,2,1,78
772253974,28,18,2,1,49
772254517,25,76,2,1,104
772267312,15,5,2,2,24
772271200,59,6,3,1,69
772279758,105,30,12,7,154
772282611,141,25,6,13,185
772284541,28,15,3,11,57
772285769,133,3,2,14,152
772288144,38,3,2,1,44
772291072,139,27,36,3,205
772303634,42,36,5,14,97
772303808,60,21,17,6,104
772320419,76,11,2,2,91
772323618,19,3,2,3,27
772325842,39,5,2,2,48
772330408,38,23,2,3,66
772336630,16,14,11,7,48
772357981,50,9,5,3,67
772362322,64,53,41,1,159
772369896,72,8,61,1,142
772376110,111,33,79,19,242
772381910,24,42,5,3,74
772401361,39,41,10,15,105
772403409,41,10,21,1,73
772404297,89,7,26,28,150
772415038,60,10,117,15,202
772424736,79,59,61,4,203
772427274,34,16,2,1,53
772435541,36,4,5,2,47
772435910,14,3,2,1,20
772440408,108,3,2,1,114
772456109,35,92,10,1,138
772458379,35,11,2,2,50
772462461,18,6,2,1,27
772470191,10,3,2,2,17
772476489,41,10,2,1,54
772477978,125,3,2,35,165
772505394,90,3,2,2,97
772510482,108,3,2,11,124
772511342,60,3,2,2,67
772528274,17,41,19,2,79
772546681,47,19,3,7,76
772591352,12,4,3,1,20
772594204,76,3,2,1,82
772599675,62,3,2,12,79
772610157,34,3,2,4,43
772613007,227,3,2,9,241
772613185,41,34,2,7,84
772614817,39,3,2,3,47
772625224,33,10,2,5,50
772646272,50,18,2,36,106
772658874,56,30,29,14,129
772687415,54,24,2,1,81
772690340,94,8,2,3,107
772697685,36,3,2,1,42
772703353,54,8,2,1,65
772704678,54,4,20,1,79
772705971,13,9,2,3,27
772719914,31,6,2,13,52
772719946,28,50,8,2,88
772723159,68,3,2,3,76
772725479,1112,3,2,105,1222
772729329,11,18,3,1,33
772732149,36,9,2,7,54
772736611,134,18,19,12,183
772753215,57,7,2,7,73
772758220,18,4,2,7,31
772763753,33,13,41,19,106
772768287,88,3,2,1,94
772773103,19,3,2,1,25
772787388,110,44,30,15,199
772793567,106,56,31,112,305
772795056,222,24,33,3,282
772796516,105,10,2,1,118
772799911,16,3,2,1,22
772808771,116,37,31,6,190
772813262,12,3,2,1,18
772815152,108,34,131,8,281
772825564,12,3,2,1,18
772833696,16,5,13,3,37
772837817,63,4,8,5,80
772843247,19,3,2,1,25
772851891,10,9,2,1,22
772859641,55,22,2,2,81
772863295,30,8,18,1,57
772871112,108,80,22,1,211
772871211,58,16,35,17,126
772880203,71,25,56,7,159
772886956,41,14,12,24,91
772890566,16,15,2,3,36
772894092,60,45,22,91,218
772903885,60,3,2,2,67
772907159,84,3,2,1,90
772918525,54,73,28,28,183
772928356,64,41,2,14,121
772936718,113,10,5,20,148
772943216,53,15,2,1,71
772964245,10,4,2,3,19
772986677,162,28,12,7,209
772998794,79,17,2,2,100
773010661,116,32,93,1,242
773013905,12,10,2,1,25
773025072,83,39,2,1,125
773031309,66,24,36,3,129
773039164,20,11,2,1,34
773040028,19,25,2,1,47
773049465,54,59,78,108,299
773055440,14,61,2,1,78
773057699,69,18,83,24,194
773060414,10,3,2,4,19
773082834,17,13,8,5,43
773105333,22,15,7,19,63
773107547,15,3,2,1,21
773111253,38,3,2,1,44
773116221,38,39,7,3,87
773116940,166,3,34,9,212
773119465,64,31,53,5,153
773120292,60,44,87,37,228
773140028,148,19,2,10,179
773146887,15,19,2,1,37
773152131,165,60,6,1,232
773154877,73,3,2,36,114
773163503,37,3,2,1,43
773171106,143,31,3,12,189
773191509,105,23,191,13,332
773204795,23,26,2,2,53
773205257,138,3,2,2,145
773221233,23,3,2,1,29
773239497,38,8,5,28,79
773239737,188,19,3,14,224
773252699,13,5,2,1,21
773261169,19,32,4,1,56
773264789,71,3,2,4,80
773276030,29,58,2,3,92
773278165,116,3,2,1,122
773308935,117,36,14,1,168
773311758,123,39,8,22,192
773320269,21,3,2,1,27
773324078,13,9,2,1,25
773326988,78,3,4,1,86
773333517,41,44,57,6,148
773344961,88,27,25,11,151
773354996,85,48,11,3,147
773357631,72,31,57,68,228
773429891,13,3,2,1,19
773435199,15,4,2,3,24
773450022,36,46,2,19,103
773455137,17,8,2,1,28
773457355,74,26,2,1,103
773463653,180,3,2,9,194
773470053,206,3,2,16,227
773479566,47,15,5,5,72
773488309,11,3,2,1,17
773494386,132,63,23,4,222
773506631,49,25,2,1,77
773541529,16,17,2,1,36
773564853,84,14,2,1,101
773587108,24,17,4,1,46
773599384,65,81,3,5,154
773599696,94,30,6,7,137
773601139,36,19,24,8,87
773604788,14,3,2,1,20
773612924,80,4,24,1,109
773621402,81,19,38,3,141
773625060,16,3,2,1,22
773627367,122,9,21,10,162
773633782,67,8,3,5,83
773643938,37,14,2,1,54
773647479,57,6,20,2,85
773655266,12,3,2,1,18
773668241,50,16,3,1,70
773675142,132,14,37,86,269
773678698,91,4,2,7,104
773694423,13,6,2,1,22
773698124,37,10,2,13,62
773703562,42,12,3,13,70
773721328,88,3,2,3,96
773722711,97,66,8,44,215
773724117,105,25,2,4,136
773727904,116,3,2,4,125
773744840,12,3,2,1,18
773750195,77,4,2,2,85
773761811,60,42,13,8,123
773765582,26,17,2,1,46
773765824,226,13,2,9,250
773766505,139,34,8,32,213
773770343,36,50,5,2,93
773788018,13,3,2,1,19
773790991,11,5,2,1,19
773799976,15,3,2,5,25
773802567,37,25,2,1,65
773818836,25,12,2,1,40
773838823,101,19,2,1,123
773843705,19,9,2,1,31
773869478,168,3,2,2,175
773870761,25,3,2,1,31
773873501,58,18,16,9,101
773878001,24,39,2,1,66
773885954,98,26,16,5,145
773891920,16,3,2,1,22
773894739,74,56,23,39,192
773903104,44,28,65,1,138
773904117,99,36,31,14,180
773917622,11,3,2,1,17
773933121,103,25,15,5,148
773938712,76,22,2,2,102
773939641,31,3,2,1,37
773953958,66,3,2,5,76
773955382,40,28,15,3,86
773963878,33,12,2,2,49
773993283,96,3,2,4,105
774011586,14,6,2,1,23
774015163,42,4,2,1,49
774016966,10,31,5,1,47
774023070,11,3,2,1,17
774023106,10,5,2,1,18
774023862,58,13,2,1,74
774056838,58,25,2,1,86
774064511,29,6,2,5,42
774074320,31,114,60,7,212
774088867,16,3,2,1,22
774098582,11,4,2,1,18
774107327,121,9,39,7,176
774113105,43,3,2,1,49
774124096,100,24,3,1,128
774131093,10,15,2,1,28
774147242,74,18,40,9,141
774152365,30,3,2,1,36
774159104,168,20,3,4,195
774166833,63,21,2,4,90
774178602,10,3,2,2,17
774187830,28,3,2,6,39
774201589,60,15,2,1,78
774206251,71,7,2,2,82
774210277,19,3,2,1,25
774221264,35,6,3,1,45
774223846,24,15,35,2,76
774228754,90,3,2,3,98
774232460,12,3,2,3,20
774235063,49,20,2,1,72
774240116,67,26,2,1,96
774256318,79,3,2,1,85
774258121,10,8,2,1,21
774262934,10,12,2,1,25
774287164,46,40,2,1,89
774287724,76,5,10,2,93
774291032,24,3,3,1,31
774293407,154,16,30,1,201
774296515,89,10,2,1,102
774296701,14,3,2,1,20
774302421,20,3,2,1,26
774347211,129,41,6,13,189
774348574,116,51,31,1,199
774379489,40,21,2,1,64
774384168,73,5,162,1,241
774397249,35,15,17,42,109
774403729,92,31,18,3,144
774406337,36,26,23,39,124
774420429,81,3,2,13,99
774426004,29,30,19,1,79
774430597,14,11,2,1,28
774436253,206,3,2,1,212
774443796,51,29,16,3,99
774453371,13,3,2,1,19
774467477,41,13,2,1,57
774467686,46,3,2,10,61
774486989,55,4,53,1,113
774498571,13,3,2,1,19
774506168,43,50,10,12,115
774522499,65,3,2,1,71
774570395,76,62,9,3,150
774574907,116,10,26,23,175
774580414,96,57,70,40,263
774586601,43,3,2,1,49
774597931,132,30,9,2,173
774610263,64,8,25,7,104
774616084,113,25,58,3,199
774616883,50,20,54,1,125
774618739,19,3,2,1,25
774619852,63,14,2,6,85
774628637,176,17,7,1,201
774630244,23,3,2,2,30
774633923,44,4,2,3,53
774637983,141,50,7,16,214
774646908,22,3,2,1,28
774657343,108,25,141,34,308
774662678,62,9,2,1,74
774668442,94,59,70,12,235
774671200,33,6,2,1,42
774686473,128,33,75,3,239
774688194,76,3,2,1,82
774699310,16,3,2,1,22
774730896,170,3,2,4,179
774733477,45,20,4,4,73
774734022,50,5,2,5,62
774748559,10,7,2,2,21
774751041,49,11,4,1,65
774754613,55,36,16,8,115
774766134,14,3,2,1,20
774788242,62,36,54,4,156
774824579,148,3,2,2,155
774848634,32,47,2,1,82
774865217,54,3,2,14,73
774897850,18,13,2,1,34
774930284,16,11,2,5,34
774953470,103,3,7,1,114
774961247,14,3,2,1,20
774970779,95,32,2,1,130
774974621,22,3,2,3,30
774977087,95,17,32,5,149
774980103,26,3,2,1,32
775017078,348,3,2,2,355
775023017,173,3,2,2,180
775027376,53,25,34,11,123
775030524,38,20,3,1,62
775034760,19,15,2,1,37
775035098,106,11,2,2,121
775058508,12,3,2,1,18
775066670,83,5,2,11,101
775070502,143,37,82,14,276
775083758,33,40,12,2,87
775107400,61,49,18,42,170
775119866,84,3,2,3,92
775123009,101,40,46,21,208
775125991,133,3,2,3,141
775141487,15,3,2,1,21
775149558,23,18,2,1,44
775149903,14,3,2,2,21
775154058,90,3,2,1,96
775164040,11,4,2,1,18
775172941,56,33,3,1,93
775181353,10,5,2,1,18
775181395,11,3,2,1,17
775203841,219,15,54,7,295
775223425,132,22,2,1,157
775226665,18,15,25,9,67
775229284,200,3,2,7,212
775231054,49,29,3,8,89
775234661,35,65,4,2,106
775243791,11,20,2,1,34
775250650,28,32,17,35,112
775250770,61,19,16,1,97
775251661,47,20,11,4,82
775251741,39,21,2,1,63
775256367,12,3,2,1,18
775257291,46,37,5,1,89
775257726,54,4,2,25,85
775264961,126,20,19,6,171
775289058,75,3,2,5,85
775314979,136,23,58,32,249
775315205,80,21,4,4,109
775318074,33,3,2,1,39
775321601,25,13,2,1,41
775329179,69,9,2,1,81
775330304,34,53,4,7,98
775332645,70,23,27,37,157
775345527,69,68,17,4,158
775345529,116,21,2,1,140
775347233,29,3,2,1,35
775370526,31,46,2,9,88
775387369,134,21,10,1,166
775401315,166,25,2,77,270
775421312,19,3,2,5,29
775431224,32,12,8,2,54
775434539,128,3,2,3,136
775437611,82,30,109,3,224
775445656,19,5,14,16,54
775463922,32,10,3,3,48
775473054,117,22,2,6,147
775473936,65,19,24,14,122
775486031,59,24,3,2,88
775486556,31,27,10,2,70
775489395,40,3,2,1,46
775494586,18,31,2,1,52
775503542,23,16,4,1,44
775512496,10,7,2,1,20
775515899,21,21,2,2,46
775528599,67,12,19,4,102
775533283,105,9,28,8,150
775537635,42,28,2,1,73
775540094,74,23,9,1,107
775563728,52,5,2,17,76
775568453,40,4,7,6,57
775579481,28,3,2,1,34
775582527,23,14,5,2,44
775594696,36,3,2,1,42
775599441,79,40,31,2,152
775608372,133,3,2,1,139
775611341,15,5,2,1,23
775622269,31,13,24,20,88
775623552,57,3,2,2,64
775627100,158,43,2,1,204
775628696,33,36,49,3,121
775650086,42,21,2,8,73
775656501,181,3,2,48,234
775670446,80,51,126,1,258
775680187,46,24,12,11,93
775697363,14,47,12,28,101
775721782,20,36,2,1,59
775725074,84,3,2,1,90
775739000,74,3,2,1,80
775741244,12,32,14,29,87
775745916,14,24,17,1,56
775749328,23,17,2,11,53
775767448,107,7,2,1,117
775770580,81,19,2,1,103
775802807,68,30,2,14,114
775807649,32,20,2,2,56
775812374,62,66,57,51,236
775814946,91,3,2,1,97
775833697,21,8,2,1,32
775847841,26,28,2,1,57
775848238,152,29,95,24,300
775853195,96,58,59,1,214
775855905,65,74,2,3,144
775862938,53,3,2,1,59
775865525,24,3,2,2,31
775868898,73,22,2,1,98
775879487,61,3,2,1,67
775884929,112,3,2,14,131
775885008,51,3,2,8,64
775887896,65,3,2,21,91
775888174,96,37,57,1,191
775890039,10,3,2,2,17
775908437,16,3,2,4,25
775914822,43,26,45,11,125
775927240,38,6,50,1,95
775934128,41,25,2,26,94
775954114,267,27,42,1,337
775963685,156,15,28,17,216
775968192,96,147,7,12,262
775971302,61,81,75,1,218
775971901,99,59,10,1,169
775972194,43,62,10,9,124
775973834,46,3,2,1,52
775981074,41,3,2,5,51
775988080,87,7,2,15,111
775991540,15,3,2,1,21
775999532,61,42,2,1,106
776000938,39,18,3,6,66
776004160,76,13,31,23,143
776031829,112,3,2,2,119
776038678,17,5,2,1,25
776057575,131,16,2,4,153
776061387,36,42,20,15,113
776064488,85,41,5,6,137
776072418,36,9,3,1,49
776079717,194,3,2,2,201
776097243,36,13,2,1,52
776097834,17,10,2,8,37
776100033,16,10,2,3,31
776108823,19,3,2,1,25
776110859,128,57,12,9,206
776132216,203,40,89,10,342
776136445,12,7,2,1,22
776148436,31,3,2,1,37
776157974,11,4,2,1,18
776173420,210,36,11,17,274
776204117,15,3,2,7,27
776225215,68,3,2,1,74
776246677,10,31,2,1,44
776254396,65,10,2,4,81
776263028,32,36,17,1,86
776280336,29,4,2,1,36
776305991,80,3,2,1,86
776316603,170,53,37,1,261
776321393,152,25,9,11,197
776324942,30,3,17,4,54
776327302,28,28,60,9,125
776334778,107,21,2,1,131
776335041,97,3,2,3,105
776335778,11,9,2,2,24
776342258,68,17,2,13,100
776352540,22,58,9,2,91
776365709,36,76,2,1,115
776366840,14,5,2,1,22
776371595,61,20,3,3,87
776393381,23,23,18,1,65
776429955,123,65,2,1,191
776430981,60,3,2,1,66
776435483,40,3,4,1,48
776436015,758,3,2,39,802
776443348,47,28,17,11,103
776445988,270,38,2,75,385
776453346,35,3,2,1,41
776457306,160,3,2,11,176
776471210,67,68,2,12,149
776471641,17,35,2,1,55
776510644,11,3,2,1,17
776514207,25,3,2,2,32
776531079,12,3,2,1,18
776541361,51,14,12,7,84
776542842,12,6,2,1,21
776554199,30,33,18,1,82
776557456,57,15,2,1,75
776561964,109,31,13,6,159
776563154,164,49,2,2,217
776581544,86,37,107,1,231
776583091,25,4,5,3,37
776588659,69,3,2,1,75
776604484,50,3,2,5,60
776609222,94,19,10,5,128
776609968,67,3,2,1,73
776619187,42,38,34,11,125
776624059,33,26,2,4,65
776629620,101,23,2,10,136
776633411,146,5,41,3,195
776641222,95,36,2,10,143
776652804,46,48,28,2,124
776676861,69,4,20,4,97
776693844,65,3,2,4,74
776694039,11,3,3,1,18
776696086,117,11,19,3,150
776715201,31,4,2,1,38
776717342,32,21,3,1,57
776731360,72,22,3,4,101
776744678,20,3,2,1,26
776745451,43,3,2,4,52
776750028,31,16,28,1,76
776750886,34,53,2,1,90
776751630,117,3,2,1,123
776787003,33,17,30,10,90
776790587,55,20,2,1,78
776812030,87,12,2,2,103
776848997,123,3,2,5,133
776850692,16,6,4,4,30
776856474,89,35,4,4,132
776859935,11,3,2,2,18
776864373,1131,3,2,17,1153
776875175,80,58,25,6,169
776876279,39,47,5,6,97
776904629,78,25,55,1,159
776905830,19,4,5,1,29
776936137,23,23,52,22,120
776948173,84,24,2,7,117
776960733,28,3,2,1,34
776962230,136,3,2,1,142
776985264,135,19,2,1,157
776990028,158,4,2,1,165
776998450,85,43,87,3,218
776999070,58,3,2,1,64
777002658,42,40,61,9,152
777006108,188,3,2,4,197
777019830,35,14,2,6,57
777039793,25,19,2,2,48
777044592,83,38,8,1,130
777045725,58,78,21,80,237
777049939,47,142,42,8,239
777053031,85,25,15,1,126
777074478,113,75,56,1,245
777079517,158,3,2,3,166
777084185,39,3,2,1,45
777143374,73,26,3,3,105
777151677,17,36,2,2,57
777151959,13,3,2,3,21
777160136,32,70,4,15,121
777176889,78,24,4,3,109
777178815,19,30,2,1,52
777185920,77,17,164,1,259
777186239,10,11,2,1,24
777190401,26,3,2,1,32
777190788,19,29,19,6,73
777251954,70,3,2,1,76
777288972,59,3,2,1,65
777295462,18,3,2,3,26
777303611,12,3,2,2,19
777306235,301,3,2,8,314
777327091,14,3,2,1,20
777327347,53,13,44,1,111
777352960,41,45,40,20,146
777363407,32,3,2,5,42
777369747,12,3,2,1,18
777374238,15,3,2,1,21
777379345,31,3,3,17,54
777412945,76,31,14,8,129
777416101,33,18,21,1,73
777435237,221,3,2,1,227
777450236,225,3,2,8,238
777451814,48,24,26,10,108
777474745,120,37,13,44,214
777483998,10,46,3,1,60
777489675,56,5,2,1,64
777511139,46,36,15,2,99
777517019,166,47,38,19,270
777527606,90,30,20,20,160
777534494,22,38,19,1,80
777545866,130,77,7,5,219
777549889,45,38,64,13,160
777551842,10,3,2,2,17
777554166,77,15,2,5,99
777560372,63,35,56,7,161
777572995,12,3,2,1,18
777587437,44,3,2,1,50
777590324,21,9,2,1,33
777595658,68,31,5,7,111
777598557,24,6,2,4,36
777599614,12,3,2,4,21
777602469,140,15,16,2,173
777602565,11,3,2,1,17
777602887,63,3,2,1,69
777603620,221,3,2,6,232
777613506,82,14,2,6,104
777621149,11,3,2,1,17
777643175,290,3,2,2,297
777647299,71,4,95,6,176
777653095,114,29,17,1,161
777657641,11,3,2,1,17
777665989,99,50,86,5,240
777678826,62,34,125,67,288
777683513,10,5,2,1,18
777690112,46,35,8,7,96
777700177,20,5,3,4,32
777707573,14,3,2,1,20
777713237,42,21,14,9,86
777722585,36,58,9,3,106
777736468,34,3,2,1,40
777740016,132,8,2,15,157
777741842,72,3,2,2,79
777743923,52,27,62,13,154
777752036,78,5,77,3,163
777754564,116,8,27,1,152
777772517,33,77,40,6,156
777780246,52,5,14,1,72
777781496,32,19,11,12,74
777791942,108,30,6,15,159
777799881,49,78,76,24,227
777805552,82,33,52,1,168
777816121,107,8,2,7,124
777819739,41,96,61,1,199
777822908,90,3,2,1,96
777826107,45,24,2,1,72
777827326,20,6,2,1,29
777828168,42,32,7,12,93
777862233,16,3,2,1,22
777869788,101,13,3,6,123
777882962,65,13,7,1,86
777886326,20,3,2,1,26
777908352,43,27,2,35,107
777918475,18,3,2,1,24
777922694,64,3,2,2,71
777931670,55,5,18,17,95
777953688,73,3,2,1,79
777954846,17,53,20,3,93
777959204,28,9,2,1,40
777961857,13,13,2,1,29
777963100,116,32,67,10,225
777977348,63,3,2,1,69
778014351,44,3,2,1,50
778019342,14,3,2,1,20
778021082,13,4,2,1,20
778035950,111,61,21,2,195
778057596,54,4,2,2,62
778074941,555,3,2,3,563
778084703,88,3,2,12,105
778089998,127,3,2,1,133
778098542,36,40,3,1,80
778105241,145,3,2,1,151
778108378,50,26,3,4,83
778109527,106,23,4,4,137
778113587,20,105,29,14,168
778128284,102,14,9,32,157
778131892,124,8,118,4,254
778138768,138,3,2,3,146
778140510,15,6,3,1,25
778152621,51,3,2,6,62
778160471,69,13,7,23,112
778171146,80,44,2,4,130
778176936,410,3,2,3,418
778188924,16,32,2,2,52
778196274,53,20,2,1,76
778197100,213,4,3,5,225
778250242,51,43,6,1,101
778258013,102,23,44,9,178
778267998,107,3,3,3,116
778270461,199,3,2,1,205
778281756,110,91,87,24,312
778290085,44,61,67,3,175
778290209,88,3,2,1,94
778299536,39,13,2,1,55
778318259,127,3,2,12,144
778320381,10,5,2,1,18
778320555,12,3,2,1,18
778322251,217,3,2,26,248
778322553,119,3,2,42,166
778330483,94,10,2,1,107
778333659,36,5,2,1,44
778352772,36,25,9,3,73
778355894,12,3,2,1,18
778367003,39,8,5,8,60
778378286,77,3,2,10,92
778403521,12,3,2,3,20
778408864,43,3,8,1,55
778410014,106,16,2,6,130
778411400,81,11,10,1,103
778411675,30,43,14,2,89
778433257,98,20,40,7,165
778438835,136,19,94,1,250
778441232,68,52,23,21,164
778442595,21,3,2,1,27
778454555,92,45,29,2,168
778455645,52,3,2,9,66
778477461,211,3,2,7,223
778485163,13,3,2,1,19
778485972,62,12,4,17,95
778487204,10,3,2,2,17
778488906,56,16,12,2,86
778508162,41,3,2,1,47
778510640,150,3,2,1,156
778522626,14,3,2,2,21
778523785,14,3,2,1,20
778527940,52,3,2,2,59
778555520,57,14,20,3,94
778560587,389,3,2,6,400
778560726,34,15,2,1,52
778565434,67,22,106,3,198
778579330,130,28,2,8,168
778581457,34,19,2,1,56
778586930,15,5,14,1,35
778607070,57,47,57,3,164
778612930,115,3,2,1,121
778628037,20,3,2,1,26
778640322,23,9,2,1,35
778647170,144,18,2,5,169
778648292,33,25,2,4,64
778660671,192,7,2,3,204
778665739,196,3,2,63,264
778674863,195,33,7,2,237
778681113,32,3,2,1,38
778685341,11,4,2,1,18
778704152,194,16,11,30,251
778710646,28,3,2,1,34
778714743,23,34,24,7,88
778730365,60,3,2,1,66
778731124,106,5,2,1,114
778734156,85,16,2,16,119
778744751,100,3,3,4,110
778747561,135,3,2,1,141
778751105,147,9,4,5,165
778752837,20,3,2,3,28
778755627,77,3,2,2,84
778761710,21,3,2,1,27
778772430,131,21,23,5,180
778793717,88,14,2,2,106
778794836,73,18,2,8,101
778802885,40,3,2,1,46
778806663,12,3,2,1,18
778808551,21,7,2,1,31
778813742,25,29,3,8,65
778816482,17,4,2,1,24
778821510,26,6,3,7,42
778826764,39,3,2,1,45
778830459,29,15,2,7,53
778835443,42,28,2,1,73
778844577,36,25,2,2,65
778845827,110,28,29,19,186
778868466,35,3,2,1,41
778887215,98,16,19,1,134
778914435,34,5,2,18,59
778924659,124,18,2,1,145
778934656,205,13,2,2,222
778937960,28,21,27,1,77
778942546,91,17,138,34,280
778952278,20,50,39,1,110
778960999,83,58,17,4,162
778967675,98,23,3,1,125
778981727,53,4,2,6,65
778990484,79,64,2,5,150
779008115,24,19,4,1,48
779017531,19,12,5,1,37
779038957,55,46,20,4,125
779085271,12,13,2,2,29
779088276,10,7,2,2,21
779110493,23,3,4,1,31
779115083,30,22,2,4,58
779116804,15,10,2,1,28
779118587,16,3,2,1,22
779121926,25,3,2,1,31
779122251,94,3,2,1,100
779129672,130,113,10,54,307
779134635,64,4,2,2,72
779141021,215,11,13,2,241
779184045,99,5,3,3,110
779200743,42,18,28,1,89
779208370,32,51,13,1,97
779215637,61,13,28,1,103
779223534,82,3,2,1,88
779223909,96,3,2,1,102
779229378,53,39,6,30,128
779245924,134,30,48,44,256
779251381,131,15,23,1,170
779259524,12,78,2,1,93
779259900,226,58,32,5,321
779265432,132,21,15,2,170
779266033,100,3,2,1,106
779276969,65,6,49,2,122
779281419,24,12,4,1,41
779281700,102,3,2,31,138
779296098,23,3,2,1,29
779315729,108,8,26,1,143
779319805,70,33,2,2,107
779325693,129,39,18,1,187
779328552,86,18,6,3,113
779332867,27,9,8,11,55
779338196,80,3,2,1,86
779341507,16,3,2,1,22
779346930,21,27,17,7,72
779352327,104,3,2,1,110
779370158,29,39,19,2,89
779378405,99,3,2,1,105
779381195,34,3,2,1,40
779405258,101,35,19,11,166
779408581,30,9,2,31,72
779411388,107,69,15,8,199
779428432,22,3,2,2,29
779439876,33,3,12,3,51
779447969,24,3,2,1,30
779455498,58,29,50,12,149
779458947,54,84,16,1,155
779465177,168,8,9,2,187
779470363,67,15,13,8,103
779477668,31,147,35,5,218
779497297,29,22,4,1,56
779504755,17,7,2,1,27
779510557,78,20,30,35,163
779522729,63,3,2,1,69
779523366,78,21,2,4,105
779532472,84,3,6,1,94
779533896,131,3,2,8,144
779536457,33,3,2,1,39
779547338,28,3,2,3,36
779553627,36,31,23,8,98
779554714,63,22,3,1,89
779587502,15,28,6,1,50
779598681,130,47,44,9,230
779598939,53,3,2,3,61
779599627,11,3,2,1,17
779601564,111,6,2,2,121
779611288,163,24,2,7,196
779612301,44,41,26,4,115
779647862,64,35,10,2,111
779659315,56,6,3,4,69
779660405,47,3,2,1,53
779663875,54,35,49,11,149
779666704,53,3,2,1,59
779668006,60,28,2,4,94
779671081,68,6,2,19,95
779677014,14,9,2,1,26
779677511,82,28,2,1,113
779698676,21,3,2,1,27
779700318,42,41,4,4,91
779701778,118,28,2,1,149
779705847,41,8,34,1,84
779707526,41,16,5,4,66
779716313,91,7,27,1,126
779726727,38,9,2,1,50
779730046,37,9,2,4,52
779741926,21,7,2,1,31
779748926,147,20,2,15,184
779750348,12,49,11,7,79
779763709,116,28,9,23,176
779768188,94,25,22,2,143
779774307,37,5,2,1,45
779799025,40,6,2,1,49
779803428,10,19,2,1,32
779803600,35,12,38,3,88
779821282,10,22,2,4,38
779823574,37,13,2,1,53
779832191,81,15,12,2,110
779848563,90,19,23,4,136
779849999,52,13,2,8,75
779854462,45,47,19,1,112
779862833,153,37,37,1,228
779865591,150,97,122,12,381
779872572,50,3,2,9,64
779872951,78,4,9,2,93
779884951,79,43,29,17,168
779887756,11,4,2,1,18
779890307,268,7,3,20,298
779894992,40,3,2,1,46
779902965,71,39,39,2,151
779905045,12,3,2,1,18
779910181,91,33,6,59,189
779911030,10,18,2,1,31
779925629,117,46,66,19,248
779929184,11,3,2,1,17
779950927,97,89,10,40,236
779954653,14,3,2,1,20
779960644,53,3,2,1,59
779963251,74,13,26,10,123
779970974,15,13,3,9,40
779983877,51,34,93,5,183
779989490,10,5,2,1,18
779993867,76,3,2,1,82
780002518,47,3,2,7,59
780004271,80,12,19,62,173
780007857,112,11,3,3,129
780025948,28,3,2,2,35
780030542,72,36,14,1,123
780044606,11,9,3,1,24
780045679,37,24,4,2,67
780050171,57,30,21,20,128
780070886,55,3,8,1,67
780072336,45,121,22,56,244
780086283,102,15,74,25,216
780086306,94,50,57,34,235
780088325,46,3,2,3,54
780095254,65,3,2,6,76
780115548,61,46,3,14,124
780136610,58,14,2,1,75
780140240,169,3,2,9,183
780141467,41,14,2,10,67
780141761,43,62,2,1,108
780146542,25,23,7,2,57
780182921,72,18,8,12,110
780210175,50,14,6,5,75
780215800,39,28,54,32,153
780217457,96,26,2,17,141
780218006,80,4,14,7,105
780219614,102,3,2,7,114
780225819,77,38,2,11,128
780237026,33,25,2,1,61
780242369,27,3,2,1,33
780255908,10,8,2,1,21
780259516,23,3,2,1,29
780261308,75,13,11,6,105
780263303,173,4,2,1,180
780265790,148,21,2,4,175
780279598,53,24,33,4,114
780291913,54,7,56,6,123
780296157,36,48,20,5,109
780299891,109,3,2,6,120
780319773,12,3,2,1,18
780386267,37,7,117,1,162
780411849,16,7,2,1,26
780416824,79,5,9,7,100
780428779,151,66,34,2,253
780433856,14,15,2,1,32
780456687,50,66,28,3,147
780464884,50,45,2,1,98
780469194,23,79,3,1,106
780470936,114,12,25,18,169
780474123,50,19,2,1,72
780486133,22,8,2,1,33
780493765,139,3,2,16,160
780496966,46,14,11,22,93
780499370,43,9,3,2,57
780499915,15,62,2,5,84
780502339,54,27,46,2,129
780514329,33,32,2,1,68
780523941,95,54,91,6,246
780525141,55,23,22,3,103
780536514,155,51,72,5,283
780545454,11,10,2,1,24
780552209,20,4,2,1,27
780552925,97,3,2,8,110
780562673,28,35,7,2,72
780563757,25,3,2,1,31
780569993,60,26,14,9,109
780573616,28,21,2,2,53
780573744,56,40,7,41,144
780590506,92,25,2,1,120
780622015,31,19,2,2,54
780642500,58,28,2,1,89
780644111,15,5,2,1,23
780646190,51,67,44,38,200
780653003,20,22,2,3,47
780653482,10,5,2,1,18
780653844,28,3,14,1,46
780669939,24,3,2,1,30
780681048,158,28,2,1,189
780682483,88,3,2,1,94
780694878,19,3,2,19,43
780701428,10,3,4,2,19
780703013,140,26,8,28,202
780727024,49,46,73,18,186
780728356,50,24,7,20,101
780728520,51,21,27,3,102
780750500,61,44,10,3,118
780750530,40,3,2,1,46
780752183,40,3,2,2,47
780758164,67,26,2,5,100
780766656,50,9,3,2,64
780774059,29,44,2,2,77
780782395,76,85,171,3,335
780782401,81,11,2,3,97
780785855,35,85,7,3,130
780793124,87,115,22,5,229
780836036,68,11,7,3,89
780837261,58,3,2,1,64
780838993,47,43,2,1,93
780847035,61,3,2,2,68
780873082,72,3,2,1,78
780873625,74,16,39,1,130
780893713,87,30,2,6,125
780917039,212,5,2,2,221
780917366,94,3,38,1,136
780917723,19,18,2,1,40
780919464,52,3,2,1,58
780925543,10,13,5,1,29
780927348,70,156,22,61,309
780937957,59,3,2,1,65
780953693,148,15,14,4,181
780958968,65,25,8,1,99
780963872,45,8,2,6,61
780969142,179,3,2,8,192
780971960,12,3,2,1,18
780975427,58,4,2,8,72
780977363,13,3,2,3,21
780977770,67,3,2,2,74
780996710,91,38,5,4,138
780996877,264,3,2,33,302
781010765,12,3,6,2,23
781016877,133,17,2,18,170
781020063,94,43,2,3,142
781027885,76,25,30,18,149
781037707,329,3,2,5,339
781057421,87,56,42,6,191
781064967,26,3,2,1,32
781080671,55,17,2,9,83
781085982,53,3,2,11,69
781092524,25,15,2,1,43
781098064,10,16,2,1,29
781114460,92,59,88,2,241
781130024,10,8,2,1,21
781173951,25,65,43,1,134
781179344,52,66,53,17,188
781200534,28,3,2,7,40
781210039,39,3,2,9,53
781237671,17,11,2,9,39
781244178,46,28,2,1,77
781249935,38,3,2,2,45
781254941,30,5,18,7,60
781267316,26,3,2,1,32
781268536,185,4,2,2,193
781271231,13,59,15,1,88
781275493,10,3,2,2,17
781282119,54,44,62,16,176
781286192,12,3,2,1,18
781286442,104,3,2,1,110
781289075,62,3,2,1,68
781292874,55,65,34,3,157
781293270,80,28,34,2,144
781300770,738,3,2,17,760
781301777,37,31,24,32,124
781307252,94,64,33,6,197
781311452,115,191,26,2,334
781342519,92,3,2,27,124
781343801,76,43,2,3,124
781347173,14,8,2,1,25
781357594,63,32,3,5,103
781361887,97,3,2,1,103
781370520,59,65,2,16,142
781371989,54,20,4,2,80
781382535,14,13,2,2,31
781409912,11,3,2,2,18
781411610,111,11,2,36,160
781423386,29,6,2,1,38
781430906,119,38,2,1,160
781433624,84,14,2,1,101
781435599,118,24,22,2,166
781456707,63,8,51,7,129
781473002,51,9,2,1,63
781479360,158,24,21,16,219
781487023,129,16,2,1,148
781492076,142,14,2,1,159
781535477,11,21,2,1,35
781551233,32,3,17,2,54
781555239,12,3,2,4,21
781561584,61,7,11,1,80
781563274,81,41,2,3,127
781574179,181,3,5,36,225
781604546,24,3,2,1,30
781612668,19,8,2,4,33
781615640,12,47,2,1,62
781623268,61,9,7,9,86
781623753,32,3,2,1,38
781633093,30,3,2,1,36
781641009,44,18,15,1,78
781643607,117,3,2,1,123
781647537,11,7,2,4,24
781650253,10,4,2,1,17
781659605,14,3,2,1,20
781661817,32,4,2,1,39
781665140,40,50,5,1,96
781667758,21,35,2,1,59
781689309,28,51,6,1,86
781698001,52,46,15,5,118
781701686,93,79,33,21,226
781704422,12,3,2,2,19
781704636,126,6,26,1,159
781724393,127,26,22,29,204
781725227,74,36,71,3,184
781731953,15,11,4,3,33
781734405,41,14,2,1,58
781735909,20,16,2,7,45
781772746,43,3,2,1,49
781775092,44,86,2,1,133
781795135,112,3,2,3,120
781800570,165,47,3,3,218
781803352,15,20,2,1,38
781810039,96,15,2,1,114
781811022,33,3,2,1,39
781818659,16,3,2,1,22
781819158,118,103,4,4,229
781821541,55,34,6,21,116
781828576,201,3,5,1,210
781829249,119,31,39,3,192
781829759,66,17,2,3,88
781831232,48,26,15,22,111
781835002,31,17,2,5,55
781847263,63,51,99,2,215
781855230,178,35,2,5,220
781862955,55,3,2,25,85
781889067,18,15,3,1,37
781892206,14,3,2,1,20
781892544,73,14,41,26,154
781898668,86,4,3,1,94
781899669,35,15,2,16,68
781899770,62,17,6,14,99
781923180,96,3,2,1,102
781924452,18,3,2,1,24
781943434,120,10,2,1,133
781947091,22,11,2,1,36
781947345,109,45,49,1,204
781973935,116,3,2,1,122
781988212,63,35,4,1,103
781990397,92,14,113,18,237
781993435,74,3,2,15,94
781998765,48,3,2,1,54
782011910,135,13,12,18,178
782031742,10,10,2,1,23
782034081,25,28,2,2,57
782042634,51,36,22,6,115
782057508,10,3,2,2,17
782071756,86,3,2,1,92
782072524,107,13,47,1,168
782074531,145,23,59,5,232
782080451,43,17,36,8,104
782129844,55,11,2,3,71
782136228,123,3,2,1,129
782169110,19,3,2,1,25
782169895,107,7,2,1,117
782172441,11,3,2,1,17
782175994,110,5,5,18,138
782178874,59,11,5,6,81
782187050,11,3,2,1,17
782190137,123,3,2,1,129
782197866,10,27,2,1,40
782198527,112,3,2,2,119
782207806,56,16,2,1,75
782218017,31,26,5,6,68
782242219,13,3,2,1,19
782249440,51,43,14,1,109
782252017,21,30,37,1,89
782258791,10,22,2,1,35
782273425,99,27,3,18,147
782275004,56,27,3,21,107
782281008,91,33,14,5,143
782288553,89,3,2,1,95
782298879,80,52,2,24,158
782306919,104,44,13,2,163
782312597,10,3,2,3,18
782314315,10,4,2,2,18
782317078,131,30,2,3,166
782318478,22,10,2,3,37
782324971,10,4,2,1,17
782329888,10,3,2,2,17
782335407,38,66,18,1,123
782338817,191,4,2,11,208
782351064,12,3,2,1,18
782357503,130,29,2,61,222
782360009,19,19,2,9,49
782360427,11,3,2,1,17
782368524,13,3,2,1,19
782384524,90,6,2,3,101
782393713,99,5,8,1,113
782393740,11,5,3,1,20
782406967,99,79,2,11,191
782432513,58,4,2,1,65
782458150,13,40,2,1,56
782471890,102,61,37,19,219
782472243,38,3,2,13,56
782530885,15,3,2,1,21
782564440,73,17,2,1,93
782572136,156,39,24,47,266
782572595,129,9,18,8,164
782580603,48,75,27,5,155
782597814,35,3,2,1,41
782597904,20,11,10,2,43
782609345,31,5,2,1,39
782611282,40,11,2,1,54
782614972,85,7,2,1,95
782618379,22,18,2,12,54
782633931,21,3,2,1,27
782637097,27,11,2,1,41
782646425,133,29,64,29,255
782686807,30,18,22,11,81
782706976,70,70,5,72,217
782709515,56,13,5,8,82
782717733,73,55,9,42,179
782721242,15,3,2,1,21
782728309,114,3,2,2,121
782735620,47,31,20,12,110
782745971,38,3,2,1,44
782757979,14,19,2,1,36
782759081,101,30,2,1,134
782766439,161,40,2,4,207
782780941,23,3,2,2,30
782784191,34,65,22,19,140
782784653,11,3,2,1,17
782792069,54,34,42,38,168
782792864,120,20,24,1,165
782800985,22,40,5,15,82
782816409,20,5,2,3,30
782821053,25,122,34,7,188
782835942,89,3,2,1,95
782842599,15,10,2,6,33
782843411,38,3,2,1,44
782856093,34,56,14,10,114
782856621,144,51,28,3,226
782856684,32,3,3,8,46
782875775,11,3,2,1,17
782912534,141,6,6,5,158
782914113,36,34,4,10,84
782916660,74,12,2,13,101
782926781,107,3,2,1,113
782932110,12,15,2,1,30
782933900,35,48,22,4,109
782947498,247,3,2,20,272
782954381,129,29,86,1,245
782964716,85,20,26,4,135
782976167,40,27,2,7,76
782981058,24,30,3,3,60
782984267,179,3,2,1,185
782986268,110,39,23,1,173
782988650,71,9,2,1,83
782997105,121,23,37,4,185
783016439,206,3,2,27,238
783025772,35,32,2,6,75
783032107,17,4,2,1,24
783049961,160,6,2,2,170
783050707,54,29,5,3,91
783051654,73,13,9,2,97
783055977,12,3,2,1,18
783076830,11,39,2,1,53
783107018,64,33,5,2,104
783128458,150,27,2,15,194
783140850,58,45,3,2,108
783141347,69,4,2,4,79
783159667,96,43,26,3,168
783174406,25,37,31,48,141
783182090,98,3,2,1,104
783208037,24,14,2,1,41
783216362,134,15,2,2,153
783217946,114,34,28,26,202
783226043,27,10,2,3,42
783255445,167,19,2,17,205
783277270,120,36,29,32,217
783281935,16,3,2,2,23
783289175,11,3,2,1,17
783290714,113,13,2,2,130
783295436,88,30,26,3,147
783297885,147,18,2,4,171
783300026,171,3,2,43,219
783310302,71,15,2,5,93
783310741,44,20,50,9,123
783315021,124,28,66,14,232
783328138,83,20,20,15,138
783332454,55,15,2,2,74
783333636,52,41,15,3,111
783337269,66,7,4,2,79
783359340,65,20,43,1,129
783365297,99,5,3,2,109
783373636,43,3,2,1,49
783377570,164,12,2,7,185
783389347,54,25,8,1,88
783397653,192,42,2,1,237
783407821,82,38,98,7,225
783412337,55,35,2,1,93
783423557,29,18,2,1,50
783427134,95,47,25,3,170
783427276,37,73,3,1,114
783429378,77,11,26,4,118
783432890,66,5,2,1,74
783443725,43,34,77,15,169
783446953,20,3,2,6,31
783459068,14,3,2,4,23
783461172,59,46,84,3,192
783465155,22,29,3,1,55
783481111,53,3,12,4,72
783496499,206,9,53,4,272
783500575,48,20,2,5,75
783504137,31,3,2,1,37
783511741,10,22,2,1,35
783525424,14,6,2,1,23
783525441,14,3,2,1,20
783525823,34,59,26,2,121
783545262,46,19,2,1,68
783550481,71,19,12,4,106
783586640,26,26,2,1,55
783631664,11,18,2,15,46
783642645,13,3,2,1,19
783657784,12,3,2,1,18
783663217,62,3,2,1,68
783666092,16,93,22,12,143
783676622,121,16,2,3,142
783681141,65,8,2,1,76
783683628,45,3,2,1,51
783703783,13,3,2,1,19
783714535,99,55,57,51,262
783719585,17,7,2,1,27
783725643,12,3,2,1,18
783733795,117,8,12,29,166
783737854,30,3,2,1,36
783741241,83,3,2,5,93
783747714,42,3,10,1,56
783749441,165,43,5,31,244
783753843,10,6,2,1,19
783757443,104,3,30,72,209
783760566,36,3,2,1,42
783762425,88,3,2,1,94
783764059,41,22,46,9,118
783768442,94,34,4,1,133
783777093,28,25,4,5,62
783777225,95,17,4,22,138
783779726,314,3,5,6,328
783797576,10,4,2,1,17
783799843,88,30,53,1,172
783804032,143,34,13,4,194
783808775,20,22,4,1,47
783817107,19,3,2,3,27
783819371,152,3,2,1,158
783825254,98,3,2,1,104
783834702,15,3,2,1,21
783858511,24,6,6,1,37
783868208,52,36,4,2,94
783878785,63,49,11,6,129
783879266,11,6,2,1,20
783888661,44,3,2,1,50
783907188,47,3,2,1,53
783907531,23,8,8,2,41
783908296,13,3,2,1,19
783921513,34,13,3,7,57
783934969,35,51,74,11,171
783945870,93,29,2,6,130
783955764,119,3,2,22,146
783965406,94,4,2,8,108
783965858,43,3,2,1,49
783968125,13,4,2,2,21
783995814,24,40,14,1,79
784016107,17,37,2,1,57
784040441,98,20,3,11,132
784040590,106,3,2,2,113
784042893,51,3,2,2,58
784071908,38,3,2,1,44
784075538,55,12,32,6,105
784081043,72,82,2,10,166
784090449,39,8,29,5,81
784096768,43,7,2,6,58
784100811,21,19,16,5,61
784103678,23,38,29,1,91
784109881,13,3,2,1,19
784113677,54,3,2,1,60
784114554,62,18,34,6,120
784126925,108,3,2,8,121
784141223,34,7,5,1,47
784141324,12,3,2,2,19
784164678,11,3,2,1,17
784173904,82,3,2,1,88
784190599,91,39,27,4,161
784208019,134,12,2,1,149
784223743,127,32,5,7,171
784229103,56,42,36,13,147
784235923,88,3,2,1,94
784246952,91,8,2,1,102
784253456,86,3,2,4,95
784254727,148,33,54,8,243
784285267,186,19,4,14,223
784292254,83,17,4,1,105
784297458,14,27,2,6,49
784297580,11,23,2,1,37
784300423,11,3,2,1,17
784313166,32,32,69,1,134
784323601,25,3,2,4,34
784334362,78,15,40,15,148
784362037,61,21,9,1,92
784366298,85,3,2,1,91
784370425,24,71,26,1,122
784384855,19,37,2,1,59
784398758,136,48,5,1,190
784412626,39,3,2,15,59
784435121,21,19,2,6,48
784435275,42,34,12,14,102
784466228,60,47,44,35,186
784476220,27,3,2,1,33
784477759,26,3,2,1,32
784478583,53,3,2,2,60
784481009,23,35,2,8,68
784496648,50,3,2,2,57
784505257,29,27,16,7,79
784509473,37,3,2,8,50
784510589,53,3,2,1,59
784516636,11,18,2,1,32
784518653,64,6,2,4,76
784524055,24,3,2,8,37
784551318,27,6,2,2,37
784553673,67,3,2,4,76
784556435,32,3,2,1,38
784568411,11,9,2,1,23
784570574,80,3,2,57,142
784571840,114,22,2,1,139
784571845,28,31,44,6,109
784572508,160,57,51,20,288
784573378,96,12,12,1,121
784582049,28,38,4,3,73
784587729,37,33,21,9,100
784607014,35,3,2,1,41
784609620,179,30,33,1,243
784613736,69,80,86,44,279
784614282,91,3,2,3,99
784648450,48,16,25,2,91
784659022,92,22,2,1,117
784662587,83,41,2,6,132
784663524,156,3,2,4,165
784678655,65,26,2,2,95
784679990,35,69,6,3,113
784686841,46,26,2,1,75
784694882,10,9,2,1,22
784717666,214,24,2,18,258
784719398,98,51,13,5,167
784734140,188,3,2,1,194
784751784,48,7,16,1,72
784771614,94,64,38,13,209
784771693,84,12,2,7,105
784775288,10,3,2,2,17
784775923,107,29,59,1,196
784784394,33,11,2,1,47
784791976,39,3,2,1,45
784795741,197,9,17,7,230
784796226,68,3,2,2,75
784798322,10,7,2,4,23
784808316,41,5,2,4,52
784821853,73,3,3,1,80
784821995,14,17,2,1,34
784830733,71,9,37,1,118
784831375,65,43,19,9,136
784833786,19,3,2,3,27
784852043,48,3,19,4,74
784859282,202,3,2,1,208
784862581,40,11,12,43,106
784865260,42,3,2,1,48
784867458,55,8,6,1,70
784874457,19,130,8,9,166
784875059,12,3,2,1,18
784875321,27,32,3,4,66
784888287,61,29,68,1,159
784892232,25,36,18,1,80
784912981,71,15,2,1,89
784932450,52,33,17,4,106
784962100,38,22,3,24,87
784985055,59,3,2,1,65
784990897,82,28,5,1,116
784997757,10,27,2,1,40
785028305,11,4,2,1,18
785035425,44,8,2,3,57
785048691,94,16,123,3,236
785060182,40,14,11,6,71
785060715,34,90,21,3,148
785071921,10,17,2,1,30
785086984,145,59,39,40,283
785089761,157,16,5,3,181
785112449,103,21,2,9,135
785118597,232,62,50,3,347
785126580,13,3,2,3,21
785131500,82,39,11,3,135
785147228,11,3,2,1,17
785155444,66,3,2,1,72
785178866,86,74,40,12,212
785184952,217,34,62,9,322
785219682,13,5,3,1,22
785227886,36,7,2,1,46
785228984,23,33,17,2,75
785242239,61,29,65,6,161
785245690,14,9,2,1,26
785255578,69,22,35,9,135
785299068,66,9,9,1,85
785306139,121,3,2,1,127
785315879,100,28,13,25,166
785318408,55,102,19,15,191
785347377,10,3,2,2,17
785349323,87,16,2,1,106
785354054,30,12,13,1,56
785372385,72,31,29,7,139
785402337,24,7,2,3,36
785403376,51,3,2,14,70
785408300,12,3,2,1,18
785410151,30,29,2,5,66
785412202,30,15,14,36,95
785425628,60,23,2,3,88
785434324,57,6,2,2,67
785455386,58,9,7,24,98
785456465,30,18,5,8,61
785470987,131,59,3,1,194
785472134,85,23,8,27,143
785477482,16,3,2,1,22
785478183,22,25,4,15,66
785488445,161,11,3,19,194
785495227,101,18,3,7,129
785499333,100,20,2,1,123
785506478,88,3,2,1,94
785519446,16,3,2,2,23
785523286,122,9,15,16,162
785539296,37,20,23,13,93
785561114,117,53,51,6,227
785586169,12,3,2,1,18
785606153,34,28,4,1,67
785638088,43,3,2,1,49
785642357,28,71,15,6,120
785651056,15,3,2,1,21
785656187,96,6,2,3,107
785667826,56,4,41,2,103
785674397,16,3,2,1,22
785678403,25,15,13,1,54
785693693,12,14,23,54,103
785696133,131,3,2,5,141
785705391,49,3,2,6,60
785710135,10,3,2,2,17
785721557,239,3,2,1,245
785722816,101,3,2,3,109
785727129,91,16,144,9,260
785736320,14,3,2,1,20
785741003,103,38,10,49,200
785753979,78,17,2,3,100
785754490,64,3,2,4,73
785756679,84,3,2,1,90
785769312,16,8,2,1,27
785776245,66,3,2,1,72
785784284,34,36,11,8,89
785789174,14,3,2,1,20
785789349,114,5,2,1,122
785798985,11,3,2,1,17
785806381,15,5,2,1,23
785818284,91,3,2,6,102
785825828,112,3,2,1,118
785828673,202,3,2,11,218
785832511,53,3,2,1,59
785841671,46,51,7,3,107
785848610,68,14,2,13,97
785869187,24,3,2,1,30
785874211,25,3,2,1,31
785885115,52,3,2,1,58
785890339,58,44,7,22,131
785897456,115,19,2,1,137
785919675,56,18,47,22,143
785921691,70,5,47,1,123
785926706,24,20,2,1,47
785927402,14,16,2,8,40
785947015,147,61,3,1,212
785954127,11,3,2,1,17
785968770,35,15,2,5,57
785975342,17,3,2,1,23
785990949,78,3,2,1,84
786009789,56,22,20,12,110
786018554,14,6,31,1,52
786035287,130,3,2,20,155
786041870,58,13,2,1,74
786051181,81,4,2,2,89
786062817,11,3,2,1,17
786067794,99,10,2,1,112
786100653,20,11,2,14,47
786115576,118,27,2,2,149
786117449,113,13,2,4,132
786118325,96,3,2,1,102
786126335,36,35,102,4,177
786130275,10,5,2,1,18
786130683,79,9,2,2,92
786145580,32,3,2,5,42
786154127,19,12,6,1,38
786154428,25,53,17,4,99
786170590,65,22,2,1,90
786189281,105,3,2,4,114
786223479,14,3,2,1,20
786226076,28,39,61,1,129
786237501,160,44,24,9,237
786238078,72,3,2,7,84
786243076,122,42,4,4,172
786277597,125,19,2,2,148
786279458,88,38,4,11,141
786283367,80,3,2,15,100
786298059,118,3,2,30,153
786298920,226,8,7,1,242
786301101,50,19,2,1,72
786301782,269,3,2,3,277
786315059,33,58,2,1,94
786317500,79,12,2,1,94
786318835,31,3,2,3,39
786327001,69,3,2,5,79
786340342,78,42,9,6,135
786341792,16,3,2,1,22
786343887,11,3,2,1,17
786345143,28,18,2,7,55
786352280,41,3,2,14,60
786359887,51,3,2,1,57
786362507,38,29,7,2,76
786391567,44,92,2,18,156
786392084,19,3,2,2,26
786397848,87,7,12,2,108
786401347,11,3,2,4,20
786410905,17,27,2,1,47
786418267,38,3,2,1,44
786447289,57,112,112,10,291
786454020,184,69,21,20,294
786479439,65,3,30,1,99
786479641,43,36,27,3,109
786489434,102,21,3,1,127
786501450,19,3,2,1,25
786504879,11,15,15,1,42
786515117,34,3,2,1,40
786517037,102,3,2,1,108
786517616,134,22,2,8,166
786519670,63,43,122,10,238
786523163,14,13,2,1,30
786523455,43,14,29,1,87
786528198,256,15,2,1,274
786536781,57,47,2,3,109
786536793,26,19,2,6,53
786537990,129,74,29,4,236
786543610,25,3,2,1,31
786551825,32,52,38,20,142
786561293,89,35,71,1,196
786570834,28,41,13,9,91
786570855,87,13,3,1,104
786584328,10,4,2,1,17
786602915,54,66,34,48,202
786606492,16,11,2,1,30
786611536,43,8,2,3,56
786623052,93,50,3,1,147
786639313,11,3,2,1,17
786658484,111,3,2,8,124
786684035,20,36,9,5,70
786686688,87,12,2,5,106
786688467,59,3,2,2,66
786688592,27,3,2,1,33
786689113,111,32,71,9,223
786706936,47,16,3,3,69
786715461,85,7,2,1,95
786725701,94,33,4,5,136
786728033,1004,3,2,6,1015
786757212,165,3,2,2,172
786759494,64,32,26,1,123
786765444,21,3,2,1,27
786768436,43,21,5,5,74
786770380,81,27,45,21,174
786779260,67,14,2,65,148
786780014,13,3,2,1,19
786791421,25,3,2,1,31
786792632,82,3,2,7,94
786810320,45,12,8,13,78
786829675,19,8,2,1,30
786836003,20,3,2,2,27
786837160,165,22,10,2,199
786839242,62,50,2,5,119
786841364,53,12,5,3,73
786857557,60,3,2,1,66
786858712,13,7,2,1,23
786859121,60,3,2,1,66
786868793,123,24,19,39,205
786871649,35,30,11,10,86
786878648,50,25,20,1,96
786883721,167,3,2,6,178
786891356,137,24,63,1,225
786904405,70,13,26,1,110
786910766,133,15,11,4,163
786922905,76,24,2,3,105
786928852,59,19,2,2,82
786929734,69,3,2,1,75
786932198,96,21,2,1,120
786940282,66,10,2,10,88
786949576,72,39,6,13,130
786949747,80,31,6,3,120
786966064,47,8,3,2,60
786977189,47,8,14,2,71
787000685,41,3,2,1,47
787034153,61,17,9,1,88
787034533,64,30,10,1,105
787035484,11,3,2,1,17
787041549,67,99,2,1,169
787041577,41,20,16,1,78
787050187,92,62,2,14,170
787063429,16,3,2,1,22
787071429,16,3,2,1,22
787084281,42,21,3,1,67
787087175,196,47,45,11,299
787103957,139,17,100,15,271
787105984,43,36,30,2,111
787116422,68,5,2,2,77
787122652,10,14,2,1,27
787150108,145,4,14,4,167
787169688,129,43,2,1,175
787170242,54,31,28,10,123
787175856,10,6,2,1,19
787176413,36,32,7,2,77
787191515,91,31,2,12,136
787194498,13,44,6,1,64
787200632,102,31,3,3,139
787224760,118,34,2,1,155
787257099,11,3,2,1,17
787279943,24,3,2,1,30
787284551,96,3,2,1,102
787298519,101,51,60,5,217
787299686,88,3,2,3,96
787302811,36,3,2,3,44
787307219,162,33,24,33,252
787319856,77,33,7,1,118
787320827,37,14,6,13,70
787321285,108,3,13,10,134
787323343,16,29,2,1,48
787331449,17,3,2,1,23
787339168,117,31,35,23,206
787344068,49,17,2,2,70
787344619,66,3,2,1,72
787354017,12,24,2,3,41
787365365,207,58,2,1,268
787368228,38,50,38,12,138
787372800,90,3,2,1,96
787384911,48,3,2,1,54
787387547,18,3,2,2,25
787393404,46,78,39,1,164
787396438,161,4,2,7,174
787412492,23,14,2,1,40
787418454,165,3,2,2,172
787426812,115,4,2,3,124
787440604,401,25,8,1,435
787440696,20,13,2,1,36
787443265,10,6,2,1,19
787446889,101,20,2,9,132
787459110,239,4,2,2,247
787474150,49,4,2,1,56
787475702,145,3,2,7,157
787478089,48,3,2,1,54
787480438,138,3,2,5,148
787482356,14,11,4,2,31
787489074,214,18,2,3,237
787496368,62,3,2,10,77
787506211,46,29,10,8,93
787509484,38,3,2,2,45
787515471,101,3,2,1,107
787518931,36,3,2,1,42
787526773,27,19,14,10,70
787527325,11,3,2,1,17
787560977,11,5,2,1,19
787561261,57,3,2,5,67
787594240,11,3,2,1,17
787616668,12,3,2,1,18
787623935,18,3,2,1,24
787626003,32,22,9,6,69
787634793,76,27,38,33,174
787650884,107,3,2,8,120
787660319,164,3,2,1,170
787661232,38,27,13,1,79
787664024,87,3,2,2,94
787670912,234,3,2,4,243
787685148,46,11,7,7,71
787691092,115,3,2,1,121
787695553,59,53,88,36,236
787702341,17,3,2,1,23
787710032,141,29,30,2,202
787718849,68,23,2,9,102
787719380,262,54,2,9,327
787733836,77,79,50,45,251
787738399,50,27,37,26,140
787753995,15,3,2,1,21
787754421,10,7,2,2,21
787761710,102,34,27,4,167
787769287,88,33,11,9,141
787775910,69,27,8,121,225
787779752,41,16,2,1,60
787780146,101,21,3,3,128
787784490,123,57,39,25,244
787824951,81,19,17,6,123
787852557,24,54,15,1,94
787868705,30,21,9,1,61
787882350,115,34,32,8,189
787884439,72,62,2,5,141
787891659,138,23,17,1,179
787902492,139,53,18,13,223
787911218,14,11,2,1,28
787912320,22,4,6,5,37
787914672,187,47,3,12,249
787919122,171,49,83,62,365
787926439,45,43,8,4,100
787935799,42,19,28,2,91
787946359,36,17,13,6,72
787953357,40,37,2,20,99
787971769,28,15,2,1,46
787975682,84,52,89,1,226
787980724,25,12,2,1,40
787992731,147,3,2,4,156
787994037,39,5,2,1,47
787997502,183,3,2,3,191
788014062,39,33,80,8,160
788020907,46,13,28,29,116
788055499,13,3,2,4,22
788058553,123,3,32,4,162
788071134,22,69,11,3,105
788079321,16,16,2,1,35
788095130,44,12,11,1,68
788103321,23,3,2,1,29
788121160,36,19,2,1,58
788139820,97,3,2,38,140
788142332,25,3,2,1,31
788159869,121,3,2,1,127
788202659,126,3,2,5,136
788203064,70,3,2,1,76
788218826,84,47,3,3,137
788220045,33,3,2,1,39
788238975,60,19,2,7,88
788244925,86,19,2,2,109
788273995,19,34,2,1,56
788286415,14,3,2,1,20
788287392,119,22,2,2,145
788290793,39,3,2,1,45
788308408,55,11,30,1,97
788317233,226,3,2,22,253
788339142,120,32,41,16,209
788342592,18,3,2,1,24
788352718,65,6,47,4,122
788360442,39,18,3,3,63
788364250,82,3,2,1,88
788369288,96,3,2,15,116
788373254,14,3,2,7,26
788389834,19,3,2,1,25
788403979,13,3,2,3,21
788433066,91,3,2,11,107
788446570,19,9,2,1,31
788453948,49,6,2,5,62
788455512,58,3,2,1,64
788459077,51,17,11,2,81
788462982,11,3,2,3,19
788470237,63,63,12,6,144
788493477,119,5,2,4,130
788494935,52,8,3,1,64
788504769,11,78,2,1,92
788524890,13,3,2,1,19
788527162,87,22,2,7,118
788544972,49,3,21,1,74
788547055,88,42,20,7,157
788553926,44,39,12,1,96
788559073,47,9,3,6,65
788562606,44,34,2,6,86
788587374,14,12,19,78,123
788597588,77,3,2,1,83
788597952,35,13,2,2,52
788624176,55,3,2,1,61
788628241,14,5,6,1,26
788632596,92,55,19,20,186
788634838,134,33,2,28,197
788639677,43,51,5,2,101
788640310,123,28,2,24,177
788648239,10,10,2,1,23
788676857,33,58,2,1,94
788687859,10,10,2,3,25
788704302,94,42,14,3,153
788715414,36,26,3,1,66
788721582,62,3,2,1,68
788722590,38,3,2,7,50
788745117,210,3,2,3,218
788760408,144,38,47,5,234
788762916,38,36,63,22,159
788764015,98,24,6,5,133
788768835,28,3,2,3,36
788783927,74,3,2,3,82
788786613,126,26,3,10,165
788796188,28,99,38,17,182
788796350,16,3,2,1,22
788797444,42,42,37,14,135
788824628,162,11,2,5,180
788826062,41,53,27,2,123
788826113,45,73,10,19,147
788828537,36,145,18,1,200
788830008,11,3,2,1,17
788840520,89,6,2,1,98
788849920,11,3,2,1,17
788873177,30,3,2,1,36
788887021,20,4,2,12,38
788888547,61,17,3,20,101
788893992,64,21,2,1,88
788895848,22,17,2,11,52
788898088,176,82,3,8,269
788915698,89,3,2,5,99
788917281,11,7,2,1,21
788920707,58,25,39,1,123
788922071,15,3,2,1,21
788936783,13,3,2,1,19
788938190,64,3,2,3,72
788938941,70,9,29,1,109
788954392,16,17,2,4,39
788964586,23,27,2,1,53
788984568,41,34,20,2,97
788989745,14,17,15,9,55
788991097,73,3,2,1,79
789006679,64,46,36,16,162
789013642,16,11,6,7,40
789050543,26,14,3,11,54
789064266,13,3,2,1,19
789077226,117,5,2,2,126
789080534,83,5,2,1,91
789134388,54,15,6,1,76
789146475,45,7,118,5,175
789158574,52,35,16,11,114
789178209,71,12,32,1,116
789195220,31,3,2,1,37
789209317,86,21,2,1,110
789218896,121,43,9,45,218
789229468,45,3,2,1,51
789272471,131,47,48,24,250
789275903,16,3,2,1,22
789290188,56,17,40,51,164
789300456,45,3,2,1,51
789317743,103,7,35,23,168
789318984,23,111,20,1,155
789319903,210,27,3,2,242
789324342,41,3,2,1,47
789324912,21,11,2,1,35
789355819,81,25,6,6,118
789363694,67,3,3,2,75
789370052,28,45,21,1,95
789377215,151,3,2,1,157
789381999,10,7,2,1,20
789389237,76,10,2,7,95
789393229,163,16,54,17,250
789408965,10,3,2,2,17
789415803,186,25,5,14,230
789437583,11,5,2,1,19
789455438,12,5,2,1,20
789466578,59,11,2,3,75
789471918,23,12,5,1,41
789504993,32,35,45,4,116
789514376,704,15,2,19,740
789516024,43,38,40,1,122
789519493,94,3,2,1,100
789533610,28,40,2,7,77
789562646,264,3,2,15,284
789577644,48,3,2,30,83
789582791,98,22,2,1,123
789592828,16,23,43,1,83
789595976,12,3,2,1,18
789596619,27,4,3,19,53
789618305,102,66,53,1,222
789643258,100,63,39,9,211
789650464,82,3,2,1,88
789659269,19,26,5,2,52
789662401,110,8,20,105,243
789668311,327,3,2,49,381
789673601,31,11,2,16,60
789688706,13,3,2,3,21
789691442,96,3,2,1,102
789693754,10,5,2,1,18
789694907,89,82,60,4,235
789695012,31,8,2,8,49
789698480,33,20,2,1,56
789704469,54,3,2,1,60
789714714,32,7,2,17,58
789727710,50,18,2,3,73
789730580,23,3,2,5,33
789734959,46,40,32,1,119
789737899,58,29,9,9,105
789751753,118,18,27,15,178
789755449,33,9,24,1,67
789756541,60,3,2,1,66
789763979,111,3,2,1,117
789764420,28,32,2,2,64
789768640,19,57,44,2,122
789773562,25,3,2,11,41
789774904,56,54,3,2,115
789785774,70,51,18,16,155
789787560,22,3,2,1,28
789791300,12,3,2,1,18
789797197,17,16,2,8,43
789824095,131,31,2,11,175
789827450,57,3,2,1,63
789828535,22,3,2,1,28
789828617,422,3,2,11,438
789828879,70,34,5,1,110
789830023,29,19,2,1,51
789845133,48,12,2,5,67
789848310,13,28,2,3,46
789853007,54,23,12,5,94
789855560,16,3,2,4,25
789860921,68,24,38,1,131
789886292,22,18,2,1,43
789890844,46,3,2,1,52
789894145,25,28,2,3,58
789896579,61,24,3,5,93
789905291,14,49,2,2,67
789915074,57,3,2,1,63
789918719,121,51,133,15,320
789919226,85,3,2,1,91
789926927,14,14,2,10,40
789928179,24,49,21,4,98
789929820,25,13,5,14,57
789931245,134,3,2,3,142
789956695,33,30,3,6,72
789969015,135,52,4,20,211
789979860,133,14,34,1,182
789980786,120,47,31,100,298
789987575,35,3,2,1,41
789989210,13,13,2,1,29
789992297,62,86,2,1,151
790002193,11,3,2,1,17
790013985,48,29,2,1,80
790021042,89,3,2,3,97
790022604,20,34,3,1,58
790034114,54,12,2,4,72
790060676,36,38,4,13,91
790076407,99,64,2,5,170
790084578,51,15,2,10,78
790086029,17,3,2,1,23
790087391,14,3,2,1,20
790089975,27,3,2,1,33
790092302,44,48,6,1,99
790096835,27,59,3,2,91
790115115,150,3,2,1,156
790125758,59,47,39,9,154
790126074,60,32,2,1,95
790141511,82,4,2,1,89
790148723,27,3,2,1,33
790150396,19,3,2,1,25
790167395,36,13,12,2,63
790170149,33,3,4,1,41
790170760,10,3,2,2,17
790194940,23,3,2,10,38
790209099,116,3,2,1,122
790209387,13,3,2,1,19
790213606,14,3,2,1,20
790225971,151,40,19,2,212
790228682,11,5,3,2,21
790240785,47,58,2,1,108
790252789,46,13,3,12,74
790259294,20,23,9,1,53
790262345,67,72,10,58,207
790266263,50,31,47,6,134
790267411,75,3,2,1,81
790270806,24,3,2,1,30
790275455,13,3,2,1,19
790286875,21,3,2,1,27
790288236,14,3,2,1,20
790303421,14,21,2,5,42
790327312,10,6,2,1,19
790327886,17,3,2,1,23
790328808,20,16,3,2,41
790369259,92,14,51,1,158
790373449,67,7,2,2,78
790377701,24,14,18,9,65
790406552,68,3,2,1,74
790412370,61,3,2,4,70
790426358,145,3,2,1,151
790430887,27,18,2,7,54
790432294,52,20,29,3,104
790445707,14,3,2,1,20
790451032,11,3,2,1,17
790452885,21,18,13,9,61
790455617,39,11,2,4,56
790456194,86,32,6,2,126
790466663,41,24,3,1,69
790467989,13,5,2,1,21
790476970,46,34,4,3,87
790491409,59,25,8,5,97
790505712,11,12,2,3,28
790511201,30,25,3,3,61
790523302,156,18,2,16,192
790529704,13,3,2,1,19
790542840,122,18,2,2,144
790566607,13,4,5,10,32
790570901,16,12,2,11,41
790581123,53,48,2,9,112
790582114,108,71,16,3,198
790591773,59,25,16,2,102
790592443,11,3,2,1,17
790592451,46,13,14,16,89
790598621,33,9,2,17,61
790626191,46,27,12,27,112
790628103,43,3,2,1,49
790638790,11,17,2,1,31
790641853,11,3,2,1,17
790670759,27,3,2,1,33
790681698,34,28,7,52,121
790690009,111,9,2,1,123
790691099,194,22,8,2,226
790713959,189,7,5,3,204
790728297,340,3,2,7,352
790737759,88,20,2,3,113
790763420,13,9,2,1,25
790796846,37,3,2,1,43
790798352,116,50,40,19,225
790808141,89,82,2,1,174
790809186,76,16,11,1,104
790811017,30,25,2,2,59
790820993,16,20,2,1,39
790823689,26,52,6,4,88
790830572,216,12,2,1,231
790842407,19,3,2,1,25
790844845,22,12,2,1,37
790856896,116,38,2,10,166
790857324,19,12,2,1,34
790862689,10,4,2,1,17
790867133,81,3,2,4,90
790868939,27,20,10,2,59
790870934,33,17,2,1,53
790877730,11,10,2,3,26
790879169,15,6,2,2,25
790882606,28,34,40,3,105
790888906,53,8,6,2,69
790890696,24,12,8,22,66
790896407,28,56,14,3,101
790899005,159,72,2,2,235
790913732,276,64,72,16,428
790918965,30,38,9,1,78
790934722,72,89,8,1,170
790937897,68,41,41,3,153
790971394,46,24,27,18,115
790990925,13,40,3,8,64
790991119,12,14,9,1,36
790995571,11,3,2,1,17
791000969,34,22,3,20,79
791003632,41,17,4,3,65
791007191,87,80,12,7,186
791020874,27,3,2,1,33
791025210,26,13,3,1,43
791037250,50,21,26,1,98
791043007,62,26,2,1,91
791053311,92,100,40,72,304
791061232,24,3,2,6,35
791067207,21,3,2,2,28
791070015,79,3,2,1,85
791076721,30,26,7,5,68
791092329,91,19,2,18,130
791111414,52,86,24,15,177
791113062,11,13,4,1,29
791123343,12,3,2,1,18
791134468,62,18,2,1,83
791167182,116,18,2,7,143
791168531,153,25,63,61,302
791173228,109,4,2,1,116
791177962,17,3,2,1,23
791202614,61,37,72,1,171
791205979,173,18,2,19,212
791211696,91,3,2,6,102
791221648,35,17,11,1,64
791247165,41,25,34,68,168
791247573,18,29,2,1,50
791259808,31,84,14,1,130
791262122,20,8,8,19,55
791269761,10,3,2,2,17
791276145,16,11,7,1,35
791308126,31,3,2,4,40
791309803,78,31,2,1,112
791315227,25,14,2,3,44
791324985,38,3,2,6,49
791327159,12,3,2,1,18
791330841,58,3,2,6,69
791332775,197,9,2,1,209
791364910,75,45,31,1,152
791373827,47,50,75,4,176
791377060,107,25,80,2,214
791377785,13,28,2,1,44
791379530,110,12,2,4,128
791390224,11,32,2,1,46
791393584,15,8,5,1,29
791398745,37,3,2,2,44
791398846,40,27,22,2,91
791401658,31,19,23,28,101
791402542,12,24,2,1,39
791452197,44,12,2,1,59
791460069,182,43,179,9,413
791468513,62,13,5,21,101
791472546,52,10,11,1,74
791479142,28,3,2,1,34
791486972,128,33,47,2,210
791492677,21,3,2,1,27
791506096,39,58,2,3,102
791508624,63,38,3,17,121
791509568,13,3,2,2,20
791517935,77,3,14,1,95
791532392,13,3,2,1,19
791534726,85,6,2,4,97
791553486,23,9,2,8,42
791574074,70,27,2,9,108
791575317,16,33,7,1,57
791579508,18,3,2,1,24
791597950,20,37,4,1,62
791606052,12,12,2,1,27
791614428,151,39,48,46,284
791644861,67,49,23,43,182
791651854,10,3,2,5,20
791656842,73,19,42,49,183
791660123,104,83,31,47,265
791674803,24,3,2,1,30
791685230,36,146,2,1,185
791685459,77,27,26,16,146
791693807,18,3,2,2,25
791717661,13,27,2,1,43
791723409,15,18,14,1,48
791733789,148,30,2,2,182
791734672,85,7,4,1,97
791737767,60,75,7,30,172
791741688,68,19,2,1,90
791743014,130,13,18,6,167
791754324,64,5,2,1,72
791757490,94,46,24,1,165
791760703,19,3,2,1,25
791760956,74,30,59,22,185
791761497,35,21,2,2,60
791764893,101,17,16,1,135
791770296,244,42,2,14,302
791772057,97,3,2,1,103
791773600,208,10,27,3,248
791797784,64,5,3,1,73
791822573,82,34,11,3,130
791835468,168,57,2,23,250
791842226,80,3,2,1,86
791852635,57,64,48,13,182
791862938,19,26,6,2,53
791868347,42,11,2,1,56
791875950,151,32,20,4,207
791876282,60,21,2,9,92
791884527,51,17,5,8,81
791893485,111,82,3,5,201
791903558,23,3,2,1,29
791904481,181,8,2,5,196
791912477,47,3,2,4,56
791915388,67,3,21,1,92
791919639,16,10,2,1,29
791922218,17,20,29,3,69
791923626,31,5,33,1,70
791944113,28,3,2,2,35
791950841,16,3,2,1,22
791951226,23,20,43,13,99
791952272,13,3,2,5,23
791971540,138,3,2,2,145
791991447,11,3,2,1,17
791992178,14,3,2,1,20
791997523,48,38,14,23,123
792007094,95,41,21,2,159
792028105,73,6,2,11,92
792046430,113,25,45,36,219
792051941,11,3,2,1,17
792055714,10,12,2,1,25
792071078,155,41,4,19,219
792073515,113,22,3,18,156
792074528,10,45,2,1,58
792079626,155,25,2,1,183
792084798,24,17,2,1,44
792087496,48,55,5,2,110
792088776,48,16,2,2,68
792109905,164,3,2,5,174
792112046,191,3,2,3,199
792121026,10,6,2,1,19
792138881,49,36,15,2,102
792141744,130,69,9,13,221
792147892,53,3,2,1,59
792152920,26,24,7,1,58
792168298,36,26,6,1,69
792179760,46,63,18,35,162
792183995,42,10,2,1,55
792189376,197,33,2,9,241
792204813,38,30,2,1,71
792223629,23,10,2,2,37
792243824,28,43,28,4,103
792254418,43,3,2,1,49
792287773,31,18,15,1,65
792295067,99,38,40,10,187
792311030,68,3,2,2,75
792326766,305,3,2,33,343
792329721,84,21,159,1,265
792339652,225,3,2,2,232
792348489,61,14,25,28,128
792348538,15,4,2,1,22
792348773,10,4,2,1,17
792370024,72,37,30,1,140
792372389,68,3,2,1,74
792399348,27,29,2,5,63
792446381,16,7,2,1,26
792455044,76,4,4,2,86
792462398,46,11,2,18,77
792463183,12,4,2,1,19
792476893,42,81,17,3,143
792479475,46,3,2,3,54
792491496,75,14,12,4,105
792520891,140,15,2,1,158
792523277,92,35,2,2,131
792524791,52,3,2,1,58
792528062,12,3,2,2,19
792530005,109,8,48,2,167
792530971,20,22,14,1,57
792532286,52,32,13,13,110
792532455,17,8,2,3,30
792554192,119,12,3,1,135
792554276,11,16,2,3,32
792555399,100,22,23,5,150
792555570,12,3,2,1,18
792558140,10,3,2,2,17
792572447,73,3,2,1,79
792574674,47,42,3,1,93
792590893,54,16,2,2,74
792605706,150,3,2,1,156
792615231,117,4,2,8,131
792617716,80,15,3,1,99
792628471,37,19,2,2,60
792630604,82,3,2,1,88
792634763,45,6,2,8,61
792643023,111,27,6,3,147
792663555,175,14,2,3,194
792670227,70,3,2,7,82
792674418,117,19,2,9,147
792676564,84,26,27,1,138
792684498,1370,3,2,2,1377
792686543,53,33,7,11,104
792693144,146,65,49,1,261
792700057,54,3,6,1,64
792709275,98,15,26,45,184
792717196,74,44,83,2,203
792718199,77,55,37,3,172
792723834,117,3,2,4,126
792750857,11,30,2,1,44
792783621,40,40,49,1,130
792792865,43,29,12,1,85
792806001,121,34,10,19,184
792827742,168,3,2,2,175
792830080,100,28,13,4,145
792833580,139,3,2,1,145
792837675,57,24,3,2,86
792850209,95,21,36,27,179
792850891,81,9,50,1,141
792856673,90,25,7,3,125
792870150,81,19,28,58,186
792877184,53,3,2,16,74
792895848,17,3,5,1,26
792903663,93,26,32,22,173
792913705,49,38,69,3,159
792930342,107,9,3,2,121
792944233,167,12,4,3,186
792951629,13,18,2,1,34
792951858,10,6,2,1,19
792958905,94,26,21,1,142
792961065,38,71,42,13,164
792962613,20,5,2,3,30
792964922,32,32,2,2,68
792979693,22,18,10,1,51
792980829,101,27,60,3,191
792997251,61,21,40,27,149
792998154,10,4,2,1,17
793001397,15,21,2,1,39
793001643,18,42,16,2,78
793002440,70,4,2,9,85
793008285,88,21,2,3,114
793011899,93,46,113,45,297
793035258,15,3,2,1,21
793040359,64,3,2,3,72
793048254,43,32,10,1,86
793053344,113,46,3,8,170
793060539,31,36,3,1,71
793077726,98,11,2,1,112
793078110,10,3,2,3,18
793084317,128,54,2,2,186
793093205,22,3,2,1,28
793127162,21,3,2,1,27
793131361,89,82,4,6,181
793142128,16,5,2,1,24
793167137,166,20,2,12,200
793174041,52,19,42,13,126
793196163,42,3,2,1,48
793205654,59,9,2,11,81
793206967,42,9,2,3,56
793207039,36,12,2,6,56
793216131,30,8,11,24,73
793219468,16,34,2,1,53
793220532,51,62,3,23,139
793222490,17,3,2,1,23
793225298,158,61,70,28,317
793226118,106,3,2,1,112
793234777,81,17,14,23,135
793237836,61,3,2,3,69
793238501,12,3,2,1,18
793255731,24,12,58,4,98
793255933,36,19,4,2,61
793263809,40,48,56,1,145
793265396,23,113,38,3,177
793270100,15,3,3,1,22
793280810,11,3,2,1,17
793299098,15,22,2,1,40
793315054,118,13,17,14,162
793322318,25,3,2,1,31
793330857,213,3,2,51,269
793332855,51,35,21,94,201
793338038,30,31,31,2,94
793341642,32,24,19,14,89
793342076,26,14,2,3,45
793368232,100,46,87,2,235
793372129,14,3,2,1,20
793433295,76,3,2,1,82
793450926,97,29,35,18,179
793471085,78,9,2,2,91
793472856,81,12,2,19,114
793476281,138,11,2,4,155
793492435,18,34,4,1,57
793514322,12,16,2,1,31
793531926,10,30,2,1,43
793538611,32,24,18,5,79
793540891,52,7,16,1,76
793555726,74,8,8,1,91
793563816,155,26,2,2,185
793576789,120,27,3,9,159
793596346,20,3,2,1,26
793604130,14,3,2,1,20
793616960,122,42,2,1,167
793627926,10,5,2,1,18
793646601,91,9,17,15,132
793654459,31,3,2,1,37
793654506,126,30,4,3,163
793655549,95,3,2,4,104
793658622,13,15,2,1,31
793666287,10,37,2,1,50
793669493,26,33,2,6,67
793682859,30,3,2,1,36
793693585,124,3,2,2,131
793695447,72,15,2,6,95
793713478,44,3,3,2,52
793715218,12,6,2,1,21
793732592,50,14,11,2,77
793737355,60,20,2,1,83
793738034,38,19,3,1,61
793746323,75,48,2,8,133
793748501,25,14,3,1,43
793752145,50,3,2,1,56
793756883,16,14,2,1,33
793764267,17,3,2,1,23
793771902,10,32,2,1,45
793778204,160,19,2,16,197
793781564,11,3,2,1,17
793790853,99,19,17,32,167
793821914,14,12,2,1,29
793822279,31,29,7,3,70
793827478,35,62,86,32,215
793841099,62,16,2,6,86
793841425,52,5,30,9,96
793859681,14,16,15,29,74
793882186,193,31,35,9,268
793901086,11,3,2,1,17
793902319,61,38,14,1,114
793904971,93,3,2,14,112
793909924,27,84,2,5,118
793910667,69,4,15,2,90
793916941,137,17,2,1,157
793917201,18,3,9,3,33
793927560,41,137,2,1,181
793929281,12,5,2,2,21
793940672,151,34,53,10,248
793943299,69,65,65,10,209
793959489,24,38,2,1,65
794007420,15,9,2,1,27
794008457,190,25,17,5,237
794021213,77,3,2,1,83
794027300,99,3,2,7,111
794052283,15,3,2,1,21
794076354,43,24,2,95,164
794107223,59,13,2,3,77
794139592,77,18,2,1,98
794147598,11,3,2,1,17
794156757,76,7,69,20,172
794162269,15,13,7,1,36
794181133,281,141,11,10,443
794184305,24,3,2,4,33
794198894,128,56,19,100,303
794204338,87,31,29,1,148
794207434,57,12,2,1,72
794211483,53,51,2,1,107
794220169,68,15,2,5,90
794232299,185,10,2,13,210
794243294,44,32,7,11,94
794251557,41,3,2,16,62
794265679,110,3,2,1,116
794269047,38,18,2,3,61
794295438,100,16,59,7,182
794299059,88,3,2,1,94
794300829,35,43,3,1,82
794311184,41,20,9,1,71
794314530,16,18,2,1,37
794320356,151,25,63,3,242
794331830,80,26,61,10,177
794365456,35,22,16,13,86
794412889,29,54,2,1,86
794445390,41,4,2,3,50
794447451,20,3,2,1,26
794449559,62,50,54,86,252
794452194,95,26,60,3,184
794453431,11,9,2,1,23
794487790,120,81,130,6,337
794489351,10,3,2,2,17
794489688,54,30,20,1,105
794515738,41,3,2,3,49
794527822,86,5,19,7,117
794527936,91,38,37,1,167
794530494,27,12,10,1,50
794534777,21,51,12,1,85
794538141,90,19,16,4,129
794568640,12,3,2,1,18
794588478,54,15,2,2,73
794591145,30,3,2,1,36
794596255,57,58,3,1,119
794603544,14,3,2,1,20
794617265,60,90,56,10,216
794626101,20,5,2,1,28
794638910,11,37,2,1,51
794660470,12,3,2,1,18
794677546,63,3,2,1,69
794678898,92,46,40,22,200
794678925,84,17,4,3,108
794695352,36,3,2,9,50
794741484,32,21,58,1,112
794753361,48,15,3,1,67
794779753,29,32,3,1,65
794781734,23,7,2,4,36
794802171,10,14,2,2,28
794812593,14,49,9,1,73
794823088,76,11,2,2,91
794839616,64,3,2,22,91
794866414,74,22,13,2,111
794874399,67,35,12,3,117
794884844,32,3,30,1,66
794884955,156,28,73,7,264
794895656,82,43,4,17,146
794901080,109,9,9,4,131
794914504,50,11,4,1,66
794918439,95,3,2,1,101
794920351,64,3,2,1,70
794927074,66,19,8,1,94
794930022,143,47,2,8,200
794937686,136,15,17,8,176
794941114,54,15,2,1,72
794944595,34,26,7,3,70
794948509,33,3,2,3,41
794951976,18,33,5,22,78
794953418,164,3,2,4,173
794970346,67,39,21,1,128
794988941,127,21,6,13,167
794990277,14,3,2,2,21
795001738,59,6,2,2,69
795001935,44,3,2,1,50
795014233,16,3,2,1,22
795022241,11,3,2,1,17
795025907,103,3,2,2,110
795037975,43,28,7,6,84
795051983,115,12,80,70,277
795053592,71,22,2,1,96
795053812,115,3,2,5,125
795061717,172,38,14,24,248
795075984,74,21,8,15,118
795081894,58,21,5,2,86
795098010,67,15,4,2,88
795116328,80,36,2,1,119
795116532,157,10,9,8,184
795122275,43,5,2,1,51
795127991,11,4,2,1,18
795131463,55,16,12,9,92
795140018,156,37,5,4,202
795155659,137,35,9,16,197
795156892,189,3,2,2,196
795169732,16,3,2,1,22
795185627,12,3,2,1,18
795185666,76,25,45,25,171
795189651,1580,3,2,99,1684
795191832,20,45,2,1,68
795199170,167,7,70,18,262
795228244,10,17,2,1,30
795230598,129,4,2,2,137
795232940,11,3,2,2,18
795240670,10,6,2,1,19
795241888,67,20,6,5,98
795248437,67,7,2,3,79
795249901,121,45,5,18,189
795259481,12,8,2,1,23
795262645,73,3,2,3,81
795268083,55,5,5,10,75
795268426,58,9,2,3,72
795273485,36,63,2,1,102
795274021,43,9,2,5,59
795275229,11,3,2,1,17
795278882,132,21,5,2,160
795284147,83,31,2,2,118
795317820,127,5,15,1,148
795351706,24,5,2,1,32
795359345,32,10,5,6,53
795372574,21,16,2,6,45
795372636,71,55,3,5,134
795374757,128,3,2,1,134
795383376,128,21,6,5,160
795386526,51,3,2,1,57
795389901,177,20,35,4,236
795395127,141,32,117,4,294
795398385,11,13,2,1,27
795399630,60,3,8,7,78
795404744,22,3,2,1,28
795430879,11,4,2,1,18
795432929,30,5,2,9,46
795440249,20,37,2,2,61
795441574,79,5,2,3,89
795458140,97,26,7,1,131
795472663,102,28,11,3,144
795472897,18,3,2,2,25
795476752,25,5,12,27,69
795493044,53,21,102,13,189
795493353,89,11,15,1,116
795509404,23,44,17,3,87
795513236,85,20,2,7,114
795517099,34,35,53,4,126
795526416,53,3,2,16,74
795529221,12,4,2,1,19
795546658,19,8,3,10,40
795565462,157,38,14,7,216
795573115,10,5,2,1,18
795582239,52,44,14,41,151
795607631,84,3,2,1,90
795610560,95,35,2,3,135
795616027,13,4,2,5,24
795633657,128,3,2,1,134
795635069,13,3,2,2,20
795649709,32,8,2,1,43
795660769,46,24,3,12,85
795670062,214,22,13,11,260
795675910,46,3,2,1,52
795678292,42,3,2,1,48
795681440,23,5,2,2,32
795695145,75,32,19,16,142
795698865,16,3,2,1,22
795702130,111,3,3,1,118
795705759,105,3,18,7,133
795707121,25,14,2,2,43
795726564,52,7,16,15,90
795744011,62,17,13,8,100
795745793,30,3,2,1,36
795756443,11,3,2,2,18
795782424,21,7,9,4,41
795798600,101,46,5,5,157
795809249,11,37,2,5,55
795809974,21,21,6,1,49
795835790,146,6,2,1,155
795837530,102,3,2,1,108
795839326,85,22,2,13,122
795840879,31,22,2,1,56
795845440,94,41,56,7,198
795847976,134,3,2,1,140
795852738,66,39,9,1,115
795872100,17,29,2,1,49
795895519,15,3,2,1,21
795897612,66,6,2,5,79
795911496,115,330,2,3,450
795917141,10,35,2,1,48
795919772,11,3,2,1,17
795945685,11,3,2,1,17
795952905,25,3,2,1,31
795953900,179,49,56,37,321
795961879,33,17,6,1,57
795972114,14,3,2,1,20
795977529,35,8,2,1,46
795992092,57,16,2,8,83
796000420,20,11,2,1,34
796018109,112,18,30,1,161
796029603,56,3,2,1,62
796036270,53,26,13,2,94
796038947,23,30,2,4,59
796044181,22,3,2,2,29
796054012,35,59,39,3,136
796058990,22,3,2,6,33
796064515,205,26,2,11,244
796071011,167,27,3,2,199
796080298,46,36,2,15,99
796084274,61,3,2,1,67
796106655,15,23,7,7,52
796128732,61,8,36,29,134
796134036,16,3,2,2,23
796138345,52,32,17,42,143
796147635,22,3,2,1,28
796149390,53,8,2,1,64
796154199,11,3,2,1,17
796154200,95,3,2,1,101
796161137,99,19,4,2,124
796175756,14,23,2,1,40
796177111,81,105,30,11,227
796179179,44,8,3,2,57
796194425,96,20,40,8,164
796194530,81,3,2,1,87
796194596,14,16,2,1,33
796194817,33,28,12,1,74
796199676,30,22,2,1,55
796214838,23,14,6,27,70
796224725,12,7,2,1,22
796232739,43,3,2,3,51
796235716,100,72,8,13,193
796240491,91,27,2,12,132
796247006,38,19,26,16,99
796248545,32,11,2,8,53
796250532,67,55,57,8,187
796264690,67,4,21,4,96
796275829,54,3,2,1,60
796287270,15,23,7,4,49
796288042,35,9,2,12,58
796313815,39,78,27,21,165
796320398,20,3,2,2,27
796334555,22,3,2,1,28
796351428,19,15,2,1,37
796355485,38,20,2,1,61
796355571,17,20,9,1,47
796358070,11,3,2,1,17
796364271,11,8,10,1,30
796366900,133,18,10,7,168
796399153,88,18,19,7,132
796417508,67,42,16,16,141
796427093,11,13,2,3,29
796432702,120,3,2,31,156
796455556,118,30,2,6,156
796467824,114,7,2,1,124
796471896,59,9,11,4,83
796490355,28,8,2,1,39
796490570,36,18,2,1,57
796493559,101,14,21,1,137
796495942,201,19,11,4,235
796503675,10,5,2,1,18
796504766,54,20,6,11,91
796515027,10,4,2,1,17
796520730,18,15,2,1,36
796529951,50,7,32,3,92
796546816,35,28,3,6,72
796549526,19,3,2,1,25
796556420,131,3,2,4,140
796562442,24,25,3,3,55
796575406,106,34,25,1,166
796579803,35,3,2,1,41
796584767,48,66,2,3,119
796615467,31,71,24,4,130
796618775,52,3,2,1,58
796621979,113,17,11,21,162
796624145,45,88,2,13,148
796633639,166,11,3,7,187
796639083,72,11,9,3,95
796642519,12,8,2,2,24
796647321,29,71,20,3,123
796650956,12,3,2,4,21
796651608,153,10,6,42,211
796670746,61,6,2,1,70
796674100,49,20,2,6,77
796676540,23,14,2,1,40
796679280,10,3,2,3,18
796681936,21,20,2,1,44
796683468,48,19,2,1,70
796689690,303,35,20,7,365
796692699,116,3,2,1,122
796700917,67,3,2,1,73
796709972,84,24,33,2,143
796717381,41,10,2,1,54
796717589,93,63,121,33,310
796723082,108,57,41,8,214
796725537,102,3,2,1,108
796743875,252,262,34,32,580
796762315,90,3,2,1,96
796800929,191,3,2,1,197
796805653,63,27,22,3,115
796807918,171,12,2,9,194
796823748,23,18,2,1,44
796825918,132,3,2,1,138
796829495,23,3,2,12,40
796833144,84,3,2,3,92
796843803,186,3,2,2,193
796852310,45,63,12,14,134
796859367,53,15,8,1,77
796869184,25,14,2,1,42
796882439,34,114,36,10,194
796895081,16,42,2,1,61
796903304,99,19,11,1,130
796904587,103,14,146,27,290
796920886,39,57,3,2,101
796928849,121,3,2,17,143
796940304,95,41,7,21,164
796940375,24,11,9,15,59
796950594,65,27,7,1,100
796966494,43,30,3,2,78
796979821,63,3,2,1,69
796983312,70,30,22,4,126
796990335,13,3,2,2,20
797003015,14,18,2,19,53
797007100,44,14,2,1,61
797007860,134,65,33,7,239
797008250,20,16,9,1,46
797040126,82,61,4,1,148
797061769,26,28,2,1,57
797063331,13,3,2,1,19
797063503,21,3,2,2,28
797086323,40,18,29,4,91
797110813,16,15,2,1,34
797122826,22,17,2,4,45
797128728,38,18,11,12,79
797137181,22,3,2,1,28
797137286,47,31,2,1,81
797161112,10,4,2,1,17
797163685,54,3,2,9,68
797169804,68,8,6,5,87
797177531,15,3,2,1,21
797179976,67,3,2,11,83
797183033,11,3,2,2,18
797198187,37,14,2,4,57
797218108,15,12,2,1,30
797223573,99,16,9,1,125
797239486,13,14,2,1,30
797260220,127,30,2,1,160
797280680,40,4,22,1,67
797282505,19,21,2,2,44
797293344,69,3,2,1,75
797308732,71,3,2,4,80
797322150,14,3,2,1,20
797329141,13,3,2,1,19
797344227,11,14,2,1,28
797351757,21,23,3,1,48
797352890,30,28,52,1,111
797363694,19,6,2,1,28
797373825,56,20,6,19,101
797382030,73,3,2,2,80
797386364,28,3,2,17,50
797393980,62,22,8,32,124
797402957,12,43,7,2,64
797429202,60,12,4,1,77
797430412,53,6,2,2,63
797454076,83,23,2,21,129
797461997,124,19,10,21,174
797478291,121,3,2,5,131
797478826,32,3,2,1,38
797483319,182,19,2,11,214
797484424,17,3,2,1,23
797492331,100,3,2,5,110
797503958,69,58,5,5,137
797506978,105,22,2,3,132
797513280,83,39,51,17,190
797519602,60,21,18,7,106
797521388,39,35,2,4,80
797537540,36,3,2,1,42
797545655,39,19,2,8,68
797553958,67,14,2,2,85
797557879,15,5,2,3,25
797558133,71,38,18,1,128
797563405,18,9,2,1,30
797574551,50,8,17,41,116
797576410,50,16,2,1,69
797591894,40,3,2,5,50
797610615,17,7,2,1,27
797613036,43,3,2,1,49
797631401,199,3,2,3,207
797631820,367,3,2,2,374
797634067,11,3,2,1,17
797644565,89,3,2,1,95
797645824,25,10,2,2,39
797661134,82,38,59,5,184
797666117,75,3,2,1,81
797676674,33,9,2,4,48
797680083,117,4,2,1,124
797697607,61,22,2,1,86
797731006,10,5,2,1,18
797742241,22,25,2,1,50
797749157,40,47,16,12,115
797757754,10,4,2,1,17
797782041,36,3,2,1,42
797784551,97,3,2,2,104
797804062,21,3,2,1,27
797814907,36,16,2,7,61
797814928,276,3,2,10,291
797818246,13,3,2,1,19
797843271,56,9,20,5,90
797859585,21,3,2,2,28
797878461,40,6,3,12,61
797884670,89,45,19,1,154
797893368,13,3,2,2,20
797903113,14,3,2,1,20
797915862,19,20,2,1,42
797922241,16,3,2,1,22
797931515,43,15,2,3,63
797931637,43,26,2,2,73
797934593,72,33,2,16,123
797946124,17,4,2,1,24
797956439,57,18,21,1,97
797969603,91,69,10,72,242
797977619,255,5,2,1,263
797990153,162,21,2,2,187
797992631,174,36,2,5,217
798001584,18,3,2,1,24
798003661,31,8,3,1,43
798014999,40,35,9,23,107
798028690,77,17,2,10,106
798038700,54,8,2,1,65
798068304,17,3,4,1,25
798073140,82,27,20,1,130
798091734,16,3,2,1,22
798093060,18,20,12,13,63
798100507,10,4,2,1,17
798111588,36,3,2,1,42
798115873,102,34,79,11,226
798116206,13,21,8,1,43
798128629,32,15,6,1,54
798143062,30,32,2,1,65
798152189,101,65,2,58,226
798164221,20,17,3,1,41
798189973,161,27,8,4,200
798211682,79,21,2,1,103
798215387,45,3,2,12,62
798218240,152,68,5,8,233
798229149,121,7,2,7,137
798234871,120,15,3,4,142
798247120,29,8,2,1,40
798251846,15,3,2,1,21
798252382,94,11,17,30,152
798265106,11,3,2,3,19
798266687,72,14,64,1,151
798279374,30,13,20,1,64
798295922,63,48,30,2,143
798296262,64,16,8,10,98
798307073,17,36,73,1,127
798308340,20,3,2,11,36
798308474,115,12,21,1,149
798313376,167,3,2,12,184
798321465,160,31,56,7,254
798324233,60,40,10,7,117
798325068,12,3,2,1,18
798333934,365,3,2,14,384
798337367,145,28,2,7,182
798346586,44,5,2,13,64
798355671,11,13,2,1,27
798360197,37,21,28,1,87
798361052,32,5,9,1,47
798361958,147,22,37,26,232
798367485,115,47,54,7,223
798371595,11,9,3,1,24
798373468,12,5,2,1,20
798377489,16,12,2,1,31
798384602,36,37,5,17,95
798405767,27,40,34,2,103
798409480,52,3,2,6,63
798417462,85,82,46,20,233
798434556,72,35,8,14,129
798448220,132,24,2,7,165
798484702,89,77,32,31,229
798486286,108,3,2,1,114
798492897,36,20,2,13,71
798504645,66,9,32,1,108
798517684,130,38,57,3,228
798525241,33,192,5,13,243
798525827,72,25,2,6,105
798529926,47,3,2,1,53
798535976,12,3,2,1,18
798538481,83,20,49,4,156
798551898,10,9,2,1,22
798562647,64,3,2,3,72
798563847,345,3,2,1,351
798572719,10,4,2,1,17
798573799,134,46,72,15,267
798574530,22,29,2,1,54
798584321,10,3,2,2,17
798592613,52,3,2,1,58
798593092,45,16,2,2,65
798594033,17,3,16,2,38
798629254,63,24,3,8,98
798637100,61,30,10,5,106
798649589,46,3,2,1,52
798651323,20,8,2,4,34
798671639,259,29,114,10,412
798676812,153,18,10,1,182
798681088,104,29,2,1,136
798701550,110,32,12,23,177
798702682,108,44,14,1,167
798704950,15,17,2,9,43
798712924,40,8,134,20,202
798716583,86,13,10,1,110
798717270,44,3,2,6,55
798728069,90,3,2,1,96
798736247,15,22,2,1,40
798748084,63,29,24,1,117
798761621,29,20,44,3,96
798765448,93,15,2,1,111
798778778,12,8,2,1,23
798795013,19,3,2,1,25
798803854,56,3,2,1,62
798810133,60,19,2,9,90
798823387,17,3,2,1,23
798824631,145,3,3,2,153
798840989,10,15,2,1,28
798851714,21,3,2,1,27
798851752,38,81,13,38,170
798853920,115,62,18,50,245
798855824,90,51,10,1,152
798860880,104,3,2,1,110
798862209,18,26,2,3,49
798879416,15,9,2,2,28
798882450,133,31,3,14,181
798886059,111,3,2,4,120
798900887,125,3,2,2,132
798911202,59,56,34,1,150
798911749,18,4,2,1,25
798935845,23,7,2,1,33
798957348,104,9,47,1,161
799013127,95,3,2,5,105
799019959,89,70,2,25,186
799020178,24,24,19,1,68
799041178,85,63,132,5,285
799043077,85,3,2,2,92
799047052,160,59,6,4,229
799059353,40,9,2,1,52
799064780,370,3,2,28,403
799080126,35,44,4,9,92
799095767,116,3,2,5,126
799102704,52,6,3,10,71
799110860,49,9,2,4,64
799110924,69,30,2,1,102
799113565,84,3,2,7,96
799122855,49,14,2,2,67
799126039,19,3,2,1,25
799126755,11,3,2,1,17
799128040,123,26,27,19,195
799139013,96,55,2,6,159
799166670,36,31,8,3,78
799168811,51,12,15,1,79
799169678,165,3,2,5,175
799181771,59,13,35,11,118
799190132,119,4,4,25,152
799192092,15,5,3,1,24
799193629,21,10,2,7,40
799208597,78,11,2,1,92
799231477,10,5,2,1,18
799250235,110,88,20,1,219
799274549,96,37,122,4,259
799275935,10,5,2,2,19
799281705,99,10,2,5,116
799302952,56,3,2,5,66
799303618,47,15,2,1,65
799338439,11,10,2,2,25
799357725,76,12,7,14,109
799358363,165,3,2,1,171
799382672,41,14,2,2,59
799383922,88,22,2,2,114
799384745,23,7,2,5,37
799394422,50,10,2,1,63
799396104,12,5,2,1,20
799399341,449,6,2,34,491
799400975,157,57,97,9,320
799416981,105,51,30,63,249
799435866,75,28,19,12,134
799442286,86,10,2,24,122
799442496,27,3,2,2,34
799448915,38,3,2,1,44
799450182,40,37,2,8,87
799450228,122,3,2,3,130
799476328,70,42,8,14,134
799485860,10,3,2,3,18
799488131,15,8,3,3,29
799494864,174,27,26,1,228
799533386,48,11,2,2,63
799535456,14,7,2,1,24
799536473,18,36,2,1,57
799549506,20,12,2,1,35
799551698,65,19,17,6,107
799562297,64,14,35,7,120
799597824,11,3,2,1,17
799603469,38,20,3,4,65
799606629,141,37,40,10,228
799608273,91,15,7,2,115
799620981,88,20,13,2,123
799643528,116,19,2,4,141
799648893,19,80,2,24,125
799660891,58,15,2,1,76
799667322,47,12,4,5,68
799675232,89,18,2,1,110
799684700,74,38,23,3,138
799687754,63,3,2,1,69
799688248,43,10,4,1,58
799699662,20,3,2,1,26
799701139,13,3,2,1,19
799711136,33,43,15,1,92
799727259,98,20,16,4,138
799733744,86,11,5,1,103
799737881,68,23,6,11,108
799739607,18,3,2,2,25
799745409,34,7,15,22,78
799758103,11,3,2,1,17
799761902,67,3,2,1,73
799774613,77,3,2,2,84
799775572,44,32,6,12,94
799778740,99,3,14,1,117
799801147,57,45,53,2,157
799821664,23,13,2,2,40
799846948,66,6,11,1,84
799853922,21,3,2,3,29
799863911,38,3,2,3,46
799882987,77,3,2,1,83
799887449,55,65,17,2,139
799905266,58,19,15,4,96
799921652,39,18,12,2,71
799921797,14,17,2,1,34
799924601,80,29,2,1,112
799926806,56,11,4,5,76
799933270,66,22,15,1,104
799969190,45,8,38,12,103
799970508,10,3,2,2,17
799984577,75,28,2,2,107
799984810,47,24,2,1,74
799996314,34,45,20,13,112
800012800,10,25,2,1,38
800019042,105,24,102,6,237
800030603,17,3,2,1,23
800039001,19,3,2,1,25
800044168,34,26,3,1,64
800056755,73,39,2,10,124
800067287,21,3,2,1,27
800068701,160,3,2,2,167
800076638,10,7,2,1,20
800084738,97,40,13,2,152
800092304,20,22,2,1,45
800100779,84,21,110,2,217
800127587,12,3,2,1,18
800128766,74,3,2,1,80
800131286,50,4,2,1,57
800135686,19,3,2,1,25
800142081,106,3,2,1,112
800142685,122,26,86,2,236
800145890,51,42,19,2,114
800174215,45,33,3,7,88
800174577,73,24,2,8,107
800178090,147,8,15,7,177
800178614,12,8,2,3,25
800184774,77,41,2,4,124
800201908,23,10,13,1,47
800215269,85,3,2,3,93
800233053,22,3,2,2,29
800246285,78,17,11,2,108
800247732,133,6,52,1,192
800266719,22,22,11,1,56
800271072,75,33,17,2,127
800273113,27,4,2,21,54
800274471,16,14,2,2,34
800279238,72,34,17,9,132
800282251,29,23,3,11,66
800283484,37,17,2,2,58
800288107,12,4,2,1,19
800292329,12,3,2,7,24
800295217,47,17,2,1,67
800297317,55,33,83,8,179
800329025,71,39,4,3,117
800358478,11,3,2,1,17
800371982,34,41,14,18,107
800375561,32,35,11,1,79
800380280,86,3,2,1,92
800393857,121,42,32,9,204
800394027,27,26,11,22,86
800404413,100,3,2,1,106
800404553,50,12,72,49,183
800405091,15,3,2,1,21
800412678,81,3,2,1,87
800415499,137,3,2,6,148
800434887,147,34,2,2,185
800437934,46,54,27,16,143
800438663,106,51,23,15,195
800441845,26,21,95,2,144
800444822,69,25,7,1,102
800451816,54,19,10,1,84
800482312,10,4,2,5,21
800483759,49,22,5,8,84
800495516,15,26,2,1,44
800499955,119,8,31,20,178
800502108,26,3,2,1,32
800503108,10,4,2,1,17
800504280,29,15,2,1,47
800510722,41,114,2,4,161
800534531,14,33,2,1,50
800536775,34,19,2,1,56
800559663,118,34,12,8,172
800587374,16,33,5,5,59
800615130,78,46,2,6,132
800633802,20,3,2,1,26
800641760,14,19,3,1,37
800662201,10,11,2,1,24
800667969,17,3,2,1,23
800683357,115,50,18,8,191
800683970,104,18,2,3,127
800696930,101,23,38,19,181
800697311,48,31,2,1,82
800709988,68,12,2,2,84
800710228,35,34,21,2,92
800714982,10,7,2,1,20
800741707,111,9,11,4,135
800763060,12,3,2,1,18
800800295,55,3,2,9,69
800814154,15,19,2,7,43
800816941,75,25,18,4,122
800822339,58,17,2,1,78
800823140,17,3,2,2,24
800825488,16,3,2,1,22
800828778,84,3,2,1,90
800832447,10,3,2,3,18
800842725,211,5,18,2,236
800844264,54,81,7,2,144
800855393,26,29,2,5,62
800860832,19,8,2,1,30
800894956,94,7,28,1,130
800901895,156,7,43,7,213
800902736,70,17,30,2,119
800905310,26,18,80,24,148
800915540,45,59,8,34,146
800918613,112,47,17,16,192
800929967,47,22,2,3,74
800943894,40,3,2,1,46
800946017,10,9,2,1,22
800948602,66,13,2,5,86
800964815,153,37,17,3,210
800968805,51,23,2,10,86
800983457,87,3,2,3,95
800990317,12,6,2,3,23
800990645,80,31,48,6,165
801004571,11,3,2,1,17
801017923,30,3,2,3,38
801022898,27,11,18,1,57
801023968,52,3,5,1,61
801044671,16,26,2,2,46
801057527,81,70,43,1,195
801062494,14,3,2,1,20
801069118,10,14,2,1,27
801069864,37,52,24,1,114
801072810,12,53,2,2,69
801080102,53,3,2,1,59
801087553,97,49,13,6,165
801108093,65,7,3,3,78
801109078,19,3,2,36,60
801139017,10,4,2,1,17
801140853,94,6,2,2,104
801141546,44,21,5,7,77
801163913,25,20,10,1,56
801174823,25,3,2,1,31
801185070,39,13,2,1,55
801216730,24,18,10,4,56
801223166,76,13,101,3,193
801235414,49,35,94,5,183
801247164,120,5,2,1,128
801249375,14,3,2,1,20
801266113,106,7,2,1,116
801280942,44,22,9,2,77
801288210,77,7,2,1,87
801296323,47,20,13,6,86
801299380,41,32,21,5,99
801306349,60,63,23,37,183
801310334,40,84,26,14,164
801316596,74,15,23,9,121
801335105,68,67,9,19,163
801341682,79,29,2,3,113
801347446,12,3,2,4,21
801351354,25,3,2,1,31
801377464,41,51,44,34,170
801379438,78,31,11,19,139
801386360,81,11,2,1,95
801386979,62,13,2,11,88
801392521,45,34,18,1,98
801401678,223,37,79,45,384
801413036,10,4,2,1,17
801426892,12,3,2,1,18
801427894,15,20,2,1,38
801431262,55,41,39,15,150
801440116,30,19,2,2,53
801442324,14,3,2,3,22
801452136,24,67,4,1,96
801454515,68,23,76,2,169
801462117,23,7,2,2,34
801476614,75,31,6,1,113
801496068,13,3,2,2,20
801499617,106,12,114,30,262
801506332,11,4,2,2,19
801506550,11,3,2,1,17
801507506,146,3,2,1,152
801510386,24,40,11,4,79
801510440,29,34,3,1,67
801513140,25,16,2,2,45
801517149,48,34,8,1,91
801521024,39,89,19,4,151
801522409,133,13,36,1,183
801528900,47,22,2,1,72
801533376,114,17,2,2,135
801538629,69,30,2,17,118
801565168,240,14,2,3,259
801570089,39,3,3,1,46
801576207,10,36,2,2,50
801578676,57,3,2,1,63
801594201,148,4,2,1,155
801606032,99,17,2,24,142
801611095,38,33,2,2,75
801613668,100,34,46,3,183
801619538,13,3,2,1,19
801622174,63,25,2,2,92
801630882,66,37,7,13,123
801634239,11,3,2,1,17
801634839,180,21,118,2,321
801670095,19,3,2,1,25
801679191,62,20,6,19,107
801691308,66,17,2,8,93
801693572,15,3,2,1,21
801732286,136,3,3,1,143
801733911,76,35,33,10,154
801750565,26,14,2,1,43
801751065,165,12,9,1,187
801759191,16,23,2,1,42
801766012,35,14,36,1,86
801769511,35,24,42,1,102
801772055,13,3,2,1,19
801774153,30,8,2,3,43
801786525,49,11,2,1,63
801786861,18,18,4,2,42
801787088,70,46,30,2,148
801790109,86,10,66,13,175
801804392,116,3,2,1,122
801804798,86,3,2,1,92
801817464,27,35,4,9,75
801844674,172,14,44,4,234
801847059,128,52,40,57,277
801853741,14,7,2,4,27
801854349,10,5,2,1,18
801874778,21,21,3,3,48
801878312,63,43,30,1,137
801887276,10,3,2,2,17
801897988,27,47,18,2,94
801901592,16,4,2,3,25
801904788,10,18,2,2,32
801912080,125,3,2,2,132
801917815,158,3,2,2,165
801930549,15,3,2,1,21
801930909,26,3,2,1,32
801946115,106,3,2,1,112
801951302,42,14,15,1,72
801958795,47,17,2,1,67
801961719,71,19,39,13,142
801968655,48,68,2,12,130
801992119,10,3,2,2,17
802018247,48,3,2,1,54
802030947,81,62,47,9,199
802037024,34,16,18,1,69
802058347,58,43,28,3,132
802073406,25,44,9,39,117
802086401,30,18,2,1,51
802090349,22,24,2,1,49
802096741,80,20,42,26,168
802110312,26,10,21,5,62
802111134,44,46,17,15,122
802118741,135,27,2,16,180
802123037,46,24,6,3,79
802143471,53,35,16,2,106
802144960,10,12,2,1,25
802156706,45,18,2,3,68
802157423,15,30,2,1,48
802162510,33,19,2,11,65
802167221,16,3,2,1,22
802170149,92,3,2,1,98
802172070,23,27,3,1,54
802184081,27,5,2,1,35
802195486,227,16,5,1,249
802203035,12,19,2,1,34
802220192,56,12,42,1,111
802225192,12,63,2,1,78
802226756,45,7,6,1,59
802237665,17,3,2,2,24
802255758,79,3,2,8,92
802257018,108,3,2,5,118
802282057,13,4,2,1,20
802291341,11,3,2,1,17
802307418,94,36,2,9,141
802309569,22,37,3,3,65
802318844,70,35,2,1,108
802319390,29,62,66,12,169
802347752,81,3,2,2,88
802357567,75,40,27,6,148
802365649,14,3,2,1,20
802366851,77,25,19,5,126
802387058,33,6,11,27,77
802401150,55,51,19,6,131
802426746,104,12,2,1,119
802452976,39,3,2,2,46
802462919,10,8,2,1,21
802463753,47,29,6,23,105
802464731,184,3,2,6,195
802487375,72,30,28,8,138
802503911,135,44,52,10,241
802524009,25,3,2,1,31
802526880,193,18,2,11,224
802531547,27,9,46,3,85
802535363,185,29,23,11,248
802538552,328,3,2,9,342
802546902,63,19,20,1,103
802574119,179,41,2,13,235
802575312,166,36,23,1,226
802580452,25,3,2,2,32
802588518,37,3,2,1,43
802609431,58,33,11,10,112
802614000,49,16,2,1,68
802617958,43,19,14,24,100
802619384,64,3,2,23,92
802625854,25,11,2,1,39
802628457,81,40,2,8,131
802631476,158,35,17,6,216
802638554,63,5,5,7,80
802654456,49,18,2,25,94
802658602,36,13,10,5,64
802663518,31,34,13,1,79
802665410,26,3,9,9,47
802674902,30,5,8,2,45
802686084,45,4,2,1,52
802694517,11,3,2,1,17
802699280,36,33,11,1,81
802700590,43,24,3,4,74
802700834,111,24,25,24,184
802713904,15,3,2,2,22
802716944,64,43,30,18,155
802729160,14,3,2,1,20
802745449,10,4,2,1,17
802752803,37,24,3,12,76
802764559,31,27,2,1,61
802767601,12,4,2,1,19
802767743,57,3,5,1,66
802770213,24,3,2,1,30
802777758,24,3,2,1,30
802792654,147,21,2,10,180
802811009,52,40,18,24,134
802822605,155,42,38,1,236
802838146,217,3,2,3,225
802839014,39,3,2,1,45
802849204,160,3,3,7,173
802853556,51,3,2,3,59
802876244,170,18,2,1,191
802876929,109,3,2,7,121
802893477,59,10,2,1,72
802897167,41,37,2,1,81
802902026,62,5,4,45,116
802911443,57,32,10,1,100
802912794,16,5,2,1,24
802922949,86,27,2,1,116
802927697,101,22,35,1,159
802929489,83,31,37,12,163
802932778,134,10,2,1,147
802938378,23,74,64,1,162
802939625,36,26,2,7,71
802946492,62,18,2,1,83
802952814,120,3,2,6,131
802959862,30,3,2,1,36
802966326,17,3,2,1,23
802971688,47,8,6,14,75
802980591,115,3,2,1,121
802988378,10,5,2,1,18
802993092,21,6,2,1,30
803017139,103,57,95,19,274
803023069,95,3,2,8,108
803024141,91,5,12,1,109
803032588,32,36,76,7,151
803044199,33,14,4,3,54
803045752,305,3,2,2,312
803054635,97,39,2,2,140
803058708,83,41,6,64,194
803061364,76,3,2,1,82
803072261,30,88,2,3,123
803076920,88,11,13,22,134
803086288,58,3,2,10,73
803088895,162,9,2,4,177
803101443,114,13,43,24,194
803117831,10,16,2,1,29
803126583,82,3,2,2,89
803129105,72,77,26,30,205
803160801,22,3,2,3,30
803169832,86,42,16,1,145
803187535,64,14,29,6,113
803203335,95,31,49,9,184
803218458,99,42,52,26,219
803218495,31,3,2,1,37
803238610,101,55,6,1,163
803251113,10,3,2,2,17
803259101,18,3,2,1,24
803272996,12,10,4,1,27
803289242,70,28,10,2,110
803296597,12,3,2,1,18
803303849,25,3,2,1,31
803307298,66,29,19,1,115
803308780,53,67,15,2,137
803332801,255,38,7,38,338
803337789,52,25,38,17,132
803343385,29,57,14,41,141
803347348,108,11,3,3,125
803349737,23,39,2,10,74
803358317,144,3,2,5,154
803359683,68,47,4,6,125
803369269,81,23,8,16,128
803380699,38,52,34,9,133
803392342,131,14,2,1,148
803395191,40,37,19,1,97
803404133,23,3,2,1,29
803409562,49,4,32,1,86
803428916,129,35,18,42,224
803429932,10,5,3,9,27
803447390,20,3,2,1,26
803457881,135,35,93,4,267
803480044,104,3,2,3,112
803482225,195,3,2,14,214
803496442,62,3,2,1,68
803501643,25,15,2,1,43
803517664,117,32,29,15,193
803524004,37,50,42,42,171
803526811,13,3,2,1,19
803537308,53,26,19,1,99
803547507,38,3,2,1,44
803552233,34,24,2,1,61
803557226,93,3,2,4,102
803557475,53,8,3,1,65
803560611,113,70,45,9,237
803573282,25,13,2,1,41
803576180,30,7,36,5,78
803582293,11,3,2,1,17
803586951,79,17,54,11,161
803587592,171,3,2,5,181
803590613,89,15,26,2,132
803599382,11,3,2,1,17
803613520,123,34,4,4,165
803614091,119,50,106,1,276
803616498,21,6,2,1,30
803631923,66,50,3,8,127
803634408,47,3,2,3,55
803645896,14,3,2,1,20
803689821,95,5,58,41,199
803697082,105,33,28,3,169
803718996,89,23,3,14,129
803732532,11,3,2,1,17
803800164,30,11,2,3,46
803802558,11,3,2,1,17
803802979,138,3,2,5,148
803810826,96,21,7,8,132
803820738,27,4,2,1,34
803839185,49,18,2,11,80
803858230,12,3,2,1,18
803862234,90,28,11,8,137
803881484,75,56,49,20,200
803928273,11,5,2,1,19
803957311,27,14,25,1,67
803960276,34,26,23,3,86
803963874,31,26,15,2,74
803970186,156,3,2,48,209
803971837,40,20,2,2,64
803976453,19,8,2,1,30
803989037,13,3,2,3,21
804000043,98,11,13,1,123
804005819,28,3,2,3,36
804029716,33,20,2,1,56
804034498,50,23,44,6,123
804048018,12,3,2,1,18
804069605,132,62,15,27,236
804072915,60,15,2,1,78
804076527,14,4,2,7,27
804098199,11,3,2,1,17
804105672,37,6,2,2,47
804112551,11,3,2,1,17
804115839,41,20,2,3,66
804122971,14,42,6,4,66
804132035,86,43,2,10,141
804136698,26,9,26,18,79
804137648,127,11,62,2,202
804144075,36,3,2,6,47
804148609,142,11,2,15,170
804160551,91,5,2,1,99
804160878,59,19,2,2,82
804165255,42,3,2,1,48
804180006,120,24,10,1,155
804180485,36,31,5,1,73
804206289,76,34,60,1,171
804233175,129,10,70,45,254
804237690,47,34,2,1,84
804269818,51,4,3,7,65
804281493,132,95,38,21,286
804286930,73,3,2,1,79
804287057,81,78,3,4,166
804292715,20,4,42,1,67
804299287,62,45,44,1,152
804301029,68,3,2,8,81
804306310,14,13,2,1,30
804306800,83,52,7,1,143
804307771,64,22,44,27,157
804316630,56,3,2,2,63
804316632,19,3,2,1,25
804318299,86,68,33,14,201
804324984,51,3,2,1,57
804352250,96,39,20,1,156
804356203,96,28,40,2,166
804362320,14,3,2,1,20
804365793,28,3,2,1,34
804368334,28,3,2,1,34
804377985,136,3,2,2,143
804381074,81,24,3,1,109
804390988,13,3,2,1,19
804398485,103,25,40,20,188
804399872,34,5,3,9,51
804410942,96,21,3,1,121
804433871,107,96,30,69,302
804445691,51,3,4,2,60
804447798,89,27,19,10,145
804447933,31,37,19,29,116
804448360,152,3,2,14,171
804486124,53,3,2,12,70
804506124,170,71,15,25,281
804510320,11,3,2,2,18
804518508,22,3,2,1,28
804533867,102,75,2,3,182
804534988,41,55,12,1,109
804547392,415,3,2,69,489
804552757,29,31,10,1,71
804557626,18,3,6,3,30
804558687,71,20,2,1,94
804569741,32,48,5,2,87
804579952,15,12,5,1,33
804585408,143,70,3,1,217
804590125,27,62,5,34,128
804616126,21,28,18,18,85
804617059,71,24,2,1,98
804638058,51,3,2,3,59
804651244,49,12,8,47,116
804653740,11,3,2,1,17
804664767,58,76,18,18,170
804674962,45,26,14,3,88
804677305,10,3,2,2,17
804680282,142,46,32,11,231
804684750,169,15,7,1,192
804686463,35,3,2,7,47
804688663,107,3,2,3,115
804697396,15,53,6,1,75
804698287,11,3,2,1,17
804714505,11,3,2,1,17
804723055,105,18,2,1,126
804749202,148,17,4,92,261
804756978,219,40,33,5,297
804780281,111,20,2,12,145
804790765,13,5,2,1,21
804798002,192,3,2,9,206
804828484,47,54,35,3,139
804830326,41,18,4,6,69
804831981,10,6,2,2,20
804863842,16,3,2,1,22
804872659,147,25,74,8,254
804878625,13,24,4,1,42
804885416,22,3,2,1,28
804905354,24,6,2,1,33
804908925,11,33,2,6,52
804909531,132,10,11,35,188
804918852,11,7,3,4,25
804932009,126,3,2,1,132
804935445,15,5,6,2,28
804943147,116,29,23,21,189
804977066,10,30,2,1,43
804986728,19,15,2,3,39
804986753,33,51,24,1,109
804989262,67,26,6,5,104
805005232,165,24,3,2,194
805007025,123,18,17,4,162
805013749,185,3,2,9,199
805018361,12,22,4,14,52
805048198,74,18,2,3,97
805049693,61,42,20,14,137
805067360,105,3,2,3,113
805078198,18,3,2,1,24
805084760,85,3,2,3,93
805091377,14,3,2,1,20
805104332,11,14,6,1,32
805108781,68,53,2,2,125
805109907,109,24,14,3,150
805113936,71,136,33,2,242
805119230,91,22,8,2,123
805124279,50,67,27,2,146
805126585,362,3,2,1,368
805138036,38,46,13,15,112
805162474,31,7,2,3,43
805164495,28,38,3,1,70
805170787,23,3,2,1,29
805172648,38,3,2,1,44
805173733,18,58,14,2,92
805188598,30,103,2,3,138
805194218,26,64,36,2,128
805197935,198,51,2,3,254
805211746,89,32,5,6,132
805216493,11,4,2,1,18
805221723,33,44,10,2,89
805226475,137,5,2,12,156
805240231,51,92,33,30,206
805250659,69,22,2,6,99
805251464,315,3,2,1,321
805252302,84,102,76,60,322
805271652,148,10,3,1,162
805277637,11,3,2,1,17
805281553,52,46,2,1,101
805299274,126,34,176,44,380
805302848,53,25,2,1,81
805307581,21,20,8,5,54
805309360,83,3,5,4,95
805324177,117,12,8,1,138
805324856,11,7,2,1,21
805342487,38,3,7,1,49
805345334,101,25,3,3,132
805348678,128,10,7,9,154
805351908,185,6,31,1,223
805369881,15,21,3,1,40
805387236,83,7,2,2,94
805390132,30,3,2,1,36
805392615,56,50,2,8,116
805401191,44,12,9,1,66
805402425,61,44,2,4,111
805404867,57,17,2,1,77
805408814,116,3,2,1,122
805419568,45,3,2,14,64
805439877,12,3,2,1,18
805439926,27,70,16,2,115
805443658,62,38,27,46,173
805464473,77,21,26,4,128
805483683,18,16,4,2,40
805484821,15,6,25,6,52
805497762,190,47,6,7,250
805498815,18,8,3,1,30
805500895,69,41,70,5,185
805517002,21,43,31,21,116
805517572,30,3,2,1,36
805537473,22,3,2,2,29
805539322,13,38,3,4,58
805551783,113,32,43,15,203
805569455,13,3,2,1,19
805584985,145,54,94,33,326
805588374,111,3,2,2,118
805595657,20,3,2,1,26
805607279,11,3,2,1,17
805612212,87,33,2,3,125
805617959,69,47,11,9,136
805646868,173,22,36,14,245
805655132,166,3,2,2,173
805658096,109,3,2,1,115
805659077,75,18,2,1,96
805660402,28,9,2,1,40
805664759,44,3,2,10,59
805672673,12,15,7,1,35
805676279,136,31,4,11,182
805678085,38,8,4,7,57
805681562,51,66,59,1,177
805699655,64,32,129,4,229
805707029,12,38,2,1,53
805716654,31,3,2,1,37
805728799,88,25,5,1,119
805745531,15,3,2,1,21
805748827,21,17,2,12,52
805750854,109,7,2,4,122
805760402,18,3,2,2,25
805775554,64,37,10,9,120
805779991,52,13,13,2,80
805783546,71,34,2,1,108
805784829,12,3,2,14,31
805808036,115,9,2,1,127
805815990,22,12,8,9,51
805818356,32,20,3,6,61
805827569,40,33,2,1,76
805835356,85,29,124,7,245
805838739,96,13,2,2,113
805854495,79,3,2,1,85
805857696,112,60,2,1,175
805873362,126,30,78,3,237
805906325,23,24,7,1,55
805906487,170,3,2,2,177
805917690,14,43,2,1,60
805918004,151,25,5,39,220
805937541,48,10,2,2,62
805940790,103,21,2,4,130
805949113,386,70,67,4,527
805957762,100,40,16,2,158
805962133,17,51,2,2,72
805968508,87,23,2,18,130
805969968,139,25,2,7,173
805999343,35,36,6,20,97
806005589,45,22,2,4,73
806011980,126,19,2,3,150
806033470,188,3,2,13,206
806037455,56,32,14,1,103
806067570,11,3,2,1,17
806072791,125,70,2,15,212
806086473,79,13,64,1,157
806106057,153,16,3,9,181
806112972,13,5,2,1,21
806114525,84,3,2,1,90
806127399,122,14,2,2,140
806127413,35,3,2,1,41
806135997,165,26,2,1,194
806142894,204,3,6,9,222
806152152,10,5,2,1,18
806155853,72,29,10,20,131
806164184,21,22,2,2,47
806167984,79,24,2,1,106
806183814,196,23,124,19,362
806209049,23,8,2,8,41
806219844,71,8,2,3,84
806222097,132,16,2,17,167
806225466,96,25,14,14,149
806230548,13,4,2,1,20
806237287,22,75,2,23,122
806246174,66,14,22,35,137
806257130,91,34,2,2,129
806264099,151,9,2,1,163
806281904,184,3,2,15,204
806303501,12,15,4,2,33
806324629,154,11,12,1,178
806325502,15,3,2,1,21
806325734,12,3,4,3,22
806334548,30,8,2,1,41
806335926,67,43,41,33,184
806336440,17,3,2,7,29
806355692,20,3,2,1,26
806366849,26,20,2,1,49
806374262,170,31,2,1,204
806386453,58,3,2,4,67
806387063,99,3,2,1,105
806389207,19,3,2,1,25
806393678,27,100,32,2,161
806400825,96,20,2,1,119
806410507,63,61,47,43,214
806415724,95,3,2,2,102
806427367,64,24,10,1,99
806435957,47,14,36,12,109
806441064,60,3,2,1,66
806451990,17,3,2,1,23
806474357,11,71,2,2,86
806491996,92,4,2,6,104
806509465,139,43,45,1,228
806541206,11,3,2,1,17
806553274,88,3,2,1,94
806554015,26,52,10,5,93
806563860,100,42,2,1,145
806580802,36,3,2,1,42
806595496,85,50,2,3,140
806598653,43,3,2,1,49
806620083,53,3,2,1,59
806625984,17,15,3,1,36
806626452,43,3,2,1,49
806658146,12,3,2,2,19
806666754,11,6,2,1,20
806670098,187,3,2,1,193
806670298,15,38,2,4,59
806677919,15,3,2,1,21
806684610,36,3,2,1,42
806690515,108,3,2,2,115
806694300,128,33,3,10,174
806700693,70,87,31,18,206
806715358,29,3,2,2,36
806723488,64,18,4,15,101
806731416,66,65,11,9,151
806747639,48,3,2,1,54
806754624,178,41,43,3,265
806759632,11,10,2,2,25
806777880,139,3,2,8,152
806800492,28,16,2,1,47
806803939,73,3,2,8,86
806807803,98,19,28,23,168
806817056,43,3,2,5,53
806844387,18,3,2,1,24
806845161,70,33,3,8,114
806849162,56,6,2,4,68
806858443,166,59,60,13,298
806865590,67,3,2,1,73
806872279,14,3,2,1,20
806884820,142,44,8,2,196
806907767,16,3,2,3,24
806910327,26,30,18,2,76
806919574,54,13,14,10,91
806920461,14,3,2,1,20
806924779,11,3,2,1,17
806926952,19,90,2,1,112
806945815,46,27,2,1,76
806947827,18,7,2,1,28
806972958,27,36,9,17,89
806973400,134,8,3,10,155
806975225,68,15,2,7,92
806979864,186,77,5,22,290
806982379,61,19,2,1,83
806991532,113,23,7,9,152
806996921,111,83,62,3,259
806997783,31,38,41,48,158
807006474,25,8,2,3,38
807007398,11,3,2,1,17
807013821,241,61,3,31,336
807018382,64,3,2,1,70
807024791,202,7,2,1,212
807025365,44,5,14,1,64
807026092,139,3,2,1,145
807027549,11,7,2,2,22
807027899,61,9,40,1,111
807035324,48,41,40,18,147
807044254,31,74,2,1,108
807064457,52,24,2,1,79
807065058,78,37,29,3,147
807091312,118,23,50,20,211
807113219,24,3,2,1,30
807113626,114,79,35,57,285
807157716,129,32,2,13,176
807157785,15,3,2,1,21
807166134,14,26,48,5,93
807173715,61,3,2,1,67
807180935,119,4,2,2,127
807182094,76,51,2,6,135
807182281,73,3,2,3,81
807190224,166,32,6,1,205
807208048,66,33,2,9,110
807212263,87,66,62,23,238
807214340,18,3,2,1,24
807215772,19,14,9,6,48
807221289,25,3,2,1,31
807237620,134,31,147,1,313
807248214,79,3,2,2,86
807251234,116,3,25,2,146
807256028,81,24,2,11,118
807264161,56,33,17,36,142
807273649,43,3,2,3,51
807274002,38,14,16,3,71
807275692,24,9,9,2,44
807276031,11,5,2,1,19
807276415,40,8,9,1,58
807280554,154,163,26,16,359
807287171,64,15,12,6,97
807290499,26,3,2,1,32
807306546,10,14,2,1,27
807307475,100,3,2,5,110
807357488,33,3,2,4,42
807357648,97,3,2,6,108
807359167,14,19,10,7,50
807375205,72,3,10,1,86
807386189,49,3,2,1,55
807389483,36,3,2,1,42
807398981,206,43,10,2,261
807407187,52,29,9,38,128
807408498,45,3,28,1,77
807447116,104,15,89,39,247
807478059,52,40,14,29,135
807481951,12,32,2,3,49
807489258,28,3,2,3,36
807508784,13,17,4,4,38
807512261,21,17,2,1,41
807512972,112,29,34,25,200
807519441,109,37,35,15,196
807520004,78,22,5,3,108
807520247,78,25,2,15,120
807521806,126,53,39,43,261
807536708,79,25,100,2,206
807541480,42,3,2,1,48
807551926,15,16,2,1,34
807561450,38,47,14,3,102
807566596,129,33,39,22,223
807580592,17,11,2,2,32
807585639,10,5,2,1,18
807612277,46,29,19,5,99
807625743,19,3,2,1,25
807643192,61,36,2,1,100
807649569,97,38,37,24,196
807650220,17,3,2,1,23
807671235,48,39,14,4,105
807684638,32,3,2,1,38
807686883,47,3,2,1,53
807688207,17,32,5,9,63
807695253,86,6,2,2,96
807702976,224,3,2,1,230
807706604,15,3,2,1,21
807711318,35,15,45,3,98
807732221,16,6,3,1,26
807749424,55,55,11,1,122
807752518,11,3,2,1,17
807752874,63,42,30,1,136
807754510,34,14,20,10,78
807764931,77,20,2,21,120
807765851,36,30,2,3,71
807777397,54,24,10,2,90
807778061,84,26,4,4,118
807787011,11,3,2,8,24
807788665,23,34,48,2,107
807797992,35,3,2,1,41
807803005,27,9,3,1,40
807803236,186,14,60,12,272
807803261,25,30,18,17,90
807810952,11,44,2,1,58
807820235,98,21,2,7,128
807834511,37,6,2,1,46
807840176,143,24,2,4,173
807848575,553,3,2,3,561
807852628,166,26,2,10,204
807874104,17,16,2,1,36
807878329,89,10,2,6,107
807882790,48,27,73,2,150
807888692,52,3,2,7,64
807890250,80,11,2,10,103
807897050,18,4,2,1,25
807913126,66,22,2,3,93
807915319,86,54,25,1,166
807916953,130,3,2,1,136
807921108,44,30,41,10,125
807944026,27,3,2,2,34
807951856,66,3,2,1,72
807952866,36,21,2,2,61
807963440,16,3,2,1,22
807972161,56,132,8,10,206
807991127,46,41,39,3,129
808011132,20,3,2,1,26
808013989,60,3,2,1,66
808016369,16,18,2,8,44
808039898,19,20,67,20,126
808040317,42,18,2,1,63
808050262,15,4,8,1,28
808052520,103,87,93,26,309
808058927,55,19,12,17,103
808083619,11,3,2,2,18
808100531,41,39,2,2,84
808112256,113,10,25,29,177
808121215,83,70,25,45,223
808128482,13,3,2,1,19
808142229,74,17,2,1,94
808153192,158,31,112,1,302
808159330,12,3,2,1,18
808165582,20,16,4,1,41
808180812,24,21,35,2,82
808186290,39,7,2,2,50
808186565,32,3,2,1,38
808189895,132,3,2,12,149
808194621,97,33,40,7,177
808194654,90,47,45,1,183
808204718,93,18,104,1,216
808216880,11,63,2,9,85
808237213,358,3,2,3,366
808253632,16,32,2,1,51
808275317,14,3,2,1,20
808291047,130,4,2,1,137
808299054,34,3,2,1,40
808301212,56,16,2,1,75
808308441,142,5,13,1,161
808308732,42,3,3,1,49
808310687,70,3,2,1,76
808314757,57,3,2,1,63
808318232,175,97,6,2,280
808321062,111,16,5,1,133
808329704,26,15,5,39,85
808330221,76,96,7,5,184
808330269,20,40,2,14,76
808338873,65,20,2,1,88
808351774,47,13,7,9,76
808355375,85,11,16,12,124
808360121,64,6,2,18,90
808361469,183,3,2,2,190
808364280,69,26,3,18,116
808365902,45,3,2,1,51
808369548,29,3,2,1,35
808373417,20,19,19,7,65
808396024,12,44,20,2,78
808419995,96,3,2,7,108
808442878,220,3,2,1,226
808451319,136,17,84,2,239
808452721,18,10,2,1,31
808457698,10,3,2,6,21
808460140,78,31,4,10,123
808482438,29,42,4,1,76
808489930,15,11,2,1,29
808498481,51,36,39,13,139
808517142,14,8,2,1,25
808517631,66,8,4,1,79
808518047,133,32,52,53,270
808522217,87,12,19,3,121
808534017,35,26,34,1,96
808557045,44,9,20,2,75
808562508,24,3,2,1,30
808575629,161,38,12,64,275
808575688,21,18,2,2,43
808583676,65,3,2,1,71
808606382,16,4,2,1,23
808608991,38,30,29,5,102
808615670,46,29,2,3,80
808618160,38,6,5,40,89
808618770,29,3,2,1,35
808620888,111,36,43,17,207
808625602,68,29,10,2,109
808637069,12,8,2,1,23
808644131,11,3,2,1,17
808649124,55,51,13,35,154
808656469,12,19,3,1,35
808660889,32,22,2,2,58
808674022,34,29,6,1,70
808684747,268,38,2,3,311
808693778,99,36,12,1,148
808701674,94,6,23,1,124
808703273,55,3,2,1,61
808713788,15,11,5,9,40
808741712,148,12,3,2,165
808763811,10,5,2,3,20
808773746,48,37,2,1,88
808776856,77,27,2,49,155
808778387,21,3,2,1,27
808781203,21,3,19,4,47
808781766,10,4,2,1,17
808800232,20,3,2,1,26
808803002,58,111,16,73,258
808806342,19,11,3,1,34
808807575,41,30,3,3,77
808810476,192,41,89,4,326
808811271,11,3,2,1,17
808819390,44,16,3,1,64
808825654,161,65,5,73,304
808829798,50,16,2,57,125
808833356,23,17,2,1,43
808862603,171,32,3,3,209
808883565,79,101,3,14,197
808888270,68,35,11,38,152
808913928,41,6,2,2,51
808914772,44,55,20,18,137
808917522,48,81,58,2,189
808924513,240,3,2,3,248
808939798,11,27,2,1,41
808942583,62,3,2,1,68
808958051,42,26,37,3,108
809000682,68,60,29,10,167
809003169,60,3,2,1,66
809015477,63,28,2,15,108
809020301,70,8,36,2,116
809062922,10,11,2,1,24
809068287,27,3,2,1,33
809069809,28,57,4,1,90
809071446,33,31,2,7,73
809071728,27,16,2,1,46
809071984,117,3,2,5,127
809083013,85,3,2,2,92
809088721,152,59,29,4,244
809112454,73,8,2,3,86
809134557,346,3,2,3,354
809140075,132,22,16,4,174
809141764,141,3,2,1,147
809152787,194,3,2,33,232
809156083,42,14,2,1,59
809173210,71,8,2,1,82
809176854,96,23,2,6,127
809184277,40,54,12,8,114
809184412,65,19,7,2,93
809185248,36,3,2,1,42
809185476,63,3,2,1,69
809188792,22,3,2,1,28
809194454,73,11,25,19,128
809195036,17,8,2,2,29
809224883,171,3,2,11,187
809231748,148,40,13,14,215
809233455,62,55,26,2,145
809234485,10,3,2,3,18
809244397,107,9,130,5,251
809250463,168,3,2,22,195
809262467,20,20,2,1,43
809270443,85,8,26,4,123
809299969,204,3,2,1,210
809325202,26,55,14,19,114
809325772,63,22,3,2,90
809351828,139,26,2,2,169
809367257,77,31,2,1,111
809384234,16,17,2,3,38
809386688,17,3,2,1,23
809403737,23,8,2,5,38
809403945,22,6,2,1,31
809406682,67,21,2,1,91
809407379,181,17,2,1,201
809412593,36,3,33,3,75
809416882,43,27,2,13,85
809423838,97,14,11,1,123
809424981,59,3,3,1,66
809435162,44,26,9,24,103
809441921,143,12,2,11,168
809444493,65,57,5,2,129
809447682,43,88,10,2,143
809449519,66,14,4,3,87
809450952,100,8,28,2,138
809455786,35,3,2,2,42
809456300,61,9,2,1,73
809466228,42,12,2,4,60
809472636,29,26,29,10,94
809486075,46,29,2,1,78
809496942,170,25,8,3,206
809500214,40,17,2,4,63
809507196,27,25,4,1,57
809513643,106,31,40,3,180
809516976,132,14,2,1,149
809533169,29,3,2,1,35
809543870,109,28,91,5,233
809545236,68,73,2,1,144
809554908,94,3,2,1,100
809559750,98,16,76,1,191
809564500,66,14,20,1,101
809575807,17,11,2,1,31
809597625,10,4,2,1,17
809604518,126,31,74,6,237
809616085,21,3,2,1,27
809629464,70,18,2,2,92
809641973,43,4,2,3,52
809648911,121,5,2,25,153
809657115,15,49,35,3,102
809664349,42,12,20,3,77
809667948,170,57,19,8,254
809687747,146,37,2,1,186
809704778,19,42,2,1,64
809715374,56,3,2,1,62
809728640,297,7,2,1,307
809732031,42,3,2,1,48
809741228,113,53,12,4,182
809743157,60,13,2,8,83
809757413,27,42,35,12,116
809757891,30,41,2,3,76
809771733,13,3,2,1,19
809785246,91,3,2,1,97
809787406,26,18,8,1,53
809811577,63,23,2,1,89
809814188,63,20,5,27,115
809824925,34,36,53,1,124
809841342,121,3,2,18,144
809841915,19,3,2,9,33
809843058,118,17,3,2,140
809855607,57,50,23,1,131
809858791,122,33,54,30,239
809885641,49,52,24,5,130
809894214,17,3,2,4,26
809895342,119,29,3,1,152
809900118,118,12,8,6,144
809911842,12,46,6,1,65
809917116,131,3,2,58,194
809924904,28,15,2,5,50
809940271,12,19,2,1,34
809953663,145,3,2,11,161
809974118,83,19,2,3,107
809975585,110,25,29,41,205
809981819,78,35,26,1,140
809985483,76,58,2,2,138
809994570,142,70,11,24,247
810005745,58,25,8,3,94
810012535,33,26,32,22,113
810024372,109,39,15,45,208
810028006,46,40,38,11,135
810028952,51,15,3,2,71
810033109,20,4,2,2,28
810043658,12,3,2,1,18
810045596,53,18,7,5,83
810047972,90,7,2,19,118
810056356,98,16,2,11,127
810074759,347,3,2,5,357
810085501,81,10,17,1,109
810100025,119,3,2,1,125
810101941,152,22,2,2,178
810102070,317,8,42,4,371
810107672,11,3,2,1,17
810118193,500,3,2,67,572
810151188,121,19,3,22,165
810167620,16,7,2,1,26
810173851,15,36,8,4,63
810177636,43,20,6,6,75
810178791,38,11,3,5,57
810180768,20,3,2,1,26
810183571,24,3,2,1,30
810193775,38,15,2,1,56
810194339,182,27,3,6,218
810205807,31,17,7,1,56
810214880,51,8,34,5,98
810232590,83,19,7,43,152
810234922,18,3,2,1,24
810255008,131,64,24,59,278
810262276,11,3,2,1,17
810278285,33,36,6,3,78
810288525,110,3,2,1,116
810297960,58,58,7,5,128
810307064,186,43,18,2,249
810309460,64,26,13,8,111
810329489,61,11,2,1,75
810339580,49,43,13,37,142
810342840,68,18,36,19,141
810347072,12,3,2,1,18
810364638,31,24,4,21,80
810406792,130,4,15,1,150
810415507,39,9,36,1,85
810425186,145,40,118,9,312
810429037,122,19,6,2,149
810431773,82,49,2,1,134
810434464,162,21,28,1,212
810446471,95,3,2,5,105
810468078,10,4,2,1,17
810471205,39,10,11,3,63
810478798,64,15,2,1,82
810498917,10,4,2,1,17
810508758,36,16,2,1,55
810521648,147,7,2,9,165
810527181,82,6,14,7,109
810529537,86,12,2,1,101
810541138,57,23,2,15,97
810548149,54,20,2,1,77
810562299,123,27,7,20,177
810563276,11,3,2,1,17
810566411,90,83,26,5,204
810567216,62,44,26,4,136
810572005,21,3,2,3,29
810583704,13,4,2,1,20
810591428,22,3,2,1,28
810591884,91,25,15,2,133
810594838,59,31,16,2,108
810598596,14,3,2,1,20
810630697,17,3,2,1,23
810632640,22,36,2,1,61
810657947,301,3,2,2,308
810662791,195,19,12,16,242
810665316,23,8,2,1,34
810673241,56,26,25,33,140
810675583,25,25,15,1,66
810682290,31,34,5,22,92
810695460,73,23,2,1,99
810699647,100,36,69,3,208
810708702,67,3,2,1,73
810710512,60,24,2,2,88
810748111,83,3,2,1,89
810755866,79,17,67,22,185
810756743,57,21,15,1,94
810759021,57,3,2,1,63
810764340,107,7,2,6,122
810765781,108,3,2,5,118
810776659,27,12,6,8,53
810793009,62,50,2,20,134
810796719,119,98,67,3,287
810803130,30,3,2,1,36
810805227,162,52,50,8,272
810807764,209,53,3,7,272
810814053,40,19,41,8,108
810855320,121,9,2,1,133
810880075,103,17,2,2,124
810881734,56,87,2,23,168
810892296,17,3,2,2,24
810898389,47,16,3,1,67
810915380,60,37,43,4,144
810939226,29,13,3,1,46
810943473,110,14,2,12,138
810946226,25,14,2,2,43
810949312,28,16,21,4,69
810954434,11,3,2,1,17
810965933,31,33,2,1,67
810978711,57,15,5,1,78
810985994,32,110,5,10,157
810990788,15,15,2,1,33
810994942,51,7,2,2,62
811004335,107,5,2,8,122
811009933,16,43,3,1,63
811011028,13,8,2,1,24
811032403,43,3,2,8,56
811050600,11,13,11,7,42
811052221,85,12,14,9,120
811071739,44,32,3,1,80
811074024,37,4,2,7,50
811078799,64,31,14,1,110
811114499,32,3,2,5,42
811119245,41,3,2,3,49
811130207,11,6,2,4,23
811130610,63,33,22,6,124
811132878,62,9,2,2,75
811145629,13,3,2,1,19
811154902,68,3,2,1,74
811178626,51,29,38,6,124
811185165,53,29,18,1,101
811193508,132,3,2,2,139
811200012,14,23,5,4,46
811206916,54,17,29,4,104
811211384,63,3,2,2,70
811227146,44,7,2,2,55
811235596,30,40,30,1,101
811237357,11,3,2,1,17
811238383,18,21,2,1,42
811245286,31,32,41,7,111
811246603,33,83,2,11,129
811251535,10,4,2,1,17
811253002,12,3,2,4,21
811259091,136,4,18,1,159
811262149,32,3,2,3,40
811272710,175,50,6,53,284
811275822,41,8,2,1,52
811278421,11,7,2,1,21
811279435,114,20,9,1,144
811283213,34,3,2,1,40
811294799,76,3,2,18,99
811295176,63,30,62,16,171
811300635,81,3,2,1,87
811343844,42,116,20,30,208
811345336,12,4,2,1,19
811352765,76,33,12,1,122
811352883,17,27,2,27,73
811359269,49,49,2,1,101
811361730,146,16,2,5,169
811365920,65,12,25,6,108
811374043,58,7,2,5,72
811374851,119,25,22,25,191
811394068,52,9,6,7,74
811403270,80,19,69,5,173
811420413,57,36,24,3,120
811422226,279,53,132,60,524
811425085,432,3,2,22,459
811436595,100,48,16,11,175
811439923,52,20,9,4,85
811457512,114,16,4,63,197
811460322,182,3,2,1,188
811469847,11,14,2,1,28
811470196,62,11,2,1,76
811472237,123,12,24,7,166
811477763,89,23,2,1,115
811485842,31,3,2,1,37
811485919,26,3,2,1,32
811487030,34,3,2,1,40
811502799,13,3,2,1,19
811513516,39,27,29,6,101
811527642,20,11,2,2,35
811528966,22,3,2,1,28
811535373,22,3,2,1,28
811538232,137,31,2,5,175
811540214,26,12,3,3,44
811545831,29,19,19,1,68
811568267,10,29,2,1,42
811569207,14,3,2,1,20
811573351,41,23,9,11,84
811597726,15,3,2,1,21
811606699,42,24,7,5,78
811611225,20,3,8,1,32
811613308,26,24,2,5,57
811618285,77,6,2,2,87
811625173,43,16,6,4,69
811632624,45,25,14,9,93
811632867,90,5,2,1,98
811635365,14,12,2,1,29
811637224,132,26,85,33,276
811647483,49,10,2,1,62
811648142,36,19,8,6,69
811650715,33,59,7,1,100
811650813,79,32,36,14,161
811652117,23,11,2,1,37
811683290,44,3,2,2,51
811684184,15,10,2,1,28
811699360,16,35,2,3,56
811703570,11,12,2,1,26
811704195,135,9,2,81,227
811711864,104,41,13,8,166
811714932,11,13,2,2,28
811726972,25,11,12,3,51
811730803,34,5,2,1,42
811745364,176,49,2,5,232
811746889,167,41,26,21,255
811763238,64,3,2,1,70
811771912,108,10,21,1,140
811772991,49,32,68,76,225
811783487,68,20,2,1,91
811799133,64,3,2,1,70
811802079,11,5,2,1,19
811804325,46,11,2,3,62
811805976,46,23,9,12,90
811828977,44,27,19,7,97
811846273,129,15,2,24,170
811855183,88,3,2,2,95
811872031,12,26,2,1,41
811879112,29,55,5,1,90
811896048,46,8,2,1,57
811903073,58,33,2,13,106
811904792,12,20,2,1,35
811905594,107,28,2,6,143
811926149,103,31,16,13,163
811934244,81,5,2,22,110
811938194,130,64,87,30,311
811947431,62,15,4,6,87
811966333,11,3,2,1,17
811984173,43,39,2,13,97
812005306,124,89,62,2,277
812013251,69,32,9,23,133
812016411,57,35,15,31,138
812031207,45,37,2,2,86
812032381,140,8,20,29,197
812053517,13,6,2,1,22
812067041,99,7,5,8,119
812077181,10,5,2,1,18
812084502,32,3,2,3,40
812092611,122,42,17,1,182
812099643,12,31,2,2,47
812099995,41,50,25,6,122
812103236,17,3,2,1,23
812103430,145,3,2,2,152
812103821,52,3,2,1,58
812107680,16,4,2,4,26
812128875,108,7,69,23,207
812133609,12,12,2,7,33
812135936,60,42,80,7,189
812147187,117,17,14,33,181
812148041,12,3,2,1,18
812154938,134,59,3,21,217
812156848,11,3,2,1,17
812175409,28,42,5,1,76
812190747,12,3,2,3,20
812194178,149,33,26,1,209
812204087,50,12,10,1,73
812217206,153,37,2,5,197
812220261,175,3,2,1,181
812228030,87,43,37,1,168
812247422,36,18,25,2,81
812256825,136,15,2,10,163
812269295,102,40,6,1,149
812272044,44,21,2,1,68
812317633,71,14,3,1,89
812327021,50,33,2,1,86
812335349,73,41,25,4,143
812339116,113,98,13,2,226
812340918,104,3,2,8,117
812350236,69,77,17,26,189
812364050,65,7,15,7,94
812389764,10,8,2,1,21
812391112,13,3,2,1,19
812395666,79,3,2,1,85
812412069,98,3,2,1,104
812417535,111,20,55,3,189
812418080,28,10,3,1,42
812427569,16,4,2,1,23
812432386,42,44,19,6,111
812433774,18,11,2,1,32
812461350,100,3,10,1,114
812462795,43,52,32,25,152
812467239,34,24,6,9,73
812477741,220,3,2,145,370
812480521,90,4,2,9,105
812488049,56,32,2,1,91
812488582,20,3,2,1,26
812495791,129,3,2,46,180
812507197,72,3,2,6,83
812513655,85,96,48,16,245
812516098,26,3,2,1,32
812526209,157,37,2,4,200
812528226,178,36,31,18,263
812536314,87,3,2,1,93
812538398,51,62,15,68,196
812564684,152,31,58,20,261
812579900,20,3,2,1,26
812582200,13,3,2,1,19
812588837,86,41,36,19,182
812590651,119,3,2,5,129
812599077,97,4,2,3,106
812608315,23,11,6,4,44
812626942,18,13,2,2,35
812662199,16,58,2,1,77
812664683,13,3,2,1,19
812668899,272,26,2,30,330
812669282,144,19,2,2,167
812679146,74,29,2,5,110
812679554,17,3,2,1,23
812697746,107,24,27,3,161
812701761,59,65,38,25,187
812704747,13,45,20,2,80
812706331,87,23,2,4,116
812720673,11,3,2,1,17
812728359,75,25,3,18,121
812741048,71,14,30,1,116
812756202,138,16,2,19,175
812761854,89,39,28,37,193
812779718,89,128,16,1,234
812793021,93,3,2,1,99
812810065,57,12,27,4,100
812815928,75,10,2,12,99
812817003,84,28,3,1,116
812834901,94,3,2,1,100
812840195,83,21,2,4,110
812853756,38,9,37,2,86
812859346,32,47,13,1,93
812861270,10,28,2,5,45
812861693,138,3,2,1,144
812865575,12,3,2,1,18
812880631,83,21,4,1,109
812961323,26,3,2,1,32
812966330,79,4,2,1,86
812969058,113,9,2,9,133
812973595,14,14,2,1,31
812974930,11,3,2,1,17
812993800,48,3,2,7,60
812997708,19,19,5,10,53
813015235,99,29,78,1,207
813020912,49,48,4,2,103
813025861,32,3,2,7,44
813032368,135,3,2,1,141
813034230,22,24,2,3,51
813042740,302,13,41,25,381
813052314,62,3,2,4,71
813054462,82,42,25,13,162
813058761,271,3,2,4,280
813071567,60,3,2,23,88
813098975,33,18,2,1,54
813106195,44,3,2,1,50
813127229,103,31,3,9,146
813128856,28,3,2,1,34
813156490,65,3,2,3,73
813160914,57,9,2,1,69
813171089,20,5,2,1,28
813175000,56,3,2,1,62
813188975,60,3,2,12,77
813193115,98,27,2,1,128
813195007,18,21,13,10,62
813208322,49,65,2,15,131
813213338,22,27,2,1,52
813216250,12,5,2,3,22
813219593,26,81,30,10,147
813221693,125,54,28,7,214
813228103,48,4,2,1,55
813238165,36,35,31,1,103
813257953,67,3,2,3,75
813260694,240,14,17,1,272
813272654,28,27,21,1,77
813272801,56,9,2,1,68
813282610,31,41,2,2,76
813302331,13,3,2,1,19
813318944,12,3,2,1,18
813331408,12,3,2,1,18
813331860,89,3,2,9,103
813333721,33,14,13,31,91
813352617,59,13,20,33,125
813363534,266,35,16,7,324
813366099,36,22,16,2,76
813368598,23,3,2,1,29
813375032,20,44,2,4,70
813382655,37,3,2,1,43
813399163,140,40,7,3,190
813415202,10,3,2,2,17
813420603,173,104,19,5,301
813426729,141,3,2,1,147
813427162,15,3,2,1,21
813438812,23,3,2,3,31
813442214,67,103,47,34,251
813448298,85,6,2,1,94
813466543,180,19,43,9,251
813482972,90,84,57,16,247
813483877,20,3,2,1,26
813486966,249,3,2,8,262
813490365,18,11,3,1,33
813525440,15,25,2,3,45
813527261,32,6,2,3,43
813529255,92,16,2,3,113
813539358,74,3,2,1,80
813542653,135,31,17,8,191
813552753,51,7,3,1,62
813567585,30,27,7,3,67
813571254,105,6,2,1,114
813572511,64,30,37,13,144
813577222,48,20,9,1,78
813581641,105,64,17,17,203
813582194,66,19,23,7,115
813594420,62,3,2,1,68
813594731,64,3,2,1,70
813606218,222,26,2,2,252
813626239,49,3,2,1,55
813629427,70,3,2,6,81
813643496,90,4,2,2,98
813650739,58,47,29,10,144
813681007,40,60,17,1,118
813687018,209,13,2,3,227
813696211,67,27,2,1,97
813716546,11,3,2,2,18
813723205,28,3,2,1,34
813734318,109,27,11,14,161
813735399,147,3,2,2,154
813739235,31,4,2,2,39
813741964,126,36,27,6,195
813742934,52,42,2,4,100
813754506,47,5,17,18,87
813772474,19,67,15,27,128
813778075,71,26,53,17,167
813783028,180,3,2,1,186
813785909,27,11,4,11,53
813797214,27,7,6,5,45
813808820,105,16,43,2,166
813814382,17,3,2,1,23
813819177,39,55,2,1,97
813822695,11,6,2,1,20
813827569,92,47,43,26,208
813850551,21,5,2,1,29
813883330,16,37,2,1,56
813884255,56,49,2,16,123
813896179,35,5,2,4,46
813897123,118,30,30,7,185
813897307,22,3,2,3,30
813900603,46,26,44,1,117
813908674,10,9,2,1,22
813912026,22,29,5,1,57
813921233,18,3,2,1,24
813929634,100,56,4,3,163
813929703,39,64,23,3,129
813937522,91,60,3,38,192
813942183,47,34,2,1,84
813942259,29,33,56,23,141
813943163,54,60,69,48,231
813944484,64,3,2,1,70
813955810,20,3,2,1,26
813967877,176,12,32,6,226
813982153,47,47,4,16,114
813998647,12,14,2,2,30
814005833,43,26,2,3,74
814033945,76,3,2,1,82
814051768,150,3,2,1,156
814052778,95,3,12,1,111
814066955,30,41,11,1,83
814067297,51,26,2,1,80
814069619,29,14,5,3,51
814074723,25,8,2,2,37
814075111,35,4,2,4,45
814076573,50,40,17,9,116
814081139,371,3,2,19,395
814085327,10,3,2,8,23
814087063,40,12,2,1,55
814091048,42,29,28,9,108
814095555,35,3,2,1,41
814097210,68,22,16,4,110
814107495,121,38,2,12,173
814124937,188,3,2,1,194
814129455,38,3,2,1,44
814131885,111,59,19,48,237
814139099,32,3,2,2,39
814168381,56,29,76,4,165
814173535,51,3,2,2,58
814179131,72,9,2,1,84
814183694,46,12,2,4,64
814197635,39,42,7,1,89
814200026,64,31,38,1,134
814205313,77,39,2,12,130
814208298,13,3,2,3,21
814208492,13,5,15,1,34
814214192,15,14,5,1,35
814215581,32,46,17,5,100
814223478,57,29,60,7,153
814224437,214,49,102,50,415
814225922,102,3,2,6,113
814238348,43,61,8,14,126
814241055,13,10,2,2,27
814249603,11,3,2,2,18
814252130,20,41,55,19,135
814255629,92,26,19,1,138
814264006,132,20,2,19,173
814280888,37,39,23,4,103
814292817,53,3,2,16,74
814305079,141,3,2,4,150
814320002,96,18,16,6,136
814331646,90,23,3,1,117
814338234,130,3,2,11,146
814344933,28,30,17,1,76
814345771,132,3,2,9,146
814352597,11,3,2,1,17
814361832,13,3,2,1,19
814363049,126,3,2,6,137
814369375,55,57,66,32,210
814383024,151,3,2,15,171
814394467,10,22,2,1,35
814394577,173,3,2,16,194
814413503,51,53,2,3,109
814417477,14,7,2,1,24
814421803,11,3,2,1,17
814426120,11,3,2,1,17
814440991,54,12,11,6,83
814443868,175,3,2,1,181
814466556,128,89,2,2,221
814490270,48,15,9,1,73
814502956,30,9,2,1,42
814504571,78,3,2,5,88
814515467,92,3,2,75,172
814532353,11,7,2,1,21
814538297,51,14,3,6,74
814574245,46,24,12,5,87
814575160,21,3,2,1,27
814586718,50,21,25,1,97
814589921,66,103,2,1,172
814599583,61,3,2,11,77
814603564,26,5,8,1,40
814614962,70,27,27,3,127
814630761,12,3,2,1,18
814633953,48,66,15,5,134
814666524,28,3,2,1,34
814673297,124,20,2,6,152
814690099,135,65,11,6,217
814697794,123,64,139,24,350
814700211,17,10,17,14,58
814707328,32,13,2,1,48
814721668,37,34,11,22,104
814725202,109,3,2,1,115
814726273,55,3,2,11,71
814739769,49,3,2,6,60
814741633,111,3,2,2,118
814754392,75,29,10,21,135
814756258,19,3,2,2,26
814773965,19,3,2,1,25
814774279,43,29,15,5,92
814774616,88,5,2,3,98
814802170,11,33,4,1,49
814814181,22,9,2,1,34
814816344,22,19,5,4,50
814819985,14,3,2,1,20
814820185,30,3,2,1,36
814850665,92,45,10,15,162
814869047,44,10,2,1,57
814869127,41,24,31,42,138
814879191,88,3,2,4,97
814881166,19,20,2,1,42
814887298,11,26,3,1,41
814921122,84,45,45,1,175
814949113,34,53,2,1,90
814949283,47,3,2,1,53
814973573,255,65,41,19,380
814983103,68,28,2,9,107
814985276,22,82,19,4,127
814989869,10,3,2,3,18
814995446,125,46,4,9,184
815001832,17,11,2,1,31
815016827,43,8,2,2,55
815021462,11,3,2,1,17
815023050,73,43,8,4,128
815026206,42,19,3,3,67
815028844,10,28,2,1,41
815032714,169,24,26,3,222
815035591,116,12,19,1,148
815047636,42,3,2,9,56
815078243,254,3,2,1,260
815078983,19,11,2,1,33
815082546,14,7,2,2,25
815090655,238,3,2,1,244
815103560,135,21,2,1,159
815119718,42,16,3,7,68
815121747,40,15,27,10,92
815124242,306,3,2,1,312
815132393,10,8,2,1,21
815136980,113,29,2,2,146
815137370,56,9,5,4,74
815143770,27,3,2,1,33
815149047,50,13,2,1,66
815157378,37,3,2,2,44
815161456,12,3,2,1,18
815176129,94,3,2,1,100
815178220,63,31,56,1,151
815185544,58,97,14,8,177
815186642,85,3,2,1,91
815201105,20,3,2,1,26
815214318,19,3,2,1,25
815217119,13,7,2,1,23
815229793,60,3,2,1,66
815231255,106,17,18,4,145
815233952,23,6,2,1,32
815248354,122,25,33,2,182
815249137,63,3,2,5,73
815251834,31,35,7,2,75
815253319,132,3,8,9,152
815260424,73,9,9,2,93
815262837,48,48,5,1,102
815265431,66,18,2,1,87
815306457,150,39,37,25,251
815308163,13,3,2,1,19
815309571,14,3,2,1,20
815317046,11,3,2,1,17
815333827,10,4,2,1,17
815336550,51,55,6,1,113
815338441,58,3,2,1,64
815341331,22,3,2,1,28
815343220,101,3,2,11,117
815368795,121,39,10,2,172
815371178,1726,3,2,67,1798
815418579,29,29,10,1,69
815419202,138,3,2,5,148
815426001,12,3,2,1,18
815433310,51,3,2,16,72
815493341,150,3,2,4,159
815512668,15,3,2,1,21
815515074,68,13,5,2,88
815517924,22,3,2,4,31
815522409,80,42,12,21,155
815523048,16,3,2,1,22
815527322,113,58,24,4,199
815527757,10,3,2,3,18
815528667,29,33,5,6,73
815531181,34,7,13,8,62
815531372,162,45,2,1,210
815557883,1017,3,2,4,1026
815579473,33,3,2,11,49
815591156,64,13,2,1,80
815593535,41,43,26,4,114
815597905,18,15,2,12,47
815601005,66,11,15,4,96
815620133,55,7,32,3,97
815628816,57,6,6,1,70
815639894,15,12,2,1,30
815640668,20,6,2,1,29
815643391,100,15,22,1,138
815646470,28,8,2,1,39
815648126,30,3,2,1,36
815649437,37,16,11,5,69
815649451,150,32,28,6,216
815664051,117,3,2,4,126
815664424,33,11,2,3,49
815667765,45,28,35,8,116
815669014,151,3,2,2,158
815670733,58,3,2,43,106
815691420,29,26,8,1,64
815696149,114,58,68,29,269
815718913,1025,3,2,4,1034
815724701,64,3,2,1,70
815725093,84,3,2,11,100
815799929,12,7,2,1,22
815800204,13,3,2,1,19
815801392,34,3,31,1,69
815805254,61,3,2,13,79
815811153,62,8,31,4,105
815813308,49,64,6,5,124
815833836,182,9,8,19,218
815838855,105,6,3,1,115
815867654,147,3,2,1,153
815903028,13,3,2,1,19
815928430,122,3,2,2,129
815931232,53,18,20,7,98
815932444,58,36,19,12,125
815938803,103,23,16,2,144
815944527,13,3,2,1,19
815963540,104,26,3,2,135
815967750,35,3,2,1,41
815973837,86,3,2,16,107
815988270,69,3,2,2,76
815989857,11,3,2,1,17
816003831,67,60,6,3,136
816005848,83,22,35,7,147
816012931,79,18,2,1,100
816018862,134,75,2,18,229
816027174,253,20,2,2,277
816046046,45,3,2,1,51
816056397,26,43,2,1,72
816061646,22,12,2,2,38
816063832,72,6,2,1,81
816092213,121,3,2,23,149
816106133,23,6,2,7,38
816107156,30,3,2,1,36
816114619,111,50,5,1,167
816119023,92,62,24,10,188
816120156,110,3,2,2,117
816120890,44,52,3,19,118
816157858,123,80,103,38,344
816178693,102,28,9,6,145
816190428,31,13,2,1,47
816195427,14,3,2,2,21
816197018,10,5,2,6,23
816198674,107,21,30,13,171
816202050,58,5,2,22,87
816202519,35,16,2,18,71
816212141,19,24,2,4,49
816216858,15,21,2,1,39
816225675,69,3,2,1,75
816239645,154,64,4,9,231
816244575,70,3,2,1,76
816255002,14,37,2,1,54
816255794,79,12,2,7,100
816269691,60,25,2,6,93
816273224,63,8,2,5,78
816279048,19,3,2,1,25
816304912,314,3,2,3,322
816308509,14,3,2,1,20
816352219,31,22,2,2,57
816363733,69,66,18,2,155
816383446,108,82,2,19,211
816388289,142,15,18,4,179
816402630,28,40,50,1,119
816408734,139,7,2,5,153
816415292,63,3,7,18,91
816419164,35,15,2,7,59
816423721,54,14,2,4,74
816447133,20,3,2,2,27
816447951,10,8,2,1,21
816450403,46,5,2,1,54
816456515,68,3,2,1,74
816459248,45,5,4,1,55
816460396,41,30,2,4,77
816463342,12,3,2,2,19
816477984,123,6,2,6,137
816482571,113,57,21,7,198
816507337,24,10,3,3,40
816511989,200,60,3,4,267
816550526,19,3,2,1,25
816557790,17,3,2,1,23
816560327,17,3,2,1,23
816566690,15,19,2,1,37
816581708,68,48,51,98,265
816589162,26,53,2,1,82
816593176,92,3,2,9,106
816595283,79,4,2,9,94
816615631,35,40,4,14,93
816622150,64,11,80,6,161
816636961,39,6,25,1,71
816637281,84,16,2,5,107
816639609,93,11,23,2,129
816658068,60,46,102,1,209
816667453,136,69,11,9,225
816667493,30,4,2,4,40
816674262,74,3,2,1,80
816700240,17,6,2,1,26
816704004,11,55,2,1,69
816705592,12,5,2,3,22
816721226,35,3,2,38,78
816725764,88,22,2,2,114
816729764,16,22,2,1,41
816737103,11,3,2,2,18
816751272,82,3,2,1,88
816759761,32,33,120,3,188
816760225,19,3,2,1,25
816761481,79,11,2,1,93
816762746,109,58,30,1,198
816771372,13,3,2,1,19
816778976,30,17,3,2,52
816785901,48,11,2,1,62
816802321,10,6,5,1,22
816806762,102,20,25,3,150
816813941,91,30,24,5,150
816818300,87,19,2,1,109
816829395,37,31,15,4,87
816847567,12,3,2,1,18
816849388,71,25,17,14,127
816873782,18,3,2,1,24
816884946,16,3,2,1,22
816888851,49,27,17,3,96
816890708,167,3,2,1,173
816899927,149,10,82,2,243
816912742,27,5,11,1,44
816916332,60,3,2,1,66
816926816,10,4,2,1,17
816928264,71,12,8,19,110
816943534,66,16,45,5,132
816963913,15,11,2,1,29
816967916,57,4,2,10,73
816973661,167,6,29,22,224
816980584,11,3,2,1,17
816990490,75,34,12,1,122
816991561,24,13,27,3,67
817013902,18,3,2,1,24
817038019,148,3,2,1,154
817064729,95,3,7,2,107
817086541,18,7,8,9,42
817089938,117,3,2,1,123
817093295,11,3,2,1,17
817096142,37,30,13,1,81
817139297,29,4,9,2,44
817159978,31,10,2,1,44
817160729,10,4,2,1,17
817162366,32,32,2,10,76
817164975,139,37,43,18,237
817173168,74,61,122,15,272
817173573,36,14,2,4,56
817174113,12,10,2,2,26
817180682,51,37,2,11,101
817186542,85,85,9,6,185
817199203,11,3,2,1,17
817216830,14,19,2,1,36
817217626,54,12,2,1,69
817221323,24,3,2,1,30
817228842,16,5,2,1,24
817229368,10,7,2,1,20
817233402,28,9,3,1,41
817245531,144,3,2,4,153
817249860,139,13,133,2,287
817250853,115,74,25,5,219
817257801,13,6,2,1,22
817258130,12,10,4,1,27
817289844,15,3,2,4,24
817306853,72,3,2,2,79
817310867,99,41,4,1,145
817316289,18,23,10,1,52
817327351,16,3,2,8,29
817337207,42,16,2,2,62
817344158,77,16,36,9,138
817353546,44,3,2,1,50
817357792,28,3,2,2,35
817368595,12,3,2,4,21
817387312,68,40,2,2,112
817399065,11,3,2,1,17
817402038,31,3,2,1,37
817407357,93,27,10,19,149
817421173,51,3,2,7,63
817434492,32,32,31,2,97
817478354,55,18,2,3,78
817486371,85,6,17,43,151
817499566,63,3,2,9,77
817505238,75,3,2,1,81
817507700,18,4,2,2,26
817525362,43,9,107,1,160
817530754,45,52,39,1,137
817574180,99,85,29,33,246
817579663,485,3,2,3,493
817594320,135,41,14,18,208
817597140,66,3,2,1,72
817610277,95,43,21,13,172
817611888,21,11,13,8,53
817624321,91,17,17,7,132
817632392,77,3,2,1,83
817643974,36,61,15,9,121
817653026,40,3,2,1,46
817657640,209,10,4,16,239
817660033,99,3,2,1,105
817666026,65,37,2,5,109
817674659,120,70,34,15,239
817676167,120,63,40,11,234
817678760,146,3,2,4,155
817680914,42,13,2,5,62
817697484,37,85,9,1,132
817699008,49,24,2,2,77
817703811,99,6,66,1,172
817717868,40,13,3,1,57
817722885,20,3,2,6,31
817791052,80,3,2,1,86
817793234,146,32,5,1,184
817795307,178,50,3,3,234
817796743,53,3,2,1,59
817844241,21,9,2,1,33
817854052,90,5,59,2,156
817860500,43,10,17,7,77
817868428,38,3,2,4,47
817868908,65,16,16,9,106
817876256,43,15,15,1,74
817878263,48,59,7,4,118
817884496,26,21,3,3,53
817892666,129,3,4,4,140
817899992,62,41,14,3,120
817900863,31,3,2,1,37
817903386,52,18,22,10,102
817913749,113,3,2,2,120
817917105,103,31,2,3,139
817939620,162,56,2,2,222
817942658,55,36,48,29,168
817956228,22,68,2,5,97
817960025,19,4,2,6,31
817969643,133,56,142,2,333
817981852,15,3,2,1,21
817984011,75,94,41,6,216
817988879,117,3,2,19,141
817994666,161,18,3,25,207
817996443,91,90,3,18,202
817996658,25,13,4,1,43
817997418,70,3,2,2,77
817997858,20,3,2,3,28
818007787,101,14,2,41,158
818012232,77,40,38,6,161
818022632,51,18,28,13,110
818028006,107,3,2,1,113
818041872,31,12,3,4,50
818044771,98,34,5,1,138
818047356,113,4,2,1,120
818049759,15,33,3,1,52
818050312,13,7,2,1,23
818057240,14,12,2,1,29
818076944,73,7,2,2,84
818098719,89,37,7,2,135
818105829,169,3,2,7,181
818106042,86,31,3,1,121
818123296,81,44,2,2,129
818134485,28,3,2,1,34
818152476,36,9,2,3,50
818175580,194,3,2,30,229
818187180,59,30,31,12,132
818193954,39,10,31,5,85
818195118,22,6,2,4,34
818196795,97,23,125,1,246
818207964,29,14,4,2,49
818237779,13,12,2,1,28
818253502,142,33,2,3,180
818255122,95,33,2,9,139
818258115,106,21,2,1,130
818263926,21,5,2,14,42
818280843,26,3,2,3,34
818284336,127,38,38,6,209
818295097,74,26,20,3,123
818309900,34,74,7,2,117
818312790,28,3,2,1,34
818314578,134,26,2,3,165
818316593,26,3,2,1,32
818320541,49,9,2,1,61
818321116,131,14,3,1,149
818332742,48,89,6,6,149
818350097,25,35,36,7,103
818358470,51,25,28,93,197
818358765,112,13,19,12,156
818365490,25,3,2,2,32
818372602,12,6,2,1,21
818375549,18,7,7,8,40
818386973,15,3,2,1,21
818403726,16,3,2,1,22
818407613,22,10,2,17,51
818416904,26,3,2,2,33
818420280,36,5,2,1,44
818420495,50,3,2,1,56
818425806,18,3,2,1,24
818435271,85,10,2,1,98
818453248,191,36,3,6,236
818458655,23,3,2,1,29
818461868,25,4,2,1,32
818466366,122,3,5,28,158
818477506,86,52,15,1,154
818484750,166,16,37,36,255
818487825,75,45,62,9,191
818490881,47,48,16,8,119
818500752,100,20,2,1,123
818506131,83,52,13,3,151
818524469,71,34,2,13,120
818553275,113,28,70,50,261
818561684,174,14,3,14,205
818565912,38,3,2,1,44
818568900,48,18,24,4,94
818570482,45,36,16,7,104
818583342,24,3,2,1,30
818601004,20,45,2,5,72
818602630,38,4,2,18,62
818607911,43,10,2,7,62
818622661,59,22,72,16,169
818625847,61,17,2,2,82
818628163,40,18,8,1,67
818631304,38,9,2,5,54
818640033,15,21,2,2,40
818642243,213,3,2,8,226
818643296,22,52,2,1,77
818661325,57,8,24,5,94
818678673,10,9,2,1,22
818681964,43,3,2,1,49
818705559,91,59,75,13,238
818706290,150,24,6,1,181
818707114,10,11,2,1,24
818714318,20,3,2,1,26
818716670,95,26,99,27,247
818732653,11,3,2,1,17
818753729,71,4,2,3,80
818756699,202,59,12,2,275
818771063,28,3,2,7,40
818785765,13,29,2,1,45
818816967,332,3,2,2,339
818826113,63,24,48,11,146
818838684,146,7,2,3,158
818845814,70,4,7,2,83
818853070,50,129,123,5,307
818864759,50,23,7,4,84
818873300,71,3,2,1,77
818874308,51,7,3,1,62
818878611,121,16,30,1,168
818881764,71,95,92,11,269
818888454,35,3,2,1,41
818893864,39,3,2,1,45
818914784,12,3,2,1,18
818917261,50,65,5,25,145
818937811,49,36,32,2,119
818941791,46,12,2,1,61
818959210,56,20,11,1,88
818972272,47,42,27,18,134
818972988,52,51,13,9,125
818973728,57,28,2,2,89
818980521,152,56,4,3,215
818992024,11,3,2,1,17
819026408,52,10,2,1,65
819028166,47,34,32,46,159
819031407,34,3,2,1,40
819035243,14,3,2,1,20
819049491,21,4,6,17,48
819050475,16,9,20,3,48
819078430,25,13,2,1,41
819083060,41,50,3,5,99
819114666,44,24,40,16,124
819119138,105,3,2,1,111
819136681,46,33,2,5,86
819150913,54,88,19,9,170
819159609,33,13,2,7,55
819169328,10,4,2,1,17
819172230,105,3,2,1,111
819176596,106,3,2,1,112
819176709,63,6,25,2,96
819177478,87,3,2,2,94
819188290,98,57,10,1,166
819198473,60,19,7,1,87
819201462,44,44,14,32,134
819213698,25,10,3,1,39
819228236,13,3,2,2,20
819240015,28,26,8,4,66
819264269,190,3,2,1,196
819273150,43,28,2,1,74
819283768,73,50,52,5,180
819286627,63,29,41,33,166
819301171,72,14,17,5,108
819305791,83,3,18,2,106
819313003,61,31,2,1,95
819315166,110,3,2,1,116
819318571,121,111,42,1,275
819319561,21,29,2,2,54
819322304,114,6,5,1,126
819354596,32,17,2,1,52
819355110,17,18,2,1,38
819362391,57,13,2,2,74
819363469,114,34,133,1,282
819365584,10,5,2,1,18
819369001,25,26,2,1,54
819369805,56,3,2,27,88
819375484,40,23,34,14,111
819378317,37,23,6,14,80
819385798,138,7,2,1,148
819391784,76,3,2,6,87
819426759,16,3,2,1,22
819436806,80,18,18,5,121
819439390,66,36,11,3,116
819448363,75,6,2,1,84
819454947,202,3,2,1,208
819456892,33,3,2,4,42
819462915,135,3,2,1,141
819504718,10,5,2,1,18
819512929,106,35,8,1,150
819518165,105,24,31,8,168
819519131,116,3,2,7,128
819536225,146,24,3,6,179
819553235,137,37,25,10,209
819569305,13,3,2,1,19
819576304,66,3,2,1,72
819578113,53,12,2,1,68
819605213,123,15,46,9,193
819607445,19,3,2,1,25
819615450,139,3,2,14,158
819628891,62,25,62,2,151
819640412,46,20,37,8,111
819645580,67,14,2,1,84
819647616,54,25,31,36,146
819657678,68,30,3,1,102
819660683,30,55,2,13,100
819666617,49,22,2,1,74
819678057,55,79,2,6,142
819684699,41,18,30,13,102
819686915,112,56,34,8,210
819703000,24,3,2,1,30
819706230,23,48,6,2,79
819707564,58,21,24,2,105
819709085,172,9,3,49,233
819714443,18,3,2,1,24
819717863,127,20,2,24,173
819720287,52,11,2,14,79
819740419,15,8,2,1,26
819754067,32,37,5,3,77
819764185,28,3,2,1,34
819771712,69,9,2,1,81
819774396,65,10,10,55,140
819786584,67,4,2,4,77
819792877,181,24,2,2,209
819802526,76,10,3,27,116
819805094,25,3,2,2,32
819810023,202,21,3,31,257
819813772,72,35,22,8,137
819827340,91,3,2,7,103
819827874,113,36,2,3,154
819832440,53,13,23,15,104
819837708,32,15,2,8,57
819847631,10,3,2,5,20
819861229,77,25,32,15,149
819868723,11,3,2,1,17
819894087,77,3,5,14,99
819894533,13,7,14,3,37
819896432,14,3,2,1,20
819898060,37,15,2,9,63
819913796,46,54,18,6,124
819927191,63,49,7,1,120
819932156,30,3,2,2,37
819932511,13,3,2,1,19
819936289,20,7,2,1,30
819946438,56,51,6,1,114
819951444,11,6,2,1,20
819955085,13,11,2,1,27
819960034,41,9,14,6,70
819966558,55,30,4,62,151
819985320,113,3,2,81,199
819998742,159,18,35,12,224
820002446,42,26,41,3,112
820005703,37,11,2,10,60
820010947,90,20,2,2,114
820014744,29,5,6,5,45
820020286,87,28,94,18,227
820036646,13,3,2,1,19
820040362,31,34,2,4,71
820042312,31,3,2,1,37
820043303,17,3,2,1,23
820051195,19,8,2,1,30
820054052,31,9,14,3,57
820055339,70,3,2,15,90
820069504,96,3,2,12,113
820082824,100,9,30,1,140
820097434,41,11,2,10,64
820102747,63,3,2,3,71
820103093,163,22,2,1,188
820116094,91,40,28,1,160
820116651,73,26,2,7,108
820140626,54,3,2,1,60
820143837,156,51,3,6,216
820152444,192,39,2,22,255
820159640,61,41,11,4,117
820173183,31,46,2,1,80
820174742,12,6,2,1,21
820181247,51,10,11,1,73
820187779,62,3,20,5,90
820198992,20,3,2,1,26
820208292,11,3,2,2,18
820211944,21,3,2,1,27
820219099,12,3,2,1,18
820230410,118,27,2,1,148
820234888,16,103,44,2,165
820255918,60,26,2,38,126
820286611,11,3,2,1,17
820289228,61,41,24,7,133
820295018,13,3,2,3,21
820295786,94,38,54,5,191
820299389,22,8,2,1,33
820300762,101,14,17,21,153
820310398,79,3,2,1,85
820315940,16,38,3,2,59
820320725,62,3,2,3,70
820323224,23,19,37,1,80
820333105,214,3,2,5,224
820382167,20,19,2,1,42
820388207,59,11,21,1,92
820392552,22,9,35,3,69
820393654,29,49,5,1,84
820400275,54,48,7,7,116
820404688,13,3,2,1,19
820406733,74,14,3,1,92
820419367,40,17,2,4,63
820437277,10,3,2,3,18
820445686,46,53,9,11,119
820449560,123,3,2,16,144
820456325,239,12,85,15,351
820472898,34,28,2,1,65
820477195,19,5,2,8,34
820478005,76,15,54,14,159
820491839,86,42,30,11,169
820493350,57,45,2,3,107
820495260,30,22,18,2,72
820497982,95,20,2,3,120
820535674,12,3,2,1,18
820560628,131,21,2,25,179
820573032,50,10,3,5,68
820576249,79,73,99,32,283
820587276,118,27,4,6,155
820597443,42,18,11,12,83
820607663,161,3,2,2,168
820612717,20,3,2,1,26
820615463,77,22,88,14,201
820636181,42,4,2,1,49
820636909,108,3,2,3,116
820638414,144,25,22,1,192
820639128,59,48,42,13,162
820706137,54,48,2,23,127
820708854,11,3,2,1,17
820720185,129,8,2,17,156
820730995,35,37,31,3,106
820749327,57,9,2,7,75
820799479,72,18,2,1,93
820801682,49,70,20,1,140
820811771,26,54,27,2,109
820820508,97,3,2,2,104
820832237,57,46,2,2,107
820839154,40,27,6,5,78
820842500,118,3,2,7,130
820843892,12,3,2,3,20
820846795,12,3,2,1,18
820859235,14,13,23,1,51
820898866,75,25,19,3,122
820904116,12,13,3,1,29
820920015,194,3,2,1,200
820975951,167,16,2,3,188
820992172,61,67,110,7,245
820992615,106,22,36,19,183
820994832,17,4,2,2,25
820998408,104,16,2,1,123
821013751,83,23,18,33,157
821020321,39,56,36,1,132
821021179,154,97,5,4,260
821022046,63,3,2,1,69
821022369,169,36,40,83,328
821033797,54,9,2,8,73
821050621,51,5,9,2,67
821061039,16,3,2,1,22
821066458,90,4,68,2,164
821069073,31,48,2,1,82
821075671,64,15,15,11,105
821081825,149,30,33,39,251
821090938,69,3,66,57,195
821103251,62,17,55,16,150
821114705,13,3,2,1,19
821151567,33,32,25,1,91
821153638,12,3,2,1,18
821153948,28,16,2,1,47
821161858,65,3,2,3,73
821163515,88,40,2,2,132
821176213,36,39,3,5,83
821184667,10,5,2,1,18
821186977,39,10,4,5,58
821201175,39,3,2,1,45
821201489,44,51,21,13,129
821208234,13,3,2,1,19
821212727,87,25,3,15,130
821231105,18,3,2,14,37
821263207,70,16,5,1,92
821269947,113,42,3,8,166
821303728,73,3,2,1,79
821311958,32,3,2,2,39
821312366,32,5,2,15,54
821315356,11,3,2,1,17
821323038,60,55,2,2,119
821329060,50,3,2,1,56
821340817,111,6,2,2,121
821346670,33,18,19,8,78
821349265,76,37,9,13,135
821351191,138,14,2,3,157
821352305,38,28,2,3,71
821367089,20,3,2,1,26
821373206,17,4,14,1,36
821375622,16,10,2,1,29
821383761,50,7,4,3,64
821392721,65,9,39,1,114
821414579,88,81,4,9,182
821421646,70,41,18,8,137
821457190,13,3,2,1,19
821465760,69,5,4,1,79
821476334,47,16,7,40,110
821482872,59,39,8,3,109
821483390,53,6,2,3,64
821485255,170,35,2,4,211
821494893,158,27,17,34,236
821500569,164,9,29,9,211
821500772,11,3,2,1,17
821503794,35,4,3,7,49
821521843,43,30,7,7,87
821526620,14,3,2,5,24
821542038,265,5,2,3,275
821546276,10,20,2,2,34
821563325,19,7,2,2,30
821564809,12,16,2,1,31
821574100,48,10,2,3,63
821610463,11,12,2,1,26
821617504,17,11,2,2,32
821623854,19,5,2,1,27
821638040,54,3,2,1,60
821644485,29,19,3,1,52
821655168,21,25,3,1,50
821675513,92,3,2,3,100
821680105,15,3,2,1,21
821687151,30,18,2,13,63
821696077,58,25,16,1,100
821706140,13,5,2,2,22
821712680,33,36,14,1,84
821718542,68,51,9,5,133
821732868,75,3,2,1,81
821749153,11,3,2,1,17
821754787,10,10,2,1,23
821756086,81,13,2,6,102
821758748,23,33,2,24,82
821759018,146,86,7,6,245
821779187,29,3,2,7,41
821784077,40,10,5,3,58
821795022,81,5,2,3,91
821795840,51,29,15,16,111
821797006,49,31,2,1,83
821798059,59,59,2,23,143
821800123,13,7,2,1,23
821810915,45,25,5,9,84
821813033,149,4,2,10,165
821822681,28,3,7,1,39
821822917,165,3,2,5,175
821835865,54,34,16,2,106
821845447,151,42,100,5,298
821847607,159,19,4,1,183
821853679,397,3,2,3,405
821879648,86,15,22,2,125
821891021,77,4,2,2,85
821899620,26,39,18,1,84
821900440,83,3,2,1,89
821902240,135,26,2,1,164
821903290,114,18,2,10,144
821916401,130,3,2,2,137
821917909,119,3,3,1,126
821922000,52,19,2,4,77
821936019,93,16,2,1,112
821939222,13,67,21,1,102
821958809,184,61,5,5,255
821966912,58,16,27,10,111
821971694,22,64,2,1,89
821982496,35,22,2,20,79
822001123,177,3,2,1,183
822002849,82,32,23,7,144
822011557,184,60,12,5,261
822012471,33,25,7,32,97
822021100,40,3,2,1,46
822051051,27,58,25,2,112
822056213,13,11,2,6,32
822063751,11,3,2,1,17
822081953,105,3,2,2,112
822085806,17,3,2,1,23
822087841,23,10,11,1,45
822124123,48,36,42,54,180
822139253,92,30,2,2,126
822147387,34,14,2,1,51
822153368,37,26,2,1,66
822160116,114,49,2,10,175
822166449,25,14,2,2,43
822169168,25,5,2,3,35
822173526,11,3,2,1,17
822190049,153,3,2,1,159
822217072,62,3,2,4,71
822222386,54,18,43,3,118
822232698,22,3,2,1,28
822243160,40,47,20,12,119
822246290,27,11,7,25,70
822247846,38,31,58,4,131
822257681,223,35,5,99,362
822286186,35,3,2,1,41
822299886,53,30,24,49,156
822310273,75,51,21,12,159
822314840,33,3,2,1,39
822341319,17,3,2,1,23
822344978,72,65,54,7,198
822348211,36,17,16,1,70
822355086,13,3,2,1,19
822364416,36,3,2,1,42
822369634,28,12,2,3,45
822386083,102,19,2,4,127
822414258,50,3,2,5,60
822420731,78,30,20,3,131
822436016,29,16,2,5,52
822440613,80,94,11,2,187
822468590,116,12,2,1,131
822481039,58,22,2,27,109
822487728,42,10,2,47,101
822494391,10,3,2,2,17
822500118,110,47,23,4,184
822526428,17,3,2,1,23
822529969,13,6,2,2,23
822538830,121,30,30,21,202
822542014,14,3,2,1,20
822548008,56,3,2,3,64
822558508,56,11,2,3,72
822575920,16,9,2,1,28
822588238,139,3,2,1,145
822608903,15,3,2,1,21
822634498,152,16,2,1,171
822642324,71,23,25,2,121
822670787,39,14,2,12,67
822674233,63,3,2,5,73
822678044,11,57,2,5,75
822688002,12,11,2,1,26
822690463,62,3,11,1,77
822701371,12,3,2,1,18
822702202,12,3,2,2,19
822702407,49,30,3,6,88
822711898,48,7,2,3,60
822719997,13,8,3,1,25
822729085,45,13,3,1,62
822732126,95,3,2,4,104
822733330,28,3,2,1,34
822736651,77,11,4,6,98
822752213,115,5,2,1,123
822752546,11,3,2,1,17
822755528,129,29,53,1,212
822773806,23,35,36,6,100
822787451,13,5,2,1,21
822794654,210,132,2,1,345
822814235,37,18,2,1,58
822815614,46,3,2,1,52
822819443,152,41,7,9,209
822832780,11,3,2,1,17
822866112,18,66,9,1,94
822867219,44,20,3,4,71
822876661,40,35,90,2,167
822878350,104,11,5,7,127
822880424,76,47,39,9,171
822881486,43,3,2,1,49
822884432,69,23,5,16,113
822895684,25,3,2,6,36
822904798,11,3,2,3,19
822904996,47,47,2,1,97
822907811,43,29,7,1,80
822915740,35,15,5,1,56
822920069,68,10,53,22,153
822922836,17,3,2,1,23
822924554,10,3,2,3,18
822928952,93,28,2,1,124
822934945,43,57,44,1,145
822945258,95,23,2,8,128
822949404,20,10,6,1,37
822973210,111,90,63,19,283
822973643,81,31,62,1,175
822975904,13,3,2,1,19
822978366,64,3,2,1,70
822981385,509,3,2,1,515
822995433,23,19,2,1,45
823012028,63,16,2,1,82
823036058,14,30,21,3,68
823061827,86,3,2,1,92
823066387,18,12,8,5,43
823067730,34,8,2,2,46
823072909,78,4,2,1,85
823074841,68,6,2,1,77
823090895,87,15,2,1,105
823091329,33,13,2,1,49
823107992,39,34,24,3,100
823118324,32,3,2,1,38
823128499,71,3,2,1,77
823159321,176,82,5,14,277
823185525,24,40,2,4,70
823202921,88,16,14,46,164
823210261,55,3,2,1,61
823233763,363,39,44,2,448
823251041,11,38,2,1,52
823252971,71,5,2,1,79
823256872,12,25,2,1,40
823271591,11,3,2,1,17
823275623,23,12,3,5,43
823277642,17,3,2,1,23
823299736,24,31,2,8,65
823306069,73,3,2,1,79
823307744,90,5,6,7,108
823310764,78,5,2,5,90
823313436,40,20,28,1,89
823318390,45,31,2,1,79
823318422,131,3,2,66,202
823323586,11,3,2,1,17
823340821,40,47,30,33,150
823352935,107,16,21,6,150
823364826,88,15,2,1,106
823365183,52,7,90,17,166
823387537,67,35,2,5,109
823395907,75,5,2,1,83
823402780,51,39,2,1,93
823411058,28,38,46,23,135
823436824,78,16,2,37,133
823439993,199,29,27,14,269
823452521,10,3,2,2,17
823480244,23,42,4,5,74
823484319,270,30,2,77,379
823493708,109,34,6,7,156
823506041,41,3,2,1,47
823521160,13,6,3,3,25
823525830,184,18,2,4,208
823528049,20,15,7,4,46
823538346,107,47,2,6,162
823545542,30,3,2,1,36
823558954,113,3,2,1,119
823564100,35,3,2,2,42
823579228,110,17,2,33,162
823593169,22,3,2,1,28
823597316,13,6,2,1,22
823601845,31,50,20,3,104
823611197,26,7,2,4,39
823637118,77,3,2,1,83
823638015,10,5,2,1,18
823646552,53,13,2,2,70
823651798,86,5,4,5,100
823664498,40,3,2,5,50
823672120,62,3,2,1,68
823683349,18,3,2,1,24
823684455,96,3,2,14,115
823698538,252,12,12,1,277
823719489,99,11,26,8,144
823726226,49,19,2,1,71
823729579,40,19,5,1,65
823731931,198,3,2,1,204
823742477,78,16,7,4,105
823753202,174,42,2,1,219
823754706,65,6,3,4,78
823765335,12,3,2,1,18
823774363,303,40,51,2,396
823776876,50,8,2,1,61
823795838,192,47,2,9,250
823826039,126,3,2,1,132
823828154,16,10,2,1,29
823836421,18,3,2,1,24
823860053,27,40,2,3,72
823883482,27,3,2,2,34
823891135,90,24,7,22,143
823895708,67,46,25,1,139
823898675,47,29,2,3,81
823948245,69,17,14,1,101
823949716,66,11,51,1,129
823952428,23,34,10,3,70
823962398,42,34,2,1,79
823996646,46,51,13,4,114
824000146,41,31,10,16,98
824021127,80,64,14,6,164
824027234,50,43,13,12,118
824051919,11,3,2,2,18
824053280,214,33,16,6,269
824053731,11,3,2,1,17
824054456,99,26,22,17,164
824056555,93,30,3,1,127
824057645,28,3,27,1,59
824063927,16,21,2,1,40
824064820,82,31,2,1,116
824064979,79,46,32,1,158
824077178,94,24,2,5,125
824104934,18,3,2,1,24
824128367,25,3,2,1,31
824154535,11,7,2,1,21
824155244,88,18,13,2,121
824168954,69,11,2,2,84
824174294,11,3,2,1,17
824177666,71,3,2,7,83
824200482,59,13,8,8,88
824227930,58,24,16,8,106
824231904,18,3,2,1,24
824238359,67,24,2,2,95
824240122,94,18,3,6,121
824242810,187,36,2,6,231
824254596,43,42,2,2,89
824261879,92,17,2,4,115
824281672,41,10,35,5,91
824282706,69,47,36,3,155
824291626,64,3,2,4,73
824307995,68,3,2,2,75
824317827,76,5,2,1,84
824325444,20,34,6,3,63
824330932,44,3,2,4,53
824332895,41,3,2,6,52
824368040,94,11,5,14,124
824381221,54,23,2,6,85
824382913,61,23,7,32,123
824387851,59,3,2,1,65
824388715,59,3,2,1,65
824389317,51,10,2,6,69
824396595,15,3,2,4,24
824407800,30,23,2,1,56
824412465,74,20,12,51,157
824415111,38,9,3,1,51
824422724,11,24,2,1,38
824441482,84,4,6,68,162
824471952,11,3,2,1,17
824473097,50,19,17,8,94
824486671,21,4,2,1,28
824508932,187,35,2,24,248
824517244,11,12,2,1,26
824524617,81,51,7,23,162
824534883,47,3,2,1,53
824539604,186,3,3,9,201
824560706,155,30,2,22,209
824561320,228,37,2,13,280
824566169,94,12,72,3,181
824583670,39,4,2,1,46
824591179,11,5,2,1,19
824592878,70,13,2,6,91
824604139,65,6,21,6,98
824616565,57,21,17,35,130
824617763,14,3,2,2,21
824618661,56,42,2,1,101
824619890,123,29,19,118,289
824621906,12,5,2,1,20
824623114,58,3,2,1,64
824629036,105,3,2,2,112
824639473,28,14,2,19,63
824639566,13,3,2,1,19
824644432,38,3,2,7,50
824650120,10,4,2,1,17
824660267,68,11,2,2,83
824668878,134,19,45,4,202
824679030,107,44,2,17,170
824684508,16,3,2,9,30
824693837,120,82,46,24,272
824696122,23,10,5,3,41
824696726,94,14,2,1,111
824700447,19,3,2,5,29
824717395,29,55,2,2,88
824723672,46,72,11,2,131
824725295,15,4,2,7,28
824743450,88,27,137,1,253
824754514,98,34,13,68,213
824774097,109,3,2,8,122
824781266,12,7,2,1,22
824786545,61,3,2,1,67
824812466,10,14,3,1,28
824821228,129,3,2,14,148
824828376,52,38,4,26,120
824843505,18,3,2,1,24
824844984,37,12,7,7,63
824856774,157,14,2,2,175
824869220,22,3,2,15,42
824871538,12,3,2,1,18
824879454,44,3,2,1,50
824885219,49,18,83,4,154
824888349,11,4,2,3,20
824891014,116,139,43,62,360
824904594,47,31,12,10,100
824906656,25,42,29,10,106
824919515,59,19,2,5,85
824929246,28,3,10,1,42
824930321,25,3,2,1,31
824967368,98,40,2,1,141
824986933,26,3,2,1,32
824990604,27,17,11,21,76
825011785,14,7,3,2,26
825054070,87,4,38,13,142
825054672,54,80,17,8,159
825064394,24,9,8,15,56
825090051,46,5,2,1,54
825094990,114,54,148,13,329
825098704,137,61,7,77,282
825104769,51,3,2,6,62
825106543,63,16,27,5,111
825108683,63,25,27,20,135
825120603,86,3,2,4,95
825126457,38,14,2,1,55
825132952,12,38,2,3,55
825161411,102,16,21,21,160
825180212,52,21,3,16,92
825190681,29,24,37,28,118
825219944,96,7,16,9,128
825229836,33,12,3,1,49
825241308,109,27,2,5,143
825241479,16,15,2,1,34
825244470,26,50,35,2,113
825249683,92,39,125,1,257
825258460,14,3,2,2,21
825258859,66,5,19,6,96
825271199,51,34,2,2,89
825280906,90,24,14,1,129
825282141,18,3,2,2,25
825284021,25,4,20,3,52
825285370,31,18,11,1,61
825291526,66,44,2,7,119
825297604,12,3,2,1,18
825298500,11,6,2,1,20
825346059,66,18,2,2,88
825351514,172,15,2,9,198
825369378,35,20,25,1,81
825376339,205,3,2,13,223
825378132,49,46,35,7,137
825390709,12,75,2,1,90
825395608,113,40,43,42,238
825436948,15,19,11,1,46
825439410,73,4,2,7,86
825441081,23,8,2,10,43
825441648,23,4,2,4,33
825460516,24,25,2,7,58
825480422,107,3,2,3,115
825482009,30,21,2,14,67
825482439,22,3,2,1,28
825497800,56,3,2,7,68
825508772,113,18,38,6,175
825517931,109,27,25,5,166
825524045,48,3,2,8,61
825547194,178,19,26,7,230
825555194,17,3,2,2,24
825556315,114,15,23,10,162
825569142,96,26,18,4,144
825600989,25,3,2,1,31
825626850,11,4,2,1,18
825661399,65,3,2,22,92
825664228,22,11,2,1,36
825673415,55,29,9,2,95
825674379,59,28,2,1,90
825683991,130,15,2,2,149
825686520,12,3,2,1,18
825689647,90,3,2,3,98
825698085,58,3,2,2,65
825702443,99,25,2,4,130
825705551,46,3,2,1,52
825707854,24,21,2,3,50
825712184,35,23,2,1,61
825726527,129,14,13,1,157
825737561,65,52,12,2,131
825747313,113,20,24,8,165
825750443,47,12,7,4,70
825767992,258,3,2,8,271
825772006,26,12,13,44,95
825779789,11,6,2,1,20
825781234,31,10,4,7,52
825784724,82,7,2,10,101
825795089,16,10,2,1,29
825795980,56,3,2,1,62
825804681,104,10,2,4,120
825833845,11,3,2,1,17
825842640,52,11,4,6,73
825852946,24,3,2,1,30
825864276,33,35,6,26,100
825874306,19,18,2,10,49
825892873,64,3,2,2,71
825896662,12,33,2,1,48
825898420,59,15,2,1,77
825917356,95,3,2,1,101
825918637,11,3,2,1,17
825941354,161,6,43,1,211
825942775,10,12,2,1,25
825949760,12,3,2,5,22
825954833,39,3,2,2,46
825960277,117,4,12,6,139
825969221,11,9,2,1,23
825990247,195,3,2,1,201
826014553,151,86,42,4,283
826014748,62,15,15,1,93
826017653,109,50,44,189,392
826022300,62,14,14,4,94
826039370,10,5,2,1,18
826044133,150,3,2,36,191
826045453,48,7,2,2,59
826056384,27,8,34,1,70
826070942,53,23,47,27,150
826076050,110,35,65,35,245
826078039,39,4,2,1,46
826093332,21,26,2,1,50
826109131,76,51,62,3,192
826112384,102,3,2,3,110
826112673,77,16,6,13,112
826116515,10,12,2,2,26
826127521,103,3,2,5,113
826161346,74,56,32,5,167
826174182,10,5,2,1,18
826181431,38,104,20,17,179
826183497,11,33,2,7,53
826188136,94,29,28,1,152
826194715,86,12,2,1,101
826194973,63,20,4,32,119
826198329,51,3,2,2,58
826200390,45,60,17,2,124
826204688,10,3,2,3,18
826210355,163,34,3,4,204
826215185,209,22,41,5,277
826218353,20,3,2,1,26
826232025,27,24,2,10,63
826234599,162,52,10,5,229
826248408,151,3,2,1,157
826279924,113,70,2,19,204
826286224,134,90,40,1,265
826291737,129,55,144,32,360
826299518,45,40,4,4,93
826308793,48,4,2,3,57
826317779,182,37,4,2,225
826325401,183,42,14,11,250
826334761,40,15,2,1,58
826339862,28,7,3,8,46
826344896,12,15,2,3,32
826388183,18,3,2,2,25
826390703,40,3,2,11,56
826396921,89,41,16,43,189
826398411,30,27,24,7,88
826399741,27,10,4,10,51
826407418,63,20,19,3,105
826415175,45,20,2,1,68
826422912,85,7,3,5,100
826436371,38,3,2,1,44
826444102,18,45,51,9,123
826450010,22,13,2,15,52
826456350,91,12,20,2,125
826464904,28,42,2,5,77
826471636,17,3,2,2,24
826492080,67,23,4,1,95
826504059,86,16,51,1,154
826506576,39,3,2,2,46
826507712,10,6,2,1,19
826513250,46,3,2,1,52
826519982,82,3,2,1,88
826543200,81,8,2,1,92
826558905,11,3,2,1,17
826586769,11,4,2,1,18
826593462,52,59,4,2,117
826603013,10,3,2,3,18
826618497,57,3,2,5,67
826621743,42,34,2,6,84
826642278,86,3,2,1,92
826684304,202,13,2,1,218
826698496,23,88,51,5,167
826703228,96,38,94,1,229
826703908,51,53,4,1,109
826703919,28,4,4,3,39
826717686,99,38,55,7,199
826745562,14,3,2,5,24
826751959,195,23,15,11,244
826755607,34,14,7,5,60
826758033,96,119,36,2,253
826766269,86,8,2,1,97
826769274,83,3,2,1,89
826771067,68,39,12,3,122
826784791,59,63,27,14,163
826789079,39,27,2,1,69
826789656,33,51,6,7,97
826810260,37,15,43,1,96
826827479,34,50,9,1,94
826832892,28,63,2,4,97
826848292,51,18,2,1,72
826855423,219,10,8,42,279
826862635,16,24,2,1,43
826864999,111,12,12,4,139
826868517,50,34,8,6,98
826871437,88,57,11,29,185
826884448,190,7,2,8,207
826888860,35,19,31,2,87
826895993,58,29,33,32,152
826902972,83,47,6,1,137
826906375,55,3,2,4,64
826907553,53,3,2,1,59
826911491,134,29,22,11,196
826912791,11,3,2,1,17
826925845,94,62,41,21,218
826951585,76,35,27,9,147
826960172,11,53,2,1,67
826960505,313,3,2,1,319
826973904,91,3,2,1,97
826977078,138,22,95,9,264
826978563,84,3,2,5,94
826983495,23,3,2,1,29
827014182,149,4,24,4,181
827016879,12,3,2,1,18
827023280,56,3,2,1,62
827026427,99,18,7,3,127
827052325,43,7,20,1,71
827054429,83,18,2,13,116
827070859,52,19,3,1,75
827080900,73,8,3,4,88
827084257,170,72,76,13,331
827090263,76,42,25,49,192
827091467,122,93,23,34,272
827091917,43,23,2,8,76
827148016,15,3,2,1,21
827163267,213,3,4,3,223
827192175,108,52,2,12,174
827200718,78,24,22,4,128
827207281,90,49,19,19,177
827207657,18,5,2,5,30
827210356,30,45,7,1,83
827229350,33,13,2,12,60
827231186,62,13,75,2,152
827234583,81,3,2,1,87
827235999,79,22,2,2,105
827239295,127,20,2,4,153
827250560,75,34,13,6,128
827251922,93,28,2,1,124
827263122,34,11,60,1,106
827289703,72,3,2,2,79
827293144,210,61,3,2,276
827301671,164,25,3,3,195
827323359,12,8,2,1,23
827326541,81,3,2,1,87
827330797,148,19,12,12,191
827335139,196,14,2,1,213
827348930,18,17,2,1,38
827349819,11,31,2,1,45
827366489,41,54,31,4,130
827367114,115,22,30,3,170
827382549,79,7,2,7,95
827391234,88,3,2,1,94
827402314,15,11,2,1,29
827412505,135,3,2,2,142
827420850,69,5,3,10,87
827451956,17,3,2,1,23
827453207,111,3,2,19,135
827455556,57,3,2,1,63
827455916,99,25,25,8,157
827519576,67,20,44,3,134
827522801,14,9,54,8,85
827525014,59,12,3,2,76
827525731,153,22,2,11,188
827531950,86,3,2,2,93
827539492,77,71,37,18,203
827579870,35,3,2,1,41
827583131,13,3,2,2,20
827617721,69,6,45,1,121
827622538,54,28,21,1,104
827625261,10,3,2,2,17
827627578,11,15,2,1,29
827662639,268,6,47,14,335
827663050,86,34,5,12,137
827678589,11,11,2,4,28
827703004,52,18,2,3,75
827709310,53,19,3,1,76
827727038,30,27,4,2,63
827743072,116,37,2,1,156
827744562,17,3,2,1,23
827764044,35,3,2,1,41
827764733,111,34,12,11,168
827774805,74,3,2,1,80
827775141,31,3,2,1,37
827789267,69,17,45,1,132
827790393,49,3,2,1,55
827794234,14,3,2,1,20
827809738,83,30,2,48,163
827819035,55,5,7,3,70
827822219,77,14,30,4,125
827826874,103,3,2,1,109
827832571,188,49,2,4,243
827850935,27,92,53,6,178
827857952,183,80,5,2,270
827872091,52,18,15,1,86
827875249,96,9,2,5,112
827876399,100,3,2,1,106
827887124,16,3,2,1,22
827900517,34,19,10,7,70
827900954,111,15,33,15,174
827908605,69,3,2,1,75
827909504,54,31,10,1,96
827930625,141,44,2,32,219
827934370,87,3,2,1,93
827935871,94,23,2,10,129
827937301,131,38,3,3,175
827944233,25,8,17,1,51
827953293,151,3,2,12,168
827957639,15,21,2,7,45
827959550,16,17,3,1,37
827989192,64,3,2,1,70
827991514,115,21,18,9,163
827991646,12,3,2,2,19
827996860,58,25,7,11,101
828006913,12,6,2,2,22
828012021,102,3,2,4,111
828012288,38,26,2,1,67
828019127,30,3,2,3,38
828020375,59,54,2,12,127
828027233,37,30,7,5,79
828032080,124,3,2,1,130
828035284,25,7,2,1,35
828036907,81,26,24,11,142
828056577,14,5,2,3,24
828074608,114,3,2,3,122
828076913,75,13,2,44,134
828092877,45,3,2,1,51
828093606,167,13,2,8,190
828098697,73,32,31,43,179
828103586,19,17,8,8,52
828108503,91,35,26,5,157
828113004,43,20,13,9,85
828140537,74,10,2,1,87
828165096,47,22,6,1,76
828165513,38,31,5,21,95
828174199,47,3,15,1,66
828182337,92,3,2,17,114
828184023,21,3,2,1,27
828195587,32,42,26,20,120
828223473,50,51,74,6,181
828242947,27,17,2,1,47
828247312,83,23,54,1,161
828249474,43,27,21,6,97
828275490,13,3,2,1,19
828281536,73,21,20,2,116
828285462,43,23,2,1,69
828286268,68,44,57,32,201
828286796,48,6,36,1,91
828296365,22,11,2,3,38
828297874,59,11,19,24,113
828298842,15,24,2,4,45
828302456,50,4,2,2,58
828324903,10,10,2,2,24
828326646,45,23,15,8,91
828330930,26,3,2,1,32
828336198,29,12,2,4,47
828336985,18,3,2,1,24
828339452,141,41,60,1,243
828351366,55,22,3,17,97
828369921,74,3,2,1,80
828378382,21,52,19,1,93
828408067,49,3,2,1,55
828414658,17,9,2,2,30
828419642,89,25,2,9,125
828434107,51,9,35,3,98
828435490,74,22,11,1,108
828437255,60,36,28,36,160
828439094,42,25,3,8,78
828439778,189,7,2,3,201
828447007,13,3,2,1,19
828462964,43,3,2,8,56
828478546,10,11,2,1,24
828478767,23,7,2,7,39
828490909,57,14,2,11,84
828498227,10,16,12,3,41
828499797,78,6,10,4,98
828513107,83,19,2,5,109
828515142,53,33,3,13,102
828517071,100,3,2,7,112
828521262,97,24,47,18,186
828529621,112,15,27,2,156
828540413,16,9,2,1,28
828544406,129,3,2,1,135
828546064,139,22,63,5,229
828561501,34,3,2,1,40
828562860,153,21,14,45,233
828562938,12,3,2,1,18
828608354,140,3,2,4,149
828614441,46,11,21,24,102
828624149,103,3,2,20,128
828630839,62,11,2,2,77
828631958,269,30,26,49,374
828640377,106,10,25,8,149
828648414,55,3,2,6,66
828659181,134,3,2,1,140
828659380,17,3,2,2,24
828672025,143,66,2,1,212
828674139,52,34,18,15,119
828675660,52,54,2,2,110
828678887,78,3,2,2,85
828681224,73,3,2,1,79
828684525,21,3,2,1,27
828691754,13,4,2,3,22
828731400,50,25,8,17,100
828738032,226,103,40,2,371
828745992,112,6,2,8,128
828746083,107,6,8,2,123
828747895,18,3,2,1,24
828765024,21,34,2,1,58
828774193,109,24,3,8,144
828780176,17,3,2,1,23
828785973,65,21,7,3,96
828796788,11,3,2,1,17
828800560,108,3,2,9,122
828814275,170,75,3,14,262
828818860,80,14,16,65,175
828820608,42,3,2,3,50
828835723,28,12,2,1,43
828837170,75,9,2,1,87
828837226,31,3,2,4,40
828856762,13,20,2,1,36
828876727,13,3,2,1,19
828887847,14,18,2,2,36
828896474,11,3,2,2,18
828908715,18,104,38,11,171
828919900,37,3,2,1,43
828922190,128,3,2,12,145
828929811,96,44,2,27,169
828942370,102,21,17,4,144
828949646,79,3,10,2,94
828950800,28,3,2,1,34
828955710,70,65,10,37,182
828960997,64,3,2,1,70
828965374,148,19,2,12,181
828979601,124,3,2,1,130
828987467,51,3,2,1,57
828988330,19,20,2,1,42
828989281,98,13,3,7,121
828993347,72,3,2,2,79
829000882,10,5,2,1,18
829011566,85,16,57,1,159
829020778,50,15,2,1,68
829030250,17,3,2,1,23
829040255,163,13,15,27,218
829054788,130,6,38,6,180
829065379,56,69,12,23,160
829069488,76,3,2,8,89
829073756,152,40,4,5,201
829082909,17,3,2,1,23
829085095,61,15,3,1,80
829104240,62,27,3,1,93
829104868,93,20,24,1,138
829110056,91,13,2,6,112
829115017,14,8,2,1,25
829115402,60,3,2,1,66
829119411,51,55,26,7,139
829120012,129,7,2,1,139
829136158,26,10,4,7,47
829142223,42,6,2,2,52
829142672,55,14,2,2,73
829152374,13,3,2,1,19
829157816,12,3,2,1,18
829163746,112,3,2,1,118
829185402,51,18,12,1,82
829187628,32,3,2,3,40
829200110,48,42,10,4,104
829215503,67,5,31,1,104
829242654,30,32,11,8,81
829253136,64,20,9,4,97
829254295,200,50,41,49,340
829276125,38,23,2,1,64
829289627,46,8,3,1,58
829292176,15,3,2,1,21
829308192,13,3,2,1,19
829308357,81,3,2,10,96
829331992,131,16,40,23,210
829336688,68,77,43,36,224
829337211,194,7,2,3,206
829338693,153,126,44,27,350
829341699,19,33,2,12,66
829353843,48,42,12,5,107
829356750,29,65,8,2,104
829378900,98,3,2,1,104
829386289,14,3,2,1,20
829429236,29,27,35,26,117
829439523,655,3,2,6,666
829455030,18,3,2,2,25
829461032,82,35,15,4,136
829469655,41,16,2,8,67
829469753,14,22,2,5,43
829479204,36,3,2,5,46
829484803,94,39,22,1,156
829493040,43,15,2,2,62
829498771,71,3,2,3,79
829519036,13,3,2,1,19
829528098,51,46,8,1,106
829529659,47,18,19,65,149
829534601,100,3,2,1,106
829540886,26,47,11,7,91
829557155,70,56,5,5,136
829580684,15,8,2,7,32
829580826,35,24,11,5,75
829587326,136,35,56,2,229
829593314,30,3,2,1,36
829603521,72,6,11,8,97
829604142,495,3,2,6,506
829605384,31,27,2,2,62
829611013,155,4,2,2,163
829624048,11,3,2,1,17
829627822,35,22,4,5,66
829633436,54,152,51,1,258
829640377,78,9,2,12,101
829641477,20,3,2,1,26
829641875,65,3,2,1,71
829651653,20,54,2,11,87
829654009,153,23,48,27,251
829663357,165,12,47,5,229
829680843,25,3,13,1,42
829694537,27,3,2,3,35
829694752,54,20,2,24,100
829695016,34,43,7,1,85
829697619,46,135,21,22,224
829711636,84,46,13,3,146
829715589,26,9,3,4,42
829716200,79,72,35,29,215
829717559,70,98,58,4,230
829726093,52,4,2,10,68
829729663,11,35,4,8,58
829737789,20,3,2,1,26
829739075,10,13,3,1,27
829747762,173,26,117,1,317
829767192,13,3,2,1,19
829767616,16,5,2,1,24
829788341,12,4,2,1,19
829797847,144,16,12,2,174
829803917,13,18,2,1,34
829825412,61,51,31,1,144
829829296,179,18,2,1,200
829829600,40,30,40,1,111
829831456,43,3,2,1,49
829836341,35,3,2,2,42
829852033,12,6,2,1,21
829857455,14,32,2,1,49
829895188,20,14,2,1,37
829900299,91,11,2,2,106
829905165,32,13,2,1,48
829913191,16,3,2,1,22
829948779,79,16,18,1,114
829952245,31,13,3,9,56
829954944,94,44,23,2,163
829959546,94,21,2,1,118
829959995,164,3,2,1,170
829961542,572,3,2,22,599
829966545,103,3,2,6,114
829968706,71,48,3,8,130
829979478,37,85,21,8,151
829986576,34,66,21,8,129
829988833,16,3,2,4,25
829989099,24,12,2,1,39
830003227,17,6,2,6,31
830022713,11,3,2,1,17
830027851,96,21,3,10,130
830031069,106,20,33,3,162
830031478,51,21,14,3,89
830058325,19,25,39,1,84
830059718,30,5,2,1,38
830062122,18,3,2,1,24
830064598,74,3,2,1,80
830064601,23,12,22,3,60
830085620,123,3,2,6,134
830096558,24,10,2,19,55
830103494,56,11,10,1,78
830111431,47,18,21,16,102
830131563,31,18,10,19,78
830135443,134,4,2,1,141
830148338,26,6,4,1,37
830151093,127,80,34,2,243
830158835,93,10,22,2,127
830161262,47,14,38,1,100
830162240,78,34,12,2,126
830165643,43,3,2,1,49
830171458,11,3,2,3,19
830187493,65,20,2,13,100
830187589,26,44,21,1,92
830192552,64,25,21,10,120
830193699,111,3,5,2,121
830218233,17,15,3,1,36
830225251,63,117,43,30,253
830235167,91,34,18,21,164
830265244,76,3,2,1,82
830272662,210,20,11,9,250
830285215,104,17,2,10,133
830291144,61,23,36,20,140
830293512,23,3,2,1,29
830295130,103,14,12,3,132
830298027,56,9,14,1,80
830301654,78,11,29,6,124
830301813,11,3,2,1,17
830302357,11,5,2,1,19
830310677,211,62,21,47,341
830313882,52,3,2,4,61
830320376,39,15,3,1,58
830323212,98,25,2,3,128
830329005,251,14,2,23,290
830348091,46,3,2,5,56
830354294,79,34,8,13,134
830365054,49,58,2,8,117
830368999,61,43,55,5,164
830374284,11,15,2,4,32
830382446,80,23,21,2,126
830439289,11,3,2,1,17
830444804,15,3,2,1,21
830452745,12,3,2,1,18
830458865,144,67,3,4,218
830461866,428,50,2,9,489
830462044,51,3,2,1,57
830467817,128,12,22,1,163
830479294,22,3,2,1,28
830482325,80,50,28,12,170
830483230,24,4,4,2,34
830486164,55,4,2,3,64
830489686,134,5,12,2,153
830505642,23,3,2,1,29
830506341,106,35,17,7,165
830506720,42,3,2,1,48
830518775,88,39,18,25,170
830529032,74,44,38,4,160
830534816,60,11,22,5,98
830554085,127,64,18,6,215
830600864,13,3,2,1,19
830613033,14,3,2,1,20
830616812,122,13,13,34,182
830632511,26,3,2,1,32
830643374,144,53,38,14,249
830651787,46,21,4,1,72
830657297,34,76,3,6,119
830673065,56,3,2,1,62
830690139,56,42,4,1,103
830709942,84,3,2,5,94
830716582,78,34,58,1,171
830722246,66,24,2,2,94
830742135,12,3,2,1,18
830772147,29,3,2,1,35
830779168,22,30,26,3,81
830786154,57,56,4,4,121
830794963,37,34,2,4,77
830801511,14,3,2,1,20
830805173,105,44,2,1,152
830807288,21,3,2,5,31
830812184,40,12,4,1,57
830816713,36,8,2,1,47
830828784,125,20,5,1,151
830840404,59,21,2,4,86
830849019,40,41,19,3,103
830856080,107,3,2,2,114
830867989,17,3,2,1,23
830872601,83,61,71,7,222
830888592,46,4,2,1,53
830912596,134,34,4,1,173
830916425,98,28,4,25,155
830916526,16,18,2,1,37
830916868,46,3,2,1,52
830920619,28,19,4,14,65
830940067,41,3,2,9,55
830948846,44,28,4,1,77
830964808,48,3,2,1,54
830974308,95,3,2,1,101
830977240,27,25,16,5,73
830981671,49,37,54,3,143
830987349,68,3,2,5,78
831001146,160,3,2,1,166
831013722,17,3,2,1,23
831018297,137,35,3,2,177
831025791,12,4,2,1,19
831032206,95,18,2,1,116
831042654,16,3,2,1,22
831050394,14,16,2,1,33
831058934,30,32,2,4,68
831067115,12,6,2,6,26
831071758,24,12,2,1,39
831111945,106,34,10,3,153
831133801,14,6,2,1,23
831140185,56,88,30,6,180
831157939,11,3,2,1,17
831158260,130,3,35,1,169
831174671,81,3,2,1,87
831174806,202,7,2,2,213
831177689,19,6,2,1,28
831178225,22,23,2,1,48
831180663,27,67,2,8,104
831187795,56,95,66,11,228
831188173,71,49,8,6,134
831189506,47,3,2,1,53
831198145,36,14,6,1,57
831211441,115,3,2,23,143
831221238,25,3,2,1,31
831221559,119,20,16,34,189
831222199,121,3,2,8,134
831231736,49,3,2,1,55
831237451,89,59,16,30,194
831239829,42,23,3,1,69
831246611,37,52,3,2,94
831268853,30,3,2,1,36
831290190,32,11,3,3,49
831297039,10,8,2,24,44
831297898,20,13,51,4,88
831303116,23,13,2,1,39
831304826,174,4,2,8,188
831307105,19,50,11,2,82
831310162,74,31,3,3,111
831335544,24,87,15,1,127
831340188,140,69,11,111,331
831340235,127,3,2,2,134
831341708,183,94,5,1,283
831342921,18,10,2,1,31
831346564,24,20,5,11,60
831353662,19,17,2,4,42
831365903,186,23,5,1,215
831367010,203,23,177,8,411
831370304,24,3,2,1,30
831380375,15,9,2,2,28
831392247,66,26,2,1,95
831415379,32,25,2,23,82
831421617,122,13,32,1,168
831426906,21,18,2,8,49
831438998,61,3,2,1,67
831441631,25,19,2,1,47
831444803,61,22,22,4,109
831452640,60,36,91,4,191
831463239,64,3,2,1,70
831464806,12,5,2,2,21
831466749,45,3,2,1,51
831474624,82,25,48,31,186
831497633,13,3,2,4,22
831498368,69,33,2,8,112
831504527,54,4,13,6,77
831517810,26,5,2,3,36
831518679,249,12,16,4,281
831524004,85,25,3,6,119
831528026,28,36,2,1,67
831545731,70,50,48,25,193
831587087,10,8,2,1,21
831606293,35,3,2,1,41
831641366,44,4,11,2,61
831648191,33,40,23,1,97
831649130,44,20,2,1,67
831670258,44,13,2,1,60
831673959,77,3,2,3,85
831675979,93,17,38,98,246
831689152,26,5,2,6,39
831689215,101,15,3,4,123
831701837,44,15,2,3,64
831711970,39,12,2,1,54
831714408,130,48,2,1,181
831726048,165,42,7,7,221
831731022,88,80,42,67,277
831741603,38,3,2,2,45
831744752,10,3,2,6,21
831751653,141,42,5,5,193
831761100,180,34,3,5,222
831761811,131,3,2,3,139
831767088,53,22,61,5,141
831771150,30,3,2,4,39
831786626,89,22,7,1,119
831800932,112,26,4,1,143
831801999,100,27,33,4,164
831813891,73,63,2,2,140
831815097,146,3,14,7,170
831822610,42,3,2,1,48
831835976,78,59,32,1,170
831854041,97,5,2,8,112
831856881,36,35,20,5,96
831880122,41,64,13,3,121
831881556,86,42,7,7,142
831913313,90,15,2,2,109
831915411,62,5,45,4,116
831919576,122,16,91,1,230
831936554,57,6,7,18,88
831941845,26,40,8,11,85
831946418,140,3,2,7,152
831962136,41,17,5,6,69
831964369,12,3,2,1,18
831967120,123,9,82,7,221
831969272,40,29,24,4,97
831969685,24,3,2,1,30
831994747,28,3,2,2,35
832005699,30,3,2,8,43
832007924,53,21,2,15,91
832020018,60,26,80,5,171
832032371,52,20,5,15,92
832034035,26,29,12,8,75
832052349,11,34,2,5,52
832055330,20,3,2,1,26
832055958,19,12,2,1,34
832056865,78,3,2,1,84
832068438,82,7,2,1,92
832070906,106,34,2,3,145
832077940,596,3,2,14,615
832089526,76,3,2,4,85
832091154,41,32,14,8,95
832105970,36,60,3,9,108
832113964,84,3,2,1,90
832114515,11,13,3,1,28
832126178,80,7,2,7,96
832130100,55,80,2,1,138
832144390,22,23,2,1,48
832153607,51,20,3,3,77
832157787,133,42,8,8,191
832161199,139,34,3,2,178
832164462,10,3,2,2,17
832169496,31,83,35,1,150
832178813,14,11,2,1,28
832187325,45,18,2,9,74
832203928,67,10,3,11,91
832207517,19,8,2,1,30
832221649,57,17,5,25,104
832221763,24,7,12,5,48
832224765,40,16,2,1,59
832229767,71,24,43,20,158
832231428,26,26,2,6,60
832240536,13,3,2,1,19
832283467,85,54,59,6,204
832301863,70,31,32,14,147
832322417,117,7,2,7,133
832324616,42,57,9,3,111
832328163,11,39,2,1,53
832330572,28,8,2,1,39
832332929,34,4,2,1,41
832336019,103,3,2,12,120
832340423,51,35,8,2,96
832359188,10,11,2,1,24
832379620,49,37,40,2,128
832382260,73,35,25,17,150
832387727,21,29,3,1,54
832391758,91,65,10,1,167
832413936,40,46,81,6,173
832416476,104,28,50,12,194
832418919,50,34,2,9,95
832450199,14,7,2,1,24
832459690,73,42,25,7,147
832486814,103,9,25,6,143
832495956,33,34,8,6,81
832503828,97,29,148,2,276
832514856,107,29,87,9,232
832526375,32,9,2,1,44
832528707,62,12,32,5,111
832535000,59,14,2,1,76
832537012,16,4,2,1,23
832551142,10,5,2,1,18
832559796,11,3,2,1,17
832561549,12,3,2,1,18
832562564,11,28,2,1,42
832588338,170,12,10,14,206
832590997,71,18,4,1,94
832605739,15,45,2,2,64
832619194,112,21,2,1,136
832621156,201,24,4,1,230
832623555,23,18,2,1,44
832651908,10,5,2,1,18
832662368,118,3,2,1,124
832669960,126,3,2,1,132
832672959,21,3,2,1,27
832673578,12,3,2,1,18
832684218,85,34,16,4,139
832694468,67,8,2,3,80
832745121,48,9,2,8,67
832746738,86,92,2,29,209
832752382,66,3,2,1,72
832756011,44,3,2,1,50
832757647,99,49,2,1,151
832757922,13,48,2,1,64
832763787,96,3,2,3,104
832787305,55,26,47,9,137
832787647,68,49,6,46,169
832807984,95,40,3,5,143
832808069,26,23,11,1,61
832808692,39,18,29,1,87
832817097,117,18,18,11,164
832821472,43,4,2,6,55
832827486,129,9,2,1,141
832835175,79,45,34,46,204
832837166,48,3,2,1,54
832840403,198,20,4,27,249
832843972,11,3,2,2,18
832870331,88,16,2,5,111
832874342,22,3,2,1,28
832876384,116,9,2,1,128
832882984,10,73,2,1,86
832886150,140,25,6,8,179
832892552,10,6,2,1,19
832911588,13,5,3,1,22
832915645,55,3,2,1,61
832929230,63,4,12,16,95
832940049,231,3,45,2,281
832944669,71,14,45,1,131
832947000,283,3,2,2,290
832960760,66,11,2,7,86
832966780,54,47,25,16,142
832967812,62,27,34,2,125
832981391,11,3,2,2,18
832984124,175,50,14,2,241
832990877,42,37,95,1,175
832991123,46,7,8,10,71
833009523,136,41,2,1,180
833009973,63,26,17,2,108
833028424,122,4,2,1,129
833029470,10,7,2,1,20
833033658,159,9,13,1,182
833034967,10,4,2,1,17
833047932,92,15,23,8,138
833050578,62,19,34,24,139
833051130,36,60,14,11,121
833053315,25,31,2,1,59
833056749,101,16,89,3,209
833061791,156,18,2,12,188
833066800,32,11,8,1,52
833083725,93,51,181,10,335
833084471,11,3,2,1,17
833096848,45,10,2,1,58
833112856,68,8,2,1,79
833116487,24,35,2,12,73
833121383,55,26,4,1,86
833134545,19,3,2,1,25
833141654,36,34,2,3,75
833155011,83,3,2,10,98
833158323,258,3,24,79,364
833162017,11,96,18,1,126
833172174,70,24,2,1,97
833179200,10,18,2,1,31
833200844,107,47,16,11,181
833202600,113,29,3,14,159
833204162,18,14,2,1,35
833228636,18,3,2,1,24
833234130,513,3,2,2,520
833239526,69,7,47,71,194
833248835,52,14,3,5,74
833256383,71,4,2,2,79
833256409,12,6,2,1,21
833270053,49,11,18,3,81
833272345,13,96,14,1,124
833287069,142,3,2,1,148
833338086,75,45,9,32,161
833351183,95,55,124,3,277
833355500,15,8,2,1,26
833357151,25,3,2,1,31
833368911,64,36,2,7,109
833386158,48,37,41,15,141
833394038,66,3,2,21,92
833411482,13,49,4,33,99
833418857,133,3,2,1,139
833430378,10,16,2,1,29
833439556,12,4,2,3,21
833440841,103,35,14,29,181
833441500,16,16,2,1,35
833479084,94,15,78,1,188
833494965,31,3,2,1,37
833497488,86,51,28,38,203
833499534,17,3,2,1,23
833501879,94,16,2,3,115
833507355,23,3,2,5,33
833516587,34,42,5,15,96
833519146,116,12,23,6,157
833525855,126,50,102,2,280
833543369,62,4,2,2,70
833546920,30,40,15,12,97
833552709,60,3,2,9,74
833555571,42,53,2,14,111
833562401,53,11,3,5,72
833563595,13,16,2,1,32
833572712,12,3,2,1,18
833574857,85,3,2,1,91
833580417,63,47,2,1,113
833601339,115,31,85,7,238
833604134,31,3,29,1,64
833607625,83,3,2,2,90
833612106,114,87,11,1,213
833643237,228,3,2,2,235
833648756,75,11,3,9,98
833670381,15,3,2,1,21
833673875,104,95,26,57,282
833678467,14,3,2,1,20
833679393,17,5,2,1,25
833687494,128,72,14,99,313
833694311,12,4,2,1,19
833719043,56,12,96,1,165
833729950,11,3,2,5,21
833751948,16,8,2,1,27
833787248,20,3,2,2,27
833797067,41,3,2,1,47
833805700,132,13,15,2,162
833819582,11,4,2,1,18
833834935,84,8,2,1,95
833838935,46,20,29,3,98
833847031,11,9,2,1,23
833865633,13,9,2,1,25
833867636,61,7,5,1,74
833872298,68,43,2,1,114
833872763,36,5,41,24,106
833899028,88,5,2,1,96
833906693,37,3,2,3,45
833920196,92,3,2,6,103
833927223,46,3,2,12,63
833932541,18,25,2,3,48
833939610,28,23,3,1,55
833981244,62,46,2,7,117
833985538,219,3,2,4,228
833990392,16,14,13,2,45
833997783,17,4,2,4,27
834010087,72,3,2,3,80
834011560,118,21,2,3,144
834014857,10,4,2,3,19
834023775,78,19,5,1,103
834027083,103,18,2,2,125
834032416,31,8,43,2,84
834038117,50,3,2,1,56
834047103,146,4,28,10,188
834059132,23,3,2,6,34
834060669,29,16,2,1,48
834064563,139,3,2,3,147
834072555,20,11,2,1,34
834092319,130,9,7,7,153
834116745,248,42,11,4,305
834129273,45,20,2,5,72
834132092,12,20,7,5,44
834132741,52,64,23,17,156
834150995,135,3,2,6,146
834155695,169,7,4,10,190
834163134,23,26,2,1,52
834166716,48,3,2,1,54
834179673,19,3,2,4,28
834180141,30,19,12,3,64
834202232,11,3,2,1,17
834215229,45,44,25,2,116
834220777,46,16,2,1,65
834222398,156,3,2,1,162
834232425,30,29,3,1,63
834236314,38,5,2,1,46
834236960,12,8,2,1,23
834244604,11,3,2,1,17
834246904,65,3,2,17,87
834251002,52,8,2,1,63
834255357,116,23,4,20,163
834257873,14,6,3,1,24
834263743,43,38,62,13,156
834270806,34,11,10,1,56
834270967,14,3,2,1,20
834280775,233,3,2,12,250
834326946,89,39,2,2,132
834354343,33,37,57,1,128
834360043,14,3,2,2,21
834364925,60,13,2,3,78
834366607,115,41,16,4,176
834370879,23,6,2,3,34
834373838,44,17,6,2,69
834375531,103,27,2,12,144
834413900,49,10,2,1,62
834416608,93,3,2,12,110
834423521,86,8,14,2,110
834433858,13,94,3,1,111
834461069,46,3,2,1,52
834469754,34,3,2,1,40
834478878,50,55,7,15,127
834504235,33,18,2,1,54
834518861,23,73,9,1,106
834522684,44,3,2,1,50
834529426,64,24,18,9,115
834555590,117,44,11,4,176
834556189,14,26,2,1,43
834571599,83,3,2,23,111
834576296,17,3,2,1,23
834587474,50,5,13,1,69
834615070,28,20,2,1,51
834619608,28,3,2,2,35
834620186,46,9,13,1,69
834623278,11,3,2,1,17
834623364,25,3,2,4,34
834634553,110,3,2,1,116
834637863,16,8,2,1,27
834652067,10,3,2,2,17
834660872,219,3,2,20,244
834662244,10,12,2,1,25
834675913,15,12,2,2,31
834686001,81,13,2,1,97
834692132,50,56,6,1,113
834709430,56,14,34,1,105
834709980,19,35,2,1,57
834712667,16,3,2,1,22
834713318,73,47,4,2,126
834718813,68,39,2,34,143
834726116,83,3,2,12,100
834727793,18,3,3,6,30
834733245,28,25,2,1,56
834736613,77,5,17,2,101
834745843,24,3,2,1,30
834758452,36,3,2,1,42
834772658,22,3,2,3,30
834774807,18,3,2,1,24
834779382,96,3,2,1,102
834783210,14,3,2,1,20
834789811,12,3,2,1,18
834789895,130,48,35,4,217
834793975,30,21,8,1,60
834797211,11,3,2,1,17
834797494,14,3,2,1,20
834820360,162,22,28,13,225
834830936,77,3,2,3,85
834841459,123,3,2,2,130
834848878,47,32,11,20,110
834857407,27,3,2,1,33
834864459,36,3,2,1,42
834870106,110,3,2,37,152
834872154,41,48,34,42,165
834872655,76,30,2,2,110
834901505,35,12,11,1,59
834913203,13,16,2,8,39
834927111,11,3,2,1,17
834936745,100,7,5,11,123
834938234,41,40,2,6,89
834954337,43,43,2,1,89
834964507,21,26,2,1,50
834966600,76,3,2,1,82
834995715,167,20,6,6,199
834996183,13,11,2,1,27
835002635,12,3,2,1,18
835005076,17,3,2,1,23
835025253,17,7,2,1,27
835026733,42,26,31,5,104
835033211,58,25,6,10,99
835033652,71,7,2,1,81
835046119,129,57,2,2,190
835052311,47,18,70,1,136
835052733,12,14,2,1,29
835060235,12,7,2,1,22
835064437,35,11,4,9,59
835067769,84,26,12,10,132
835076654,78,3,28,2,111
835108065,33,58,13,5,109
835108589,79,36,18,25,158
835109010,27,51,3,2,83
835116909,26,3,2,1,32
835120784,45,10,3,7,65
835126537,50,26,4,6,86
835135704,18,33,6,1,58
835153937,115,3,2,2,122
835172087,109,5,2,1,117
835173029,37,3,2,1,43
835182878,80,38,15,4,137
835185098,48,47,42,3,140
835197524,74,9,7,12,102
835206488,23,27,17,1,68
835228739,26,11,4,1,42
835234558,11,3,2,1,17
835236346,95,27,72,1,195
835257952,15,3,2,1,21
835263905,76,44,15,98,233
835264357,38,12,3,1,54
835272842,43,4,2,8,57
835280416,11,3,2,1,17
835282728,42,70,18,4,134
835309239,82,4,2,1,89
835351905,17,3,2,1,23
835360772,207,3,2,3,215
835371268,25,4,2,7,38
835372767,30,3,2,5,40
835375101,11,4,2,1,18
835379892,13,3,2,1,19
835380454,30,3,2,2,37
835391093,12,3,2,1,18
835405154,24,3,2,5,34
835408385,57,35,104,7,203
835423586,58,12,2,7,79
835429693,88,11,18,1,118
835430268,16,13,3,4,36
835437994,98,20,15,3,136
835452861,13,9,2,1,25
835454580,62,18,2,5,87
835460910,35,38,52,1,126
835470163,24,31,2,1,58
835478728,21,50,6,2,79
835479336,64,25,55,6,150
835499311,46,64,2,6,118
835523656,10,4,2,1,17
835531065,26,40,10,2,78
835546470,163,12,2,2,179
835547434,138,68,44,1,251
835553389,24,10,12,7,53
835557248,26,3,2,1,32
835558787,78,3,2,9,92
835592149,65,19,2,1,87
835598863,42,18,26,1,87
835602166,75,47,5,10,137
835620679,88,10,19,8,125
835624028,72,3,2,2,79
835629781,110,39,8,8,165
835636605,13,3,2,1,19
835646132,12,3,2,7,24
835651104,61,62,30,19,172
835654414,137,3,2,4,146
835655003,74,9,2,1,86
835668355,47,25,2,16,90
835673922,20,3,2,1,26
835684140,130,6,24,1,161
835686960,152,22,2,39,215
835689227,35,37,5,13,90
835690948,188,8,16,3,215
835698429,48,24,2,20,94
835712019,112,20,16,1,149
835722269,18,6,2,4,30
835723235,57,38,25,148,268
835726813,26,3,2,1,32
835732591,76,3,3,1,83
835734637,159,14,4,17,194
835742964,716,3,2,2,723
835746630,23,13,6,1,43
835753249,125,7,77,2,211
835760066,414,5,2,23,444
835769439,26,4,23,1,54
835770955,43,3,2,1,49
835775549,176,18,2,12,208
835785278,156,15,19,54,244
835788740,64,3,2,1,70
835791467,101,3,2,3,109
835793080,149,19,2,1,171
835804928,99,3,2,4,108
835817343,164,42,22,1,229
835827277,29,37,2,7,75
835829389,11,3,2,1,17
835844336,46,7,2,1,56
835849603,53,19,12,9,93
835859037,82,16,2,2,102
835875085,10,20,2,1,33
835875495,123,38,4,8,173
835892902,12,3,2,1,18
835893959,12,5,2,1,20
835898222,15,3,2,3,23
835907281,103,36,2,1,142
835908522,10,89,2,5,106
835922789,11,3,2,1,17
835931656,10,5,2,1,18
835934068,50,33,23,15,121
835940173,61,13,17,17,108
835941047,104,21,24,1,150
835941909,16,3,2,2,23
835959432,10,27,2,1,40
835980400,119,18,2,1,140
835988209,85,23,2,45,155
836004595,44,12,28,1,85
836011466,73,23,37,1,134
836013236,10,42,5,1,58
836015801,12,3,2,1,18
836028445,75,34,2,1,112
836033116,20,3,13,6,42
836034963,84,7,86,3,180
836046143,99,3,2,3,107
836052822,21,22,11,61,115
836059459,60,18,26,1,105
836064216,34,33,2,29,98
836064995,13,6,2,1,22
836066877,83,15,23,1,122
836067954,39,3,2,2,46
836074655,42,31,69,12,154
836075290,21,19,2,5,47
836085167,176,22,75,3,276
836097094,50,34,54,36,174
836099295,64,31,3,2,100
836108725,43,3,2,3,51
836109738,96,38,84,10,228
836126995,81,15,2,3,101
836127785,165,3,2,19,189
836133557,51,34,2,24,111
836135710,60,4,13,1,78
836143332,35,21,6,1,63
836153399,14,14,2,1,31
836166411,64,38,52,1,155
836176067,21,3,2,5,31
836182695,119,55,109,8,291
836187703,35,3,2,1,41
836187769,12,3,2,1,18
836196906,57,24,2,4,87
836217270,19,7,2,1,29
836218906,12,4,2,1,19
836229957,56,76,17,12,161
836231462,23,7,2,2,34
836234486,20,60,14,3,97
836236678,27,3,2,1,33
836241865,176,7,45,1,229
836256860,13,3,2,1,19
836273578,35,35,2,2,74
836276461,25,3,2,1,31
836284698,67,12,2,2,83
836308218,52,13,2,11,78
836311817,33,14,3,3,53
836313358,10,3,2,2,17
836315343,32,14,2,4,52
836329126,21,5,2,2,30
836356276,31,27,23,1,82
836359423,57,21,28,12,118
836374594,33,10,2,1,46
836375236,47,30,9,1,87
836377150,152,39,37,6,234
836403158,10,29,2,5,46
836403944,200,27,88,14,329
836411009,189,51,2,2,244
836413301,52,13,26,7,98
836437514,64,36,2,1,103
836449600,83,3,2,2,90
836462280,36,54,2,2,94
836482988,19,3,2,1,25
836489506,63,3,2,2,70
836492864,87,12,2,12,113
836519490,64,5,2,8,79
836528407,69,62,59,8,198
836532768,36,4,2,4,46
836537333,56,3,2,1,62
836541083,105,29,2,6,142
836556116,53,3,2,7,65
836557539,160,3,2,2,167
836561521,103,17,27,40,187
836601290,52,3,2,1,58
836608308,39,45,24,79,187
836612828,90,76,3,5,174
836614395,63,3,2,5,73
836615973,20,3,2,2,27
836618939,63,28,115,2,208
836625132,240,15,2,2,259
836626582,21,9,2,1,33
836630777,165,14,2,3,184
836631098,106,3,2,1,112
836636786,17,9,2,7,35
836652411,92,4,2,1,99
836686957,19,4,2,1,26
836705710,30,6,2,1,39
836707627,32,9,2,1,44
836708839,96,3,2,1,102
836712860,43,44,5,17,109
836718802,116,45,113,6,280
836720840,13,5,4,1,23
836762606,77,3,2,5,87
836777464,51,5,2,1,59
836797384,52,3,2,2,59
836800628,20,17,8,2,47
836804770,25,18,5,1,49
836819678,66,3,2,4,75
836827843,101,28,106,19,254
836828855,39,16,20,7,82
836838607,82,13,5,1,101
836839459,48,11,3,1,63
836843435,62,3,2,1,68
836844486,37,10,2,1,50
836847503,16,13,4,2,35
836859074,89,3,2,1,95
836876396,12,3,2,1,18
836883753,11,8,2,1,22
836896449,46,3,2,1,52
836903071,76,3,2,1,82
836912083,55,38,13,10,116
836920284,162,3,2,19,186
836930301,138,48,2,1,189
836934807,50,23,58,13,144
836944641,82,3,2,4,91
836946739,38,14,2,2,56
836979149,32,14,4,5,55
836982721,173,64,20,15,272
836991112,59,34,83,1,177
836994661,42,30,3,3,78
837006052,10,3,2,2,17
837012636,15,3,2,1,21
837016071,289,37,8,4,338
837020693,13,3,2,1,19
837021056,10,3,2,2,17
837045103,119,42,45,45,251
837064366,69,17,56,2,144
837067444,72,54,3,1,130
837081176,68,56,4,7,135
837089807,27,74,3,1,105
837096560,45,19,13,1,78
837097356,215,3,2,1,221
837115385,77,3,2,1,83
837124614,111,8,3,1,123
837137633,138,10,21,7,176
837149669,10,4,2,1,17
837153769,61,27,32,2,122
837158849,113,3,2,3,121
837166835,212,12,2,2,228
837166876,68,3,2,1,74
837168948,83,80,23,23,209
837172590,57,45,8,1,111
837185070,43,3,2,5,53
837194618,10,10,2,1,23
837196255,24,47,2,2,75
837199033,21,18,9,1,49
837208419,151,3,2,1,157
837211221,89,6,2,1,98
837216890,81,12,2,2,97
837218131,37,5,14,14,70
837219412,80,20,2,1,103
837220866,72,39,2,3,116
837223603,82,58,26,48,214
837229066,12,3,2,1,18
837232177,17,48,77,1,143
837237711,34,22,2,1,59
837244246,133,46,2,3,184
837249854,95,25,24,28,172
837253511,31,37,12,22,102
837254674,11,3,2,1,17
837264226,23,9,2,1,35
837270310,27,19,3,1,50
837291322,60,36,29,12,137
837293031,135,38,14,4,191
837294870,64,4,2,1,71
837297920,31,38,34,23,126
837301297,53,10,2,5,70
837346133,11,4,2,1,18
837349652,20,5,2,1,28
837350753,12,3,2,1,18
837354669,97,20,9,7,133
837358594,123,31,24,15,193
837362490,81,16,2,1,100
837385011,10,3,2,6,21
837385587,107,4,32,10,153
837388702,65,70,2,5,142
837395230,21,12,2,1,36
837431184,12,27,10,25,74
837433406,161,3,2,7,173
837441360,163,26,29,18,236
837442470,95,25,110,78,308
837447107,52,42,19,6,119
837449767,53,10,17,6,86
837451680,13,3,2,1,19
837451984,105,12,8,113,238
837458478,16,3,2,1,22
837467683,44,71,5,1,121
837468413,31,21,2,8,62
837479784,13,3,2,1,19
837493812,12,18,2,3,35
837527249,102,76,26,3,207
837537496,43,3,2,4,52
837544238,39,40,2,4,85
837546311,92,71,23,22,208
837553527,41,3,2,3,49
837566581,156,16,26,9,207
837599653,163,3,2,5,173
837624317,165,33,7,1,206
837648512,28,4,2,1,35
837648692,76,39,12,30,157
837659856,52,16,2,1,71
837666694,67,25,37,2,131
837669352,118,3,2,3,126
837675234,62,15,33,4,114
837683504,23,18,2,2,45
837704408,11,9,2,2,24
837705269,32,3,2,2,39
837710375,137,66,2,1,206
837721946,16,5,2,1,24
837728457,33,6,2,2,43
837736722,11,4,2,2,19
837742918,10,6,2,5,23
837743323,36,17,2,4,59
837745090,34,42,23,7,106
837747536,238,28,41,3,310
837750993,55,3,2,1,61
837757186,17,3,2,1,23
837763105,101,19,69,1,190
837766324,64,14,5,3,86
837783090,52,25,13,12,102
837805204,214,20,5,6,245
837808758,39,3,2,1,45
837809471,10,19,2,1,32
837809613,71,3,2,13,89
837812175,36,18,20,1,75
837824050,10,3,2,2,17
837832126,49,9,5,2,65
837833522,76,12,2,1,91
837841379,179,38,2,9,228
837854119,116,18,2,4,140
837863533,76,23,2,12,113
837865598,17,28,10,5,60
837870260,56,11,2,1,70
837877150,19,22,5,1,47
837877328,35,3,2,8,48
837891472,23,26,2,1,52
837893978,43,62,9,42,156
837896441,157,28,2,37,224
837899031,19,3,2,1,25
837903968,52,21,2,1,76
837918247,63,31,2,4,100
837923844,10,3,2,2,17
837924735,63,3,2,29,97
837938428,77,3,2,12,94
837962123,27,12,2,1,42
837991972,251,24,2,1,278
838010032,11,3,2,2,18
838013757,58,40,16,5,119
838017425,25,3,2,3,33
838041208,18,53,22,1,94
838062732,44,50,32,27,153
838064578,41,43,33,8,125
838078329,23,3,2,1,29
838093144,14,28,2,1,45
838094307,180,12,3,1,196
838098918,148,3,2,10,163
838109261,39,3,2,2,46
838110266,16,25,2,1,44
838110458,26,57,2,3,88
838111067,178,3,2,4,187
838128942,28,36,14,13,91
838133217,24,16,2,1,43
838135074,25,24,2,1,52
838138358,29,32,7,1,69
838157248,149,39,2,24,214
838160493,18,13,2,4,37
838173519,1083,3,2,46,1134
838174932,203,3,2,4,212
838175774,11,4,2,1,18
838177972,217,9,2,8,236
838185804,50,3,2,1,56
838209947,32,27,3,6,68
838214752,14,39,11,2,66
838243404,34,6,3,1,44
838246126,53,16,50,1,120
838248315,49,3,2,1,55
838253900,14,3,2,3,22
838255129,49,12,7,22,90
838256185,76,3,2,46,127
838259147,122,21,2,13,158
838267845,60,4,28,7,99
838269652,90,24,70,13,197
838274854,84,3,2,4,93
838277720,74,17,7,1,99
838277727,106,17,2,1,126
838278332,28,64,4,5,101
838279295,225,47,108,2,382
838279611,15,5,2,1,23
838309391,81,11,2,3,97
838316437,147,13,3,11,174
838317849,69,3,76,1,149
838318901,151,3,2,17,173
838333743,149,46,19,7,221
838337711,58,3,2,4,67
838341765,36,3,2,1,42
838352377,126,3,2,10,141
838370692,80,5,2,1,88
838374431,19,3,2,1,25
838394167,70,38,15,3,126
838407597,24,34,2,1,61
838422072,102,97,7,1,207
838422278,151,20,77,7,255
838431154,80,22,73,1,176
838450946,91,37,44,9,181
838456583,11,3,2,1,17
838458804,54,51,23,26,154
838462870,21,20,18,1,60
838479355,66,13,3,7,89
838495981,21,3,2,1,27
838496230,174,29,2,1,206
838500247,88,14,10,5,117
838503320,21,3,2,1,27
838520891,14,21,12,2,49
838524321,212,3,2,7,224
838541586,117,65,24,12,218
838542966,89,36,2,3,130
838544728,16,32,16,8,72
838545407,26,68,19,2,115
838545754,79,33,94,7,213
838558368,41,3,2,17,63
838568442,161,3,2,8,174
838570791,115,43,39,11,208
838574259,44,20,2,7,73
838578481,98,3,2,3,106
838578527,26,3,2,1,32
838582557,87,25,3,3,118
838584289,126,46,28,27,227
838588009,68,20,3,1,92
838594427,10,8,2,1,21
838623575,12,3,2,3,20
838631185,58,37,48,11,154
838641615,95,3,2,1,101
838659039,21,8,2,1,32
838660823,108,3,2,1,114
838669164,22,49,10,4,85
838675784,128,21,4,17,170
838676718,101,16,26,2,145
838678408,64,16,2,2,84
838683436,141,3,2,6,152
838688592,53,57,12,10,132
838689683,11,3,3,1,18
838692862,52,17,2,9,80
838703607,27,28,14,16,85
838704936,129,15,3,1,148
838719400,11,3,2,2,18
838727296,40,24,2,1,67
838738199,173,27,2,3,205
838738331,112,33,43,1,189
838760610,70,3,2,1,76
838770413,97,57,20,4,178
838771039,120,50,3,1,174
838787373,16,20,8,9,53
838788833,28,11,2,1,42
838798410,20,27,4,3,54
838807513,61,37,3,3,104
838829894,77,3,2,1,83
838836684,10,5,2,1,18
838837210,87,21,86,60,254
838840948,65,34,27,1,127
838841155,32,16,28,7,83
838846736,114,20,7,1,142
838847100,97,43,34,16,190
838850052,128,20,12,1,161
838862740,195,14,2,13,224
838878926,10,4,2,1,17
838893042,95,48,74,11,228
838897880,93,3,2,1,99
838898525,33,6,6,1,46
838900965,10,4,2,1,17
838905821,63,46,48,4,161
838909975,43,3,2,1,49
838918948,168,33,4,18,223
838938177,34,28,8,3,73
838945811,101,92,37,22,252
838954166,156,20,2,3,181
838956740,10,4,6,1,21
838967538,17,68,14,5,104
838968429,34,14,30,1,79
838968791,62,9,9,7,87
838972972,166,70,32,20,288
838981945,106,15,54,6,181
838982794,49,3,2,1,55
838996580,45,35,2,4,86
839015482,51,17,4,2,74
839037781,23,24,55,1,103
839042340,46,3,2,5,56
839042756,54,20,10,1,85
839056100,11,59,2,1,73
839063532,117,57,2,7,183
839077409,104,67,91,5,267
839093022,138,16,3,1,158
839105122,160,120,19,11,310
839113153,90,7,3,2,102
839125343,45,3,2,1,51
839126272,13,3,2,1,19
839126610,61,27,7,5,100
839134138,79,34,37,8,158
839140064,70,20,17,3,110
839153096,71,30,89,9,199
839169372,215,3,2,22,242
839184211,99,3,2,5,109
839189796,15,3,2,2,22
839209971,13,71,2,3,89
839213959,41,24,20,1,86
839219966,17,3,2,5,27
839221849,82,22,36,1,141
839222869,13,3,2,1,19
839229066,189,3,2,14,208
839235051,49,42,7,32,130
839257932,42,63,25,14,144
839258322,43,50,21,1,115
839281562,65,6,11,1,83
839286628,47,49,31,4,131
839286706,38,132,2,2,174
839336149,95,29,2,3,129
839339157,140,14,48,2,204
839351287,118,11,2,4,135
839351336,72,23,4,5,104
839364601,34,3,2,11,50
839368307,19,36,7,1,63
839370939,55,19,62,14,150
839371699,47,13,2,10,72
839378421,38,59,7,3,107
839391276,49,19,2,7,77
839395443,49,14,3,10,76
839400763,37,27,16,6,86
839402306,52,3,2,4,61
839403361,17,3,2,1,23
839412508,18,5,2,1,26
839432807,105,16,7,1,129
839435266,48,18,2,14,82
839445657,17,3,2,1,23
839466155,21,51,57,1,130
839467102,105,16,5,11,137
839476514,133,3,2,3,141
839480991,13,24,2,1,40
839487608,26,3,2,12,43
839497724,17,21,2,1,41
839511391,103,24,31,3,161
839531101,57,3,2,1,63
839537696,14,3,2,2,21
839548312,15,3,2,4,24
839551641,85,3,2,1,91
839559533,129,4,2,3,138
839560152,189,10,2,37,238
839565099,60,9,2,2,73
839568107,10,21,2,4,37
839571367,30,27,10,1,68
839575245,83,68,8,10,169
839576938,31,40,3,1,75
839599127,22,3,2,2,29
839603302,122,64,26,4,216
839612131,30,14,3,4,51
839628493,65,3,2,1,71
839629796,34,48,2,1,85
839640750,93,12,2,1,108
839645456,150,16,48,8,222
839676114,50,12,7,1,70
839704189,48,3,3,3,57
839715820,129,6,4,1,140
839717345,129,66,253,72,520
839722924,10,3,2,5,20
839726590,63,67,28,21,179
839770239,49,3,31,4,87
839773349,32,60,24,26,142
839778606,156,16,72,2,246
839794055,18,3,2,1,24
839794138,13,3,2,1,19
839802492,14,3,2,1,20
839810437,90,9,2,1,102
839819305,12,17,10,1,40
839821427,69,54,16,15,154
839829419,20,5,2,1,28
839844344,63,3,2,1,69
839846658,61,21,3,2,87
839858239,131,58,23,22,234
839858571,16,3,2,1,22
839878127,14,3,2,1,20
839890034,81,3,2,1,87
839895350,31,3,2,1,37
839931592,66,6,8,3,83
839947161,80,14,4,2,100
839948142,16,3,2,1,22
839954615,41,86,11,6,144
839959254,29,37,3,1,70
839960910,29,28,13,1,71
839961429,14,3,2,1,20
839988009,182,18,2,3,205
839991542,36,39,2,1,78
839993751,60,20,5,9,94
839998251,12,42,12,1,67
840004736,25,8,4,4,41
840021495,38,12,9,1,60
840033359,248,4,16,3,271
840036923,23,3,2,1,29
840042462,73,38,25,8,144
840050238,24,3,2,1,30
840054250,63,22,15,14,114
840057249,102,3,2,1,108
840066584,49,24,2,1,76
840074084,47,3,2,1,53
840079399,27,5,2,1,35
840091314,59,21,12,14,106
840102581,92,20,10,7,129
840116056,17,15,2,1,35
840127667,10,11,2,5,28
840128419,188,14,2,1,205
840129800,67,29,4,1,101
840132008,81,34,21,3,139
840140077,164,30,2,1,197
840142052,33,3,2,1,39
840144257,28,8,7,2,45
840150653,88,11,2,20,121
840155966,18,17,2,6,43
840156815,31,3,2,1,37
840166737,32,3,2,3,40
840170071,60,17,49,5,131
840172463,14,21,2,1,38
840175955,57,23,2,4,86
840181692,80,56,22,11,169
840187130,11,9,2,3,25
840190100,84,65,12,2,163
840205732,120,49,2,20,191
840236751,18,13,2,1,34
840241975,97,26,62,6,191
840242825,111,7,9,3,130
840258786,45,11,2,1,59
840261488,112,3,2,2,119
840263852,91,27,37,5,160
840269974,81,9,16,17,123
840276240,107,10,27,5,149
840280118,67,64,28,4,163
840282842,40,3,2,1,46
840284195,40,20,56,42,158
840289086,11,3,2,1,17
840297632,103,26,21,11,161
840312642,82,3,8,1,94
840321077,36,19,4,2,61
840332392,67,11,2,15,95
840342601,114,19,14,42,189
840344817,40,15,4,22,81
840348861,25,24,2,1,52
840359555,69,9,2,6,86
840362281,65,3,5,4,77
840363697,68,3,2,22,95
840368621,72,26,6,3,107
840377163,68,42,16,11,137
840384286,110,106,8,12,236
840387935,296,159,31,20,506
840395272,83,33,62,11,189
840398219,12,3,2,1,18
840405079,74,23,71,4,172
840406843,87,19,2,6,114
840408272,30,34,2,4,70
840410783,67,3,2,1,73
840411378,224,19,30,21,294
840415748,59,18,3,4,84
840418336,42,12,2,3,59
840424437,28,3,2,1,34
840429055,14,16,39,1,70
840430646,20,8,2,1,31
840439410,16,19,2,2,39
840445321,69,45,67,6,187
840452203,166,3,2,1,172
840468286,55,44,13,10,122
840480264,30,5,2,2,39
840497264,63,3,2,1,69
840516272,50,45,3,1,99
840520061,16,3,2,1,22
840520366,68,12,3,1,84
840529933,119,32,94,7,252
840531117,31,47,7,6,91
840539525,31,13,2,1,47
840540272,13,3,2,2,20
840550448,101,3,2,2,108
840552051,240,3,2,4,249
840572397,17,3,6,1,27
840584296,93,6,2,15,116
840598582,17,25,2,2,46
840627919,200,25,2,64,291
840654530,15,3,2,1,21
840663023,94,13,2,28,137
840663721,75,3,2,3,83
840685811,183,3,2,7,195
840687994,82,6,2,1,91
840698301,110,24,23,18,175
840701647,100,6,34,1,141
840720942,50,3,2,1,56
840724037,42,15,2,2,61
840731442,51,27,17,2,97
840732284,25,33,2,3,63
840735136,32,9,8,1,50
840747073,10,3,4,1,18
840756258,92,13,11,50,166
840770341,43,43,39,3,128
840776400,47,4,15,1,67
840790752,62,3,2,1,68
840797020,69,18,19,1,107
840797804,121,56,2,1,180
840799284,36,29,6,3,74
840807546,58,14,2,5,79
840823112,51,26,47,12,136
840828328,13,3,2,1,19
840876593,18,3,2,1,24
840899240,15,3,2,1,21
840899619,18,3,2,1,24
840906629,24,7,2,2,35
840931505,14,6,2,1,23
840932703,35,45,2,1,83
840951568,29,7,12,1,49
840959208,126,31,2,9,168
840960944,72,62,38,72,244
840968003,87,21,31,5,144
840971693,53,59,75,26,213
840993094,65,51,12,1,129
840999189,34,61,8,2,105
841018640,82,8,3,20,113
841021033,26,3,2,3,34
841033277,44,12,4,2,62
841062094,80,30,12,1,123
841065069,69,42,84,2,197
841065346,73,104,12,15,204
841066674,44,23,59,21,147
841067652,82,27,6,1,116
841080039,20,28,2,1,51
841096925,12,5,2,2,21
841100429,69,15,2,1,87
841100861,40,5,2,2,49
841108726,49,12,18,21,100
841122782,46,61,6,10,123
841125545,10,3,2,2,17
841125687,42,43,4,3,92
841132838,67,34,24,10,135
841144590,145,7,2,5,159
841144941,55,3,2,1,61
841153190,34,3,2,1,40
841160128,21,3,2,1,27
841167426,136,23,2,3,164
841168931,160,12,29,3,204
841183427,82,55,15,21,173
841196075,79,22,2,1,104
841207391,51,11,2,1,65
841207520,31,10,13,9,63
841210809,18,12,3,16,49
841212968,11,3,2,1,17
841217844,52,5,2,1,60
841227616,46,3,2,1,52
841229906,13,3,2,1,19
841244168,31,88,14,12,145
841253031,17,3,2,1,23
841253037,38,42,15,12,107
841256559,10,8,2,1,21
841306358,26,24,49,8,107
841314946,52,13,30,1,96
841315904,20,12,4,8,44
841328670,30,3,2,2,37
841330128,69,40,6,2,117
841347842,149,35,14,2,200
841355807,172,16,2,22,212
841362970,21,3,2,1,27
841364317,52,24,2,4,82
841377136,86,7,2,4,99
841378110,100,32,29,1,162
841380261,21,45,32,1,99
841386897,15,13,2,12,42
841388436,129,26,2,41,198
841397305,11,3,2,1,17
841414511,73,23,2,3,101
841418702,46,12,52,7,117
841435884,23,54,2,2,81
841441947,100,57,17,65,239
841447065,25,29,3,5,62
841455518,48,14,2,1,65
841460938,164,19,8,31,222
841461129,75,4,2,3,84
841476800,24,3,2,1,30
841486865,18,19,2,1,40
841501517,10,4,2,3,19
841521864,103,32,78,2,215
841523206,51,3,2,1,57
841525307,21,3,2,3,29
841525425,25,20,2,6,53
841527190,46,45,39,37,167
841531823,84,22,18,22,146
841535166,82,50,4,2,138
841536581,49,27,2,4,82
841544239,84,6,8,10,108
841550032,11,3,2,1,17
841554535,12,25,2,2,41
841586292,52,20,2,1,75
841586589,130,4,2,6,142
841599393,31,3,6,1,41
841608537,42,8,47,1,98
841612155,97,43,111,7,258
841619892,31,20,25,1,77
841634436,92,43,17,6,158
841637182,129,8,9,14,160
841648582,27,26,22,23,98
841658481,71,3,2,4,80
841670055,156,3,2,1,162
841687051,50,3,2,3,58
841692465,25,58,2,1,86
841705848,50,24,45,7,126
841745940,236,81,13,3,333
841761708,38,3,2,1,44
841770939,14,31,18,4,67
841776556,25,46,9,9,89
841777529,68,15,8,25,116
841781740,19,59,2,1,81
841806663,64,29,15,27,135
841809416,48,85,2,1,136
841813975,177,44,3,27,251
841814669,14,7,2,1,24
841824353,47,35,26,8,116
841824970,130,38,50,6,224
841830941,151,3,2,1,157
841843152,160,3,2,1,166
841871826,220,25,38,1,284
841874987,37,14,2,1,54
841876963,56,15,4,4,79
841879453,12,3,2,1,18
841880281,76,11,22,4,113
841882605,15,35,2,1,53
841893559,126,27,10,7,170
841894147,102,6,2,21,131
841911870,28,22,70,20,140
841920061,11,3,2,1,17
841921011,11,8,2,1,22
841925209,39,4,9,2,54
841927321,119,60,133,56,368
841932522,77,3,2,2,84
841935510,88,3,2,1,94
841938502,59,3,2,1,65
841944773,99,3,2,1,105
841949888,55,3,2,1,61
841967060,32,3,2,3,40
841970676,19,17,2,2,40
841983539,77,17,2,2,98
841985375,44,3,2,1,50
841994976,27,3,2,8,40
841998644,93,17,28,3,141
841999405,105,3,2,6,116
842000001,32,3,2,1,38
842016959,76,90,2,1,169
842026744,38,29,7,3,77
842031118,15,4,2,1,22
842043183,47,8,22,2,79
842052132,63,22,2,12,99
842067180,91,28,17,1,137
842070486,81,3,2,1,87
842074651,83,10,65,9,167
842075348,65,3,2,1,71
842077331,73,26,12,4,115
842081177,20,11,2,1,34
842086729,277,3,2,7,289
842122372,102,18,57,1,178
842134118,92,3,2,4,101
842135048,30,3,2,1,36
842144461,64,23,14,1,102
842154416,63,39,4,19,125
842156015,20,3,2,1,26
842156669,11,17,2,1,31
842167113,166,34,4,7,211
842174845,97,8,2,3,110
842175292,18,8,2,1,29
842175402,61,103,25,1,190
842196790,63,37,6,8,114
842206148,58,18,2,3,81
842212135,104,3,2,2,111
842242579,66,18,2,1,87
842245214,64,13,4,1,82
842252649,65,59,13,1,138
842262120,50,15,2,2,69
842271188,10,8,2,3,23
842287515,53,25,6,5,89
842332063,11,3,2,1,17
842339360,70,3,2,1,76
842339898,77,3,2,1,83
842340091,134,42,53,48,277
842341178,13,3,2,1,19
842348129,208,56,7,17,288
842353708,86,4,22,6,118
842356131,105,36,27,1,169
842377284,10,3,2,2,17
842397978,71,31,16,14,132
842402521,38,11,2,1,52
842407961,12,38,2,1,53
842408145,12,4,2,1,19
842411520,21,32,2,15,70
842418006,20,20,2,1,43
842419725,21,66,2,3,92
842424015,207,56,31,21,315
842427579,106,23,5,1,135
842432482,39,3,2,1,45
842451077,75,25,18,5,123
842453415,11,3,2,1,17
842458594,11,3,2,1,17
842478333,37,17,2,6,62
842481867,512,3,2,138,655
842502726,51,3,2,1,57
842520632,46,39,17,8,110
842535633,105,3,2,18,128
842541667,48,34,50,8,140
842545091,11,12,2,3,28
842546003,11,3,2,2,18
842546456,41,23,2,1,67
842551351,67,35,58,12,172
842562612,28,45,2,7,82
842565510,258,24,2,8,292
842566562,62,38,20,11,131
842577827,105,42,47,24,218
842580843,130,26,17,7,180
842614384,74,3,2,1,80
842621361,13,3,2,2,20
842621657,53,58,20,9,140
842623666,22,13,2,4,41
842629299,123,20,2,1,146
842646879,13,12,2,1,28
842648806,149,3,2,3,157
842652637,187,3,2,50,242
842654314,10,3,2,2,17
842670467,14,15,2,2,33
842683334,35,25,3,9,72
842697401,68,16,24,22,130
842698932,132,8,43,12,195
842701528,79,4,2,43,128
842726846,15,13,2,1,31
842729963,10,33,2,9,54
842740661,62,14,2,1,79
842756066,55,3,2,5,65
842758866,133,58,8,49,248
842767146,89,43,13,7,152
842767625,54,56,71,1,182
842773436,141,28,38,7,214
842773718,89,11,2,1,103
842785259,15,3,2,1,21
842790543,133,24,52,4,213
842808489,32,89,40,9,170
842813051,53,19,2,1,75
842835304,14,14,2,1,31
842859467,80,4,2,1,87
842859613,72,3,2,1,78
842862783,36,56,2,13,107
842869070,85,3,2,1,91
842870534,58,3,2,1,64
842891331,40,38,2,7,87
842892514,160,55,40,22,277
842897027,12,3,2,1,18
842901872,176,3,4,3,186
842902639,59,5,2,3,69
842914117,91,6,2,1,100
842916530,105,13,2,14,134
842920049,30,51,5,12,98
842920123,101,14,51,3,169
842927153,98,35,63,1,197
842946451,80,40,43,9,172
842952245,126,10,2,1,139
842953543,165,29,9,2,205
842964864,48,69,29,1,147
842976670,336,3,2,33,374
842977863,33,18,2,3,56
842979006,20,3,2,1,26
842980732,88,3,2,1,94
842983015,18,5,2,1,26
842992753,77,3,2,3,85
842992844,132,36,97,20,285
843007118,53,52,54,16,175
843015187,25,14,8,6,53
843015774,11,3,2,1,17
843042415,13,6,6,2,27
843050330,81,35,18,2,136
843079275,159,19,16,9,203
843090286,33,3,2,11,49
843102977,228,26,2,2,258
843104881,53,3,22,2,80
843118318,32,18,2,2,54
843119688,10,6,2,1,19
843140860,58,41,8,10,117
843144391,31,18,2,1,52
843144421,59,28,25,77,189
843151802,61,21,51,10,143
843153637,72,18,2,1,93
843182035,108,22,47,32,209
843183193,77,3,2,1,83
843190140,193,87,4,5,289
843192192,16,3,2,1,22
843200450,30,9,2,60,101
843205140,24,20,60,1,105
843208850,136,3,3,6,148
843244663,40,24,11,1,76
843245579,135,37,2,4,178
843255956,11,23,2,1,37
843260067,382,11,3,1,397
843264258,30,18,20,5,73
843280411,40,4,2,2,48
843281775,30,3,2,1,36
843291356,165,7,7,6,185
843300503,24,5,20,9,58
843302710,22,23,8,9,62
843307875,87,45,37,34,203
843357272,74,21,2,1,98
843365809,27,3,2,1,33
843367882,49,42,18,16,125
843371598,70,3,2,9,84
843372677,135,17,2,2,156
843378217,81,8,3,11,103
843384356,13,20,11,5,49
843397112,252,3,2,77,334
843399007,20,21,2,2,45
843401939,38,3,2,10,53
843423819,78,33,3,1,115
843424695,108,5,2,1,116
843432008,117,29,2,1,149
843437415,88,42,4,5,139
843448253,74,29,2,12,117
843453121,109,3,5,3,120
843467079,21,4,2,1,28
843470618,32,45,30,18,125
843495503,30,59,2,2,93
843503780,15,3,2,1,21
843505372,85,9,3,1,98
843511245,10,5,2,1,18
843514618,52,12,44,16,124
843541108,96,53,2,1,152
843541918,39,3,2,3,47
843549097,91,3,2,1,97
843555749,86,74,4,2,166
843558806,53,23,2,1,79
843572711,10,21,2,1,34
843592815,113,30,57,3,203
843595491,102,3,2,1,108
843626182,96,98,76,1,271
843626300,17,53,24,5,99
843626390,25,28,3,7,63
843628352,46,5,2,12,65
843630396,108,23,35,17,183
843631631,95,54,56,15,220
843667457,51,19,7,1,78
843681639,65,61,3,10,139
843687808,16,3,2,1,22
843721111,19,13,2,1,35
843732797,21,3,2,1,27
843747864,39,6,2,2,49
843770232,31,3,2,6,42
843770467,48,44,56,11,159
843794333,10,42,2,6,60
843807040,30,3,2,1,36
843810924,38,8,2,1,49
843816272,41,3,2,1,47
843818374,21,66,11,7,105
843859044,77,76,27,2,182
843861384,171,15,2,7,195
843870804,73,24,20,12,129
843871604,16,72,13,7,108
843878142,25,48,12,21,106
843879902,92,17,11,9,129
843889522,13,7,2,3,25
843892074,13,3,2,1,19
843894418,21,3,2,1,27
843905000,23,4,2,2,31
843906843,17,3,2,1,23
843920391,64,24,65,5,158
843925931,71,37,3,3,114
843936070,77,41,44,55,217
843949515,16,45,2,1,64
843971884,11,3,2,1,17
843994379,97,17,18,14,146
843996317,258,16,9,15,298
844005333,83,3,2,3,91
844011829,101,19,2,7,129
844027593,21,3,2,2,28
844034803,11,4,2,1,18
844041143,84,6,14,13,117
844042574,79,29,2,3,113
844044573,18,14,4,1,37
844045591,40,32,46,39,157
844048569,46,35,15,25,121
844050804,55,50,4,1,110
844060450,17,47,2,2,68
844073827,12,35,2,1,50
844075201,111,34,53,7,205
844089650,73,14,19,7,113
844094428,74,17,7,45,143
844097950,40,3,2,1,46
844108877,104,49,4,44,201
844117273,11,3,2,4,20
844123498,204,33,40,1,278
844136695,11,3,2,1,17
844139236,14,3,2,1,20
844145782,42,3,2,2,49
844150068,27,5,2,1,35
844155094,248,41,2,11,302
844165344,11,25,2,3,41
844166458,93,3,2,14,112
844166774,35,31,2,1,69
844169908,74,17,2,1,94
844171754,54,30,3,1,88
844177882,198,10,207,17,432
844181268,64,7,100,1,172
844218440,14,3,2,1,20
844226317,60,19,81,4,164
844240526,12,3,2,2,19
844241328,239,21,9,9,278
844261070,82,80,25,1,188
844281884,86,4,4,201,295
844282879,27,3,2,9,41
844295333,59,28,18,1,106
844296378,65,26,21,21,133
844313309,170,87,53,7,317
844327734,18,3,2,3,26
844334533,10,7,2,4,23
844338140,50,8,2,1,61
844340113,92,5,70,6,173
844363743,16,7,2,4,29
844366400,140,25,40,14,219
844373201,333,3,2,121,459
844374926,78,17,2,2,99
844375604,21,3,2,2,28
844381679,103,13,5,1,122
844391897,118,3,2,2,125
844394033,11,3,2,1,17
844394948,239,3,2,8,252
844402126,57,7,3,4,71
844426637,23,3,2,3,31
844428148,23,3,2,15,43
844477822,553,3,2,7,565
844487893,24,3,2,2,31
844502858,97,3,2,1,103
844507661,99,6,49,5,159
844512212,50,18,29,1,98
844519962,229,3,2,1,235
844522178,139,106,37,4,286
844525127,53,40,2,20,115
844527752,102,56,54,6,218
844528243,41,3,2,1,47
844558090,127,32,22,3,184
844571254,44,29,38,1,112
844572326,70,22,2,5,99
844593217,10,4,2,1,17
844594929,432,3,2,3,440
844635207,200,3,2,9,214
844647631,16,3,2,1,22
844667532,180,3,2,1,186
844669707,56,24,2,9,91
844670133,36,3,2,9,50
844674318,29,11,2,7,49
844679729,65,84,2,4,155
844681225,184,22,7,13,226
844681495,184,71,9,13,277
844683206,24,3,2,1,30
844688526,46,36,70,1,153
844712950,25,3,2,12,42
844722237,20,17,2,1,40
844722479,203,23,11,13,250
844723283,81,3,2,1,87
844724181,46,3,2,4,55
844724684,21,3,8,4,36
844725963,14,13,2,1,30
844746360,66,3,2,1,72
844747609,10,3,2,2,17
844747769,49,27,2,99,177
844749432,66,13,23,1,103
844749954,16,3,2,1,22
844755930,98,3,2,1,104
844761415,42,23,18,4,87
844769474,33,3,2,1,39
844773776,57,9,2,1,69
844787267,147,34,5,4,190
844795505,44,3,2,12,61
844819813,118,24,2,3,147
844822791,22,13,2,1,38
844834237,65,64,31,5,165
844844869,61,55,50,1,167
844864155,20,4,2,1,27
844873772,591,3,2,8,604
844876086,87,18,2,2,109
844877236,53,30,3,3,89
844886263,30,5,3,1,39
844921611,65,10,4,1,80
844938880,91,26,154,49,320
844951856,46,26,95,3,170
844952392,139,10,2,4,155
844971575,41,13,2,16,72
844971679,97,3,2,3,105
844986977,225,3,2,1,231
844999490,193,41,5,1,240
845002628,13,13,2,1,29
845002796,14,17,2,1,34
845011999,71,19,2,1,93
845028055,32,45,13,32,122
845028854,59,4,13,1,77
845050899,48,46,27,3,124
845052892,16,3,2,1,22
845053661,135,8,2,1,146
845057919,91,20,38,2,151
845061889,18,3,2,1,24
845071382,17,22,3,1,43
845073360,35,27,3,11,76
845081594,158,3,2,2,165
845087869,117,9,2,1,129
845103738,129,3,5,4,141
845116763,97,51,10,3,161
845128007,106,17,28,2,153
845147010,15,11,2,1,29
845151727,549,3,2,66,620
845153659,27,3,2,1,33
845159979,27,3,2,6,38
845165517,25,6,2,1,34
845171562,63,6,2,1,72
845172451,82,19,30,2,133
845192960,600,3,2,4,609
845200563,29,3,2,2,36
845205338,186,36,17,1,240
845224872,36,11,7,1,55
845232411,56,15,71,23,165
845233103,56,11,2,1,70
845235951,47,13,2,12,74
845242275,10,3,2,2,17
845252569,11,3,2,1,17
845253510,10,12,2,1,25
845254509,73,39,3,9,124
845259382,11,13,3,1,28
845262400,16,6,2,8,32
845262781,12,3,2,1,18
845298180,72,3,2,2,79
845298418,216,5,11,3,235
845313551,154,8,59,1,222
845318329,111,66,69,3,249
845323031,100,18,2,2,122
845336982,244,4,3,12,263
845346855,27,134,25,1,187
845352144,19,14,2,1,36
845370490,21,42,2,3,68
845402701,134,3,2,8,147
845440690,16,11,6,1,34
845442276,44,20,25,1,90
845443478,129,47,3,24,203
845445661,103,36,18,1,158
845450478,12,3,2,1,18
845451764,86,45,43,1,175
845484169,204,47,44,1,296
845488998,310,3,2,6,321
845497698,117,24,2,2,145
845498786,78,3,2,2,85
845519131,14,3,2,1,20
845534281,77,40,2,1,120
845536986,12,3,2,19,36
845539965,168,45,49,9,271
845541301,10,8,2,1,21
845549450,14,3,2,1,20
845552516,32,13,2,1,48
845574791,74,3,18,1,96
845592241,61,11,4,4,80
845595182,44,4,45,16,109
845598796,12,22,2,2,38
845603230,104,9,6,9,128
845622773,68,9,27,7,111
845622871,18,22,5,4,49
845631466,56,3,2,1,62
845640987,11,3,2,1,17
845649004,31,82,5,1,119
845656590,60,15,2,1,78
845679243,54,18,18,2,92
845686514,48,3,2,2,55
845693877,27,15,10,4,56
845700639,75,3,2,4,84
845702314,77,67,47,49,240
845723201,25,14,2,4,45
845727046,70,42,32,1,145
845731860,10,3,2,6,21
845733725,115,7,2,5,129
845738150,137,27,3,1,168
845752503,51,69,17,1,138
845764908,12,3,2,1,18
845779590,37,5,7,1,50
845783748,42,75,18,21,156
845794559,38,3,2,1,44
845802959,115,12,5,17,149
845805101,11,3,2,1,17
845809298,88,12,48,5,153
845821111,10,5,2,1,18
845821781,114,64,38,1,217
845831661,26,6,8,1,41
845840560,18,3,2,1,24
845844471,109,14,2,16,141
845859527,37,57,5,4,103
845864550,68,13,27,6,114
845869238,21,21,38,1,81
845877784,18,5,2,1,26
845920313,68,3,2,3,76
845934575,46,50,13,2,111
845936933,102,10,27,15,154
845943220,78,21,9,6,114
845944124,12,3,2,1,18
845968109,90,51,34,11,186
845973674,83,34,58,9,184
845977703,82,62,73,23,240
845997047,21,18,5,1,45
846008087,10,4,2,1,17
846015251,44,25,2,12,83
846030789,28,37,23,1,89
846031312,16,3,2,1,22
846040609,263,18,2,2,285
846049546,114,29,2,3,148
846050292,93,3,2,1,99
846051084,27,37,7,5,76
846062285,55,3,2,1,61
846099590,98,27,2,2,129
846103177,85,20,5,6,116
846130715,69,26,2,8,105
846136710,63,22,4,25,114
846150360,17,3,2,1,23
846153869,26,16,2,3,47
846155159,120,3,2,4,129
846156374,47,12,17,5,81
846164083,13,3,2,1,19
846177276,60,24,18,2,104
846177967,71,8,2,1,82
846184356,99,3,2,7,111
846196931,71,83,43,26,223
846197182,36,18,34,11,99
846198579,44,14,19,4,81
846201533,149,3,2,5,159
846201901,11,4,2,1,18
846202473,108,20,66,7,201
846204900,82,30,17,20,149
846221289,42,79,22,1,144
846225697,51,28,2,3,84
846228786,48,3,2,1,54
846229759,15,3,2,1,21
846237335,59,22,96,25,202
846251120,33,31,7,2,73
846251310,33,3,2,1,39
846259205,58,39,2,3,102
846266245,116,3,2,1,122
846275932,97,39,3,6,145
846285052,36,15,2,12,65
846299469,30,39,13,7,89
846314629,36,3,2,1,42
846322755,14,3,2,1,20
846332044,61,18,31,28,138
846344101,39,14,21,1,75
846348292,83,37,40,25,185
846362876,220,9,6,1,236
846373041,22,10,2,1,35
846376820,154,3,2,9,168
846382084,147,24,33,1,205
846389165,31,14,3,2,50
846411482,18,3,2,4,27
846413345,21,33,44,7,105
846416983,13,3,2,3,21
846419237,22,28,64,9,123
846421044,111,36,31,3,181
846429018,75,32,16,1,124
846445483,101,10,2,13,126
846446869,50,34,82,7,173
846451857,129,6,2,3,140
846452951,149,34,93,16,292
846456815,27,5,7,14,53
846461267,36,18,2,1,57
846463629,82,30,7,22,141
846480656,149,3,2,13,167
846492643,43,14,30,10,97
846496254,65,59,130,35,289
846503681,196,19,2,1,218
846513129,40,23,2,1,66
846514673,107,26,2,9,144
846526948,21,3,2,1,27
846560605,52,20,50,2,124
846581268,147,19,2,1,169
846583397,39,6,2,1,48
846670040,87,14,2,1,104
846676599,27,6,9,7,49
846677179,92,3,2,1,98
846682563,31,3,2,1,37
846700094,125,24,2,2,153
846736912,10,3,2,2,17
846746651,10,3,2,2,17
846755036,61,11,4,2,78
846762993,95,3,2,5,105
846769638,69,22,64,3,158
846779481,33,13,2,1,49
846815082,19,3,2,1,25
846816699,38,36,5,1,80
846820783,14,3,2,1,20
846829558,108,41,27,47,223
846830513,133,25,25,1,184
846831864,242,3,2,1,248
846835936,23,18,9,10,60
846845431,35,3,2,1,41
846849625,39,36,17,6,98
846854806,30,46,11,1,88
846854821,89,69,2,19,179
846865121,199,29,116,83,427
846867544,10,17,2,1,30
846906027,11,3,2,1,17
846912096,327,3,2,18,350
846942740,10,5,2,1,18
846945006,92,24,57,45,218
846960057,10,8,2,1,21
846964465,26,29,37,2,94
846974568,67,3,2,1,73
847010371,15,55,2,18,90
847018789,15,3,2,2,22
847028868,42,25,2,1,70
847034544,66,3,2,4,75
847041290,37,21,46,23,127
847042025,84,34,11,13,142
847043258,27,5,2,5,39
847047160,61,3,2,1,67
847048551,27,11,2,11,51
847053391,10,15,2,1,28
847053535,66,100,70,21,257
847053690,57,61,33,27,178
847058186,124,25,28,8,185
847062233,101,3,2,1,107
847062423,329,3,2,5,339
847062903,10,3,5,3,21
847081179,91,79,70,2,242
847088822,34,16,2,2,54
847091720,128,3,2,6,139
847094085,36,24,20,11,91
847108164,29,3,2,1,35
847175584,12,3,2,1,18
847179327,104,3,2,1,110
847191156,19,3,2,1,25
847207232,152,31,2,2,187
847215081,68,27,23,19,137
847230336,10,5,2,1,18
847256976,102,19,2,16,139
847259920,92,10,3,1,106
847261039,64,36,2,8,110
847282013,61,24,31,1,117
847298555,27,4,12,1,44
847300848,10,4,2,1,17
847313798,64,24,105,2,195
847316282,113,16,2,1,132
847345980,12,16,4,1,33
847350557,31,3,2,1,37
847353900,37,20,2,1,60
847361622,21,31,3,1,56
847370666,76,4,2,1,83
847387171,36,42,10,7,95
847388669,63,3,2,1,69
847403451,49,5,44,9,107
847404861,85,48,11,8,152
847406733,129,17,42,21,209
847409811,19,6,3,4,32
847418435,43,30,55,5,133
847423061,94,3,2,1,100
847430048,46,21,2,2,71
847437967,29,19,3,1,52
847462967,35,27,28,14,104
847471499,111,42,3,1,157
847485593,116,23,96,80,315
847493116,98,114,48,23,283
847499874,111,22,162,23,318
847501359,12,6,2,1,21
847502945,100,58,8,1,167
847512964,66,75,41,118,300
847516974,65,30,5,2,102
847526648,84,3,2,1,90
847532100,175,17,2,2,196
847533937,25,3,2,1,31
847537908,108,3,5,1,117
847540070,123,22,20,11,176
847547339,25,122,9,6,162
847577722,97,3,2,1,103
847584987,13,5,2,1,21
847586518,109,16,2,5,132
847598332,54,38,4,1,97
847615798,37,3,2,1,43
847624049,60,36,5,13,114
847626892,133,14,9,5,161
847629175,14,3,2,1,20
847630679,88,8,19,4,119
847633279,23,35,2,21,81
847651473,85,3,2,1,91
847651963,46,4,2,1,53
847655649,12,3,2,1,18
847671138,26,20,6,1,53
847672961,31,14,2,1,48
847676712,17,40,5,3,65
847694735,22,32,2,1,57
847696580,90,43,48,8,189
847700780,28,14,2,56,100
847728952,20,10,3,1,34
847734243,60,4,10,6,80
847742336,85,29,12,15,141
847742592,21,3,2,2,28
847747197,94,17,20,3,134
847761065,32,48,28,12,120
847765298,14,3,2,2,21
847775979,13,33,13,5,64
847784412,26,42,41,1,110
847786110,22,43,115,15,195
847787158,12,3,2,1,18
847824941,41,44,23,88,196
847838084,19,54,2,22,97
847846479,61,4,2,4,71
847846938,38,16,5,1,60
847850844,17,3,2,1,23
847867186,75,3,2,47,127
847874259,22,26,11,8,67
847916197,105,48,101,24,278
847923105,44,11,2,2,59
847937182,11,17,5,1,34
847945395,12,38,15,3,68
847948367,22,3,2,1,28
847949331,70,13,2,9,94
847955691,20,3,2,1,26
847961019,23,18,5,1,47
847966159,12,4,3,2,21
847986299,140,3,2,1,146
847990124,29,31,2,1,63
847997728,71,31,3,13,118
848021951,36,17,58,1,112
848050033,14,13,2,1,30
848052364,17,24,2,1,44
848074746,87,34,29,47,197
848075511,17,15,2,1,35
848077135,32,21,5,1,59
848079302,35,18,2,1,56
848089842,15,3,2,1,21
848090492,29,5,2,5,41
848096335,121,9,2,3,135
848098343,29,3,2,1,35
848114749,53,3,2,1,59
848118538,20,8,2,1,31
848126663,43,13,2,17,75
848129853,122,3,2,7,134
848143378,11,27,2,1,41
848154136,39,43,7,1,90
848154942,27,15,2,5,49
848158627,40,14,2,2,58
848159924,19,3,2,3,27
848161440,74,4,2,1,81
848190003,14,3,2,1,20
848197180,53,36,2,1,92
848208693,40,37,2,1,80
848211228,63,3,2,4,72
848215626,107,3,2,1,113
848223947,15,5,2,2,24
848230860,24,4,17,1,46
848235439,99,64,5,9,177
848243679,90,3,2,3,98
848247205,169,3,2,1,175
848260464,57,13,59,9,138
848260718,118,16,9,7,150
848260929,19,59,2,13,93
848263585,186,57,4,13,260
848301331,14,24,2,1,41
848306030,10,4,2,1,17
848325577,69,5,2,1,77
848334114,14,3,2,1,20
848334750,12,4,2,1,19
848343133,64,46,21,2,133
848383197,65,32,19,2,118
848392093,20,3,2,4,29
848394707,71,8,2,3,84
848405151,65,20,62,9,156
848415086,37,24,2,1,64
848435148,99,24,27,56,206
848438232,53,17,3,1,74
848453252,50,3,2,1,56
848455571,10,4,2,1,17
848459884,64,3,2,1,70
848477350,88,44,6,2,140
848482485,35,64,17,7,123
848484542,10,4,2,1,17
848484742,11,6,2,1,20
848509558,108,33,119,37,297
848510440,248,3,2,8,261
848518652,68,3,2,1,74
848520643,22,11,2,1,36
848540756,62,15,31,8,116
848541131,102,12,16,20,150
848553055,54,16,2,2,74
848561652,45,29,22,18,114
848567818,36,63,6,4,109
848592986,100,19,39,4,162
848600425,26,3,2,1,32
848609649,73,27,13,1,114
848619241,91,3,2,1,97
848642059,19,46,2,5,72
848650669,72,3,2,1,78
848654667,121,38,3,3,165
848654980,10,12,2,1,25
848658319,152,32,21,1,206
848671262,93,10,2,1,106
848679745,107,54,188,4,353
848679922,18,3,2,1,24
848683061,130,10,2,46,188
848685986,59,22,2,1,84
848687873,20,31,6,7,64
848724281,375,15,2,20,412
848744239,28,3,2,1,34
848746136,40,54,11,2,107
848750529,77,24,15,14,130
848778624,25,3,2,1,31
848787736,21,25,2,1,49
848790558,11,3,2,4,20
848801321,14,14,2,2,32
848803085,58,3,2,2,65
848809938,19,10,2,3,34
848823930,266,34,2,6,308
848827265,109,3,3,10,125
848842574,10,5,2,1,18
848846838,22,3,2,2,29
848859471,140,27,2,7,176
848860342,93,11,5,4,113
848862165,123,53,20,47,243
848869447,98,20,2,6,126
848877531,56,31,2,13,102
848893288,38,26,2,6,72
848899898,91,73,66,7,237
848901975,205,25,191,13,434
848922729,35,3,15,1,54
848923111,64,8,47,9,128
848923196,65,61,19,10,155
848935598,49,32,6,9,96
848937738,24,3,2,1,30
848942344,20,89,20,13,142
848980732,81,3,2,1,87
848981296,39,37,2,7,85
848988041,80,22,39,5,146
849003295,76,11,23,5,115
849007177,74,3,2,1,80
849010609,27,56,12,1,96
849022783,40,3,2,5,50
849030468,139,12,2,6,159
849033433,91,3,2,6,102
849044894,114,74,47,34,269
849059272,42,34,2,8,86
849060102,19,3,2,1,25
849062103,80,3,8,28,119
849066342,34,6,2,1,43
849066753,34,3,2,1,40
849076452,14,3,2,1,20
849082531,29,12,3,8,52
849086459,50,3,6,1,60
849086896,29,10,2,11,52
849103714,15,58,2,3,78
849106794,31,27,2,1,61
849113917,123,15,2,1,141
849122498,78,9,17,8,112
849122692,131,3,2,4,140
849144944,20,20,2,1,43
849160475,197,13,3,40,253
849161702,106,8,14,2,130
849167296,90,23,3,10,126
849172897,27,4,2,1,34
849187517,160,3,2,13,178
849210239,10,5,2,8,25
849216018,44,3,2,1,50
849220855,73,11,54,5,143
849225925,32,39,40,47,158
849240630,13,3,2,1,19
849246880,114,3,2,10,129
849260493,136,52,82,9,279
849277517,14,3,2,1,20
849281756,94,12,2,4,112
849307389,13,11,2,2,28
849307839,43,29,7,1,80
849312552,59,30,3,2,94
849312624,133,9,2,1,145
849350595,26,45,4,6,81
849364675,133,18,2,1,154
849372386,19,3,2,1,25
849394411,35,4,32,1,72
849402126,15,7,2,5,29
849403080,66,4,35,3,108
849423335,90,3,2,1,96
849430901,107,3,2,1,113
849437603,64,3,2,2,71
849441315,48,3,2,1,54
849444985,53,15,2,11,81
849448149,13,3,2,1,19
849450352,12,3,2,1,18
849452215,19,3,2,1,25
849454814,87,3,2,3,95
849464772,14,8,62,1,85
849474999,58,38,19,3,118
849478698,94,19,13,1,127
849483537,181,15,2,1,199
849509951,40,49,18,9,116
849515979,76,3,3,10,92
849538999,128,4,4,16,152
849572942,29,3,2,2,36
849581470,78,34,43,15,170
849582857,125,3,2,3,133
849584852,82,30,2,1,115
849588379,52,18,2,1,73
849600252,98,3,2,3,106
849608432,241,38,41,43,363
849627176,16,3,2,1,22
849630140,48,18,2,26,94
849636962,146,43,2,16,207
849642316,136,3,2,1,142
849660888,90,62,39,2,193
849666668,125,37,2,1,165
849697243,93,6,3,2,104
849700472,173,54,2,1,230
849717942,85,3,2,1,91
849728141,122,82,3,5,212
849730685,64,16,2,15,97
849742044,51,18,3,1,73
849754877,67,38,23,7,135
849759108,101,14,59,22,196
849771357,36,16,2,2,56
849776302,12,4,2,1,19
849784229,57,46,3,2,108
849786936,89,12,32,11,144
849795302,31,3,2,1,37
849796295,22,3,2,1,28
849809842,48,3,2,11,64
849828264,10,3,2,7,22
849829536,56,19,4,5,84
849837786,113,32,16,1,162
849838058,79,3,2,1,85
849838989,16,44,12,3,75
849839945,10,4,2,1,17
849840037,21,27,2,1,51
849846740,156,3,2,2,163
849853637,111,65,2,2,180
849857600,24,51,11,13,99
849868101,38,14,47,3,102
849870751,40,118,17,3,178
849873965,93,3,8,1,105
849887296,124,27,3,1,155
849890598,17,19,7,2,45
849900515,17,9,34,1,61
849901125,86,3,2,15,106
849911654,15,10,2,1,28
849914209,11,13,2,2,28
849915991,20,3,2,1,26
849931976,94,3,2,4,103
849937191,135,3,53,1,192
849941157,85,82,9,5,181
849969104,16,4,2,1,23
849971253,414,3,2,8,427
849977733,82,20,2,1,105
849995195,11,3,2,1,17
850012275,38,7,11,1,57
850017046,36,16,50,3,105
850026858,56,17,13,1,87
850041152,51,52,4,3,110
850041980,118,3,3,1,125
850045083,72,17,2,15,106
850048395,10,6,2,2,20
850050615,75,4,2,1,82
850054153,14,8,2,1,25
850076195,28,26,2,44,100
850100536,91,11,4,18,124
850102675,30,10,2,4,46
850131672,62,9,2,3,76
850140352,115,50,5,1,171
850152324,63,9,2,2,76
850160279,17,9,2,2,30
850166626,52,14,2,4,72
850170100,106,3,2,3,114
850178332,35,41,2,16,94
850179175,40,27,16,1,84
850182610,109,3,2,16,130
850191163,35,38,3,16,92
850199555,13,3,2,1,19
850200532,70,3,2,12,87
850202639,11,4,2,1,18
850210920,103,4,2,3,112
850214653,56,113,3,1,173
850223829,58,5,2,8,73
850224055,14,17,2,5,38
850259171,29,3,2,1,35
850269328,10,9,4,9,32
850274337,43,3,2,1,49
850288461,60,10,2,11,83
850298501,37,3,2,1,43
850299952,10,7,2,1,20
850301880,61,49,30,2,142
850306707,145,9,6,1,161
850319548,55,16,29,1,101
850330601,73,7,2,6,88
850335906,39,25,97,5,166
850363871,18,13,2,1,34
850366370,133,12,5,10,160
850379970,44,27,2,4,77
850396174,15,21,2,1,39
850402418,23,3,2,1,29
850408615,33,16,2,7,58
850434716,12,3,2,1,18
850457055,74,14,3,1,92
850481371,118,3,2,1,124
850481957,78,35,7,21,141
850483034,108,54,38,2,202
850486395,135,18,119,8,280
850496235,73,18,83,1,175
850503069,733,3,2,3,741
850508907,15,24,16,2,57
850510504,92,73,4,11,180
850517242,66,3,2,1,72
850534946,166,3,2,1,172
850547318,17,6,3,3,29
850572784,13,3,2,1,19
850586333,26,3,2,4,35
850594239,54,46,16,1,117
850597178,50,3,2,4,59
850602216,27,3,2,1,33
850636722,50,20,50,28,148
850642479,149,21,3,14,187
850652076,35,16,8,2,61
850657500,29,7,2,2,40
850665834,144,3,2,2,151
850703295,88,3,2,6,99
850705118,12,5,2,1,20
850706724,33,35,50,1,119
850718850,62,14,16,2,94
850729546,29,4,4,11,48
850731299,61,22,16,5,104
850732078,52,26,3,2,83
850743885,40,36,3,3,82
850749140,22,6,2,1,31
850752098,172,12,32,22,238
850754734,32,3,2,1,38
850757836,11,3,2,1,17
850766214,68,10,9,8,95
850779299,43,10,2,2,57
850782121,23,3,2,1,29
850782632,115,33,28,28,204
850787831,109,19,2,1,131
850791972,42,48,8,13,111
850792577,17,3,2,1,23
850796672,47,46,5,8,106
850796828,79,11,7,14,111
850798420,36,11,2,1,50
850812843,72,69,53,3,197
850815751,11,3,2,1,17
850826014,35,10,21,6,72
850830309,60,24,46,1,131
850835937,118,3,2,2,125
850840530,76,4,2,4,86
850843059,72,3,2,1,78
850845856,43,11,4,1,59
850848962,81,36,24,25,166
850850794,57,49,17,3,126
850857946,91,3,2,1,97
850861280,125,5,9,1,140
850913440,101,6,19,4,130
850948858,27,6,11,3,47
850961247,139,19,2,16,176
850963515,117,12,2,30,161
850964599,61,19,19,1,100
850966349,30,80,7,1,118
850993649,54,14,2,11,81
851023352,43,3,2,1,49
851027978,29,77,16,1,123
851037722,16,24,2,2,44
851038762,27,7,2,1,37
851041483,12,3,2,1,18
851049434,28,41,33,2,104
851057652,22,3,2,1,28
851057749,10,23,2,1,36
851066924,78,9,2,4,93
851072293,119,38,38,22,217
851096327,19,3,2,3,27
851104038,20,12,2,2,36
851106928,71,3,2,1,77
851126335,16,3,2,1,22
851158439,13,23,2,2,40
851185805,69,64,9,1,143
851187161,13,3,2,2,20
851198572,12,4,2,3,21
851206555,66,15,43,3,127
851228570,10,7,2,4,23
851231626,39,3,2,7,51
851232064,105,3,2,1,111
851237914,48,19,8,8,83
851243225,12,3,2,1,18
851246037,15,6,2,1,24
851255061,36,36,5,1,78
851295263,14,3,2,1,20
851296493,53,3,2,2,60
851312839,14,68,2,1,85
851319021,79,15,25,1,120
851329486,12,7,2,2,23
851338828,64,16,2,1,83
851345731,74,3,2,1,80
851352042,45,34,49,13,141
851358655,20,3,2,1,26
851382602,18,3,2,3,26
851387632,42,3,2,1,48
851389139,48,7,19,1,75
851411026,39,32,2,1,74
851411717,68,63,4,1,136
851421178,53,3,2,1,59
851427303,11,12,2,1,26
851433780,74,19,22,1,116
851433922,80,17,2,2,101
851444856,82,4,87,11,184
851446816,158,46,12,20,236
851454273,91,3,7,1,102
851462054,15,3,2,1,21
851506375,694,3,2,2,701
851536970,19,25,2,1,47
851541185,10,17,2,2,31
851566295,62,40,24,12,138
851573479,87,18,2,1,108
851575567,98,34,4,42,178
851590846,41,12,2,2,57
851592544,37,19,12,6,74
851597089,300,10,2,1,313
851599225,233,3,2,5,243
851607713,10,3,2,2,17
851616833,154,45,13,33,245
851631913,101,106,2,2,211
851643839,42,9,100,1,152
851656556,214,3,2,2,221
851658562,76,59,58,6,199
851683919,66,44,46,5,161
851684662,158,3,2,1,164
851685162,59,3,2,1,65
851702260,193,6,2,17,218
851705762,45,7,5,6,63
851733329,21,23,8,3,55
851733465,166,85,72,2,325
851747016,35,27,16,10,88
851750118,19,3,2,1,25
851750821,104,8,4,1,117
851765924,57,64,72,20,213
851766628,142,15,106,13,276
851770651,91,3,2,1,97
851790248,47,10,2,2,61
851790311,65,49,19,4,137
851794504,11,16,2,2,31
851813330,17,17,27,13,74
851816855,88,3,2,1,94
851830321,137,14,26,8,185
851837291,19,4,2,1,26
851879243,113,3,2,26,144
851883154,52,17,51,2,122
851883753,67,12,2,1,82
851901351,41,6,2,1,50
851911248,20,64,4,4,92
851918789,11,3,2,5,21
851919273,103,18,2,4,127
851919694,19,54,16,1,90
851923103,22,8,2,3,35
851925277,24,55,121,1,201
851926107,17,23,3,1,44
851933099,37,14,10,4,65
851947867,58,65,15,7,145
851951532,62,5,2,5,74
851955498,17,4,2,1,24
851978916,11,3,2,1,17
851993267,26,17,3,1,47
851994396,81,3,2,1,87
852007236,18,7,2,1,28
852009216,26,6,4,4,40
852009270,118,30,26,4,178
852013325,393,3,2,58,456
852023721,75,11,9,3,98
852025770,56,38,31,16,141
852030815,19,14,2,9,44
852040478,63,30,72,2,167
852050941,11,3,2,1,17
852053845,108,21,2,1,132
852066731,203,11,23,1,238
852077121,117,3,2,1,123
852090924,13,3,2,1,19
852091035,77,29,13,15,134
852115568,99,41,4,1,145
852122174,144,3,2,8,157
852122334,90,11,43,4,148
852129922,79,17,19,23,138
852130201,51,17,7,1,76
852133860,60,93,105,1,259
852142166,77,29,31,19,156
852159433,14,3,2,1,20
852177709,87,18,2,1,108
852192249,274,3,18,2,297
852207453,147,23,4,4,178
852209167,85,58,58,12,213
852224262,29,75,2,3,109
852233512,13,6,2,1,22
852240121,94,3,2,23,122
852241135,72,19,8,2,101
852241376,19,104,3,2,128
852254588,166,3,2,7,178
852254858,81,3,2,6,92
852255838,146,43,9,22,220
852259288,74,17,29,2,122
852274745,42,51,13,30,136
852318096,29,3,2,1,35
852318649,12,3,2,3,20
852321584,110,51,4,2,167
852365268,41,6,2,7,56
852367307,15,7,2,2,26
852379535,110,33,46,6,195
852403278,13,5,2,3,23
852411069,10,13,2,1,26
852419836,157,3,2,12,174
852420979,29,5,2,1,37
852423856,22,27,26,28,103
852434378,21,8,2,6,37
852435223,37,3,2,1,43
852441829,41,30,2,1,74
852448581,51,69,4,1,125
852459276,148,3,2,1,154
852459459,11,3,2,1,17
852468212,98,43,22,27,190
852489788,26,3,2,2,33
852502641,11,3,2,1,17
852503924,17,3,2,6,28
852512835,105,16,43,1,165
852525111,227,30,2,1,260
852525473,19,14,2,2,37
852546077,32,20,5,1,58
852548519,66,40,3,13,122
852552680,74,7,2,1,84
852553011,47,35,2,2,86
852564832,57,3,2,7,69
852577567,23,23,69,8,123
852591342,17,3,2,5,27
852597014,57,24,3,22,106
852601100,12,3,2,1,18
852601427,51,19,2,1,73
852601709,42,3,2,1,48
852606232,107,4,5,1,117
852609294,15,3,2,3,23
852609361,69,35,41,4,149
852616534,41,3,2,1,47
852629911,42,9,3,4,58
852642025,285,118,7,14,424
852651891,14,7,2,1,24
852656381,44,28,2,1,75
852665509,37,3,2,1,43
852667669,111,11,62,1,185
852683320,136,3,2,1,142
852719029,63,25,3,1,92
852735836,16,5,2,1,24
852737157,12,3,2,1,18
852738910,13,25,13,1,52
852752594,10,3,2,2,17
852752811,59,40,63,1,163
852767807,90,3,2,2,97
852770331,49,50,51,51,201
852802022,26,46,3,1,76
852807802,37,30,4,1,72
852819440,16,6,2,1,25
852826246,45,7,2,1,55
852826461,48,57,26,6,137
852830800,14,3,2,1,20
852832672,67,17,108,7,199
852844980,20,61,131,1,213
852885304,126,32,21,133,312
852900905,136,30,28,1,195
852901575,86,3,2,6,97
852902499,25,30,13,1,69
852907227,59,37,10,3,109
852910776,54,39,2,1,96
852923364,106,82,2,15,205
852927808,38,27,12,12,89
852945711,18,3,2,1,24
852974495,41,91,57,39,228
852983030,81,12,2,1,96
852987189,32,35,8,11,86
852995214,10,5,2,1,18
853011634,68,11,82,3,164
853016239,16,3,2,1,22
853023107,18,3,2,2,25
853026241,32,11,2,1,46
853026869,13,3,2,3,21
853031154,125,3,2,2,132
853032862,71,28,5,4,108
853045730,63,38,8,13,122
853071517,14,10,2,1,27
853080676,59,33,23,26,141
853090972,18,7,2,1,28
853094718,113,41,31,8,193
853104675,49,11,7,7,74
853116745,43,32,4,2,81
853124166,31,8,2,2,43
853137244,75,4,6,1,86
853140085,78,40,4,9,131
853143263,320,28,13,9,370
853157927,48,46,10,13,117
853162657,31,18,9,16,74
853179804,17,3,2,1,23
853186637,16,3,2,2,23
853194138,109,3,2,2,116
853197448,60,30,23,10,123
853211653,344,26,11,16,397
853231925,30,3,2,1,36
853244033,33,45,27,1,106
853245202,23,24,2,1,50
853247606,76,19,2,1,98
853251356,107,26,4,3,140
853261026,34,26,16,34,110
853261256,30,3,2,2,37
853262004,26,3,2,1,32
853266470,25,4,6,3,38
853317539,30,3,2,2,37
853326378,24,16,2,3,45
853332485,31,26,2,21,80
853343711,47,8,2,1,58
853359955,58,11,2,11,82
853360695,27,3,2,1,33
853366464,41,3,2,1,47
853368228,157,40,2,7,206
853369609,25,73,13,1,112
853375692,112,8,6,18,144
853389320,77,41,2,6,126
853392685,85,3,2,1,91
853394311,63,36,3,7,109
853438431,120,23,6,11,160
853446358,15,26,2,4,47
853461669,23,3,2,1,29
853461845,111,3,2,9,125
853467418,53,34,2,3,92
853480753,68,10,23,1,102
853481054,13,15,2,1,31
853491269,22,17,2,2,43
853514834,101,8,2,1,112
853532960,29,20,2,4,55
853536450,140,3,2,1,146
853549844,98,3,2,8,111
853554171,13,3,2,1,19
853569879,31,3,2,3,39
853572702,49,23,15,8,95
853583706,86,3,2,4,95
853588211,45,40,28,7,120
853594407,56,46,26,6,134
853596705,27,17,2,1,47
853598232,38,10,2,4,54
853608974,13,3,2,1,19
853612636,10,3,2,2,17
853617651,75,3,2,4,84
853621883,17,5,2,8,32
853624590,115,18,85,67,285
853628638,17,14,2,1,34
853630177,27,82,28,1,138
853631037,45,29,23,1,98
853641000,264,17,2,15,298
853647265,76,3,2,1,82
853665695,21,9,28,1,59
853681924,45,57,20,1,123
853695919,57,15,2,3,77
853696964,10,13,3,1,27
853728603,39,28,8,1,76
853738678,43,3,2,1,49
853770119,68,29,8,4,109
853775927,114,34,18,14,180
853792233,10,7,2,1,20
853793637,57,26,3,9,95
853799215,16,3,2,1,22
853806549,16,6,2,1,25
853819861,37,37,16,3,93
853831690,47,3,2,4,56
853832722,119,14,9,4,146
853838339,101,3,2,1,107
853844919,169,33,2,5,209
853845553,109,3,2,1,115
853848440,21,21,2,1,45
853849139,29,6,2,2,39
853851696,47,27,15,24,113
853855053,159,3,2,3,167
853859129,68,33,7,46,154
853871635,30,6,4,1,41
853872959,15,3,2,2,22
853876185,23,13,9,26,71
853879434,47,3,2,1,53
853884937,36,24,3,10,73
853906660,87,24,3,1,115
853908172,84,7,2,1,94
853910763,174,3,2,31,210
853912085,27,14,18,12,71
853912464,13,3,2,1,19
853918417,90,13,36,7,146
853920127,85,5,15,8,113
853927130,80,3,2,1,86
853936788,72,3,2,1,78
853948215,17,3,2,1,23
853963264,69,23,100,24,216
853965887,32,3,2,6,43
853976389,12,18,2,12,44
853986225,90,16,23,7,136
853988097,38,7,2,1,48
853991344,13,3,2,1,19
853996803,94,19,2,1,116
854007164,117,20,25,12,174
854007366,49,45,101,10,205
854009179,12,3,2,1,18
854024927,10,14,2,1,27
854027801,40,15,4,1,60
854035120,11,3,2,1,17
854037023,10,3,2,2,17
854051933,108,39,77,19,243
854058954,10,6,2,1,19
854068522,154,19,16,4,193
854075346,95,41,86,5,227
854076140,61,48,13,13,135
854077857,51,3,2,5,61
854080918,10,13,2,1,26
854086016,48,10,2,1,61
854104371,61,3,2,1,67
854105676,75,56,43,2,176
854109742,119,61,3,2,185
854119972,40,28,44,6,118
854126123,29,76,46,5,156
854131559,99,18,41,1,159
854137866,38,27,2,1,68
854149897,66,7,17,1,91
854151935,242,19,2,3,266
854166245,45,52,14,11,122
854167161,124,48,2,3,177
854169903,112,3,2,1,118
854170692,13,40,2,9,64
854181888,23,51,27,5,106
854189433,47,5,3,2,57
854193740,200,38,90,27,355
854203774,88,3,2,6,99
854210250,205,14,9,2,230
854225995,56,32,9,25,122
854230685,13,3,2,1,19
854234137,38,18,4,1,61
854242103,40,69,47,22,178
854248189,23,5,2,2,32
854248218,66,30,17,7,120
854253370,46,24,2,25,97
854274534,75,4,17,1,97
854287394,116,3,2,1,122
854293522,140,3,2,6,151
854303755,22,3,2,1,28
854313109,14,3,2,1,20
854330294,27,3,2,1,33
854336127,97,3,2,1,103
854340420,226,26,3,7,262
854355066,20,36,3,15,74
854369629,58,19,6,1,84
854373754,65,16,2,1,84
854379295,131,3,2,16,152
854383239,84,70,31,4,189
854384130,54,43,9,10,116
854385192,61,3,2,5,71
854392071,110,43,66,120,339
854398604,10,5,2,1,18
854421298,11,5,2,3,21
854423611,30,3,2,1,36
854444524,55,22,2,20,99
854448297,48,3,2,5,58
854457715,41,3,2,1,47
854458956,53,3,2,1,59
854468842,83,32,2,2,119
854471075,20,26,57,1,104
854474387,38,14,3,3,58
854481018,90,3,2,1,96
854485250,15,3,2,1,21
854488374,89,3,2,1,95
854493618,154,39,24,4,221
854496937,13,11,2,1,27
854498437,23,3,2,1,29
854511945,43,29,2,1,75
854513350,144,5,2,25,176
854527056,156,68,45,15,284
854543269,11,4,2,1,18
854548500,74,15,2,5,96
854568464,11,3,2,1,17
854581552,32,43,18,1,94
854590789,39,79,18,8,144
854602979,32,62,7,10,111
854604593,48,21,13,6,88
854605782,69,3,2,1,75
854614480,10,3,2,2,17
854623373,45,3,2,4,54
854624019,70,3,2,4,79
854648841,92,18,2,2,114
854650080,15,27,2,2,46
854659662,83,29,3,12,127
854670731,70,54,33,19,176
854672158,125,17,2,4,148
854672330,167,3,2,1,173
854677921,32,3,2,1,38
854678658,35,35,25,4,99
854696814,14,6,2,2,24
854703661,67,55,47,14,183
854709889,27,3,2,4,36
854720334,48,28,29,16,121
854728014,22,13,2,1,38
854755273,49,50,20,15,134
854764129,13,3,2,1,19
854766187,99,8,5,3,115
854768678,11,64,2,1,78
854768829,54,23,7,1,85
854797793,70,3,2,5,80
854801047,82,3,2,14,101
854801992,19,9,2,1,31
854803361,11,3,2,11,27
854808019,26,59,6,1,92
854824349,39,8,2,1,50
854829030,14,8,2,1,25
854845299,19,4,2,1,26
854858437,33,34,41,1,109
854864429,19,20,2,1,42
854871361,38,3,2,4,47
854880464,16,3,2,1,22
854881839,17,34,2,1,54
854883076,70,10,5,17,102
854885482,70,13,2,5,90
854900029,28,30,2,1,61
854930177,17,3,2,2,24
854937240,58,13,2,1,74
854951719,43,30,2,1,76
854986832,28,25,27,1,81
854991004,113,22,22,10,167
855000466,106,22,2,1,131
855010172,12,39,2,1,54
855016404,33,5,2,8,48
855019773,23,3,2,1,29
855021255,50,48,11,4,113
855025241,41,23,18,4,86
855029766,215,63,30,3,311
855051026,17,30,11,1,59
855056777,23,3,2,1,29
855069393,95,3,2,8,108
855070137,146,12,12,3,173
855071534,105,19,6,4,134
855084186,11,3,2,1,17
855088088,199,57,11,7,274
855088421,27,7,2,2,38
855105239,19,3,2,1,25
855105794,19,41,25,4,89
855116793,65,4,2,6,77
855186871,92,4,36,8,140
855198298,99,37,84,1,221
855217929,48,32,11,40,131
855218247,88,12,24,3,127
855264151,107,18,3,32,160
855271150,11,3,2,1,17
855287128,48,6,2,6,62
855289904,12,24,2,1,39
855290852,12,3,2,1,18
855296602,61,27,107,32,227
855304067,56,16,8,3,83
855304116,175,3,2,9,189
855313671,48,3,2,7,60
855315028,17,8,2,1,28
855316273,15,3,2,1,21
855328025,64,10,3,16,93
855333446,46,41,30,2,119
855333995,11,3,2,1,17
855334423,81,21,2,3,107
855335634,81,13,25,23,142
855345021,79,87,10,35,211
855372547,10,5,2,1,18
855373601,95,96,41,14,246
855385360,47,3,2,1,53
855396716,14,6,2,1,23
855397311,11,12,2,5,30
855417096,12,3,2,1,18
855421337,35,36,3,1,75
855426218,63,56,16,3,138
855429046,137,57,4,45,243
855435196,21,3,2,1,27
855439107,12,9,2,1,24
855449955,11,3,2,1,17
855453179,56,3,2,20,81
855464721,43,3,2,1,49
855471657,10,3,2,2,17
855486234,95,35,4,2,136
855490139,94,22,89,9,214
855494254,28,44,30,5,107
855494439,47,79,19,4,149
855496872,23,3,2,1,29
855502025,12,3,2,1,18
855513094,12,3,2,1,18
855518284,120,72,65,29,286
855525637,102,7,2,1,112
855527442,12,3,2,1,18
855530291,64,3,2,1,70
855530409,17,3,2,3,25
855537435,16,3,2,1,22
855540766,61,41,8,21,131
855551526,139,85,65,1,290
855556648,85,28,6,14,133
855563923,57,18,2,4,81
855568968,10,3,2,4,19
855569566,45,27,2,3,77
855580162,79,62,32,83,256
855587320,17,45,2,3,67
855601654,99,7,2,9,117
855610365,35,21,2,3,61
855612343,67,14,10,6,97
855633114,48,45,16,1,110
855644841,51,3,2,2,58
855650111,40,20,2,6,68
855654177,26,30,5,1,62
855654922,54,3,2,1,60
855670296,47,15,20,2,84
855673528,171,29,13,16,229
855681294,14,7,2,1,24
855682532,32,3,2,1,38
855686956,129,51,26,9,215
855697012,92,42,30,7,171
855697242,19,3,2,1,25
855711710,34,3,2,1,40
855718186,11,3,2,1,17
855738862,92,53,12,7,164
855743826,183,3,2,1,189
855746617,87,71,2,3,163
855758113,78,3,2,1,84
855769284,52,37,82,1,172
855773252,20,37,2,1,60
855786445,74,8,20,2,104
855793741,50,3,2,1,56
855799046,186,3,2,1,192
855806696,57,13,2,2,74
855812106,47,41,5,1,94
855817787,44,44,36,16,140
855818819,87,3,2,1,93
855821466,33,45,36,1,115
855828004,72,16,3,1,92
855828331,60,3,2,1,66
855831340,143,45,2,1,191
855853897,63,35,3,2,103
855865240,238,91,3,53,385
855871823,89,10,53,25,177
855888671,46,41,17,3,107
855889637,140,19,3,15,177
855904146,50,29,43,16,138
855911110,59,47,22,1,129
855913951,139,34,4,11,188
855915992,37,39,8,8,92
855931768,27,36,3,9,75
855953533,37,3,2,17,59
855953947,94,25,123,10,252
855958806,218,11,2,10,241
855963287,25,14,23,3,65
855978301,87,32,38,4,161
855989259,93,39,2,1,135
855989581,78,10,2,3,93
855995048,41,55,11,3,110
856000546,20,11,3,1,35
856006362,120,3,2,14,139
856008569,12,3,2,1,18
856020475,12,3,2,1,18
856025517,75,19,8,15,117
856027658,89,3,9,6,107
856045000,52,51,9,1,113
856065476,17,3,2,2,24
856077799,109,6,2,18,135
856091826,171,9,2,2,184
856096476,13,19,2,1,35
856096648,41,16,2,3,62
856099523,115,71,76,9,271
856105533,106,36,2,10,154
856109235,10,10,2,1,23
856114353,47,68,19,21,155
856123999,108,26,2,5,141
856126564,57,3,2,4,66
856126578,42,22,46,3,113
856128734,11,17,2,1,31
856157632,57,31,93,1,182
856169384,25,3,2,1,31
856171961,12,7,2,1,22
856192326,106,3,2,9,120
856199630,132,3,2,2,139
856205305,23,36,38,3,100
856207887,54,9,9,17,89
856211508,10,9,16,1,36
856219387,62,7,44,4,117
856229841,57,37,10,2,106
856247796,120,45,89,5,259
856257144,40,11,3,4,58
856257518,87,3,2,4,96
856261705,15,20,2,2,39
856264549,24,11,2,1,38
856268943,148,61,26,19,254
856280060,157,3,2,2,164
856287770,54,63,2,4,123
856292218,33,3,2,1,39
856316484,45,79,19,6,149
856317984,85,8,189,9,291
856323027,77,19,3,9,108
856337516,10,19,4,1,34
856342169,44,19,27,11,101
856349868,17,3,2,1,23
856352060,63,14,2,2,81
856354323,84,3,2,3,92
856357849,133,10,79,13,235
856362470,11,3,2,2,18
856362507,10,3,2,5,20
856378148,39,38,8,47,132
856378360,11,5,2,1,19
856385009,54,21,9,1,85
856390121,125,30,5,1,161
856397191,24,30,5,5,64
856397418,87,26,166,13,292
856400454,17,4,2,1,24
856442267,205,23,2,85,315
856446346,17,3,2,2,24
856461711,10,5,2,1,18
856470343,146,14,5,3,168
856495844,100,3,2,1,106
856504112,91,18,39,1,149
856509481,23,18,2,1,44
856514442,86,31,5,4,126
856529746,87,3,2,1,93
856529867,51,3,2,1,57
856548901,40,26,13,15,94
856562228,210,31,17,1,259
856562553,51,57,31,15,154
856562678,32,7,8,14,61
856570404,86,27,23,5,141
856572591,39,3,2,1,45
856573169,12,3,2,1,18
856595700,36,9,2,1,48
856597685,59,21,4,12,96
856629001,80,3,2,3,88
856636185,14,26,2,1,43
856641901,24,17,2,1,44
856656663,32,44,48,3,127
856660495,41,9,2,6,58
856661159,72,3,2,1,78
856667073,111,49,11,20,191
856693207,103,3,2,13,121
856694504,88,3,2,1,94
856699581,55,56,72,1,184
856704884,89,3,2,30,124
856706189,48,7,2,9,66
856712497,13,3,2,1,19
856713187,11,11,13,2,37
856723036,11,3,2,1,17
856728442,44,12,8,9,73
856738647,24,58,4,4,90
856746591,51,46,55,30,182
856748865,58,13,2,1,74
856753963,20,3,2,1,26
856756778,53,22,6,6,87
856767054,13,3,2,1,19
856767572,12,3,2,1,18
856780798,13,32,2,1,48
856781578,98,23,11,5,137
856807270,93,35,78,7,213
856815021,81,3,2,1,87
856820878,42,34,2,1,79
856828294,94,21,54,1,170
856837046,192,24,16,3,235
856865399,67,7,2,3,79
856879251,165,48,5,19,237
856881552,34,38,60,6,138
856892837,252,3,2,3,260
856946266,51,46,2,1,100
856959278,126,6,43,19,194
856961632,66,3,2,41,112
856968729,73,15,2,3,93
856981378,19,4,2,1,26
856987710,17,31,2,1,51
856991500,27,20,9,2,58
856998208,159,3,2,3,167
857001451,116,3,2,5,126
857008676,37,49,31,9,126
857019960,43,16,53,5,117
857048473,43,6,7,4,60
857053428,65,3,2,2,72
857073069,49,18,15,25,107
857081438,65,3,2,1,71
857082145,143,21,2,3,169
857089745,14,3,2,1,20
857093265,14,3,2,1,20
857096995,65,13,16,1,95
857097797,11,13,2,3,29
857109751,28,48,19,5,100
857115830,10,3,2,2,17
857125306,176,3,2,20,201
857133497,11,3,2,2,18
857137729,49,3,2,13,67
857138530,74,3,2,6,85
857148373,48,91,8,11,158
857154143,125,3,2,27,157
857156190,64,61,2,8,135
857157593,39,32,69,8,148
857163347,62,34,9,12,117
857166261,25,41,6,2,74
857167086,117,6,96,2,221
857170231,222,14,2,1,239
857186663,14,3,2,3,22
857194273,70,7,13,7,97
857202771,237,3,2,3,245
857203099,38,9,2,4,53
857203952,119,4,2,14,139
857208826,142,3,2,3,150
857211341,98,6,2,3,109
857218138,27,116,50,1,194
857225304,20,9,2,1,32
857227129,41,3,5,1,50
857228848,20,32,5,1,58
857229632,27,14,2,1,44
857244810,61,20,2,11,94
857246071,12,4,2,3,21
857260304,81,26,14,7,128
857277431,81,6,3,1,91
857282354,10,5,2,1,18
857285490,17,3,2,1,23
857288111,161,52,114,6,333
857289344,62,3,2,5,72
857298437,99,25,120,3,247
857308289,94,15,4,11,124
857317147,10,32,2,1,45
857325398,14,3,2,1,20
857329252,11,3,2,1,17
857331534,119,3,2,9,133
857350979,34,45,31,8,118
857358551,28,38,14,16,96
857362130,17,3,2,1,23
857368187,106,13,2,6,127
857369388,21,3,2,1,27
857382757,49,18,8,6,81
857384999,118,16,2,3,139
857403446,44,10,5,18,77
857406867,20,14,7,8,49
857415536,11,3,2,6,22
857419326,69,24,5,2,100
857440432,13,17,2,1,33
857441611,129,21,30,1,181
857442113,89,42,4,18,153
857456498,43,69,52,93,257
857462495,18,17,4,3,42
857479788,80,10,23,3,116
857494008,71,15,4,5,95
857499063,23,8,9,1,41
857499089,136,3,2,1,142
857504128,23,3,2,1,29
857578107,56,5,17,1,79
857586138,13,4,2,4,23
857592953,129,53,31,1,214
857594871,83,3,2,1,89
857601577,27,64,2,2,95
857601746,36,3,2,1,42
857609194,16,3,2,1,22
857612309,31,50,2,1,84
857625080,15,3,2,1,21
857626290,32,3,2,5,42
857627046,17,29,5,4,55
857627775,75,3,6,2,86
857632914,23,20,2,26,71
857646539,27,3,2,37,69
857658184,27,69,9,3,108
857672312,127,64,11,7,209
857680215,63,35,13,11,122
857688775,66,32,4,2,104
857691392,42,13,4,1,60
857694881,11,3,2,1,17
857709458,12,3,2,1,18
857719196,69,3,2,2,76
857724596,35,14,31,1,81
857725679,12,17,2,1,32
857744473,20,9,2,1,32
857755793,28,10,9,1,48
857756376,63,3,2,1,69
857767483,66,17,2,3,88
857768271,91,15,55,6,167
857778462,13,3,2,2,20
857779992,55,3,2,1,61
857789206,22,3,2,1,28
857828083,37,34,58,2,131
857832014,22,27,5,1,55
857858267,21,3,2,1,27
857867530,135,12,2,1,150
857870123,237,51,22,7,317
857879352,101,105,2,3,211
857889808,92,24,79,25,220
857897470,21,3,2,5,31
857920772,71,3,2,1,77
857920927,26,3,2,4,35
857940197,19,3,2,1,25
857942459,17,3,2,6,28
857948979,13,3,2,1,19
857953884,111,24,45,1,181
857955570,92,36,6,7,141
857964665,32,9,2,7,50
857965561,52,3,2,1,58
857973106,14,3,2,1,20
857978113,166,26,80,1,273
858004383,26,36,2,1,65
858008637,11,3,2,1,17
858010415,71,43,89,4,207
858017252,38,3,2,2,45
858020900,134,21,2,16,173
858028167,92,94,15,10,211
858034062,141,3,2,16,162
858035839,61,7,2,4,74
858041120,42,37,16,1,96
858068522,152,36,4,1,193
858079587,29,3,2,1,35
858092168,51,18,2,6,77
858099251,24,10,2,1,37
858110009,60,16,3,1,80
858120644,24,39,2,1,66
858121632,27,3,2,1,33
858121823,129,51,76,72,328
858126745,144,3,2,19,168
858131966,21,33,2,13,69
858136844,14,16,2,4,36
858157536,78,67,24,20,189
858192823,72,3,2,1,78
858228000,53,30,9,1,93
858229925,49,3,2,1,55
858245821,75,20,38,1,134
858255293,31,15,10,2,58
858260016,18,3,2,1,24
858281015,82,7,90,11,190
858282600,22,23,11,7,63
858290178,41,41,47,36,165
858300240,53,27,2,5,87
858308637,10,4,2,1,17
858330604,77,3,2,1,83
858335107,106,20,29,22,177
858338999,66,35,6,19,126
858340412,14,22,2,3,41
858342240,28,3,2,2,35
858353641,34,3,2,1,40
858364981,32,7,2,4,45
858372252,10,7,2,1,20
858373779,31,3,3,2,39
858389147,48,28,31,4,111
858391252,35,74,2,14,125
858393080,15,17,2,1,35
858393574,69,10,2,1,82
858394693,27,10,2,22,61
858399247,258,31,32,2,323
858401202,114,3,2,1,120
858418042,69,8,4,1,82
858424120,42,3,2,2,49
858454057,12,9,2,1,24
858454532,28,3,2,5,38
858459629,12,5,2,1,20
858463229,60,38,16,21,135
858479040,18,42,2,2,64
858483581,73,3,2,1,79
858484674,135,3,2,3,143
858493284,11,3,2,1,17
858493524,31,3,2,1,37
858497047,52,8,2,2,64
858503090,95,49,65,1,210
858509237,108,66,2,1,177
858516465,88,11,32,46,177
858521589,93,3,3,5,104
858524723,50,20,2,1,73
858527907,85,26,2,8,121
858528548,42,15,10,8,75
858533395,118,19,7,9,153
858545341,11,3,2,1,17
858550455,46,12,2,15,75
858554800,54,38,17,4,113
858558233,52,4,19,3,78
858570706,11,3,2,1,17
858580009,60,3,2,1,66
858582471,17,3,2,1,23
858588104,165,62,43,5,275
858597664,75,21,2,1,99
858604381,17,3,2,1,23
858629038,74,3,2,1,80
858647294,47,13,2,1,63
858652877,100,16,57,25,198
858657660,140,13,3,1,157
858662682,26,21,27,2,76
858681510,128,8,3,8,147
858682989,44,74,15,2,135
858684301,14,12,2,1,29
858689997,86,18,14,17,135
858699823,39,13,2,5,59
858735364,78,3,2,1,84
858738906,30,18,2,1,51
858759567,69,3,2,1,75
858764128,20,34,2,1,57
858765447,65,21,58,10,154
858766476,48,3,2,3,56
858770644,34,5,2,6,47
858777771,87,3,2,1,93
858786468,12,3,2,1,18
858796077,61,7,2,1,71
858802682,11,3,2,1,17
858803477,86,29,4,3,122
858804771,62,47,19,61,189
858805358,13,7,4,12,36
858833710,25,3,2,3,33
858833783,127,9,55,19,210
858835129,14,3,2,1,20
858838201,82,9,2,2,95
858861506,52,52,23,13,140
858868206,10,3,2,2,17
858869090,159,5,3,4,171
858873813,14,3,2,5,24
858882887,16,3,2,2,23
858886620,89,27,44,4,164
858888220,71,71,87,8,237
858895128,359,3,2,6,370
858910805,12,7,2,1,22
858923166,23,11,7,1,42
858936450,42,33,50,1,126
858941568,61,22,2,2,87
858968162,27,23,10,3,63
858972202,37,3,2,1,43
858978266,26,21,15,9,71
858979617,142,3,2,1,148
858997235,123,37,2,2,164
859013611,11,3,2,1,17
859037613,119,3,2,1,125
859037703,37,23,16,2,78
859040960,169,93,122,22,406
859060250,89,48,9,1,147
859065558,42,12,2,6,62
859067425,57,23,2,3,85
859067702,57,28,35,5,125
859072613,40,15,2,3,60
859093152,25,3,2,1,31
859093425,61,26,23,15,125
859109237,41,43,3,1,88
859114904,29,11,2,1,43
859124993,52,56,35,1,144
859127348,52,17,12,1,82
859127427,208,28,74,1,311
859137926,64,25,26,1,116
859155353,17,17,2,1,37
859163639,18,72,12,1,103
859168498,51,34,20,4,109
859168707,90,24,5,2,121
859169290,50,14,113,1,178
859181858,79,22,25,5,131
859196956,82,5,3,3,93
859202844,47,65,80,3,195
859215816,14,3,2,1,20
859219234,22,52,2,2,78
859220015,154,25,61,2,242
859237663,47,3,2,7,59
859252413,34,69,44,1,148
859269552,34,44,27,8,113
859275144,52,8,16,7,83
859283701,19,11,2,1,33
859285435,53,58,17,2,130
859307250,34,32,23,35,124
859311939,73,59,45,1,178
859313785,24,3,2,4,33
859316383,29,9,13,13,64
859343505,118,16,39,3,176
859355644,66,73,76,35,250
859370131,91,9,2,15,117
859370683,65,29,13,9,116
859392307,115,23,13,12,163
859394581,28,52,16,5,101
859399950,114,3,2,2,121
859405710,39,14,2,36,91
859409276,46,3,2,1,52
859423393,14,3,2,2,21
859429838,80,14,50,51,195
859430964,153,3,2,5,163
859438724,93,17,2,1,113
859440874,16,3,2,1,22
859453169,20,5,2,1,28
859458068,29,3,2,1,35
859460173,186,3,6,4,199
859479908,25,44,14,1,84
859480205,51,3,2,1,57
859490285,69,24,14,5,112
859492836,99,3,2,1,105
859501731,10,3,2,3,18
859502159,24,3,2,4,33
859503512,100,3,4,9,116
859507466,64,30,26,6,126
859510537,109,38,15,24,186
859537756,13,10,2,1,26
859541532,36,7,38,30,111
859545561,48,36,8,1,93
859555284,31,61,2,2,96
859557349,70,41,18,18,147
859557429,146,43,33,23,245
859558262,38,56,46,2,142
859565693,12,3,2,1,18
859567197,43,112,8,22,185
859584465,36,21,7,11,75
859584563,35,3,2,4,44
859606023,62,60,7,3,132
859625780,279,3,6,10,298
859632272,136,3,2,10,151
859632311,124,45,7,1,177
859643069,50,3,2,1,56
859645321,73,16,27,9,125
859657826,54,69,4,1,128
859664054,53,9,32,7,101
859664190,25,3,2,1,31
859680785,104,44,26,76,250
859681485,71,16,8,6,101
859691342,110,17,13,8,148
859693323,50,35,11,11,107
859720877,32,3,8,1,44
859734645,44,43,63,22,172
859751882,18,7,2,1,28
859757087,76,13,2,7,98
859763760,75,3,2,2,82
859788650,116,3,2,1,122
859790015,109,11,4,3,127
859803899,12,3,2,1,18
859812157,34,79,37,1,151
859814808,10,20,2,1,33
859823863,56,3,2,1,62
859826991,36,55,88,1,180
859838707,16,3,2,4,25
859839121,99,10,2,17,128
859849795,50,37,4,6,97
859857814,18,3,2,1,24
859883028,23,5,2,13,43
859884273,101,3,2,1,107
859885883,39,30,4,13,86
859889451,50,17,24,2,93
859890634,12,3,2,1,18
859891550,56,15,2,9,82
859893864,199,3,2,1,205
859894165,12,3,2,1,18
859898063,13,7,2,1,23
859900682,51,25,15,1,92
859905855,48,29,2,1,80
859909030,22,3,2,2,29
859916127,15,3,2,1,21
859923475,129,33,96,12,270
859926105,53,25,6,1,85
859926324,74,65,34,1,174
859962773,62,12,6,38,118
859979884,13,3,2,1,19
860002532,129,26,2,1,158
860012287,11,3,2,3,19
860022675,635,8,2,42,687
860036212,42,3,2,1,48
860049317,11,3,2,1,17
860066784,133,3,2,1,139
860079468,87,26,15,27,155
860086120,51,3,2,7,63
860089707,89,13,2,3,107
860101177,91,22,4,1,118
860101948,168,14,22,4,208
860121137,117,47,14,14,192
860133916,107,5,2,15,129
860140364,123,56,52,11,242
860154901,106,9,3,1,119
860158658,95,35,59,24,213
860165458,99,5,2,1,107
860190652,95,55,96,7,253
860196030,62,22,22,2,108
860206491,51,88,16,3,158
860222780,178,40,7,9,234
860229341,11,3,2,2,18
860232103,87,20,45,3,155
860241650,64,9,2,35,110
860248055,54,56,19,63,192
860255600,37,10,24,44,115
860271815,31,8,11,2,52
860279201,76,29,18,7,130
860291054,56,8,30,5,99
860291825,108,12,2,1,123
860301387,23,24,7,2,56
860303343,63,3,2,1,69
860311445,84,21,18,1,124
860311998,14,37,2,1,54
860322957,43,22,11,5,81
860332012,18,3,2,5,28
860338767,14,3,2,1,20
860342729,12,3,2,1,18
860347990,25,3,2,1,31
860348704,24,31,11,33,99
860351664,124,20,2,1,147
860360588,80,4,2,3,89
860360946,149,11,2,2,164
860369649,100,64,126,11,301
860378183,74,15,3,5,97
860382102,34,49,59,30,172
860400309,74,3,2,1,80
860414411,10,8,2,1,21
860415367,96,3,4,165,268
860416498,36,42,6,1,85
860437044,16,3,2,1,22
860441851,209,17,2,1,229
860452650,128,34,45,1,208
860457779,20,7,2,3,32
860482840,37,29,11,54,131
860486372,41,15,43,7,106
860492321,160,57,2,3,222
860498515,153,27,2,2,184
860512353,68,20,2,6,96
860527059,44,3,2,1,50
860528904,13,3,2,1,19
860537152,46,17,35,3,101
860556190,48,36,12,1,97
860571402,14,3,2,1,20
860573918,16,8,2,1,27
860590740,146,13,43,29,231
860595821,31,54,2,10,97
860596315,39,42,2,2,85
860603084,21,3,2,5,31
860605753,66,16,2,8,92
860620081,93,27,6,1,127
860621727,101,27,5,1,134
860622700,95,37,74,11,217
860640941,10,8,2,1,21
860654129,26,3,2,2,33
860667740,11,3,2,3,19
860668814,166,53,12,37,268
860674648,60,19,74,1,154
860685523,32,3,2,12,49
860687288,14,3,2,1,20
860689684,33,3,2,1,39
860696508,119,30,36,6,191
860702923,15,38,2,1,56
860719206,31,3,2,1,37
860737885,51,18,2,1,72
860740805,46,22,2,35,105
860753532,13,15,20,25,73
860757222,18,3,2,1,24
860764159,19,3,2,1,25
860778585,82,3,2,1,88
860783978,28,10,2,1,41
860799503,142,8,2,4,156
860814877,133,90,2,1,226
860827066,129,32,2,12,175
860835331,28,3,2,1,34
860855725,49,25,11,12,97
860876432,64,20,41,3,128
860884590,67,17,12,3,99
860893766,51,21,9,12,93
860894515,35,14,46,1,96
860908886,30,40,20,25,115
860939914,120,8,2,7,137
860944474,64,32,2,4,102
860949735,10,19,2,1,32
860952599,94,12,15,1,122
860966384,27,3,2,3,35
860968071,73,15,2,2,92
860975614,29,16,2,1,48
860976960,106,3,2,1,112
860994593,46,7,2,2,57
861001965,161,3,2,1,167
861004345,80,3,2,2,87
861029230,64,3,2,1,70
861031434,10,18,3,1,32
861033596,27,3,2,1,33
861038803,21,3,2,1,27
861053364,27,3,2,1,33
861053914,41,69,3,1,114
861061527,88,3,2,4,97
861087748,24,3,2,1,30
861092530,17,16,13,12,58
861094741,28,10,2,1,41
861097000,26,3,2,1,32
861097833,21,3,2,3,29
861114633,10,15,2,1,28
861121756,63,28,22,7,120
861155907,66,23,57,1,147
861160422,11,3,2,1,17
861162885,12,3,2,1,18
861176155,31,14,21,7,73
861180795,89,35,48,6,178
861202734,33,3,2,1,39
861203322,99,30,4,6,139
861236242,42,20,12,5,79
861242135,48,49,9,4,110
861266340,47,3,2,4,56
861266856,40,40,13,2,95
861268592,71,27,55,4,157
861305438,56,48,96,5,205
861315890,50,75,17,1,143
861322766,69,11,2,13,95
861325054,68,19,2,6,95
861327611,29,53,47,1,130
861329243,24,35,60,3,122
861332526,16,57,5,1,79
861335216,92,23,3,2,120
861335259,146,3,2,2,153
861336525,15,31,4,1,51
861336744,93,4,3,3,103
861339564,39,56,22,28,145
861414827,167,24,100,19,310
861418742,71,23,21,21,136
861427804,91,3,40,2,136
861432213,102,17,7,2,128
861437572,15,3,2,1,21
861442085,36,3,2,1,42
861497053,105,61,32,18,216
861500353,18,3,2,1,24
861510332,74,5,6,4,89
861531127,10,5,2,1,18
861535156,132,26,3,1,162
861536389,15,8,2,1,26
861540104,104,39,47,6,196
861540613,17,3,2,1,23
861556085,122,14,26,5,167
861567087,12,19,2,1,34
861573520,18,16,2,3,39
861579530,130,33,9,7,179
861592894,22,3,2,1,28
861592962,11,3,2,1,17
861594241,10,3,2,2,17
861594976,47,16,3,4,70
861597921,93,27,77,6,203
861624538,147,59,90,3,299
861628180,87,3,2,8,100
861630753,43,80,11,5,139
861647085,11,3,2,1,17
861655062,11,4,2,5,22
861668252,82,19,16,12,129
861672918,218,15,2,2,237
861692558,40,3,2,1,46
861712479,138,22,4,3,167
861719421,35,10,2,3,50
861720137,15,82,7,12,116
861728833,56,33,2,5,96
861739184,58,63,26,26,173
861749220,144,12,2,2,160
861749391,20,19,2,9,50
861750915,25,3,2,7,37
861751850,89,9,23,1,122
861761336,19,8,2,1,30
861762430,24,30,3,1,58
861771449,16,20,4,1,41
861787287,129,3,2,1,135
861800576,57,35,2,8,102
861811847,57,3,9,1,70
861817939,24,24,2,3,53
861838307,44,12,10,3,69
861840078,45,24,32,1,102
861843419,126,3,2,10,141
861848415,73,43,17,3,136
861866828,12,3,2,1,18
861875316,23,3,2,6,34
861888371,119,3,2,1,125
861895099,49,8,2,9,68
861896164,42,3,2,1,48
861900457,24,51,2,1,78
861903807,22,3,2,1,28
861905449,225,3,2,9,239
861941218,36,11,2,1,50
861945197,95,12,2,5,114
861974574,106,18,2,1,127
861977966,12,3,3,1,19
861980047,26,9,2,1,38
862000134,27,72,28,3,130
862015783,69,52,73,2,196
862038494,191,22,22,8,243
862053718,15,3,2,1,21
862063444,118,26,4,15,163
862064924,20,3,2,1,26
862075217,48,43,32,1,124
862081861,50,3,2,4,59
862085468,88,144,33,36,301
862107359,11,3,2,1,17
862113560,41,28,44,8,121
862115440,17,5,2,1,25
862124845,19,17,4,2,42
862129835,93,59,22,14,188
862135728,123,40,2,17,182
862148699,64,44,64,20,192
862164614,79,3,2,1,85
862175204,37,14,3,1,55
862175274,25,3,2,1,31
862176159,155,79,33,7,274
862176646,71,11,2,8,92
862178774,153,32,2,1,188
862200059,13,3,2,1,19
862227834,71,86,19,11,187
862245785,20,3,2,1,26
862261136,86,11,12,1,110
862278082,72,16,7,1,96
862285141,95,3,2,5,105
862297321,46,32,3,5,86
862298656,86,11,3,1,101
862298967,54,3,2,4,63
862322013,90,3,2,2,97
862324655,187,3,2,1,193
862328903,29,3,2,1,35
862329636,79,3,2,1,85
862335331,52,3,2,1,58
862335968,126,35,108,64,333
862342311,68,28,17,9,122
862349178,11,3,2,1,17
862360454,30,8,19,9,66
862369199,19,3,2,1,25
862370421,61,6,2,3,72
862374354,91,3,2,1,97
862377790,45,84,54,5,188
862378094,54,69,19,6,148
862400526,79,29,55,3,166
862410866,46,3,2,1,52
862413655,64,3,21,6,94
862415934,15,13,2,1,31
862417230,41,35,15,16,107
862419640,53,90,12,13,168
862422344,11,7,2,2,22
862423625,18,3,2,1,24
862430698,62,3,2,2,69
862454131,178,17,3,2,200
862477599,90,42,14,3,149
862494145,52,3,2,1,58
862498578,22,12,16,21,71
862526241,159,22,39,10,230
862530342,21,18,4,1,44
862557104,126,8,79,1,214
862561576,45,3,2,10,60
862570425,105,42,2,3,152
862578460,10,15,2,4,31
862580831,23,31,2,13,69
862596611,47,16,2,4,69
862607434,85,43,105,4,237
862634392,69,15,21,1,106
862652880,85,24,2,15,126
862664353,71,3,2,1,77
862667889,83,38,16,20,157
862670607,51,49,3,14,117
862670855,31,32,26,9,98
862672714,17,28,2,1,48
862672911,107,9,43,3,162
862673135,43,13,2,5,63
862687505,11,3,2,1,17
862704861,107,35,43,4,189
862705705,26,3,2,4,35
862719850,110,25,113,1,249
862766215,72,48,60,7,187
862766731,43,12,2,1,58
862767995,50,93,78,1,222
862769891,107,69,30,6,212
862772789,122,3,2,1,128
862775208,163,18,2,1,184
862780692,39,3,2,1,45
862801282,35,3,4,1,43
862830884,18,3,2,2,25
862852479,11,3,2,1,17
862866808,29,3,2,14,48
862868454,28,48,27,3,106
862870271,54,12,19,6,91
862911616,46,24,8,8,86
862927789,122,3,2,1,128
862928580,99,33,27,14,173
862941354,65,79,41,29,214
862946512,36,29,2,1,68
862964018,30,6,9,2,47
862976281,30,20,4,1,55
862993811,48,3,2,3,56
862999286,116,27,89,1,233
863010736,27,17,2,1,47
863014772,13,3,2,1,19
863017464,105,8,2,14,129
863020023,55,89,46,13,203
863034957,17,20,2,3,42
863070028,47,15,19,6,87
863074217,24,3,2,1,30
863089494,112,12,23,6,153
863106037,74,3,2,5,84
863109281,34,3,2,1,40
863115409,11,3,2,1,17
863146237,56,22,10,2,90
863147708,32,43,46,13,134
863154990,14,3,2,1,20
863160098,10,13,2,1,26
863166905,51,25,30,1,107
863197326,53,53,4,2,112
863223438,101,46,68,49,264
863224658,21,11,82,7,121
863236343,23,44,2,3,72
863238482,43,3,2,1,49
863239052,16,84,50,10,160
863239620,38,10,9,1,58
863244777,135,53,79,8,275
863254631,128,10,115,1,254
863299701,40,3,2,1,46
863305995,68,3,2,1,74
863320702,117,43,14,37,211
863322770,17,8,2,1,28
863323985,154,3,2,5,164
863334060,43,3,2,5,53
863341733,41,7,2,7,57
863347202,10,6,2,1,19
863354630,89,37,20,1,147
863361308,10,7,3,1,21
863371059,87,30,68,1,186
863392681,24,42,70,1,137
863400630,88,34,2,18,142
863408459,42,9,2,1,54
863413085,58,9,5,5,77
863428872,182,40,21,4,247
863432378,12,3,2,1,18
863435868,81,26,13,51,171
863439320,61,4,2,5,72
863452682,115,20,33,9,177
863456151,19,3,2,1,25
863459762,127,35,2,5,169
863460009,36,8,2,2,48
863463788,63,21,2,5,91
863472697,96,36,7,12,151
863472938,22,3,2,1,28
863478460,85,3,2,1,91
863486727,120,23,58,19,220
863541294,10,3,2,3,18
863548074,13,3,2,1,19
863548486,11,3,2,1,17
863548928,94,7,28,3,132
863554204,103,3,3,2,111
863560030,13,3,2,6,24
863565135,58,3,2,1,64
863572439,17,3,2,4,26
863582788,241,15,2,3,261
863589121,41,79,3,1,124
863589744,39,36,6,1,82
863598956,53,5,12,13,83
863606562,13,9,2,3,27
863606652,85,49,22,31,187
863630074,176,11,23,8,218
863647917,80,14,20,1,115
863648184,34,27,2,1,64
863650446,86,11,28,25,150
863658861,93,8,21,3,125
863662456,30,8,2,1,41
863683152,81,69,45,11,206
863696009,24,3,2,1,30
863707100,80,5,2,4,91
863719947,145,3,2,1,151
863723934,42,8,2,3,55
863725724,11,3,2,1,17
863741776,40,11,2,1,54
863754870,18,35,13,22,88
863762922,102,9,2,1,114
863768261,53,56,9,12,130
863769284,39,47,30,16,132
863782617,94,49,72,3,218
863794682,38,35,5,1,79
863811806,10,59,2,2,73
863813048,82,16,4,3,105
863828092,489,3,2,1,495
863843254,37,28,5,4,74
863857836,108,35,55,9,207
863874271,33,75,36,18,162
863881365,10,11,2,1,24
863890896,107,3,2,1,113
863900050,58,51,57,2,168
863904459,345,4,22,13,384
863906997,22,3,2,1,28
863911001,18,3,2,1,24
863922166,119,3,2,1,125
863925792,166,19,7,4,196
863937748,17,7,2,1,27
863938639,64,33,12,2,111
863946931,12,3,2,1,18
863951637,21,3,2,3,29
863967590,14,3,2,1,20
863969692,91,32,2,6,131
863972327,80,41,3,24,148
863981589,88,52,50,83,273
864051335,19,6,2,1,28
864062689,12,3,2,1,18
864081278,63,3,2,1,69
864088459,151,3,2,1,157
864098203,107,69,2,8,186
864100742,329,3,2,11,345
864103263,11,20,2,7,40
864146634,13,3,2,1,19
864148262,32,6,2,1,41
864150667,84,46,76,13,219
864153434,12,3,2,6,23
864157624,64,64,35,6,169
864170052,22,28,2,1,53
864176365,64,3,2,1,70
864179191,46,13,7,1,67
864188044,10,22,12,3,47
864211460,204,23,8,8,243
864217337,11,3,2,1,17
864224961,71,61,5,26,163
864229409,72,12,3,2,89
864239250,83,8,2,5,98
864262034,48,20,3,1,72
864266873,17,14,2,1,34
864295116,176,7,17,7,207
864310163,46,30,2,1,79
864320809,12,3,2,1,18
864325593,20,3,2,1,26
864328642,193,26,49,8,276
864330092,20,3,2,1,26
864333825,18,6,2,1,27
864334638,90,31,19,1,141
864334721,19,3,2,1,25
864334753,143,49,102,21,315
864337442,67,7,2,10,86
864354623,10,3,2,4,19
864358636,61,38,27,1,127
864359789,12,3,2,3,20
864372148,22,39,2,1,64
864376465,39,3,2,1,45
864377940,19,22,27,2,70
864382678,97,24,33,12,166
864404686,13,3,2,8,26
864420823,51,32,2,2,87
864432519,27,89,17,18,151
864461045,57,40,3,6,106
864466068,51,4,2,5,62
864478291,54,11,33,15,113
864490155,11,9,2,1,23
864494145,12,3,2,1,18
864502713,19,14,2,1,36
864509672,81,32,2,5,120
864516686,59,3,2,1,65
864538850,40,3,2,1,46
864540383,12,3,2,1,18
864541261,16,3,2,1,22
864541498,69,16,85,1,171
864541626,52,33,15,1,101
864571488,17,3,2,1,23
864574479,43,60,55,32,190
864578876,114,3,2,8,127
864614352,28,42,2,39,111
864623504,21,12,2,1,36
864629875,93,7,2,1,103
864644195,23,3,2,3,31
864670732,70,79,17,26,192
864681836,23,3,2,2,30
864696201,67,3,2,2,74
864701042,10,6,2,1,19
864718077,49,31,23,37,140
864720893,193,78,12,37,320
864722040,31,3,2,2,38
864727430,82,26,24,3,135
864732954,15,3,2,1,21
864733800,16,23,7,6,52
864741208,78,3,78,2,161
864754291,16,3,2,2,23
864758125,59,23,2,1,85
864761869,30,3,2,1,36
864768536,12,3,2,1,18
864777559,18,3,2,1,24
864784213,22,3,2,1,28
864789535,139,6,2,8,155
864794916,30,15,24,12,81
864802982,70,34,111,1,216
864814649,43,6,19,1,69
864815011,54,4,21,27,106
864815178,73,3,2,11,89
864826793,92,5,3,10,110
864827151,19,3,2,3,27
864830892,63,16,2,1,82
864851796,11,3,2,1,17
864876089,27,38,6,1,72
864888085,41,11,2,3,57
864888611,55,12,2,3,72
864896975,24,62,32,16,134
864921465,18,45,11,14,88
864951121,127,25,3,2,157
864955853,51,22,3,1,77
864956298,10,3,2,3,18
864963660,130,20,2,11,163
864982368,13,3,2,2,20
864995500,34,5,2,13,54
865002243,37,59,8,3,107
865005875,55,31,18,3,107
865014990,13,27,2,1,43
865015276,67,6,3,1,77
865016444,90,11,3,4,108
865018988,188,8,18,2,216
865038805,124,3,2,2,131
865046913,125,21,3,11,160
865053367,36,26,4,2,68
865062725,59,17,2,2,80
865088825,22,3,2,2,29
865110425,102,12,8,10,132
865121934,66,14,12,3,95
865131529,57,28,13,7,105
865132945,61,46,15,7,129
865134377,72,3,2,5,82
865170958,19,3,2,1,25
865175728,72,7,2,7,88
865183752,31,68,11,7,117
865197958,18,12,2,1,33
865269065,92,13,2,1,108
865271314,47,17,28,5,97
865272610,12,3,2,1,18
865277340,74,5,2,1,82
865290947,70,5,11,14,100
865305421,47,18,2,1,68
865311073,108,3,2,1,114
865317507,91,44,34,2,171
865325353,21,3,2,1,27
865376709,18,36,4,10,68
865400405,25,5,4,3,37
865410919,25,22,2,1,50
865414959,13,3,2,18,36
865426119,37,3,2,1,43
865427965,13,3,2,1,19
865452290,202,6,4,9,221
865460442,25,3,2,1,31
865469137,98,71,34,5,208
865474468,32,3,2,1,38
865474612,50,3,2,4,59
865480359,48,52,2,14,116
865481116,119,6,3,10,138
865496481,44,33,2,1,80
865504975,62,51,12,9,134
865505433,44,37,57,1,139
865508861,69,31,21,9,130
865531539,58,3,2,2,65
865533614,43,86,56,13,198
865537704,127,38,9,5,179
865544242,20,3,2,1,26
865546990,13,3,2,1,19
865553887,129,20,21,3,173
865561702,73,20,4,17,114
865578399,36,3,2,1,42
865604890,34,65,9,11,119
865617501,49,13,12,1,75
865651354,46,4,5,7,62
865657622,47,49,2,9,107
865674913,96,57,19,14,186
865695909,105,5,2,3,115
865707193,10,3,2,5,20
865715678,105,67,21,6,199
865716629,53,15,2,2,72
865727032,78,3,2,2,85
865733210,51,3,2,1,57
865738789,75,3,3,7,88
865738911,67,45,14,14,140
865753264,18,3,2,1,24
865772764,14,3,2,5,24
865774612,78,32,2,3,115
865778163,16,4,2,1,23
865778398,33,30,24,22,109
865789297,88,62,31,4,185
865795046,132,11,24,6,173
865796013,12,3,2,1,18
865811607,42,23,5,2,72
865818472,12,3,2,1,18
865829812,61,34,60,20,175
865831107,133,21,2,4,160
865856893,24,3,2,13,42
865863920,26,3,5,1,35
865870930,32,16,2,1,51
865901938,27,3,2,1,33
865928446,14,15,2,1,32
865936427,82,3,2,74,161
865936674,13,20,3,1,37
865947417,89,30,3,14,136
865948733,233,21,88,36,378
865960109,51,12,21,1,85
865963277,31,82,5,1,119
865967648,160,7,24,14,205
865969032,182,13,2,9,206
865975259,11,16,2,1,30
865981251,20,13,2,1,36
865987040,11,25,5,2,43
865987914,10,29,12,8,59
865988047,80,23,25,10,138
865993157,51,3,2,1,57
866004745,14,3,2,1,20
866005075,93,74,25,6,198
866018276,19,11,2,1,33
866026829,65,3,74,6,148
866028871,24,16,57,1,98
866036735,89,12,2,11,114
866042155,44,10,2,1,57
866071537,88,60,33,8,189
866101901,52,41,3,14,110
866106591,48,11,2,1,62
866118777,53,3,2,1,59
866124324,67,20,2,13,102
866127082,27,9,2,2,40
866127645,11,3,2,7,23
866129387,29,14,2,1,46
866130694,105,19,4,4,132
866132979,137,23,51,1,212
866139918,179,35,25,10,249
866148672,125,19,2,2,148
866162229,23,26,2,12,63
866162312,18,14,3,1,36
866168743,79,23,18,8,128
866181215,90,3,2,1,96
866191383,13,3,2,1,19
866191539,45,20,13,10,88
866207378,32,43,2,5,82
866209261,30,9,2,1,42
866238600,11,3,2,2,18
866252418,11,6,2,2,21
866259963,19,33,2,1,55
866271659,19,59,35,5,118
866274218,57,23,2,1,83
866284265,11,4,3,1,19
866285183,53,3,29,2,87
866297861,96,3,2,1,102
866326952,69,3,2,1,75
866328987,10,3,2,2,17
866348067,15,3,2,1,21
866358330,17,3,2,1,23
866359677,47,6,2,3,58
866371826,24,27,17,7,75
866385447,75,26,2,8,111
866419000,54,26,2,2,84
866429596,45,20,75,41,181
866431228,15,4,2,1,22
866432569,59,3,2,1,65
866487474,25,3,2,1,31
866493828,81,50,2,1,134
866501219,34,19,2,6,61
866512400,17,3,2,1,23
866514109,80,20,33,12,145
866515933,71,4,2,3,80
866519148,11,3,2,4,20
866534393,129,3,2,9,143
866539090,101,21,3,6,131
866541845,134,10,24,17,185
866549034,146,23,20,8,197
866575959,30,11,2,5,48
866590606,14,4,2,1,21
866615641,30,3,2,1,36
866616676,65,21,2,5,93
866619114,179,18,55,1,253
866628852,180,42,7,4,233
866632260,70,20,4,3,97
866634311,98,49,6,14,167
866653800,176,3,2,9,190
866663546,39,13,6,11,69
866681765,78,50,28,99,255
866682089,180,3,2,21,206
866695632,11,31,2,31,75
866697215,73,3,2,3,81
866700329,69,3,2,16,90
866707345,11,3,2,3,19
866715377,129,28,15,1,173
866718497,148,43,2,3,196
866721580,78,6,11,43,138
866721732,105,17,2,1,125
866727222,35,3,2,1,41
866751285,31,17,3,5,56
866753159,11,10,8,3,32
866753282,60,83,2,16,161
866772446,68,37,2,1,108
866777651,78,36,5,5,124
866779945,442,3,2,11,458
866790038,36,3,2,2,43
866793487,71,3,2,1,77
866800228,55,11,17,2,85
866816856,42,73,100,1,216
866830066,45,18,2,3,68
866830654,39,25,6,13,83
866834325,14,3,2,1,20
866836365,21,3,2,1,27
866851421,44,44,30,8,126
866855004,13,20,2,2,37
866857881,89,25,35,1,150
866862845,30,49,4,8,91
866863421,157,28,6,3,194
866873228,60,38,9,22,129
866881662,62,32,18,20,132
866882586,33,3,2,2,40
866888026,69,45,55,3,172
866907927,73,43,29,23,168
866918752,13,3,2,1,19
866928892,44,41,5,1,91
866941298,102,14,12,5,133
866946514,13,43,2,1,59
866958023,18,12,7,13,50
866960654,526,3,2,17,548
866962191,172,3,2,30,207
866965184,90,66,147,27,330
866968637,61,3,2,1,67
866976978,398,3,2,29,432
866982349,114,3,2,1,120
866987347,233,77,17,57,384
866997858,97,10,3,13,123
867003542,71,3,2,3,79
867004311,35,11,2,5,53
867006177,31,6,2,5,44
867008901,70,26,2,1,99
867009151,20,16,2,1,39
867034960,35,30,11,3,79
867040769,129,33,14,4,180
867045208,13,3,2,1,19
867051331,78,17,2,1,98
867065403,60,45,15,16,136
867085230,12,11,7,1,31
867087753,14,3,2,1,20
867090020,28,23,16,1,68
867094443,54,27,73,7,161
867119302,49,14,26,3,92
867130337,112,30,93,1,236
867134612,29,19,2,1,51
867145750,18,17,2,2,39
867149235,61,4,8,3,76
867161959,32,71,22,2,127
867171930,14,10,2,1,27
867179960,23,80,23,1,127
867202899,43,20,17,1,81
867211264,11,3,2,1,17
867213228,81,3,2,1,87
867228389,15,3,2,1,21
867235014,35,3,2,2,42
867246175,22,28,17,5,72
867250798,42,3,2,2,49
867255748,89,3,2,8,102
867276473,79,6,2,1,88
867278695,79,19,4,15,117
867281660,103,21,23,13,160
867284586,42,64,20,2,128
867286069,10,3,2,2,17
867291375,27,3,2,1,33
867292206,90,10,2,1,103
867294811,138,26,21,8,193
867304813,186,3,2,6,197
867308035,27,34,5,13,79
867309245,167,41,68,1,277
867322002,43,119,14,20,196
867322462,118,29,6,6,159
867333936,121,12,2,5,140
867362442,100,35,77,8,220
867374811,48,70,15,5,138
867381222,20,29,2,1,52
867382338,12,3,2,1,18
867384548,12,3,2,1,18
867386262,11,5,2,2,20
867389175,48,3,2,1,54
867395827,70,51,31,5,157
867399379,43,9,2,9,63
867410142,110,8,10,14,142
867415131,72,29,11,1,113
867427288,15,6,2,27,50
867442188,32,25,2,2,61
867456569,103,3,2,81,189
867486624,18,3,2,1,24
867490259,11,3,2,1,17
867494880,37,3,2,7,49
867510334,78,25,2,2,107
867516700,13,30,21,3,67
867529839,50,13,6,3,72
867533374,14,13,6,3,36
867534348,13,3,2,2,20
867537595,13,10,2,1,26
867548203,29,13,2,1,45
867549189,149,3,2,1,155
867554215,152,38,2,9,201
867554466,11,3,2,1,17
867556097,12,3,2,1,18
867561155,16,12,2,1,31
867569094,110,205,2,4,321
867602885,17,3,2,1,23
867603400,36,13,26,3,78
867616551,120,27,3,34,184
867616916,18,17,2,2,39
867623313,53,3,2,1,59
867649006,241,3,2,607,853
867650245,10,22,2,1,35
867658152,144,3,2,2,151
867662211,65,38,2,8,113
867666708,18,12,21,12,63
867671006,37,3,2,1,43
867675026,58,3,2,12,75
867684505,34,3,2,2,41
867691392,10,3,2,2,17
867709570,57,16,9,3,85
867717771,139,16,5,1,161
867727140,89,14,2,6,111
867729248,13,3,2,1,19
867744323,39,3,2,1,45
867749312,15,4,2,2,23
867750191,91,3,2,4,100
867750918,27,13,2,1,43
867756644,22,3,2,1,28
867760677,32,63,26,10,131
867780548,197,3,2,15,217
867782992,10,9,3,1,23
867784491,17,3,2,1,23
867795799,66,39,3,2,110
867832727,43,18,32,16,109
867842184,89,23,13,3,128
867843708,10,3,2,3,18
867846623,58,15,7,1,81
867849221,198,22,2,30,252
867855571,35,3,2,1,41
867862536,92,11,2,4,109
867872639,37,6,2,14,59
867878068,52,40,2,9,103
867880700,11,3,2,1,17
867915829,54,3,2,1,60
867932885,65,11,2,6,84
867943739,36,3,2,10,51
867970641,34,29,48,7,118
867975144,30,53,2,1,86
867984849,54,17,91,14,176
867990637,76,14,22,19,131
868010862,31,3,2,1,37
868034716,49,3,2,1,55
868052507,13,3,2,3,21
868058195,24,3,2,9,38
868074897,62,11,11,8,92
868089898,63,30,26,8,127
868100347,11,3,2,1,17
868101725,10,4,2,1,17
868110595,15,11,2,12,40
868127726,97,28,2,1,128
868144319,10,37,2,2,51
868164430,14,25,2,1,42
868169757,85,9,2,55,151
868175799,98,3,2,57,160
868194043,68,3,2,17,90
868200268,21,9,15,1,46
868211802,93,3,2,3,101
868223763,87,17,15,4,123
868235453,82,3,2,2,89
868242294,100,28,21,45,194
868246660,10,6,2,1,19
868254368,11,3,2,1,17
868271666,110,48,2,8,168
868286514,10,3,2,2,17
868299756,30,10,2,1,43
868317853,39,51,16,4,110
868354727,93,6,21,4,124
868369928,67,36,3,5,111
868383238,46,96,5,25,172
868393448,15,21,27,7,70
868399162,84,14,2,1,101
868425235,32,64,17,2,115
868433140,17,3,2,1,23
868436070,194,5,4,5,208
868437619,142,49,130,79,400
868438094,143,46,12,4,205
868449250,113,9,4,3,129
868450688,193,10,39,13,255
868460918,87,7,2,7,103
868466916,31,76,131,18,256
868478379,15,3,2,1,21
868481685,26,80,14,1,121
868482297,11,3,2,1,17
868487649,44,13,13,1,71
868489098,14,3,2,1,20
868492309,87,3,2,1,93
868494607,56,12,2,10,80
868513952,46,15,2,43,106
868522609,19,14,4,8,45
868527309,83,35,3,18,139
868536225,64,11,2,3,80
868544327,51,40,109,10,210
868567245,19,3,2,1,25
868580072,40,18,54,14,126
868613631,11,3,2,1,17
868614789,93,28,16,2,139
868623411,11,3,2,1,17
868629444,165,3,2,2,172
868641829,91,37,86,6,220
868648555,12,27,2,3,44
868650794,11,51,2,2,66
868661438,38,30,7,2,77
868664429,13,37,2,14,66
868670315,85,41,2,11,139
868676129,22,3,2,1,28
868679522,10,5,2,1,18
868694494,51,36,15,3,105
868698303,71,28,2,2,103
868699205,18,3,2,1,24
868712806,78,23,2,9,112
868716867,57,3,2,1,63
868720081,71,40,2,6,119
868734193,69,3,11,1,84
868738148,61,15,3,1,80
868743514,48,15,2,6,71
868750582,48,3,2,1,54
868761756,96,3,2,3,104
868768871,39,3,2,1,45
868779079,12,3,2,1,18
868810109,90,54,4,86,234
868811089,17,3,2,1,23
868824957,63,9,2,1,75
868838209,87,23,17,23,150
868845895,50,8,19,12,89
868851327,26,45,2,1,74
868859858,63,16,10,12,101
868866636,13,3,2,1,19
868868999,162,54,9,4,229
868871434,121,26,2,2,151
868880317,45,55,28,6,134
868888258,112,72,72,19,275
868897883,146,36,28,1,211
868917563,21,19,23,3,66
868919928,50,38,24,4,116
868928881,29,19,2,5,55
868933212,16,3,2,1,22
868933230,10,4,2,2,18
868934174,80,3,2,5,90
868941353,29,43,30,1,103
868946322,10,24,2,1,37
868949026,51,31,3,89,174
868967143,205,3,2,6,216
868972416,75,28,63,12,178
868975514,16,3,2,1,22
868977561,77,27,3,1,108
868981611,97,3,2,3,105
868988580,39,56,2,1,98
869004695,105,11,16,2,134
869013980,27,29,13,1,70
869019419,12,3,2,1,18
869037443,27,3,2,12,44
869045080,117,19,121,1,258
869061193,17,3,2,1,23
869071927,13,3,2,1,19
869088959,30,12,30,16,88
869091771,131,19,2,6,158
869102429,92,13,2,1,108
869113391,34,34,2,4,74
869115967,54,40,39,16,149
869126273,78,15,2,1,96
869130345,51,65,2,1,119
869144340,69,16,38,25,148
869159626,48,17,3,2,70
869181345,134,3,2,3,142
869185120,32,13,2,1,48
869200165,88,17,2,4,111
869210886,91,3,2,1,97
869222011,26,52,2,1,81
869229374,28,11,26,7,72
869231425,28,13,2,1,44
869232769,28,4,2,9,43
869234903,137,3,2,2,144
869236543,77,4,28,1,110
869253313,27,38,15,1,81
869274519,14,3,2,1,20
869286967,162,57,11,11,241
869295369,16,3,2,2,23
869295452,173,3,2,1,179
869300363,35,55,23,7,120
869318644,59,3,7,11,80
869335796,37,17,2,6,62
869354287,98,3,2,1,104
869356477,69,41,8,3,121
869358099,117,43,6,1,167
869367357,285,20,10,3,318
869368179,22,27,5,1,55
869415370,45,3,2,4,54
869425212,11,18,2,1,32
869444910,34,12,2,7,55
869446051,111,32,14,21,178
869461702,55,15,2,2,74
869474276,85,3,2,5,95
869483426,12,39,2,1,54
869488067,80,36,10,7,133
869491459,13,3,2,2,20
869495450,120,15,2,15,152
869496539,82,6,2,1,91
869497454,10,3,2,2,17
869503356,47,11,2,6,66
869506103,74,3,2,2,81
869509819,26,3,2,1,32
869549708,48,24,5,33,110
869551054,21,3,2,1,27
869555200,64,28,61,22,175
869556799,39,3,2,1,45
869561421,427,33,10,9,479
869590877,11,15,2,1,29
869601640,57,18,10,48,133
869603652,68,3,2,3,76
869603732,72,3,2,14,91
869607330,10,19,2,2,33
869619075,59,9,3,9,80
869631151,14,5,2,2,23
869635158,21,10,2,1,34
869635201,70,26,69,36,201
869644612,71,10,2,24,107
869658785,165,3,2,3,173
869670317,248,41,2,7,298
869676305,27,50,2,11,90
869677564,84,9,2,1,96
869680073,36,45,2,4,87
869684497,128,13,2,4,147
869692475,16,3,2,8,29
869696652,20,44,17,1,82
869702994,10,5,2,1,18
869718276,45,46,2,34,127
869728325,43,5,29,3,80
869735144,174,16,2,10,202
869743361,18,42,2,1,63
869743422,67,3,2,1,73
869746722,15,27,3,1,46
869751820,11,3,2,1,17
869773573,66,5,2,5,78
869777587,73,9,2,1,85
869802811,41,29,55,12,137
869805041,129,21,27,4,181
869835585,22,3,2,2,29
869836299,37,3,2,11,53
869844271,31,3,2,4,40
869845370,81,6,2,1,90
869869588,122,34,9,34,199
869884317,115,19,3,49,186
869886180,61,3,2,1,67
869892402,10,5,2,3,20
869893623,25,6,6,1,38
869901048,30,30,27,7,94
869915489,108,48,10,1,167
869916074,183,57,2,7,249
869940893,38,7,6,7,58
869942383,90,23,11,2,126
869947720,471,3,2,1,477
869947754,112,47,6,15,180
869948719,14,20,2,1,37
869950523,38,48,40,14,140
869957995,68,34,5,128,235
869973746,70,52,3,2,127
869976142,10,5,2,1,18
869985372,68,24,26,1,119
869988010,18,16,2,1,37
869990885,83,16,2,1,102
869992487,34,3,2,6,45
870013670,52,3,3,1,59
870023575,29,32,10,10,81
870023639,70,10,2,8,90
870028813,122,47,2,1,172
870039553,10,3,2,2,17
870039793,171,61,21,5,258
870042821,15,17,2,1,35
870043732,13,3,2,1,19
870063805,23,3,2,2,30
870069722,11,12,2,2,27
870070204,104,60,18,66,248
870087272,106,25,3,1,135
870093110,19,20,2,1,42
870093323,23,7,2,1,33
870102542,143,3,2,1,149
870109893,43,3,2,14,62
870132876,52,23,10,1,86
870136950,24,3,2,1,30
870137546,192,26,2,2,222
870137780,47,3,2,3,55
870159866,27,69,6,16,118
870163198,12,3,2,1,18
870219069,52,3,2,1,58
870229454,17,3,2,1,23
870260841,27,3,2,2,34
870263827,25,18,6,1,50
870272536,11,3,2,1,17
870273514,58,3,2,4,67
870274102,11,3,2,1,17
870285538,13,8,2,1,24
870288337,114,12,12,2,140
870289741,82,32,13,4,131
870297967,54,3,28,5,90
870304644,15,12,2,1,30
870308886,109,24,104,11,248
870347504,93,36,89,21,239
870356835,45,26,2,12,85
870361575,60,16,112,1,189
870369331,55,11,36,20,122
870373024,79,3,3,4,89
870379626,25,3,2,1,31
870381934,211,29,3,14,257
870396230,181,3,2,2,188
870411096,26,34,7,16,83
870412538,16,26,6,3,51
870412985,45,7,3,1,56
870465756,23,28,19,8,78
870471693,21,20,2,1,44
870478186,17,3,2,1,23
870493080,112,23,14,4,153
870494278,142,35,11,14,202
870503097,60,39,2,2,103
870510341,45,3,2,1,51
870512857,17,10,2,1,30
870513507,105,15,44,2,166
870550020,56,64,23,2,145
870558006,98,3,2,1,104
870581951,29,4,2,1,36
870589416,54,54,26,6,140
870591559,66,58,36,16,176
870594998,24,13,16,6,59
870597267,114,3,2,1,120
870629335,93,20,94,1,208
870648054,13,6,2,1,22
870666976,83,16,15,1,115
870676749,60,19,37,5,121
870677256,32,7,2,6,47
870692863,318,38,7,4,367
870714682,62,3,2,1,68
870730200,114,38,9,19,180
870731597,51,3,2,1,57
870745759,57,26,2,47,132
870749391,31,40,11,6,88
870753940,51,29,13,3,96
870789014,69,3,2,1,75
870792429,37,8,2,1,48
870809254,69,25,13,5,112
870813975,21,10,2,1,34
870817407,10,39,2,1,52
870818441,26,28,29,6,89
870819143,76,44,57,5,182
870819577,21,3,2,1,27
870824929,12,3,2,1,18
870832799,106,33,2,3,144
870835961,29,21,2,3,55
870836052,148,51,56,19,274
870844034,117,17,2,7,143
870850566,147,23,6,1,177
870855018,33,17,11,4,65
870862737,67,20,2,1,90
870884604,137,52,13,52,254
870892488,11,13,2,1,27
870897905,101,3,2,8,114
870906223,11,3,2,3,19
870912651,24,15,2,9,50
870917988,108,4,3,2,117
870919357,61,44,10,1,116
870933549,92,6,9,1,108
870936300,79,13,49,1,142
870939958,12,5,2,1,20
870949349,47,30,6,31,114
870964198,91,12,2,3,108
870965747,15,16,2,1,34
870968363,75,25,4,6,110
870980721,127,35,22,16,200
870980930,29,24,17,1,71
870984672,60,12,31,1,104
870989384,52,3,2,1,58
870994813,21,19,2,1,43
870996741,107,36,23,1,167
870999496,97,3,2,1,103
871007232,51,11,6,15,83
871019165,69,64,3,1,137
871020092,58,31,24,18,131
871028632,82,18,2,1,103
871029740,13,3,2,1,19
871040375,48,7,10,3,68
871051577,31,5,2,5,43
871056064,135,3,2,6,146
871062107,69,19,153,1,242
871067624,80,3,2,1,86
871079401,37,15,2,2,56
871080679,58,3,2,1,64
871093720,35,3,2,7,47
871100914,161,18,149,6,334
871101869,146,34,9,30,219
871104887,12,3,2,1,18
871113290,83,19,2,28,132
871117691,16,3,2,1,22
871120643,11,3,2,1,17
871121247,33,3,2,1,39
871123542,21,14,68,3,106
871143707,25,4,3,1,33
871155300,58,24,35,4,121
871171878,13,7,2,2,24
871183068,98,3,2,3,106
871183689,62,30,19,11,122
871186634,148,3,2,1,154
871186675,51,13,8,3,75
871186937,59,47,4,11,121
871190726,48,8,2,6,64
871194408,126,9,9,2,146
871195326,155,17,38,5,215
871198466,65,26,2,10,103
871203099,58,3,2,1,64
871220260,41,41,3,10,95
871225347,12,12,7,1,32
871227736,15,3,2,19,39
871231242,122,3,2,9,136
871243492,17,7,2,2,28
871264625,101,30,7,3,141
871269971,96,3,2,2,103
871271416,22,86,13,9,130
871274169,130,3,2,13,148
871307326,10,7,2,1,20
871326019,15,18,2,1,36
871333959,77,3,2,1,83
871341528,62,8,2,3,75
871343304,35,3,2,2,42
871343488,35,21,29,4,89
871343919,71,3,2,1,77
871363390,86,3,2,3,94
871386888,25,23,2,1,51
871391096,114,35,4,22,175
871396526,62,29,15,6,112
871401316,88,42,69,4,203
871410631,107,31,20,26,184
871426759,19,15,4,6,44
871439841,99,3,2,24,128
871443494,41,16,2,1,60
871444400,14,3,2,1,20
871452712,53,60,14,9,136
871456457,75,25,3,1,104
871461204,113,14,2,6,135
871472467,41,18,5,1,65
871476076,102,17,2,4,125
871513606,19,13,2,1,35
871549218,43,3,2,41,89
871566014,171,32,3,2,208
871572727,94,32,3,3,132
871579854,16,6,2,6,30
871610518,143,11,27,1,182
871611182,149,29,10,54,242
871613910,108,3,2,1,114
871631981,90,3,2,56,151
871634893,14,31,2,1,48
871645657,15,3,2,1,21
871646680,85,15,2,8,110
871654765,37,3,2,1,43
871671061,153,3,2,1,159
871673447,80,21,4,1,106
871674953,78,44,4,12,138
871676597,101,39,42,11,193
871680309,50,10,2,3,65
871695140,99,3,2,1,105
871706746,52,71,52,20,195
871734846,35,43,14,7,99
871744800,180,68,99,68,415
871753818,65,22,6,5,98
871759338,79,30,2,12,123
871775203,61,27,18,11,117
871780359,21,20,43,1,85
871794018,32,23,10,9,74
871794422,53,7,70,3,133
871797267,12,5,2,1,20
871803919,181,11,105,5,302
871807276,17,3,2,1,23
871808254,90,25,14,5,134
871832304,13,3,2,1,19
871833624,12,3,2,2,19
871852892,97,27,82,33,239
871856363,32,3,2,1,38
871857089,146,30,31,1,208
871862630,25,22,2,4,53
871864775,92,34,169,11,306
871869277,18,30,2,9,59
871872532,27,52,42,1,122
871875092,11,15,2,1,29
871886285,75,3,2,1,81
871897716,16,3,2,1,22
871901851,30,49,18,6,103
871909611,46,56,24,23,149
871909652,83,3,2,1,89
871915414,10,4,2,1,17
871915772,12,3,2,1,18
871922823,13,3,2,1,19
871949091,16,3,2,1,22
871965286,21,3,2,1,27
871965431,70,21,2,6,99
871977394,48,9,12,1,70
871984633,62,19,34,16,131
871989479,150,15,3,1,169
872032658,77,3,2,8,90
872049465,27,12,2,1,42
872050425,27,38,2,1,68
872069097,219,3,2,1,225
872071490,12,46,2,4,64
872076501,258,47,23,10,338
872081977,48,62,44,4,158
872091310,12,3,2,1,18
872097199,31,3,2,2,38
872121555,73,34,65,1,173
872162239,65,27,30,3,125
872171048,25,3,2,1,31
872178036,25,106,23,6,160
872216853,158,14,46,19,237
872220337,11,3,2,1,17
872236743,76,3,2,1,82
872237249,31,6,2,1,40
872252400,19,23,2,1,45
872260175,169,3,2,7,181
872263906,21,19,2,3,45
872264458,16,3,2,1,22
872266631,111,65,2,52,230
872279021,86,11,4,20,121
872279715,122,3,2,1,128
872298203,66,41,14,12,133
872302401,38,8,2,1,49
872306139,35,38,2,6,81
872306878,50,15,6,14,85
872308217,72,3,2,1,78
872310285,34,53,18,10,115
872314176,19,11,5,1,36
872317340,80,55,14,5,154
872318455,126,20,5,15,166
872326300,10,10,2,1,23
872329148,42,7,2,10,61
872340830,23,8,2,32,65
872358898,237,3,2,9,251
872361430,33,30,2,2,67
872364552,62,20,10,15,107
872369260,123,3,2,1,129
872375091,46,63,10,22,141
872391440,90,29,66,10,195
872398334,154,23,42,2,221
872406696,111,29,10,19,169
872407376,10,3,2,3,18
872407484,106,3,2,16,127
872411106,19,3,2,1,25
872414380,65,3,2,1,71
872416734,23,43,30,10,106
872422918,174,3,2,16,195
872423037,27,3,2,2,34
872429447,68,36,11,15,130
872433745,56,3,2,2,63
872444709,63,25,29,14,131
872448359,80,3,2,1,86
872450229,22,13,46,1,82
872453314,81,30,81,2,194
872459165,13,10,2,1,26
872461857,208,15,83,8,314
872465680,59,3,8,1,71
872468663,136,59,26,13,234
872473045,60,69,27,7,163
872482121,23,25,5,1,54
872492013,110,13,2,28,153
872500619,58,55,25,13,151
872501483,10,3,2,3,18
872532875,39,28,2,2,71
872560320,65,33,8,4,110
872563344,20,7,2,1,30
872569575,163,58,2,6,229
872572811,11,3,2,1,17
872574447,65,12,56,2,135
872576289,17,3,2,3,25
872590410,61,5,2,4,72
872594155,89,32,136,27,284
872630944,47,3,2,1,53
872632224,15,3,2,6,26
872641230,110,3,12,1,126
872647216,33,3,2,2,40
872654519,71,6,5,2,84
872655548,10,6,2,1,19
872658171,13,3,2,2,20
872664902,100,3,15,2,120
872682217,52,3,2,1,58
872684932,23,11,8,9,51
872690573,16,3,2,1,22
872718408,11,3,2,1,17
872721421,220,49,18,49,336
872731611,12,24,2,5,43
872738989,61,16,2,1,80
872758640,38,3,2,6,49
872761005,76,3,4,1,84
872762192,97,23,2,2,124
872766213,117,26,7,1,151
872771771,11,3,2,1,17
872772017,53,25,2,1,81
872778413,35,43,2,3,83
872785408,61,3,2,1,67
872786225,60,33,3,25,121
872814435,204,3,2,1,210
872819159,10,4,2,1,17
872826950,71,7,11,3,92
872830295,74,46,8,25,153
872830367,39,21,3,2,65
872842153,149,78,34,4,265
872852529,67,34,2,15,118
872854438,37,17,2,5,61
872860013,56,3,2,4,65
872862776,81,39,2,2,124
872880921,24,6,2,17,49
872890707,56,16,8,2,82
872904902,27,4,2,1,34
872908054,49,3,2,1,55
872917458,19,26,2,2,49
872917523,107,9,2,3,121
872918891,10,3,2,2,17
872928579,79,64,2,3,148
872928949,20,8,2,1,31
872950484,18,28,2,3,51
872966899,21,44,2,1,68
872968058,36,59,5,5,105
872979708,15,3,2,1,21
872986466,69,3,2,1,75
872986545,109,22,23,11,165
872987002,83,14,23,5,125
873001913,39,33,2,1,75
873011665,72,22,5,9,108
873014052,11,11,2,3,27
873015337,127,3,2,2,134
873016207,43,30,4,11,88
873022792,51,17,2,5,75
873031185,12,23,2,2,39
873034682,103,61,24,5,193
873042918,116,36,64,9,225
873060869,50,65,2,1,118
873064381,46,12,2,8,68
873081446,13,4,2,2,21
873082379,12,3,2,2,19
873094368,51,32,8,1,92
873101977,54,3,2,1,60
873110873,13,3,2,1,19
873126435,13,6,2,2,23
873137651,24,4,2,7,37
873140552,42,37,2,11,92
873150067,68,3,2,13,86
873151442,105,63,44,9,221
873152120,55,74,3,1,133
873152861,35,24,2,1,62
873153849,15,3,2,1,21
873173715,145,35,2,28,210
873175317,159,34,2,1,196
873183580,85,24,2,2,113
873184121,27,76,15,1,119
873189040,37,26,9,9,81
873191926,74,8,2,1,85
873192476,17,4,2,1,24
873199827,38,4,3,1,46
873220892,49,19,36,14,118
873225787,58,34,9,6,107
873226668,12,13,2,1,28
873242780,43,46,23,43,155
873243847,151,38,2,11,202
873244052,55,3,2,1,61
873253628,64,26,17,1,108
873262152,14,11,2,1,28
873266528,17,3,2,1,23
873275165,118,11,2,32,163
873296675,88,29,58,1,176
873299137,47,3,2,3,55
873305088,41,111,48,14,214
873309974,101,57,12,11,181
873314916,89,47,39,2,177
873315639,32,27,5,1,65
873339101,192,3,2,1,198
873349457,101,6,2,1,110
873369943,107,3,2,1,113
873374802,214,55,2,4,275
873394035,82,16,36,2,136
873402297,37,3,2,1,43
873408962,111,19,2,30,162
873410992,29,33,35,10,107
873416878,69,15,2,1,87
873419959,21,3,2,1,27
873433144,107,67,20,25,219
873438844,32,3,2,1,38
873441881,30,56,10,4,100
873450223,24,3,2,1,30
873466041,40,15,7,1,63
873490104,93,22,3,10,128
873491859,30,5,17,8,60
873502435,19,46,30,2,97
873505127,161,24,18,2,205
873534705,95,6,2,1,104
873541168,12,3,2,1,18
873555712,89,16,2,5,112
873574458,144,3,2,4,153
873589784,390,3,2,12,407
873609691,48,7,2,1,58
873616414,78,27,16,7,128
873619407,55,62,58,1,176
873620248,11,5,2,1,19
873620385,113,64,15,25,217
873650918,155,17,58,1,231
873651291,15,3,2,1,21
873666947,25,29,2,3,59
873678501,10,7,2,1,20
873690348,106,6,67,4,183
873704925,50,3,2,16,71
873707948,13,48,21,2,84
873709655,62,8,2,5,77
873722158,58,23,2,5,88
873738801,90,13,2,2,107
873742349,120,9,22,2,153
873743634,11,3,2,1,17
873772111,42,26,16,2,86
873772452,83,13,35,3,134
873785909,49,5,6,3,63
873825105,65,30,2,1,98
873825408,113,29,25,6,173
873827729,28,33,4,32,97
873828036,70,14,2,4,90
873831507,577,3,2,23,605
873838338,18,33,2,1,54
873843110,10,6,2,1,19
873859649,147,3,2,15,167
873871099,16,12,2,2,32
873875251,53,3,2,3,61
873877255,29,16,25,1,71
873886735,29,11,13,4,57
873888574,11,26,2,1,40
873894473,36,54,4,1,95
873895169,63,8,5,19,95
873895677,192,9,11,5,217
873900352,35,18,10,12,75
873902328,75,3,2,1,81
873921460,56,79,43,17,195
873925647,57,57,2,3,119
873938702,132,26,19,6,183
873947140,10,30,2,4,46
873976262,37,20,4,1,62
873980896,62,3,2,4,71
873987285,21,22,5,1,49
873993346,184,6,12,19,221
874000915,38,15,2,1,56
874003972,147,29,2,1,179
874006465,30,31,21,11,93
874009931,58,23,50,3,134
874011329,35,10,7,10,62
874017627,17,3,2,1,23
874069606,61,29,24,1,115
874094610,102,3,2,2,109
874108140,75,30,7,8,120
874109820,59,12,2,1,74
874118549,203,65,87,63,418
874136997,24,43,6,4,77
874138280,23,18,13,1,55
874139302,79,3,2,1,85
874139899,109,37,9,1,156
874147176,40,3,2,1,46
874152278,62,3,2,18,85
874156461,92,24,13,55,184
874159106,32,6,9,3,50
874177862,114,28,82,9,233
874183528,81,3,2,1,87
874190752,161,28,2,2,193
874198437,77,26,28,16,147
874218476,11,8,2,1,22
874223455,277,3,2,5,287
874228671,57,3,2,1,63
874240049,116,3,2,8,129
874241905,18,46,28,1,93
874249056,27,3,2,1,33
874254738,145,3,2,1,151
874255876,45,21,18,1,85
874273511,10,9,2,1,22
874283549,29,5,2,1,37
874287471,82,27,5,52,166
874288316,68,3,2,1,74
874293928,160,34,38,59,291
874301411,97,3,4,1,105
874311257,11,3,2,1,17
874315398,50,48,37,1,136
874317536,80,57,23,22,182
874319172,12,44,2,1,59
874327223,10,3,2,2,17
874337747,15,3,2,3,23
874374767,17,44,10,1,72
874377467,173,3,2,21,199
874392656,88,14,2,6,110
874395351,64,13,9,11,97
874397455,72,33,16,9,130
874403408,85,40,23,15,163
874406858,32,12,20,4,68
874421748,48,18,14,1,81
874422284,115,12,24,100,251
874424860,237,10,9,25,281
874429564,32,79,29,9,149
874433326,66,8,42,5,121
874442469,39,6,3,8,56
874444294,44,3,2,4,53
874458403,52,60,30,1,143
874464022,250,4,2,4,260
874470327,242,38,29,28,337
874474511,88,28,2,8,126
874483825,11,5,2,4,22
874492051,137,35,7,4,183
874509532,129,22,11,6,168
874510239,109,17,2,1,129
874512589,108,20,2,4,134
874512869,139,18,24,8,189
874515558,79,48,24,4,155
874522732,96,29,8,59,192
874535751,69,60,13,66,208
874546467,59,14,18,1,92
874552270,94,3,2,1,100
874560212,18,3,2,4,27
874580861,20,6,2,1,29
874584115,25,3,2,1,31
874600548,115,48,14,4,181
874600864,15,13,2,5,35
874603468,49,17,34,11,111
874631374,101,29,58,5,193
874640418,67,11,2,10,90
874651240,28,24,2,7,61
874667858,37,45,2,1,85
874692926,102,3,2,1,108
874694379,60,3,2,5,70
874695782,15,41,11,1,68
874701453,61,35,2,3,101
874704955,100,42,35,10,187
874710819,27,46,11,5,89
874712900,150,26,15,4,195
874714729,135,3,2,24,164
874734998,42,40,8,1,91
874746266,36,46,68,1,151
874754541,187,35,41,23,286
874755230,24,17,2,1,44
874777773,95,49,3,3,150
874781675,18,3,2,1,24
874784589,113,10,6,5,134
874801080,189,3,2,2,196
874805706,47,4,2,5,58
874838827,71,57,116,129,373
874840441,37,44,3,1,85
874856552,12,3,2,1,18
874873327,114,6,2,1,123
874882910,34,3,2,1,40
874889974,83,3,2,1,89
874897439,26,14,2,1,43
874914785,66,35,4,3,108
874927595,10,3,2,2,17
874937012,88,3,2,4,97
874952193,93,43,19,8,163
874975754,17,13,4,6,40
874983157,95,16,2,17,130
874983770,59,16,7,1,83
874984496,156,19,28,3,206
874988296,18,11,2,3,34
874999751,60,3,2,1,66
875002245,66,16,2,2,86
875003981,146,58,8,43,255
875006873,31,3,2,6,42
875020155,67,52,4,16,139
875024433,20,32,2,1,55
875025117,114,38,169,69,390
875042742,27,61,5,5,98
875064380,14,23,2,5,44
875069505,20,19,3,2,44
875078783,55,13,2,13,83
875083089,78,3,2,5,88
875084954,81,22,8,12,123
875092789,46,6,2,12,66
875114941,64,25,50,1,140
875117296,130,3,2,30,165
875118687,62,78,39,4,183
875130377,21,4,2,1,28
875132220,36,41,14,6,97
875147367,12,6,3,1,22
875157478,46,22,42,3,113
875160140,30,3,2,4,39
875175041,82,27,20,1,130
875181210,82,3,2,7,94
875196593,81,3,2,1,87
875199917,47,34,7,1,89
875206896,79,11,53,4,147
875212040,155,13,6,64,238
875222771,59,3,2,1,65
875232662,27,3,2,6,38
875236842,11,3,2,1,17
875261871,11,17,2,3,33
875263164,177,20,4,5,206
875296941,10,6,2,1,19
875315684,43,3,2,1,49
875320225,54,6,26,3,89
875324327,20,28,2,5,55
875365891,35,38,48,7,128
875369191,150,11,2,6,169
875369349,56,37,3,8,104
875376982,96,24,33,4,157
875377071,156,10,17,3,186
875388324,83,23,18,9,133
875396043,12,3,2,1,18
875403606,42,85,12,13,152
875407306,118,83,20,50,271
875408370,51,8,20,12,91
875413539,20,3,2,6,31
875416557,230,54,3,11,298
875432472,39,14,2,2,57
875436250,12,3,2,1,18
875448418,69,3,2,1,75
875452595,14,3,2,1,20
875453024,11,3,2,1,17
875454517,11,3,2,2,18
875456190,13,3,2,1,19
875456583,52,20,2,16,90
875467327,35,22,31,1,89
875475072,81,37,2,1,121
875478517,56,15,10,3,84
875481914,49,28,91,87,255
875484829,233,10,5,1,249
875488178,104,3,2,1,110
875505005,27,47,37,53,164
875508051,28,3,2,1,34
875511290,13,5,2,1,21
875514158,54,8,18,4,84
875528729,71,4,14,1,90
875536451,109,3,2,11,125
875555772,26,22,2,1,51
875568109,124,15,2,12,153
875577833,115,80,9,5,209
875589010,48,3,82,8,141
875593202,143,9,2,4,158
875594835,51,3,2,1,57
875599149,58,15,27,17,117
875606621,25,3,2,1,31
875619290,103,6,2,10,121
875625622,10,4,2,1,17
875625635,41,3,2,1,47
875628606,20,14,23,1,58
875636141,132,3,2,11,148
875638608,24,6,2,1,33
875656523,79,9,2,7,97
875663288,44,111,57,9,221
875670226,10,5,2,1,18
875674475,128,18,20,1,167
